date,country,new_cases,new_deaths,total_cases,total_deaths
2020-02-24,Afghanistan,1,0,1,0
2020-02-25,Afghanistan,0,0,1,0
2020-02-26,Afghanistan,0,0,1,0
2020-02-27,Afghanistan,0,0,1,0
2020-02-28,Afghanistan,0,0,1,0
2020-02-29,Afghanistan,0,0,1,0
2020-03-01,Afghanistan,0,0,1,0
2020-03-02,Afghanistan,0,0,1,0
2020-03-03,Afghanistan,1,0,2,0
2020-03-04,Afghanistan,2,0,4,0
2020-03-05,Afghanistan,0,0,4,0
2020-03-06,Afghanistan,0,0,4,0
2020-03-07,Afghanistan,0,0,4,0
2020-03-08,Afghanistan,1,0,5,0
2020-03-09,Afghanistan,2,0,7,0
2020-03-10,Afghanistan,1,0,8,0
2020-03-11,Afghanistan,3,0,11,0
2020-03-12,Afghanistan,1,0,12,0
2020-03-13,Afghanistan,1,0,13,0
2020-03-14,Afghanistan,2,0,15,0
2020-03-15,Afghanistan,1,0,16,0
2020-03-16,Afghanistan,2,0,18,0
2020-03-17,Afghanistan,2,0,20,0
2020-03-18,Afghanistan,4,0,24,0
2020-03-19,Afghanistan,1,0,25,0
2020-03-20,Afghanistan,4,0,29,0
2020-03-21,Afghanistan,1,0,30,0
2020-03-22,Afghanistan,4,1,34,1
2020-03-23,Afghanistan,7,0,41,1
2020-03-24,Afghanistan,2,0,43,1
2020-03-25,Afghanistan,33,1,76,2
2020-03-26,Afghanistan,4,1,80,3
2020-03-27,Afghanistan,11,0,91,3
2020-03-28,Afghanistan,16,1,107,4
2020-03-29,Afghanistan,11,0,118,4
2020-03-30,Afghanistan,28,0,146,4
2020-03-31,Afghanistan,29,0,175,4
2020-04-01,Afghanistan,22,0,197,4
2020-04-02,Afghanistan,43,0,240,4
2020-04-03,Afghanistan,35,4,275,8
2020-04-04,Afghanistan,25,2,300,10
2020-04-05,Afghanistan,38,2,338,12
2020-04-06,Afghanistan,30,3,368,15
2020-04-07,Afghanistan,56,1,424,16
2020-04-08,Afghanistan,21,0,445,16
2020-04-09,Afghanistan,40,1,485,17
2020-04-10,Afghanistan,47,1,532,18
2020-04-11,Afghanistan,24,0,556,18
2020-04-12,Afghanistan,52,1,608,19
2020-04-13,Afghanistan,58,3,666,22
2020-04-14,Afghanistan,49,1,715,23
2020-04-15,Afghanistan,70,6,785,29
2020-04-16,Afghanistan,56,1,841,30
2020-04-17,Afghanistan,66,0,907,30
2020-04-18,Afghanistan,27,0,934,30
2020-04-19,Afghanistan,63,3,997,33
2020-04-20,Afghanistan,30,3,1027,36
2020-04-21,Afghanistan,66,0,1093,36
2020-04-22,Afghanistan,84,4,1177,40
2020-04-23,Afghanistan,59,0,1236,40
2020-04-24,Afghanistan,95,3,1331,43
2020-04-25,Afghanistan,133,4,1464,47
2020-04-26,Afghanistan,68,5,1532,52
2020-04-27,Afghanistan,172,6,1704,58
2020-04-28,Afghanistan,126,1,1830,59
2020-04-29,Afghanistan,110,2,1940,61
2020-04-30,Afghanistan,187,3,2127,64
2020-05-01,Afghanistan,164,4,2291,68
2020-05-02,Afghanistan,179,4,2470,72
2020-05-03,Afghanistan,235,13,2705,85
2020-05-04,Afghanistan,190,5,2895,90
2020-05-05,Afghanistan,330,5,3225,95
2020-05-06,Afghanistan,168,9,3393,104
2020-05-07,Afghanistan,171,2,3564,106
2020-05-08,Afghanistan,217,3,3781,109
2020-05-09,Afghanistan,261,6,4042,115
2020-05-10,Afghanistan,361,5,4403,120
2020-05-11,Afghanistan,284,2,4687,122
2020-05-12,Afghanistan,281,5,4968,127
2020-05-13,Afghanistan,259,5,5227,132
2020-05-14,Afghanistan,413,4,5640,136
2020-05-15,Afghanistan,414,17,6054,153
2020-05-16,Afghanistan,349,15,6403,168
2020-05-17,Afghanistan,262,2,6665,170
2020-05-18,Afghanistan,408,3,7073,173
2020-05-19,Afghanistan,581,5,7654,178
2020-05-20,Afghanistan,492,10,8146,188
2020-05-21,Afghanistan,531,6,8677,194
2020-05-22,Afghanistan,542,12,9219,206
2020-05-23,Afghanistan,782,11,10001,217
2020-05-24,Afghanistan,584,2,10585,219
2020-05-25,Afghanistan,591,1,11176,220
2020-05-26,Afghanistan,658,1,11834,221
2020-05-27,Afghanistan,625,7,12459,228
2020-05-28,Afghanistan,580,8,13039,236
2020-05-29,Afghanistan,623,11,13662,247
2020-05-30,Afghanistan,866,3,14528,250
2020-05-31,Afghanistan,680,8,15208,258
2020-06-01,Afghanistan,545,8,15753,266
2020-06-02,Afghanistan,759,8,16512,274
2020-06-03,Afghanistan,758,24,17270,298
2020-06-04,Afghanistan,787,6,18057,304
2020-06-05,Afghanistan,915,9,18972,313
2020-06-06,Afghanistan,582,18,19554,331
2020-06-07,Afghanistan,791,30,20345,361
2020-06-08,Afghanistan,575,12,20920,373
2020-06-09,Afghanistan,542,15,21462,388
2020-06-10,Afghanistan,684,21,22146,409
2020-06-11,Afghanistan,748,21,22894,430
2020-06-12,Afghanistan,656,20,23550,450
2020-06-13,Afghanistan,556,5,24106,455
2020-06-14,Afghanistan,664,20,24770,475
2020-06-15,Afghanistan,761,7,25531,482
2020-06-16,Afghanistan,783,13,26314,495
2020-06-17,Afghanistan,564,13,26878,508
2020-06-18,Afghanistan,658,42,27536,550
2020-06-19,Afghanistan,346,2,27882,552
2020-06-20,Afghanistan,546,21,28428,573
2020-06-21,Afghanistan,409,12,28837,585
2020-06-22,Afghanistan,310,12,29147,597
2020-06-23,Afghanistan,324,20,29471,617
2020-06-24,Afghanistan,234,21,29705,638
2020-06-25,Afghanistan,460,36,30165,674
2020-06-26,Afghanistan,276,8,30441,682
2020-06-27,Afghanistan,165,34,30606,716
2020-06-28,Afghanistan,351,12,30957,728
2020-06-29,Afghanistan,271,12,31228,740
2020-06-30,Afghanistan,279,12,31507,752
2020-07-01,Afghanistan,319,28,31826,780
2020-07-02,Afghanistan,186,29,32012,809
2020-07-03,Afghanistan,302,12,32314,821
2020-07-04,Afghanistan,348,7,32662,828
2020-07-05,Afghanistan,279,38,32941,866
2020-07-06,Afghanistan,239,34,33180,900
2020-07-07,Afghanistan,194,22,33374,922
2020-07-08,Afghanistan,210,17,33584,939
2020-07-09,Afghanistan,314,20,33898,959
2020-07-10,Afghanistan,286,14,34184,973
2020-07-11,Afghanistan,172,23,34356,996
2020-07-12,Afghanistan,85,16,34441,1012
2020-07-13,Afghanistan,154,28,34595,1040
2020-07-14,Afghanistan,135,24,34730,1064
2020-07-15,Afghanistan,254,32,34984,1096
2020-07-16,Afghanistan,76,21,35060,1117
2020-07-17,Afghanistan,159,32,35219,1149
2020-07-18,Afghanistan,60,17,35279,1166
2020-07-19,Afghanistan,174,17,35453,1183
2020-07-20,Afghanistan,40,2,35493,1185
2020-07-21,Afghanistan,112,3,35605,1188
2020-07-22,Afghanistan,112,4,35717,1192
2020-07-23,Afghanistan,201,21,35918,1213
2020-07-24,Afghanistan,60,14,35978,1227
2020-07-25,Afghanistan,48,22,36026,1249
2020-07-26,Afghanistan,121,12,36147,1261
2020-07-27,Afghanistan,106,10,36253,1271
2020-07-28,Afghanistan,105,1,36358,1272
2020-07-29,Afghanistan,105,1,36463,1273
2020-07-30,Afghanistan,69,10,36532,1283
2020-07-31,Afghanistan,133,1,36665,1284
2020-08-01,Afghanistan,35,1,36700,1285
2020-08-02,Afghanistan,1,1,36701,1286
2020-08-03,Afghanistan,36,4,36737,1290
2020-08-04,Afghanistan,36,0,36773,1290
2020-08-05,Afghanistan,47,6,36820,1296
2020-08-06,Afghanistan,108,5,36928,1301
2020-08-07,Afghanistan,78,9,37006,1310
2020-08-08,Afghanistan,40,5,37046,1315
2020-08-09,Afghanistan,37,6,37083,1321
2020-08-10,Afghanistan,70,8,37153,1329
2020-08-11,Afghanistan,107,17,37260,1346
2020-08-12,Afghanistan,76,10,37336,1356
2020-08-13,Afghanistan,86,9,37422,1365
2020-08-14,Afghanistan,75,5,37497,1370
2020-08-15,Afghanistan,45,1,37542,1371
2020-08-16,Afghanistan,48,5,37590,1376
2020-08-17,Afghanistan,77,2,37667,1378
2020-08-18,Afghanistan,43,4,37710,1382
2020-08-19,Afghanistan,40,2,37750,1384
2020-08-20,Afghanistan,102,2,37852,1386
2020-08-21,Afghanistan,33,0,37885,1386
2020-08-22,Afghanistan,59,0,37944,1386
2020-08-23,Afghanistan,46,2,37990,1388
2020-08-24,Afghanistan,55,2,38045,1390
2020-08-25,Afghanistan,16,8,38061,1398
2020-08-26,Afghanistan,42,4,38103,1402
2020-08-27,Afghanistan,16,0,38119,1402
2020-08-28,Afghanistan,11,1,38130,1403
2020-08-29,Afghanistan,3,0,38133,1403
2020-08-30,Afghanistan,22,0,38155,1403
2020-08-31,Afghanistan,4,0,38159,1403
2020-09-01,Afghanistan,34,4,38193,1407
2020-09-02,Afghanistan,50,3,38243,1410
2020-09-03,Afghanistan,45,0,38288,1410
2020-09-04,Afghanistan,16,0,38304,1410
2020-09-05,Afghanistan,20,0,38324,1410
2020-09-06,Afghanistan,74,3,38398,1413
2020-09-07,Afghanistan,96,3,38494,1416
2020-09-08,Afghanistan,26,3,38520,1419
2020-09-09,Afghanistan,24,2,38544,1421
2020-09-10,Afghanistan,28,0,38572,1421
2020-09-11,Afghanistan,34,0,38606,1421
2020-09-12,Afghanistan,35,0,38641,1421
2020-09-13,Afghanistan,75,0,38716,1421
2020-09-14,Afghanistan,56,6,38772,1427
2020-09-15,Afghanistan,43,1,38815,1428
2020-09-16,Afghanistan,40,10,38855,1438
2020-09-17,Afghanistan,17,0,38872,1438
2020-09-18,Afghanistan,25,1,38897,1439
2020-09-19,Afghanistan,22,0,38919,1439
2020-09-20,Afghanistan,125,4,39044,1443
2020-09-21,Afghanistan,30,3,39074,1446
2020-09-22,Afghanistan,22,1,39096,1447
2020-09-23,Afghanistan,49,1,39145,1448
2020-09-24,Afghanistan,25,5,39170,1453
2020-09-25,Afghanistan,16,0,39186,1453
2020-09-26,Afghanistan,6,2,39192,1455
2020-09-27,Afghanistan,35,0,39227,1455
2020-09-28,Afghanistan,12,3,39239,1458
2020-09-29,Afghanistan,15,2,39254,1460
2020-09-30,Afghanistan,14,0,39268,1460
2020-10-01,Afghanistan,17,0,39285,1460
2020-10-02,Afghanistan,5,0,39290,1460
2020-10-03,Afghanistan,7,4,39297,1464
2020-10-04,Afghanistan,44,0,39341,1464
2020-10-05,Afghanistan,81,4,39422,1468
2020-10-06,Afghanistan,64,1,39486,1469
2020-10-07,Afghanistan,62,2,39548,1471
2020-10-08,Afghanistan,68,1,39616,1472
2020-10-09,Afghanistan,77,2,39693,1474
2020-10-10,Afghanistan,10,1,39703,1475
2020-10-11,Afghanistan,96,4,39799,1479
2020-10-12,Afghanistan,71,2,39870,1481
2020-10-13,Afghanistan,58,1,39928,1482
2020-10-14,Afghanistan,66,1,39994,1483
2020-10-15,Afghanistan,32,0,40026,1483
2020-10-16,Afghanistan,62,4,40088,1487
2020-10-17,Afghanistan,53,3,40141,1490
2020-10-18,Afghanistan,59,4,40200,1494
2020-10-19,Afghanistan,87,5,40287,1499
2020-10-20,Afghanistan,82,2,40369,1501
2020-10-21,Afghanistan,141,2,40510,1503
2020-10-22,Afghanistan,116,4,40626,1507
2020-10-23,Afghanistan,61,2,40687,1509
2020-10-24,Afghanistan,81,4,40768,1513
2020-10-25,Afghanistan,65,3,40833,1516
2020-10-26,Afghanistan,104,4,40937,1520
2020-10-27,Afghanistan,95,5,41032,1525
2020-10-28,Afghanistan,113,6,41145,1531
2020-10-29,Afghanistan,123,3,41268,1534
2020-10-30,Afghanistan,66,1,41334,1535
2020-10-31,Afghanistan,91,3,41425,1538
2020-11-01,Afghanistan,76,0,41501,1538
2020-11-02,Afghanistan,132,6,41633,1544
2020-11-03,Afghanistan,95,3,41728,1547
2020-11-04,Afghanistan,86,4,41814,1551
2020-11-05,Afghanistan,121,6,41935,1557
2020-11-06,Afghanistan,40,0,41975,1557
2020-11-07,Afghanistan,58,2,42033,1559
2020-11-08,Afghanistan,126,6,42159,1565
2020-11-09,Afghanistan,138,12,42297,1577
2020-11-10,Afghanistan,166,3,42463,1580
2020-11-11,Afghanistan,146,4,42609,1584
2020-11-12,Afghanistan,186,10,42795,1594
2020-11-13,Afghanistan,174,4,42969,1598
2020-11-14,Afghanistan,66,10,43035,1608
2020-11-15,Afghanistan,205,12,43240,1620
2020-11-16,Afghanistan,228,15,43468,1635
2020-11-17,Afghanistan,213,6,43681,1641
2020-11-18,Afghanistan,243,7,43924,1648
2020-11-19,Afghanistan,253,5,44177,1653
2020-11-20,Afghanistan,186,13,44363,1666
2020-11-21,Afghanistan,140,12,44503,1678
2020-11-22,Afghanistan,203,12,44706,1690
2020-11-23,Afghanistan,282,12,44988,1702
2020-11-24,Afghanistan,186,13,45174,1715
2020-11-25,Afghanistan,210,13,45384,1728
2020-11-26,Afghanistan,216,9,45600,1737
2020-11-27,Afghanistan,123,3,45723,1740
2020-11-28,Afghanistan,121,12,45844,1752
2020-11-29,Afghanistan,272,22,46116,1774
2020-11-30,Afghanistan,158,21,46274,1795
2020-12-01,Afghanistan,242,27,46516,1822
2020-12-02,Afghanistan,202,19,46718,1841
2020-12-03,Afghanistan,119,5,46837,1846
2020-12-04,Afghanistan,0,0,46837,1846
2020-12-05,Afghanistan,235,18,47072,1864
2020-12-06,Afghanistan,234,10,47306,1874
2020-12-07,Afghanistan,210,26,47516,1900
2020-12-08,Afghanistan,200,6,47716,1906
2020-12-09,Afghanistan,135,13,47851,1919
2020-12-10,Afghanistan,202,16,48053,1935
2020-12-11,Afghanistan,63,10,48116,1945
2020-12-12,Afghanistan,113,11,48229,1956
2020-12-13,Afghanistan,298,9,48527,1965
2020-12-14,Afghanistan,191,4,48718,1969
2020-12-15,Afghanistan,234,26,48952,1995
2020-12-16,Afghanistan,209,16,49161,2011
2020-12-17,Afghanistan,217,14,49378,2025
2020-12-18,Afghanistan,243,5,49621,2030
2020-12-19,Afghanistan,60,17,49681,2047
2020-12-20,Afghanistan,136,20,49817,2067
2020-12-21,Afghanistan,196,15,50013,2082
2020-12-22,Afghanistan,177,14,50190,2096
2020-12-23,Afghanistan,243,21,50433,2117
2020-12-24,Afghanistan,222,9,50655,2126
2020-12-25,Afghanistan,155,13,50810,2139
2020-12-26,Afghanistan,76,10,50886,2149
2020-12-27,Afghanistan,153,11,51039,2160
2020-12-28,Afghanistan,241,14,51280,2174
2020-12-29,Afghanistan,70,5,51350,2179
2020-12-30,Afghanistan,55,2,51405,2181
2020-12-31,Afghanistan,121,10,51526,2191
2021-01-01,Afghanistan,0,0,51526,2191
2021-01-02,Afghanistan,0,0,51526,2191
2021-01-03,Afghanistan,0,0,51526,2191
2021-01-04,Afghanistan,1485,46,53011,2237
2021-01-05,Afghanistan,94,7,53105,2244
2021-01-06,Afghanistan,0,0,53105,2244
2021-01-07,Afghanistan,102,9,53207,2253
2021-01-08,Afghanistan,125,4,53332,2257
2021-01-09,Afghanistan,68,7,53400,2264
2021-01-10,Afghanistan,89,13,53489,2277
2021-01-11,Afghanistan,49,11,53538,2288
2021-01-12,Afghanistan,46,13,53584,2301
2021-01-13,Afghanistan,0,0,53584,2301
2021-01-14,Afghanistan,191,13,53775,2314
2021-01-15,Afghanistan,56,10,53831,2324
2021-01-16,Afghanistan,107,12,53938,2336
2021-01-17,Afghanistan,46,3,53984,2339
2021-01-18,Afghanistan,78,4,54062,2343
2021-01-19,Afghanistan,79,3,54141,2346
2021-01-20,Afghanistan,137,8,54278,2354
2021-01-21,Afghanistan,125,9,54403,2363
2021-01-22,Afghanistan,80,7,54483,2370
2021-01-23,Afghanistan,76,3,54559,2373
2021-01-24,Afghanistan,36,5,54595,2378
2021-01-25,Afghanistan,77,7,54672,2385
2021-01-26,Afghanistan,78,4,54750,2389
2021-01-27,Afghanistan,104,0,54854,2389
2021-01-28,Afghanistan,37,8,54891,2397
2021-01-29,Afghanistan,48,2,54939,2399
2021-01-30,Afghanistan,69,1,55008,2400
2021-01-31,Afghanistan,15,0,55023,2400
2021-02-01,Afghanistan,36,4,55059,2404
2021-02-02,Afghanistan,62,1,55121,2405
2021-02-03,Afghanistan,53,1,55174,2406
2021-02-04,Afghanistan,57,1,55231,2407
2021-02-05,Afghanistan,34,0,55265,2407
2021-02-06,Afghanistan,65,1,55330,2408
2021-02-07,Afghanistan,5,2,55335,2410
2021-02-08,Afghanistan,24,3,55359,2413
2021-02-09,Afghanistan,25,1,55384,2414
2021-02-10,Afghanistan,18,4,55402,2418
2021-02-11,Afghanistan,18,1,55420,2419
2021-02-12,Afghanistan,25,5,55445,2424
2021-02-13,Afghanistan,28,3,55473,2427
2021-02-14,Afghanistan,19,0,55492,2427
2021-02-15,Afghanistan,22,0,55514,2427
2021-02-16,Afghanistan,4,1,55518,2428
2021-02-17,Afghanistan,22,0,55540,2428
2021-02-18,Afghanistan,17,2,55557,2430
2021-02-19,Afghanistan,18,0,55575,2430
2021-02-20,Afghanistan,5,0,55580,2430
2021-02-21,Afghanistan,24,2,55604,2432
2021-02-22,Afghanistan,13,1,55617,2433
2021-02-23,Afghanistan,29,2,55646,2435
2021-02-24,Afghanistan,18,1,55664,2436
2021-02-25,Afghanistan,16,2,55680,2438
2021-02-26,Afghanistan,16,4,55696,2442
2021-02-27,Afghanistan,11,1,55707,2443
2021-02-28,Afghanistan,7,0,55714,2443
2021-03-01,Afghanistan,19,1,55733,2444
2021-03-02,Afghanistan,26,2,55759,2446
2021-03-03,Afghanistan,11,0,55770,2446
2021-03-04,Afghanistan,5,0,55775,2446
2021-03-05,Afghanistan,52,3,55827,2449
2021-03-06,Afghanistan,13,0,55840,2449
2021-03-07,Afghanistan,7,0,55847,2449
2021-03-08,Afghanistan,29,2,55876,2451
2021-03-09,Afghanistan,0,0,55876,2451
2021-03-10,Afghanistan,18,0,55894,2451
2021-03-11,Afghanistan,23,0,55917,2451
2021-03-12,Afghanistan,42,3,55959,2454
2021-03-13,Afghanistan,0,0,55959,2454
2021-03-14,Afghanistan,26,3,55985,2457
2021-03-15,Afghanistan,0,2,55985,2459
2021-03-16,Afghanistan,10,1,55995,2460
2021-03-17,Afghanistan,21,0,56016,2460
2021-03-18,Afghanistan,28,2,56044,2462
2021-03-19,Afghanistan,25,0,56069,2462
2021-03-20,Afghanistan,24,0,56093,2462
2021-03-21,Afghanistan,10,1,56103,2463
2021-03-22,Afghanistan,50,1,56153,2464
2021-03-23,Afghanistan,24,2,56177,2466
2021-03-24,Afghanistan,15,0,56192,2466
2021-03-25,Afghanistan,34,1,56226,2467
2021-03-26,Afghanistan,28,0,56254,2467
2021-03-27,Afghanistan,36,2,56290,2469
2021-03-28,Afghanistan,4,1,56294,2470
2021-03-29,Afghanistan,28,2,56322,2472
2021-03-30,Afghanistan,62,4,56384,2476
2021-03-31,Afghanistan,70,8,56454,2484
2021-04-01,Afghanistan,63,5,56517,2489
2021-04-02,Afghanistan,55,6,56572,2495
2021-04-03,Afghanistan,23,1,56595,2496
2021-04-04,Afghanistan,81,1,56676,2497
2021-04-05,Afghanistan,41,11,56717,2508
2021-04-06,Afghanistan,62,4,56779,2512
2021-04-07,Afghanistan,94,0,56873,2512
2021-04-08,Afghanistan,70,4,56943,2516
2020-02-13,Africa,0,0,0,0
2020-02-14,Africa,1,0,1,0
2020-02-15,Africa,0,0,1,0
2020-02-16,Africa,0,0,1,0
2020-02-17,Africa,0,0,1,0
2020-02-18,Africa,0,0,1,0
2020-02-19,Africa,0,0,1,0
2020-02-20,Africa,0,0,1,0
2020-02-21,Africa,0,0,1,0
2020-02-22,Africa,0,0,1,0
2020-02-23,Africa,0,0,1,0
2020-02-24,Africa,0,0,1,0
2020-02-25,Africa,1,0,2,0
2020-02-26,Africa,0,0,2,0
2020-02-27,Africa,0,0,2,0
2020-02-28,Africa,1,0,3,0
2020-02-29,Africa,0,0,3,0
2020-03-01,Africa,1,0,4,0
2020-03-02,Africa,4,0,8,0
2020-03-03,Africa,3,0,11,0
2020-03-04,Africa,10,0,21,0
2020-03-05,Africa,3,0,24,0
2020-03-06,Africa,19,0,43,0
2020-03-07,Africa,0,0,43,0
2020-03-08,Africa,40,1,83,1
2020-03-09,Africa,8,0,91,1
2020-03-10,Africa,13,1,104,2
2020-03-11,Africa,14,0,118,2
2020-03-12,Africa,16,1,134,3
2020-03-13,Africa,42,3,176,6
2020-03-14,Africa,78,1,254,7
2020-03-15,Africa,59,1,313,8
2020-03-16,Africa,87,0,400,8
2020-03-17,Africa,84,3,484,11
2020-03-18,Africa,116,6,600,17
2020-03-19,Africa,180,3,780,20
2020-03-20,Africa,188,6,968,26
2020-03-21,Africa,204,10,1172,36
2020-03-22,Africa,265,12,1437,48
2020-03-23,Africa,381,9,1818,57
2020-03-24,Africa,432,7,2250,64
2020-03-25,Africa,523,9,2773,73
2020-03-26,Africa,553,18,3326,91
2020-03-27,Africa,559,24,3885,115
2020-03-28,Africa,340,19,4225,134
2020-03-29,Africa,560,18,4785,152
2020-03-30,Africa,411,21,5196,173
2020-03-31,Africa,585,27,5781,200
2020-04-01,Africa,599,34,6380,234
2020-04-02,Africa,651,53,7031,287
2020-04-03,Africa,882,44,7913,331
2020-04-04,Africa,679,52,8592,383
2020-04-05,Africa,706,61,9298,444
2020-04-06,Africa,701,43,9999,487
2020-04-07,Africa,633,46,10632,533
2020-04-08,Africa,804,41,11436,574
2020-04-09,Africa,812,53,12248,627
2020-04-10,Africa,663,66,12911,693
2020-04-11,Africa,716,49,13627,742
2020-04-12,Africa,864,46,14491,788
2020-04-13,Africa,774,46,15265,834
2020-04-14,Africa,970,39,16235,873
2020-04-15,Africa,957,37,17192,910
2020-04-16,Africa,1168,55,18360,965
2020-04-17,Africa,1406,51,19766,1016
2020-04-18,Africa,1306,42,21072,1058
2020-04-19,Africa,1209,63,22281,1121
2020-04-20,Africa,1158,38,23439,1159
2020-04-21,Africa,1070,30,24509,1189
2020-04-22,Africa,1402,51,25911,1240
2020-04-23,Africa,1438,57,27349,1297
2020-04-24,Africa,1719,27,29068,1324
2020-04-25,Africa,1231,51,30299,1375
2020-04-26,Africa,1534,48,31833,1423
2020-04-27,Africa,1334,39,33167,1462
2020-04-28,Africa,1627,61,34794,1523
2020-04-29,Africa,2013,65,36807,1588
2020-04-30,Africa,1946,46,38753,1634
2020-05-01,Africa,1726,58,40479,1692
2020-05-02,Africa,2228,67,42707,1759
2020-05-03,Africa,1594,37,44301,1796
2020-05-04,Africa,2658,46,46959,1842
2020-05-05,Africa,2038,66,48997,1908
2020-05-06,Africa,2546,98,51543,2006
2020-05-07,Africa,2490,67,54033,2073
2020-05-08,Africa,3624,81,57657,2154
2020-05-09,Africa,2850,67,60507,2221
2020-05-10,Africa,2579,69,63086,2290
2020-05-11,Africa,3066,54,66152,2344
2020-05-12,Africa,3160,51,69312,2395
2020-05-13,Africa,2915,98,72227,2493
2020-05-14,Africa,3119,69,75346,2562
2020-05-15,Africa,2928,62,78274,2624
2020-05-16,Africa,3003,84,81277,2708
2020-05-17,Africa,3313,51,84590,2759
2020-05-18,Africa,3668,73,88258,2832
2020-05-19,Africa,3012,75,91270,2907
2020-05-20,Africa,3792,83,95062,2990
2020-05-21,Africa,4692,105,99754,3095
2020-05-22,Africa,3875,89,103629,3184
2020-05-23,Africa,3862,73,107491,3257
2020-05-24,Africa,4126,97,111617,3354
2020-05-25,Africa,4116,125,115733,3479
2020-05-26,Africa,3712,112,119445,3591
2020-05-27,Africa,5079,108,124524,3699
2020-05-28,Africa,4919,92,129443,3791
2020-05-29,Africa,5748,131,135191,3922
2020-05-30,Africa,6120,147,141311,4069
2020-05-31,Africa,5248,153,146559,4222
2020-06-01,Africa,5785,121,152344,4343
2020-06-02,Africa,4885,151,157229,4494
2020-06-03,Africa,5087,107,162316,4601
2020-06-04,Africa,7106,155,169422,4756
2020-06-05,Africa,7196,159,176618,4915
2020-06-06,Africa,6595,140,183213,5055
2020-06-07,Africa,6337,133,189550,5188
2020-06-08,Africa,6648,175,196198,5363
2020-06-09,Africa,6472,175,202670,5538
2020-06-10,Africa,6546,150,209216,5688
2020-06-11,Africa,7402,163,216618,5851
2020-06-12,Africa,8077,199,224695,6050
2020-06-13,Africa,8101,203,232796,6253
2020-06-14,Africa,8767,206,241563,6459
2020-06-15,Africa,9621,303,251184,6762
2020-06-16,Africa,7613,253,258797,7015
2020-06-17,Africa,8732,203,267529,7218
2020-06-18,Africa,8254,201,275783,7419
2020-06-19,Africa,9826,263,285609,7682
2020-06-20,Africa,11330,236,296939,7918
2020-06-21,Africa,9442,197,306381,8115
2020-06-22,Africa,8989,223,315370,8338
2020-06-23,Africa,9051,282,324421,8620
2020-06-24,Africa,11358,235,335779,8855
2020-06-25,Africa,11950,214,347729,9069
2020-06-26,Africa,11577,213,359306,9282
2020-06-27,Africa,12284,202,371590,9484
2020-06-28,Africa,10647,179,382237,9663
2020-06-29,Africa,11048,216,393285,9879
2020-06-30,Africa,11616,267,404901,10146
2020-07-01,Africa,13227,259,418128,10405
2020-07-02,Africa,14193,238,432321,10643
2020-07-03,Africa,15159,239,447480,10882
2020-07-04,Africa,15507,201,462987,11083
2020-07-05,Africa,13640,280,476627,11363
2020-07-06,Africa,13717,249,490344,11612
2020-07-07,Africa,17474,365,507818,11977
2020-07-08,Africa,14726,255,522544,12232
2020-07-09,Africa,19212,226,541756,12458
2020-07-10,Africa,17680,310,559436,12768
2020-07-11,Africa,18815,220,578251,12988
2020-07-12,Africa,16694,257,594945,13245
2020-07-13,Africa,16071,218,611016,13463
2020-07-14,Africa,14435,299,625451,13762
2020-07-15,Africa,18051,226,643502,13988
2020-07-16,Africa,20441,370,663943,14358
2020-07-17,Africa,19540,315,683483,14673
2020-07-18,Africa,19015,282,702498,14955
2020-07-19,Africa,18554,214,721052,15169
2020-07-20,Africa,15525,254,736577,15423
2020-07-21,Africa,13864,314,750441,15737
2020-07-22,Africa,19614,708,770055,16445
2020-07-23,Africa,18467,269,788522,16714
2020-07-24,Africa,22111,390,810633,17104
2020-07-25,Africa,18151,417,828784,17521
2020-07-26,Africa,18315,245,847099,17766
2020-07-27,Africa,13428,409,860527,18175
2020-07-28,Africa,13499,322,874026,18497
2020-07-29,Africa,17642,367,891668,18864
2020-07-30,Africa,17407,454,909075,19318
2020-07-31,Africa,19005,364,928080,19682
2020-08-01,Africa,16920,292,945000,19974
2020-08-02,Africa,12749,332,957749,20306
2020-08-03,Africa,10853,321,968602,20627
2020-08-04,Africa,9915,472,978517,21099
2020-08-05,Africa,15374,539,993891,21638
2020-08-06,Africa,14328,431,1008219,22069
2020-08-07,Africa,13492,439,1021711,22508
2020-08-08,Africa,14208,413,1035919,22921
2020-08-09,Africa,12356,358,1048275,23279
2020-08-10,Africa,9132,319,1057407,23598
2020-08-11,Africa,7883,269,1065290,23867
2020-08-12,Africa,9258,410,1074548,24277
2020-08-13,Africa,10393,405,1084941,24682
2020-08-14,Africa,12545,416,1097486,25098
2020-08-15,Africa,11815,240,1109301,25338
2020-08-16,Africa,9953,295,1119254,25633
2020-08-17,Africa,8872,264,1128126,25897
2020-08-18,Africa,8637,415,1136763,26312
2020-08-19,Africa,10895,328,1147658,26640
2020-08-20,Africa,10609,337,1158267,26977
2020-08-21,Africa,10272,352,1168539,27329
2020-08-22,Africa,10433,274,1178972,27603
2020-08-23,Africa,9053,182,1188025,27785
2020-08-24,Africa,7516,220,1195541,28005
2020-08-25,Africa,7543,283,1203084,28288
2020-08-26,Africa,8855,319,1211939,28607
2020-08-27,Africa,8555,253,1220494,28860
2020-08-28,Africa,8109,231,1228603,29091
2020-08-29,Africa,8370,331,1236973,29422
2020-08-30,Africa,8457,164,1245430,29586
2020-08-31,Africa,6805,226,1252235,29812
2020-09-01,Africa,7157,242,1259392,30054
2020-09-02,Africa,8714,265,1268106,30319
2020-09-03,Africa,7747,297,1275853,30616
2020-09-04,Africa,8578,238,1284431,30854
2020-09-05,Africa,7392,225,1291823,31079
2020-09-06,Africa,7823,224,1299646,31303
2020-09-07,Africa,6876,218,1306522,31521
2020-09-08,Africa,7679,226,1314201,31747
2020-09-09,Africa,8295,192,1322496,31939
2020-09-10,Africa,8050,185,1330546,32124
2020-09-11,Africa,8692,231,1339238,32355
2020-09-12,Africa,7410,146,1346648,32501
2020-09-13,Africa,6748,121,1353396,32622
2020-09-14,Africa,6483,171,1359879,32793
2020-09-15,Africa,6566,277,1366445,33070
2020-09-16,Africa,7310,179,1373755,33249
2020-09-17,Africa,8605,179,1382360,33428
2020-09-18,Africa,8161,193,1390521,33621
2020-09-19,Africa,8727,202,1399248,33823
2020-09-20,Africa,8419,133,1407667,33956
2020-09-21,Africa,6148,126,1413815,34082
2020-09-22,Africa,6839,240,1420654,34322
2020-09-23,Africa,8727,209,1429381,34531
2020-09-24,Africa,8186,175,1437567,34706
2020-09-25,Africa,7977,154,1445544,34860
2020-09-26,Africa,6410,168,1451954,35028
2020-09-27,Africa,8369,135,1460323,35163
2020-09-28,Africa,5669,294,1465992,35457
2020-09-29,Africa,7509,217,1473501,35674
2020-09-30,Africa,8434,189,1481935,35863
2020-10-01,Africa,7260,217,1489195,36080
2020-10-02,Africa,8857,149,1498052,36229
2020-10-03,Africa,8830,111,1506882,36340
2020-10-04,Africa,8086,170,1514968,36510
2020-10-05,Africa,4714,128,1519682,36638
2020-10-06,Africa,6597,188,1526279,36826
2020-10-07,Africa,10543,269,1536822,37095
2020-10-08,Africa,10908,298,1547730,37393
2020-10-09,Africa,8557,236,1556287,37629
2020-10-10,Africa,13534,271,1569821,37900
2020-10-11,Africa,8975,208,1578796,38108
2020-10-12,Africa,5887,193,1584683,38301
2020-10-13,Africa,7834,271,1592517,38572
2020-10-14,Africa,11508,263,1604025,38835
2020-10-15,Africa,9116,254,1613141,39089
2020-10-16,Africa,10686,207,1623827,39296
2020-10-17,Africa,14262,265,1638089,39561
2020-10-18,Africa,8193,185,1646282,39746
2020-10-19,Africa,9688,184,1655970,39930
2020-10-20,Africa,9776,298,1665746,40228
2020-10-21,Africa,10478,252,1676224,40480
2020-10-22,Africa,10970,216,1687194,40696
2020-10-23,Africa,10435,224,1697629,40920
2020-10-24,Africa,11739,223,1709368,41143
2020-10-25,Africa,9094,116,1718462,41259
2020-10-26,Africa,10718,348,1729180,41607
2020-10-27,Africa,8650,182,1737830,41789
2020-10-28,Africa,11900,346,1749730,42135
2020-10-29,Africa,11071,202,1760801,42337
2020-10-30,Africa,13599,292,1774400,42629
2020-10-31,Africa,11074,224,1785474,42853
2020-11-01,Africa,10296,322,1795770,43175
2020-11-02,Africa,7586,214,1803356,43389
2020-11-03,Africa,10874,316,1814230,43705
2020-11-04,Africa,14002,235,1828232,43940
2020-11-05,Africa,15393,304,1843625,44244
2020-11-06,Africa,11720,223,1855345,44467
2020-11-07,Africa,15017,378,1870362,44845
2020-11-08,Africa,12498,515,1882860,45360
2020-11-09,Africa,8889,249,1891749,45609
2020-11-10,Africa,13173,341,1904922,45950
2020-11-11,Africa,14000,332,1918922,46282
2020-11-12,Africa,15781,269,1934703,46551
2020-11-13,Africa,14678,280,1949381,46831
2020-11-14,Africa,14071,235,1963452,47066
2020-11-15,Africa,12570,296,1976022,47362
2020-11-16,Africa,10304,279,1986326,47641
2020-11-17,Africa,12868,393,1999194,48034
2020-11-18,Africa,15301,392,2014495,48426
2020-11-19,Africa,13934,276,2028429,48702
2020-11-20,Africa,15733,412,2044162,49114
2020-11-21,Africa,13356,314,2057518,49428
2020-11-22,Africa,12779,290,2070297,49718
2020-11-23,Africa,10077,269,2080374,49987
2020-11-24,Africa,12503,344,2092877,50331
2020-11-25,Africa,14667,316,2107544,50647
2020-11-26,Africa,13923,297,2121467,50944
2020-11-27,Africa,16039,320,2137506,51264
2020-11-28,Africa,13396,235,2150902,51499
2020-11-29,Africa,13071,224,2163973,51723
2020-11-30,Africa,10350,269,2174323,51992
2020-12-01,Africa,10838,258,2185161,52250
2020-12-02,Africa,16413,330,2201574,52580
2020-12-03,Africa,15701,267,2217275,52847
2020-12-04,Africa,17982,430,2235257,53277
2020-12-05,Africa,14702,287,2249959,53564
2020-12-06,Africa,13463,306,2263422,53870
2020-12-07,Africa,10628,248,2274050,54118
2020-12-08,Africa,13258,402,2287308,54520
2020-12-09,Africa,19396,350,2306704,54870
2020-12-10,Africa,19134,394,2325838,55264
2020-12-11,Africa,19081,398,2344919,55662
2020-12-12,Africa,18133,326,2363052,55988
2020-12-13,Africa,16222,346,2379274,56334
2020-12-14,Africa,11318,311,2390592,56645
2020-12-15,Africa,18002,427,2408594,57072
2020-12-16,Africa,21225,346,2429819,57418
2020-12-17,Africa,20508,396,2450327,57814
2020-12-18,Africa,19320,496,2469647,58310
2020-12-19,Africa,21260,449,2490907,58759
2020-12-20,Africa,18426,340,2509333,59099
2020-12-21,Africa,16781,429,2526114,59528
2020-12-22,Africa,19986,529,2546100,60057
2020-12-23,Africa,25729,820,2571829,60877
2020-12-24,Africa,27044,554,2598873,61431
2020-12-25,Africa,25785,524,2624658,61955
2020-12-26,Africa,21381,419,2646039,62374
2020-12-27,Africa,18675,432,2664714,62806
2020-12-28,Africa,15211,545,2679925,63351
2020-12-29,Africa,20128,717,2700053,64068
2020-12-30,Africa,30617,701,2730670,64769
2020-12-31,Africa,29789,699,2760459,65468
2021-01-01,Africa,27708,658,2788167,66126
2021-01-02,Africa,22919,515,2811086,66641
2021-01-03,Africa,21990,605,2833076,67246
2021-01-04,Africa,21792,685,2854868,67931
2021-01-05,Africa,26847,820,2881715,68751
2021-01-06,Africa,35792,1110,2917507,69861
2021-01-07,Africa,35402,689,2952909,70550
2021-01-08,Africa,36473,910,2989382,71460
2021-01-09,Africa,35099,657,3024481,72117
2021-01-10,Africa,31607,594,3056088,72711
2021-01-11,Africa,28033,681,3084121,73392
2021-01-12,Africa,26128,1076,3110249,74468
2021-01-13,Africa,33997,1220,3144246,75688
2021-01-14,Africa,34228,1053,3178474,76741
2021-01-15,Africa,31575,905,3210049,77646
2021-01-16,Africa,27568,663,3237617,78309
2021-01-17,Africa,26569,598,3264186,78907
2021-01-18,Africa,22476,725,3286662,79632
2021-01-19,Africa,23410,1202,3310072,80834
2021-01-20,Africa,28337,922,3338409,81756
2021-01-21,Africa,27865,1025,3366274,82781
2021-01-22,Africa,26179,974,3392453,83755
2021-01-23,Africa,27308,782,3419761,84537
2021-01-24,Africa,20120,647,3439881,85184
2021-01-25,Africa,16695,771,3456576,85955
2021-01-26,Africa,18598,983,3475174,86938
2021-01-27,Africa,20827,1051,3496001,87989
2021-01-28,Africa,20780,996,3516781,88985
2021-01-29,Africa,19222,846,3536003,89831
2021-01-30,Africa,17862,615,3553865,90446
2021-01-31,Africa,15752,525,3569617,90971
2021-02-01,Africa,12711,509,3582328,91480
2021-02-02,Africa,14821,884,3597149,92364
2021-02-03,Africa,15462,709,3612611,93073
2021-02-04,Africa,16474,567,3629085,93640
2021-02-05,Africa,15907,547,3644992,94187
2021-02-06,Africa,13545,548,3658537,94735
2021-02-07,Africa,11724,357,3670261,95092
2021-02-08,Africa,11413,443,3681674,95535
2021-02-09,Africa,11351,699,3693025,96234
2021-02-10,Africa,13118,536,3706143,96770
2021-02-11,Africa,11870,495,3718013,97265
2021-02-12,Africa,13922,565,3731935,97830
2021-02-13,Africa,10914,352,3742849,98182
2021-02-14,Africa,10325,293,3753174,98475
2021-02-15,Africa,9893,471,3763067,98946
2021-02-16,Africa,10027,466,3773094,99412
2021-02-17,Africa,12317,402,3785411,99814
2021-02-18,Africa,13893,511,3799304,100325
2021-02-19,Africa,11019,384,3810323,100709
2021-02-20,Africa,9559,290,3819882,100999
2021-02-21,Africa,9520,337,3829402,101336
2021-02-22,Africa,9017,336,3838419,101672
2021-02-23,Africa,7740,470,3846159,102142
2021-02-24,Africa,10529,326,3856688,102468
2021-02-25,Africa,12271,357,3868959,102825
2021-02-26,Africa,11103,317,3880062,103142
2021-02-27,Africa,7831,339,3887893,103481
2021-02-28,Africa,9414,225,3897307,103706
2021-03-01,Africa,8833,315,3906140,104021
2021-03-02,Africa,7708,363,3913848,104384
2021-03-03,Africa,10908,278,3924756,104662
2021-03-04,Africa,12382,331,3937138,104993
2021-03-05,Africa,8569,227,3945707,105220
2021-03-06,Africa,9953,263,3955660,105483
2021-03-07,Africa,8395,230,3964055,105713
2021-03-08,Africa,9277,379,3973332,106092
2021-03-09,Africa,7829,289,3981161,106381
2021-03-10,Africa,10421,301,3991582,106682
2021-03-11,Africa,15331,324,4006913,107006
2021-03-12,Africa,9824,227,4016737,107233
2021-03-13,Africa,10309,294,4027046,107527
2021-03-14,Africa,8662,251,4035708,107778
2021-03-15,Africa,8412,309,4044120,108087
2021-03-16,Africa,8983,307,4053103,108394
2021-03-17,Africa,11121,277,4064224,108671
2021-03-18,Africa,11332,261,4075556,108932
2021-03-19,Africa,12661,545,4088217,109477
2021-03-20,Africa,9204,197,4097421,109674
2021-03-21,Africa,9094,229,4106515,109903
2021-03-22,Africa,9587,260,4116102,110163
2021-03-23,Africa,8586,322,4124688,110485
2021-03-24,Africa,10895,322,4135583,110807
2021-03-25,Africa,12490,386,4148073,111193
2021-03-26,Africa,18544,344,4166617,111537
2021-03-27,Africa,9475,193,4176092,111730
2021-03-28,Africa,9000,183,4185092,111913
2021-03-29,Africa,9707,312,4194799,112225
2021-03-30,Africa,9762,277,4204561,112502
2021-03-31,Africa,12752,257,4217313,112759
2021-04-01,Africa,22144,407,4239457,113166
2021-04-02,Africa,13178,247,4252635,113413
2021-04-03,Africa,8781,168,4261416,113581
2021-04-04,Africa,9503,272,4270919,113853
2021-04-05,Africa,9254,230,4280173,114083
2021-04-06,Africa,9576,236,4289749,114319
2021-04-07,Africa,11674,267,4301423,114586
2021-04-08,Africa,16829,351,4318252,114937
2020-03-09,Albania,2,0,2,0
2020-03-10,Albania,8,0,10,0
2020-03-11,Albania,2,1,12,1
2020-03-12,Albania,11,0,23,1
2020-03-13,Albania,10,0,33,1
2020-03-14,Albania,5,0,38,1
2020-03-15,Albania,4,0,42,1
2020-03-16,Albania,9,0,51,1
2020-03-17,Albania,4,0,55,1
2020-03-18,Albania,4,1,59,2
2020-03-19,Albania,5,0,64,2
2020-03-20,Albania,6,0,70,2
2020-03-21,Albania,6,0,76,2
2020-03-22,Albania,13,0,89,2
2020-03-23,Albania,15,2,104,4
2020-03-24,Albania,19,1,123,5
2020-03-25,Albania,23,0,146,5
2020-03-26,Albania,28,1,174,6
2020-03-27,Albania,12,2,186,8
2020-03-28,Albania,11,2,197,10
2020-03-29,Albania,15,0,212,10
2020-03-30,Albania,11,1,223,11
2020-03-31,Albania,20,4,243,15
2020-04-01,Albania,16,0,259,15
2020-04-02,Albania,18,1,277,16
2020-04-03,Albania,27,1,304,17
2020-04-04,Albania,29,3,333,20
2020-04-05,Albania,28,0,361,20
2020-04-06,Albania,16,1,377,21
2020-04-07,Albania,6,1,383,22
2020-04-08,Albania,17,0,400,22
2020-04-09,Albania,9,1,409,23
2020-04-10,Albania,7,0,416,23
2020-04-11,Albania,17,0,433,23
2020-04-12,Albania,13,0,446,23
2020-04-13,Albania,21,0,467,23
2020-04-14,Albania,8,1,475,24
2020-04-15,Albania,19,1,494,25
2020-04-16,Albania,24,1,518,26
2020-04-17,Albania,21,0,539,26
2020-04-18,Albania,9,0,548,26
2020-04-19,Albania,14,0,562,26
2020-04-20,Albania,22,0,584,26
2020-04-21,Albania,25,0,609,26
2020-04-22,Albania,25,1,634,27
2020-04-23,Albania,29,0,663,27
2020-04-24,Albania,15,0,678,27
2020-04-25,Albania,34,0,712,27
2020-04-26,Albania,14,1,726,28
2020-04-27,Albania,10,0,736,28
2020-04-28,Albania,14,2,750,30
2020-04-29,Albania,16,0,766,30
2020-04-30,Albania,7,1,773,31
2020-05-01,Albania,9,0,782,31
2020-05-02,Albania,7,0,789,31
2020-05-03,Albania,6,0,795,31
2020-05-04,Albania,8,0,803,31
2020-05-05,Albania,17,0,820,31
2020-05-06,Albania,12,0,832,31
2020-05-07,Albania,10,0,842,31
2020-05-08,Albania,8,0,850,31
2020-05-09,Albania,6,0,856,31
2020-05-10,Albania,12,0,868,31
2020-05-11,Albania,4,0,872,31
2020-05-12,Albania,4,0,876,31
2020-05-13,Albania,4,0,880,31
2020-05-14,Albania,18,0,898,31
2020-05-15,Albania,18,0,916,31
2020-05-16,Albania,17,0,933,31
2020-05-17,Albania,13,0,946,31
2020-05-18,Albania,2,0,948,31
2020-05-19,Albania,1,0,949,31
2020-05-20,Albania,15,0,964,31
2020-05-21,Albania,5,0,969,31
2020-05-22,Albania,12,0,981,31
2020-05-23,Albania,8,0,989,31
2020-05-24,Albania,9,1,998,32
2020-05-25,Albania,6,0,1004,32
2020-05-26,Albania,25,1,1029,33
2020-05-27,Albania,21,0,1050,33
2020-05-28,Albania,26,0,1076,33
2020-05-29,Albania,23,0,1099,33
2020-05-30,Albania,23,0,1122,33
2020-05-31,Albania,15,0,1137,33
2020-06-01,Albania,6,0,1143,33
2020-06-02,Albania,21,0,1164,33
2020-06-03,Albania,20,0,1184,33
2020-06-04,Albania,13,0,1197,33
2020-06-05,Albania,15,0,1212,33
2020-06-06,Albania,20,1,1232,34
2020-06-07,Albania,14,0,1246,34
2020-06-08,Albania,17,0,1263,34
2020-06-09,Albania,36,0,1299,34
2020-06-10,Albania,42,0,1341,34
2020-06-11,Albania,44,1,1385,35
2020-06-12,Albania,31,1,1416,36
2020-06-13,Albania,48,0,1464,36
2020-06-14,Albania,57,0,1521,36
2020-06-15,Albania,69,0,1590,36
2020-06-16,Albania,82,1,1672,37
2020-06-17,Albania,50,1,1722,38
2020-06-18,Albania,66,1,1788,39
2020-06-19,Albania,50,3,1838,42
2020-06-20,Albania,53,1,1891,43
2020-06-21,Albania,71,1,1962,44
2020-06-22,Albania,33,0,1995,44
2020-06-23,Albania,52,1,2047,45
2020-06-24,Albania,67,2,2114,47
2020-06-25,Albania,78,2,2192,49
2020-06-26,Albania,77,2,2269,51
2020-06-27,Albania,61,2,2330,53
2020-06-28,Albania,72,2,2402,55
2020-06-29,Albania,64,3,2466,58
2020-06-30,Albania,69,4,2535,62
2020-07-01,Albania,45,3,2580,65
2020-07-02,Albania,82,4,2662,69
2020-07-03,Albania,90,3,2752,72
2020-07-04,Albania,67,2,2819,74
2020-07-05,Albania,74,2,2893,76
2020-07-06,Albania,71,3,2964,79
2020-07-07,Albania,74,2,3038,81
2020-07-08,Albania,68,2,3106,83
2020-07-09,Albania,82,0,3188,83
2020-07-10,Albania,90,2,3278,85
2020-07-11,Albania,93,4,3371,89
2020-07-12,Albania,83,4,3454,93
2020-07-13,Albania,117,2,3571,95
2020-07-14,Albania,96,2,3667,97
2020-07-15,Albania,85,4,3752,101
2020-07-16,Albania,99,3,3851,104
2020-07-17,Albania,55,3,3906,107
2020-07-18,Albania,102,4,4008,111
2020-07-19,Albania,82,1,4090,112
2020-07-20,Albania,81,1,4171,113
2020-07-21,Albania,119,4,4290,117
2020-07-22,Albania,68,3,4358,120
2020-07-23,Albania,108,3,4466,123
2020-07-24,Albania,104,5,4570,128
2020-07-25,Albania,67,6,4637,134
2020-07-26,Albania,126,4,4763,138
2020-07-27,Albania,117,6,4880,144
2020-07-28,Albania,117,4,4997,148
2020-07-29,Albania,108,2,5105,150
2020-07-30,Albania,92,4,5197,154
2020-07-31,Albania,79,3,5276,157
2020-08-01,Albania,120,4,5396,161
2020-08-02,Albania,123,5,5519,166
2020-08-03,Albania,101,6,5620,172
2020-08-04,Albania,130,4,5750,176
2020-08-05,Albania,139,6,5889,182
2020-08-06,Albania,127,6,6016,188
2020-08-07,Albania,135,1,6151,189
2020-08-08,Albania,124,4,6275,193
2020-08-09,Albania,136,6,6411,199
2020-08-10,Albania,125,1,6536,200
2020-08-11,Albania,140,5,6676,205
2020-08-12,Albania,141,3,6817,208
2020-08-13,Albania,154,5,6971,213
2020-08-14,Albania,146,6,7117,219
2020-08-15,Albania,143,6,7260,225
2020-08-16,Albania,120,3,7380,228
2020-08-17,Albania,119,2,7499,230
2020-08-18,Albania,155,2,7654,232
2020-08-19,Albania,158,2,7812,234
2020-08-20,Albania,155,4,7967,238
2020-08-21,Albania,152,2,8119,240
2020-08-22,Albania,156,5,8275,245
2020-08-23,Albania,152,5,8427,250
2020-08-24,Albania,178,4,8605,254
2020-08-25,Albania,154,5,8759,259
2020-08-26,Albania,168,4,8927,263
2020-08-27,Albania,156,3,9083,266
2020-08-28,Albania,112,5,9195,271
2020-08-29,Albania,84,4,9279,275
2020-08-30,Albania,101,5,9380,280
2020-08-31,Albania,133,4,9513,284
2020-09-01,Albania,93,6,9606,290
2020-09-02,Albania,122,6,9728,296
2020-09-03,Albania,116,5,9844,301
2020-09-04,Albania,123,5,9967,306
2020-09-05,Albania,135,6,10102,312
2020-09-06,Albania,153,4,10255,316
2020-09-07,Albania,151,3,10406,319
2020-09-08,Albania,147,2,10553,321
2020-09-09,Albania,151,1,10704,322
2020-09-10,Albania,156,2,10860,324
2020-09-11,Albania,161,3,11021,327
2020-09-12,Albania,164,3,11185,330
2020-09-13,Albania,168,4,11353,334
2020-09-14,Albania,167,4,11520,338
2020-09-15,Albania,152,2,11672,340
2020-09-16,Albania,144,3,11816,343
2020-09-17,Albania,132,4,11948,347
2020-09-18,Albania,125,6,12073,353
2020-09-19,Albania,153,5,12226,358
2020-09-20,Albania,159,4,12385,362
2020-09-21,Albania,150,2,12535,364
2020-09-22,Albania,131,3,12666,367
2020-09-23,Albania,121,3,12787,370
2020-09-24,Albania,134,0,12921,370
2020-09-25,Albania,124,3,13045,373
2020-09-26,Albania,108,2,13153,375
2020-09-27,Albania,106,2,13259,377
2020-09-28,Albania,132,3,13391,380
2020-09-29,Albania,127,4,13518,384
2020-09-30,Albania,131,3,13649,387
2020-10-01,Albania,157,1,13806,388
2020-10-02,Albania,159,1,13965,389
2020-10-03,Albania,152,3,14117,392
2020-10-04,Albania,149,4,14266,396
2020-10-05,Albania,144,4,14410,400
2020-10-06,Albania,158,3,14568,403
2020-10-07,Albania,162,4,14730,407
2020-10-08,Albania,169,4,14899,411
2020-10-09,Albania,167,2,15066,413
2020-10-10,Albania,165,3,15231,416
2020-10-11,Albania,168,4,15399,420
2020-10-12,Albania,171,4,15570,424
2020-10-13,Albania,182,5,15752,429
2020-10-14,Albania,203,5,15955,434
2020-10-15,Albania,257,5,16212,439
2020-10-16,Albania,289,4,16501,443
2020-10-17,Albania,273,5,16774,448
2020-10-18,Albania,281,3,17055,451
2020-10-19,Albania,295,3,17350,454
2020-10-20,Albania,301,4,17651,458
2020-10-21,Albania,297,4,17948,462
2020-10-22,Albania,302,3,18250,465
2020-10-23,Albania,306,4,18556,469
2020-10-24,Albania,302,4,18858,473
2020-10-25,Albania,299,4,19157,477
2020-10-26,Albania,288,3,19445,480
2020-10-27,Albania,284,7,19729,487
2020-10-28,Albania,311,6,20040,493
2020-10-29,Albania,275,6,20315,499
2020-10-30,Albania,319,3,20634,502
2020-10-31,Albania,241,7,20875,509
2020-11-01,Albania,327,9,21202,518
2020-11-02,Albania,321,9,21523,527
2020-11-03,Albania,381,5,21904,532
2020-11-04,Albania,396,4,22300,536
2020-11-05,Albania,421,7,22721,543
2020-11-06,Albania,489,6,23210,549
2020-11-07,Albania,495,8,23705,557
2020-11-08,Albania,501,2,24206,559
2020-11-09,Albania,525,12,24731,571
2020-11-10,Albania,563,8,25294,579
2020-11-11,Albania,507,11,25801,590
2020-11-12,Albania,410,8,26211,598
2020-11-13,Albania,490,7,26701,605
2020-11-14,Albania,532,7,27233,612
2020-11-15,Albania,597,11,27830,623
2020-11-16,Albania,602,8,28432,631
2020-11-17,Albania,694,6,29126,637
2020-11-18,Albania,711,9,29837,646
2020-11-19,Albania,786,11,30623,657
2020-11-20,Albania,836,15,31459,672
2020-11-21,Albania,737,13,32196,685
2020-11-22,Albania,565,14,32761,699
2020-11-23,Albania,795,17,33556,716
2020-11-24,Albania,744,19,34300,735
2020-11-25,Albania,644,8,34944,743
2020-11-26,Albania,656,10,35600,753
2020-11-27,Albania,645,18,36245,771
2020-11-28,Albania,545,16,36790,787
2020-11-29,Albania,835,11,37625,798
2020-11-30,Albania,557,12,38182,810
2020-12-01,Albania,832,12,39014,822
2020-12-02,Albania,705,17,39719,839
2020-12-03,Albania,782,13,40501,852
2020-12-04,Albania,801,18,41302,870
2020-12-05,Albania,846,19,42148,889
2020-12-06,Albania,840,16,42988,905
2020-12-07,Albania,695,17,43683,922
2020-12-08,Albania,753,14,44436,936
2020-12-09,Albania,752,15,45188,951
2020-12-10,Albania,873,14,46061,965
2020-12-11,Albania,802,12,46863,977
2020-12-12,Albania,879,12,47742,989
2020-12-13,Albania,788,14,48530,1003
2020-12-14,Albania,661,13,49191,1016
2020-12-15,Albania,809,12,50000,1028
2020-12-16,Albania,637,12,50637,1040
2020-12-17,Albania,787,15,51424,1055
2020-12-18,Albania,580,11,52004,1066
2020-12-19,Albania,538,8,52542,1074
2020-12-20,Albania,461,14,53003,1088
2020-12-21,Albania,422,10,53425,1098
2020-12-22,Albania,389,13,53814,1111
2020-12-23,Albania,503,6,54317,1117
2020-12-24,Albania,510,8,54827,1125
2020-12-25,Albania,553,9,55380,1134
2020-12-26,Albania,375,9,55755,1143
2020-12-27,Albania,499,10,56254,1153
2020-12-28,Albania,318,11,56572,1164
2020-12-29,Albania,574,6,57146,1170
2020-12-30,Albania,581,4,57727,1174
2020-12-31,Albania,589,7,58316,1181
2021-01-01,Albania,0,0,58316,1181
2021-01-02,Albania,675,9,58991,1190
2021-01-03,Albania,447,3,59438,1193
2021-01-04,Albania,185,6,59623,1199
2021-01-05,Albania,660,11,60283,1210
2021-01-06,Albania,725,7,61008,1217
2021-01-07,Albania,697,6,61705,1223
2021-01-08,Albania,673,7,62378,1230
2021-01-09,Albania,655,3,63033,1233
2021-01-10,Albania,562,8,63595,1241
2021-01-11,Albania,376,6,63971,1247
2021-01-12,Albania,656,5,64627,1252
2021-01-13,Albania,707,4,65334,1256
2021-01-14,Albania,660,5,65994,1261
2021-01-15,Albania,641,4,66635,1265
2021-01-16,Albania,581,5,67216,1270
2021-01-17,Albania,474,7,67690,1277
2021-01-18,Albania,292,4,67982,1281
2021-01-19,Albania,586,6,68568,1287
2021-01-20,Albania,670,4,69238,1291
2021-01-21,Albania,678,5,69916,1296
2021-01-22,Albania,739,7,70655,1303
2021-01-23,Albania,786,7,71441,1310
2021-01-24,Albania,833,5,72274,1315
2021-01-25,Albania,538,9,72812,1324
2021-01-26,Albania,879,8,73691,1332
2021-01-27,Albania,876,7,74567,1339
2021-01-28,Albania,887,11,75454,1350
2021-01-29,Albania,896,8,76350,1358
2021-01-30,Albania,901,11,77251,1369
2021-01-31,Albania,876,11,78127,1380
2021-02-01,Albania,865,13,78992,1393
2021-02-02,Albania,942,5,79934,1398
2021-02-03,Albania,1007,6,80941,1404
2021-02-04,Albania,1052,14,81993,1418
2021-02-05,Albania,1089,15,83082,1433
2021-02-06,Albania,1130,13,84212,1446
2021-02-07,Albania,1124,14,85336,1460
2021-02-08,Albania,953,12,86289,1472
2021-02-09,Albania,1239,16,87528,1488
2021-02-10,Albania,1143,15,88671,1503
2021-02-11,Albania,1105,14,89776,1517
2021-02-12,Albania,1059,14,90835,1531
2021-02-13,Albania,1152,12,91987,1543
2021-02-14,Albania,1088,12,93075,1555
2021-02-15,Albania,775,12,93850,1567
2021-02-16,Albania,801,15,94651,1582
2021-02-17,Albania,1075,18,95726,1600
2021-02-18,Albania,1112,17,96838,1617
2021-02-19,Albania,1071,19,97909,1636
2021-02-20,Albania,1153,17,99062,1653
2021-02-21,Albania,1184,13,100246,1666
2021-02-22,Albania,1039,15,101285,1681
2021-02-23,Albania,1021,15,102306,1696
2021-02-24,Albania,1021,19,103327,1715
2021-02-25,Albania,986,21,104313,1736
2021-02-26,Albania,916,20,105229,1756
2021-02-27,Albania,986,19,106215,1775
2021-02-28,Albania,952,21,107167,1796
2021-03-01,Albania,764,20,107931,1816
2021-03-02,Albania,892,19,108823,1835
2021-03-03,Albania,851,21,109674,1856
2021-03-04,Albania,847,20,110521,1876
2021-03-05,Albania,780,21,111301,1897
2021-03-06,Albania,777,21,112078,1918
2021-03-07,Albania,819,21,112897,1939
2021-03-08,Albania,683,17,113580,1956
2021-03-09,Albania,629,13,114209,1969
2021-03-10,Albania,631,17,114840,1986
2021-03-11,Albania,602,16,115442,2002
2021-03-12,Albania,681,16,116123,2018
2021-03-13,Albania,698,12,116821,2030
2021-03-14,Albania,653,15,117474,2045
2021-03-15,Albania,543,15,118017,2060
2021-03-16,Albania,475,17,118492,2077
2021-03-17,Albania,446,15,118938,2092
2021-03-18,Albania,590,14,119528,2106
2021-03-19,Albania,494,16,120022,2122
2021-03-20,Albania,519,11,120541,2133
2021-03-21,Albania,659,4,121200,2137
2021-03-22,Albania,344,8,121544,2145
2021-03-23,Albania,303,11,121847,2156
2021-03-24,Albania,448,15,122295,2171
2021-03-25,Albania,472,13,122767,2184
2021-03-26,Albania,449,8,123216,2192
2021-03-27,Albania,425,12,123641,2204
2021-03-28,Albania,493,6,124134,2210
2021-03-29,Albania,285,6,124419,2216
2021-03-30,Albania,304,11,124723,2227
2021-03-31,Albania,434,8,125157,2235
2021-04-01,Albania,349,6,125506,2241
2021-04-02,Albania,336,6,125842,2247
2021-04-03,Albania,341,9,126183,2256
2021-04-04,Albania,348,9,126531,2265
2021-04-05,Albania,264,9,126795,2274
2021-04-06,Albania,141,9,126936,2283
2021-04-07,Albania,256,8,127192,2291
2021-04-08,Albania,317,6,127509,2297
2020-02-25,Algeria,1,0,1,0
2020-02-26,Algeria,0,0,1,0
2020-02-27,Algeria,0,0,1,0
2020-02-28,Algeria,0,0,1,0
2020-02-29,Algeria,0,0,1,0
2020-03-01,Algeria,0,0,1,0
2020-03-02,Algeria,2,0,3,0
2020-03-03,Algeria,2,0,5,0
2020-03-04,Algeria,7,0,12,0
2020-03-05,Algeria,0,0,12,0
2020-03-06,Algeria,5,0,17,0
2020-03-07,Algeria,0,0,17,0
2020-03-08,Algeria,2,0,19,0
2020-03-09,Algeria,1,0,20,0
2020-03-10,Algeria,0,0,20,0
2020-03-11,Algeria,0,0,20,0
2020-03-12,Algeria,4,1,24,1
2020-03-13,Algeria,2,1,26,2
2020-03-14,Algeria,11,1,37,3
2020-03-15,Algeria,11,1,48,4
2020-03-16,Algeria,6,0,54,4
2020-03-17,Algeria,6,0,60,4
2020-03-18,Algeria,14,3,74,7
2020-03-19,Algeria,13,2,87,9
2020-03-20,Algeria,3,2,90,11
2020-03-21,Algeria,49,4,139,15
2020-03-22,Algeria,62,2,201,17
2020-03-23,Algeria,29,0,230,17
2020-03-24,Algeria,34,2,264,19
2020-03-25,Algeria,38,2,302,21
2020-03-26,Algeria,65,4,367,25
2020-03-27,Algeria,42,1,409,26
2020-03-28,Algeria,45,3,454,29
2020-03-29,Algeria,57,2,511,31
2020-03-30,Algeria,73,4,584,35
2020-03-31,Algeria,132,9,716,44
2020-04-01,Algeria,131,14,847,58
2020-04-02,Algeria,139,28,986,86
2020-04-03,Algeria,185,19,1171,105
2020-04-04,Algeria,80,25,1251,130
2020-04-05,Algeria,69,22,1320,152
2020-04-06,Algeria,103,21,1423,173
2020-04-07,Algeria,45,20,1468,193
2020-04-08,Algeria,104,12,1572,205
2020-04-09,Algeria,94,30,1666,235
2020-04-10,Algeria,95,21,1761,256
2020-04-11,Algeria,64,19,1825,275
2020-04-12,Algeria,89,18,1914,293
2020-04-13,Algeria,69,20,1983,313
2020-04-14,Algeria,87,13,2070,326
2020-04-15,Algeria,90,10,2160,336
2020-04-16,Algeria,108,12,2268,348
2020-04-17,Algeria,150,16,2418,364
2020-04-18,Algeria,116,3,2534,367
2020-04-19,Algeria,95,8,2629,375
2020-04-20,Algeria,89,9,2718,384
2020-04-21,Algeria,93,8,2811,392
2020-04-22,Algeria,99,10,2910,402
2020-04-23,Algeria,97,5,3007,407
2020-04-24,Algeria,120,8,3127,415
2020-04-25,Algeria,129,4,3256,419
2020-04-26,Algeria,126,6,3382,425
2020-04-27,Algeria,135,7,3517,432
2020-04-28,Algeria,132,5,3649,437
2020-04-29,Algeria,199,7,3848,444
2020-04-30,Algeria,158,6,4006,450
2020-05-01,Algeria,148,3,4154,453
2020-05-02,Algeria,141,6,4295,459
2020-05-03,Algeria,179,4,4474,463
2020-05-04,Algeria,174,2,4648,465
2020-05-05,Algeria,190,5,4838,470
2020-05-06,Algeria,159,6,4997,476
2020-05-07,Algeria,185,7,5182,483
2020-05-08,Algeria,187,5,5369,488
2020-05-09,Algeria,189,6,5558,494
2020-05-10,Algeria,165,8,5723,502
2020-05-11,Algeria,168,5,5891,507
2020-05-12,Algeria,176,8,6067,515
2020-05-13,Algeria,186,7,6253,522
2020-05-14,Algeria,189,7,6442,529
2020-05-15,Algeria,187,7,6629,536
2020-05-16,Algeria,192,6,6821,542
2020-05-17,Algeria,198,6,7019,548
2020-05-18,Algeria,182,7,7201,555
2020-05-19,Algeria,176,6,7377,561
2020-05-20,Algeria,165,7,7542,568
2020-05-21,Algeria,186,7,7728,575
2020-05-22,Algeria,190,7,7918,582
2020-05-23,Algeria,195,10,8113,592
2020-05-24,Algeria,193,8,8306,600
2020-05-25,Algeria,197,9,8503,609
2020-05-26,Algeria,194,8,8697,617
2020-05-27,Algeria,160,6,8857,623
2020-05-28,Algeria,140,7,8997,630
2020-05-29,Algeria,137,8,9134,638
2020-05-30,Algeria,133,8,9267,646
2020-05-31,Algeria,127,7,9394,653
2020-06-01,Algeria,119,8,9513,661
2020-06-02,Algeria,113,6,9626,667
2020-06-03,Algeria,107,6,9733,673
2020-06-04,Algeria,98,8,9831,681
2020-06-05,Algeria,104,9,9935,690
2020-06-06,Algeria,115,8,10050,698
2020-06-07,Algeria,104,9,10154,707
2020-06-08,Algeria,111,8,10265,715
2020-06-09,Algeria,117,9,10382,724
2020-06-10,Algeria,102,8,10484,732
2020-06-11,Algeria,105,9,10589,741
2020-06-12,Algeria,109,10,10698,751
2020-06-13,Algeria,112,9,10810,760
2020-06-14,Algeria,109,7,10919,767
2020-06-15,Algeria,112,10,11031,777
2020-06-16,Algeria,116,11,11147,788
2020-06-17,Algeria,121,11,11268,799
2020-06-18,Algeria,117,12,11385,811
2020-06-19,Algeria,119,14,11504,825
2020-06-20,Algeria,127,12,11631,837
2020-06-21,Algeria,140,8,11771,845
2020-06-22,Algeria,149,7,11920,852
2020-06-23,Algeria,156,9,12076,861
2020-06-24,Algeria,172,8,12248,869
2020-06-25,Algeria,197,9,12445,878
2020-06-26,Algeria,240,7,12685,885
2020-06-27,Algeria,283,7,12968,892
2020-06-28,Algeria,305,5,13273,897
2020-06-29,Algeria,298,8,13571,905
2020-06-30,Algeria,336,7,13907,912
2020-07-01,Algeria,365,8,14272,920
2020-07-02,Algeria,385,8,14657,928
2020-07-03,Algeria,413,9,15070,937
2020-07-04,Algeria,430,9,15500,946
2020-07-05,Algeria,441,6,15941,952
2020-07-06,Algeria,463,7,16404,959
2020-07-07,Algeria,475,9,16879,968
2020-07-08,Algeria,469,10,17348,978
2020-07-09,Algeria,460,10,17808,988
2020-07-10,Algeria,434,8,18242,996
2020-07-11,Algeria,470,8,18712,1004
2020-07-12,Algeria,483,7,19195,1011
2020-07-13,Algeria,494,7,19689,1018
2020-07-14,Algeria,527,10,20216,1028
2020-07-15,Algeria,554,12,20770,1040
2020-07-16,Algeria,585,12,21355,1052
2020-07-17,Algeria,593,5,21948,1057
2020-07-18,Algeria,601,11,22549,1068
2020-07-19,Algeria,535,10,23084,1078
2020-07-20,Algeria,607,9,23691,1087
2020-07-21,Algeria,587,13,24278,1100
2020-07-22,Algeria,594,11,24872,1111
2020-07-23,Algeria,612,13,25484,1124
2020-07-24,Algeria,675,12,26159,1136
2020-07-25,Algeria,605,10,26764,1146
2020-07-26,Algeria,593,9,27357,1155
2020-07-27,Algeria,616,8,27973,1163
2020-07-28,Algeria,642,11,28615,1174
2020-07-29,Algeria,614,12,29229,1186
2020-07-30,Algeria,602,14,29831,1200
2020-07-31,Algeria,563,10,30394,1210
2020-08-01,Algeria,556,13,30950,1223
2020-08-02,Algeria,515,8,31465,1231
2020-08-03,Algeria,507,8,31972,1239
2020-08-04,Algeria,532,9,32504,1248
2020-08-05,Algeria,551,13,33055,1261
2020-08-06,Algeria,571,12,33626,1273
2020-08-07,Algeria,529,9,34155,1282
2020-08-08,Algeria,538,11,34693,1293
2020-08-09,Algeria,467,9,35160,1302
2020-08-10,Algeria,552,10,35712,1312
2020-08-11,Algeria,492,10,36204,1322
2020-08-12,Algeria,495,11,36699,1333
2020-08-13,Algeria,488,8,37187,1341
2020-08-14,Algeria,477,10,37664,1351
2020-08-15,Algeria,469,9,38133,1360
2020-08-16,Algeria,450,10,38583,1370
2020-08-17,Algeria,442,9,39025,1379
2020-08-18,Algeria,419,12,39444,1391
2020-08-19,Algeria,403,11,39847,1402
2020-08-20,Algeria,411,9,40258,1411
2020-08-21,Algeria,409,7,40667,1418
2020-08-22,Algeria,401,6,41068,1424
2020-08-23,Algeria,392,11,41460,1435
2020-08-24,Algeria,398,11,41858,1446
2020-08-25,Algeria,370,10,42228,1456
2020-08-26,Algeria,391,9,42619,1465
2020-08-27,Algeria,397,10,43016,1475
2020-08-28,Algeria,387,8,43403,1483
2020-08-29,Algeria,378,8,43781,1491
2020-08-30,Algeria,365,10,44146,1501
2020-08-31,Algeria,348,9,44494,1510
2020-09-01,Algeria,339,8,44833,1518
2020-09-02,Algeria,325,5,45158,1523
2020-09-03,Algeria,311,6,45469,1529
2020-09-04,Algeria,304,10,45773,1539
2020-09-05,Algeria,298,10,46071,1549
2020-09-06,Algeria,293,7,46364,1556
2020-09-07,Algeria,289,6,46653,1562
2020-09-08,Algeria,285,9,46938,1571
2020-09-09,Algeria,278,10,47216,1581
2020-09-10,Algeria,272,10,47488,1591
2020-09-11,Algeria,264,8,47752,1599
2020-09-12,Algeria,255,6,48007,1605
2020-09-13,Algeria,247,7,48254,1612
2020-09-14,Algeria,242,8,48496,1620
2020-09-15,Algeria,238,12,48734,1632
2020-09-16,Algeria,232,13,48966,1645
2020-09-17,Algeria,228,9,49194,1654
2020-09-18,Algeria,219,5,49413,1659
2020-09-19,Algeria,210,6,49623,1665
2020-09-20,Algeria,203,7,49826,1672
2020-09-21,Algeria,197,7,50023,1679
2020-09-22,Algeria,191,10,50214,1689
2020-09-23,Algeria,186,9,50400,1698
2020-09-24,Algeria,179,5,50579,1703
2020-09-25,Algeria,175,4,50754,1707
2020-09-26,Algeria,160,4,50914,1711
2020-09-27,Algeria,153,3,51067,1714
2020-09-28,Algeria,146,5,51213,1719
2020-09-29,Algeria,155,7,51368,1726
2020-09-30,Algeria,162,10,51530,1736
2020-10-01,Algeria,160,5,51690,1741
2020-10-02,Algeria,157,8,51847,1749
2020-10-03,Algeria,148,7,51995,1756
2020-10-04,Algeria,141,4,52136,1760
2020-10-05,Algeria,134,8,52270,1768
2020-10-06,Algeria,129,0,52399,1768
2020-10-07,Algeria,121,3,52520,1771
2020-10-08,Algeria,138,12,52658,1783
2020-10-09,Algeria,146,6,52804,1789
2020-10-10,Algeria,136,6,52940,1795
2020-10-11,Algeria,132,6,53072,1801
2020-10-12,Algeria,253,8,53325,1809
2020-10-13,Algeria,74,9,53399,1818
2020-10-14,Algeria,185,9,53584,1827
2020-10-15,Algeria,193,0,53777,1827
2020-10-16,Algeria,221,14,53998,1841
2020-10-17,Algeria,205,5,54203,1846
2020-10-18,Algeria,199,10,54402,1856
2020-10-19,Algeria,214,9,54616,1865
2020-10-20,Algeria,213,8,54829,1873
2020-10-21,Algeria,252,7,55081,1880
2020-10-22,Algeria,276,8,55357,1888
2020-10-23,Algeria,273,9,55630,1897
2020-10-24,Algeria,250,10,55880,1907
2020-10-25,Algeria,263,7,56143,1914
2020-10-26,Algeria,276,8,56419,1922
2020-10-27,Algeria,287,9,56706,1931
2020-10-28,Algeria,320,10,57026,1941
2020-10-29,Algeria,306,8,57332,1949
2020-10-30,Algeria,319,7,57651,1956
2020-10-31,Algeria,291,8,57942,1964
2020-11-01,Algeria,330,9,58272,1973
2020-11-02,Algeria,302,7,58574,1980
2020-11-03,Algeria,405,0,58979,1980
2020-11-04,Algeria,548,19,59527,1999
2020-11-05,Algeria,642,12,60169,2011
2020-11-06,Algeria,631,13,60800,2024
2020-11-07,Algeria,581,12,61381,2036
2020-11-08,Algeria,670,12,62051,2048
2020-11-09,Algeria,642,14,62693,2062
2020-11-10,Algeria,753,15,63446,2077
2020-11-11,Algeria,811,16,64257,2093
2020-11-12,Algeria,851,18,65108,2111
2020-11-13,Algeria,867,13,65975,2124
2020-11-14,Algeria,844,15,66819,2139
2020-11-15,Algeria,860,15,67679,2154
2020-11-16,Algeria,910,14,68589,2168
2020-11-17,Algeria,1002,18,69591,2186
2020-11-18,Algeria,1038,20,70629,2206
2020-11-19,Algeria,1023,18,71652,2224
2020-11-20,Algeria,1103,12,72755,2236
2020-11-21,Algeria,1019,19,73774,2255
2020-11-22,Algeria,1088,17,74862,2272
2020-11-23,Algeria,1005,22,75867,2294
2020-11-24,Algeria,1133,15,77000,2309
2020-11-25,Algeria,1025,20,78025,2329
2020-11-26,Algeria,1085,23,79110,2352
2020-11-27,Algeria,1058,20,80168,2372
2020-11-28,Algeria,1044,21,81212,2393
2020-11-29,Algeria,1009,17,82221,2410
2020-11-30,Algeria,978,21,83199,2431
2020-12-01,Algeria,953,16,84152,2447
2020-12-02,Algeria,932,17,85084,2464
2020-12-03,Algeria,843,16,85927,2480
2020-12-04,Algeria,803,12,86730,2492
2020-12-05,Algeria,772,9,87502,2501
2020-12-06,Algeria,750,15,88252,2516
2020-12-07,Algeria,573,11,88825,2527
2020-12-08,Algeria,591,12,89416,2539
2020-12-09,Algeria,598,15,90014,2554
2020-12-10,Algeria,565,10,90579,2564
2020-12-11,Algeria,542,11,91121,2575
2020-12-12,Algeria,517,9,91638,2584
2020-12-13,Algeria,464,12,92102,2596
2020-12-14,Algeria,495,13,92597,2609
2020-12-15,Algeria,468,14,93065,2623
2020-12-16,Algeria,442,8,93507,2631
2020-12-17,Algeria,426,9,93933,2640
2020-12-18,Algeria,438,7,94371,2647
2020-12-19,Algeria,410,12,94781,2659
2020-12-20,Algeria,422,7,95203,2666
2020-12-21,Algeria,456,9,95659,2675
2020-12-22,Algeria,410,12,96069,2687
2020-12-23,Algeria,480,9,96549,2696
2020-12-24,Algeria,458,9,97007,2705
2020-12-25,Algeria,434,11,97441,2716
2020-12-26,Algeria,416,6,97857,2722
2020-12-27,Algeria,392,6,98249,2728
2020-12-28,Algeria,382,9,98631,2737
2020-12-29,Algeria,357,8,98988,2745
2020-12-30,Algeria,323,6,99311,2751
2020-12-31,Algeria,299,5,99610,2756
2021-01-01,Algeria,287,6,99897,2762
2021-01-02,Algeria,262,7,100159,2769
2021-01-03,Algeria,249,3,100408,2772
2021-01-04,Algeria,237,5,100645,2777
2021-01-05,Algeria,228,5,100873,2782
2021-01-06,Algeria,247,4,101120,2786
2021-01-07,Algeria,262,6,101382,2792
2021-01-08,Algeria,275,6,101657,2798
2021-01-09,Algeria,256,5,101913,2803
2021-01-10,Algeria,231,4,102144,2807
2021-01-11,Algeria,225,5,102369,2812
2021-01-12,Algeria,272,4,102641,2816
2021-01-13,Algeria,219,3,102860,2819
2021-01-14,Algeria,267,3,103127,2822
2021-01-15,Algeria,254,5,103381,2827
2021-01-16,Algeria,230,4,103611,2831
2021-01-17,Algeria,222,5,103833,2836
2021-01-18,Algeria,259,4,104092,2840
2021-01-19,Algeria,249,3,104341,2843
2021-01-20,Algeria,265,6,104606,2849
2021-01-21,Algeria,246,4,104852,2853
2021-01-22,Algeria,272,3,105124,2856
2021-01-23,Algeria,245,5,105369,2861
2021-01-24,Algeria,227,2,105596,2863
2021-01-25,Algeria,258,3,105854,2866
2021-01-26,Algeria,243,5,106097,2871
2021-01-27,Algeria,262,6,106359,2877
2021-01-28,Algeria,251,4,106610,2881
2021-01-29,Algeria,277,3,106887,2884
2021-01-30,Algeria,235,4,107122,2888
2021-01-31,Algeria,217,3,107339,2891
2021-02-01,Algeria,239,3,107578,2894
2021-02-02,Algeria,263,4,107841,2898
2021-02-03,Algeria,275,2,108116,2900
2021-02-04,Algeria,265,4,108381,2904
2021-02-05,Algeria,248,5,108629,2909
2021-02-06,Algeria,0,0,108629,2909
2021-02-07,Algeria,459,5,109088,2914
2021-02-08,Algeria,225,4,109313,2918
2021-02-09,Algeria,246,6,109559,2924
2021-02-10,Algeria,223,2,109782,2926
2021-02-11,Algeria,267,4,110049,2930
2021-02-12,Algeria,254,2,110303,2932
2021-02-13,Algeria,210,3,110513,2935
2021-02-14,Algeria,198,4,110711,2939
2021-02-15,Algeria,183,4,110894,2943
2021-02-16,Algeria,175,2,111069,2945
2021-02-17,Algeria,178,2,111247,2947
2021-02-18,Algeria,171,3,111418,2950
2021-02-19,Algeria,182,4,111600,2954
2021-02-20,Algeria,164,4,111764,2958
2021-02-21,Algeria,153,3,111917,2961
2021-02-22,Algeria,177,3,112094,2964
2021-02-23,Algeria,185,3,112279,2967
2021-02-24,Algeria,182,3,112461,2970
2021-02-25,Algeria,161,3,112622,2973
2021-02-26,Algeria,183,4,112805,2977
2021-02-27,Algeria,155,2,112960,2979
2021-02-28,Algeria,132,4,113092,2983
2021-03-01,Algeria,163,4,113255,2987
2021-03-02,Algeria,175,4,113430,2991
2021-03-03,Algeria,163,5,113593,2996
2021-03-04,Algeria,168,6,113761,3002
2021-03-05,Algeria,187,5,113948,3007
2021-03-06,Algeria,156,3,114104,3010
2021-03-07,Algeria,130,3,114234,3013
2021-03-08,Algeria,148,5,114382,3018
2021-03-09,Algeria,161,4,114543,3022
2021-03-10,Algeria,138,4,114681,3026
2021-03-11,Algeria,170,2,114851,3028
2021-03-12,Algeria,157,3,115008,3031
2021-03-13,Algeria,135,3,115143,3034
2021-03-14,Algeria,122,2,115265,3036
2021-03-15,Algeria,145,4,115410,3040
2021-03-16,Algeria,130,5,115540,3045
2021-03-17,Algeria,148,3,115688,3048
2021-03-18,Algeria,154,3,115842,3051
2021-03-19,Algeria,128,2,115970,3053
2021-03-20,Algeria,96,2,116066,3055
2021-03-21,Algeria,91,2,116157,3057
2021-03-22,Algeria,98,4,116255,3061
2021-03-23,Algeria,94,5,116349,3066
2021-03-24,Algeria,89,3,116438,3069
2021-03-25,Algeria,105,2,116543,3071
2021-03-26,Algeria,114,3,116657,3074
2021-03-27,Algeria,93,3,116750,3077
2021-03-28,Algeria,86,3,116836,3080
2021-03-29,Algeria,110,4,116946,3084
2021-03-30,Algeria,115,5,117061,3089
2021-03-31,Algeria,131,4,117192,3093
2021-04-01,Algeria,112,3,117304,3096
2021-04-02,Algeria,125,3,117429,3099
2021-04-03,Algeria,95,3,117524,3102
2021-04-04,Algeria,98,3,117622,3105
2021-04-05,Algeria,117,3,117739,3108
2021-04-06,Algeria,140,4,117879,3112
2021-04-07,Algeria,125,4,118004,3116
2021-04-08,Algeria,112,3,118116,3119
2020-03-02,Andorra,1,0,1,0
2020-03-03,Andorra,0,0,1,0
2020-03-04,Andorra,0,0,1,0
2020-03-05,Andorra,0,0,1,0
2020-03-06,Andorra,0,0,1,0
2020-03-07,Andorra,0,0,1,0
2020-03-08,Andorra,0,0,1,0
2020-03-09,Andorra,0,0,1,0
2020-03-10,Andorra,0,0,1,0
2020-03-11,Andorra,0,0,1,0
2020-03-12,Andorra,0,0,1,0
2020-03-13,Andorra,0,0,1,0
2020-03-14,Andorra,0,0,1,0
2020-03-15,Andorra,0,0,1,0
2020-03-16,Andorra,1,0,2,0
2020-03-17,Andorra,37,0,39,0
2020-03-18,Andorra,0,0,39,0
2020-03-19,Andorra,14,0,53,0
2020-03-20,Andorra,22,0,75,0
2020-03-21,Andorra,13,0,88,0
2020-03-22,Andorra,25,1,113,1
2020-03-23,Andorra,20,0,133,1
2020-03-24,Andorra,31,0,164,1
2020-03-25,Andorra,24,0,188,1
2020-03-26,Andorra,36,2,224,3
2020-03-27,Andorra,43,0,267,3
2020-03-28,Andorra,41,0,308,3
2020-03-29,Andorra,26,3,334,6
2020-03-30,Andorra,36,2,370,8
2020-03-31,Andorra,6,4,376,12
2020-04-01,Andorra,14,2,390,14
2020-04-02,Andorra,38,1,428,15
2020-04-03,Andorra,11,1,439,16
2020-04-04,Andorra,27,1,466,17
2020-04-05,Andorra,35,1,501,18
2020-04-06,Andorra,24,3,525,21
2020-04-07,Andorra,20,1,545,22
2020-04-08,Andorra,19,1,564,23
2020-04-09,Andorra,19,2,583,25
2020-04-10,Andorra,18,1,601,26
2020-04-11,Andorra,0,0,601,26
2020-04-12,Andorra,37,3,638,29
2020-04-13,Andorra,8,0,646,29
2020-04-14,Andorra,13,2,659,31
2020-04-15,Andorra,14,2,673,33
2020-04-16,Andorra,0,0,673,33
2020-04-17,Andorra,23,2,696,35
2020-04-18,Andorra,8,0,704,35
2020-04-19,Andorra,9,1,713,36
2020-04-20,Andorra,4,1,717,37
2020-04-21,Andorra,0,0,717,37
2020-04-22,Andorra,6,0,723,37
2020-04-23,Andorra,0,0,723,37
2020-04-24,Andorra,8,3,731,40
2020-04-25,Andorra,7,0,738,40
2020-04-26,Andorra,0,0,738,40
2020-04-27,Andorra,5,0,743,40
2020-04-28,Andorra,0,1,743,41
2020-04-29,Andorra,0,1,743,42
2020-04-30,Andorra,2,0,745,42
2020-05-01,Andorra,0,1,745,43
2020-05-02,Andorra,2,1,747,44
2020-05-03,Andorra,1,1,748,45
2020-05-04,Andorra,2,0,750,45
2020-05-05,Andorra,1,1,751,46
2020-05-06,Andorra,0,0,751,46
2020-05-07,Andorra,1,1,752,47
2020-05-08,Andorra,0,0,752,47
2020-05-09,Andorra,2,1,754,48
2020-05-10,Andorra,1,0,755,48
2020-05-11,Andorra,0,0,755,48
2020-05-12,Andorra,3,0,758,48
2020-05-13,Andorra,2,1,760,49
2020-05-14,Andorra,1,0,761,49
2020-05-15,Andorra,0,0,761,49
2020-05-16,Andorra,0,2,761,51
2020-05-17,Andorra,0,0,761,51
2020-05-18,Andorra,0,0,761,51
2020-05-19,Andorra,0,0,761,51
2020-05-20,Andorra,1,0,762,51
2020-05-21,Andorra,0,0,762,51
2020-05-22,Andorra,0,0,762,51
2020-05-23,Andorra,0,0,762,51
2020-05-24,Andorra,0,0,762,51
2020-05-25,Andorra,1,0,763,51
2020-05-26,Andorra,0,0,763,51
2020-05-27,Andorra,0,0,763,51
2020-05-28,Andorra,0,0,763,51
2020-05-29,Andorra,1,0,764,51
2020-05-30,Andorra,0,0,764,51
2020-05-31,Andorra,0,0,764,51
2020-06-01,Andorra,1,0,765,51
2020-06-02,Andorra,79,0,844,51
2020-06-03,Andorra,7,0,851,51
2020-06-04,Andorra,1,0,852,51
2020-06-05,Andorra,0,0,852,51
2020-06-06,Andorra,0,0,852,51
2020-06-07,Andorra,0,0,852,51
2020-06-08,Andorra,0,0,852,51
2020-06-09,Andorra,0,0,852,51
2020-06-10,Andorra,0,0,852,51
2020-06-11,Andorra,0,0,852,51
2020-06-12,Andorra,1,0,853,51
2020-06-13,Andorra,0,0,853,51
2020-06-14,Andorra,0,0,853,51
2020-06-15,Andorra,0,0,853,51
2020-06-16,Andorra,1,1,854,52
2020-06-17,Andorra,0,0,854,52
2020-06-18,Andorra,1,0,855,52
2020-06-19,Andorra,0,0,855,52
2020-06-20,Andorra,0,0,855,52
2020-06-21,Andorra,0,0,855,52
2020-06-22,Andorra,0,0,855,52
2020-06-23,Andorra,0,0,855,52
2020-06-24,Andorra,0,0,855,52
2020-06-25,Andorra,0,0,855,52
2020-06-26,Andorra,0,0,855,52
2020-06-27,Andorra,0,0,855,52
2020-06-28,Andorra,0,0,855,52
2020-06-29,Andorra,0,0,855,52
2020-06-30,Andorra,0,0,855,52
2020-07-01,Andorra,0,0,855,52
2020-07-02,Andorra,0,0,855,52
2020-07-03,Andorra,0,0,855,52
2020-07-04,Andorra,0,0,855,52
2020-07-05,Andorra,0,0,855,52
2020-07-06,Andorra,0,0,855,52
2020-07-07,Andorra,0,0,855,52
2020-07-08,Andorra,0,0,855,52
2020-07-09,Andorra,0,0,855,52
2020-07-10,Andorra,0,0,855,52
2020-07-11,Andorra,0,0,855,52
2020-07-12,Andorra,0,0,855,52
2020-07-13,Andorra,3,0,858,52
2020-07-14,Andorra,3,0,861,52
2020-07-15,Andorra,1,0,862,52
2020-07-16,Andorra,15,0,877,52
2020-07-17,Andorra,3,0,880,52
2020-07-18,Andorra,0,0,880,52
2020-07-19,Andorra,0,0,880,52
2020-07-20,Andorra,4,0,884,52
2020-07-21,Andorra,0,0,884,52
2020-07-22,Andorra,5,0,889,52
2020-07-23,Andorra,0,0,889,52
2020-07-24,Andorra,8,0,897,52
2020-07-25,Andorra,0,0,897,52
2020-07-26,Andorra,0,0,897,52
2020-07-27,Andorra,10,0,907,52
2020-07-28,Andorra,0,0,907,52
2020-07-29,Andorra,11,0,918,52
2020-07-30,Andorra,4,0,922,52
2020-07-31,Andorra,3,0,925,52
2020-08-01,Andorra,0,0,925,52
2020-08-02,Andorra,0,0,925,52
2020-08-03,Andorra,12,0,937,52
2020-08-04,Andorra,2,0,939,52
2020-08-05,Andorra,0,0,939,52
2020-08-06,Andorra,5,0,944,52
2020-08-07,Andorra,11,0,955,52
2020-08-08,Andorra,0,0,955,52
2020-08-09,Andorra,0,0,955,52
2020-08-10,Andorra,8,0,963,52
2020-08-11,Andorra,0,0,963,52
2020-08-12,Andorra,14,1,977,53
2020-08-13,Andorra,4,0,981,53
2020-08-14,Andorra,8,0,989,53
2020-08-15,Andorra,0,0,989,53
2020-08-16,Andorra,0,0,989,53
2020-08-17,Andorra,16,0,1005,53
2020-08-18,Andorra,0,0,1005,53
2020-08-19,Andorra,19,0,1024,53
2020-08-20,Andorra,0,0,1024,53
2020-08-21,Andorra,21,0,1045,53
2020-08-22,Andorra,0,0,1045,53
2020-08-23,Andorra,0,0,1045,53
2020-08-24,Andorra,15,0,1060,53
2020-08-25,Andorra,0,0,1060,53
2020-08-26,Andorra,38,0,1098,53
2020-08-27,Andorra,0,0,1098,53
2020-08-28,Andorra,26,0,1124,53
2020-08-29,Andorra,0,0,1124,53
2020-08-30,Andorra,0,0,1124,53
2020-08-31,Andorra,52,0,1176,53
2020-09-01,Andorra,8,0,1184,53
2020-09-02,Andorra,15,0,1199,53
2020-09-03,Andorra,0,0,1199,53
2020-09-04,Andorra,16,0,1215,53
2020-09-05,Andorra,0,0,1215,53
2020-09-06,Andorra,0,0,1215,53
2020-09-07,Andorra,46,0,1261,53
2020-09-08,Andorra,0,0,1261,53
2020-09-09,Andorra,40,0,1301,53
2020-09-10,Andorra,0,0,1301,53
2020-09-11,Andorra,43,0,1344,53
2020-09-12,Andorra,0,0,1344,53
2020-09-13,Andorra,0,0,1344,53
2020-09-14,Andorra,94,0,1438,53
2020-09-15,Andorra,0,0,1438,53
2020-09-16,Andorra,45,0,1483,53
2020-09-17,Andorra,0,0,1483,53
2020-09-18,Andorra,81,0,1564,53
2020-09-19,Andorra,0,0,1564,53
2020-09-20,Andorra,0,0,1564,53
2020-09-21,Andorra,117,0,1681,53
2020-09-22,Andorra,0,0,1681,53
2020-09-23,Andorra,72,0,1753,53
2020-09-24,Andorra,0,0,1753,53
2020-09-25,Andorra,83,0,1836,53
2020-09-26,Andorra,0,0,1836,53
2020-09-27,Andorra,0,0,1836,53
2020-09-28,Andorra,130,0,1966,53
2020-09-29,Andorra,0,0,1966,53
2020-09-30,Andorra,84,0,2050,53
2020-10-01,Andorra,0,0,2050,53
2020-10-02,Andorra,60,0,2110,53
2020-10-03,Andorra,0,0,2110,53
2020-10-04,Andorra,0,0,2110,53
2020-10-05,Andorra,260,0,2370,53
2020-10-06,Andorra,0,0,2370,53
2020-10-07,Andorra,198,0,2568,53
2020-10-08,Andorra,0,1,2568,54
2020-10-09,Andorra,128,1,2696,55
2020-10-10,Andorra,0,0,2696,55
2020-10-11,Andorra,0,0,2696,55
2020-10-12,Andorra,299,2,2995,57
2020-10-13,Andorra,0,0,2995,57
2020-10-14,Andorra,195,2,3190,59
2020-10-15,Andorra,0,0,3190,59
2020-10-16,Andorra,187,0,3377,59
2020-10-17,Andorra,0,0,3377,59
2020-10-18,Andorra,0,0,3377,59
2020-10-19,Andorra,246,3,3623,62
2020-10-20,Andorra,0,0,3623,62
2020-10-21,Andorra,188,1,3811,63
2020-10-22,Andorra,0,0,3811,63
2020-10-23,Andorra,227,6,4038,69
2020-10-24,Andorra,0,0,4038,69
2020-10-25,Andorra,0,0,4038,69
2020-10-26,Andorra,287,3,4325,72
2020-10-27,Andorra,85,0,4410,72
2020-10-28,Andorra,107,0,4517,72
2020-10-29,Andorra,50,1,4567,73
2020-10-30,Andorra,98,2,4665,75
2020-10-31,Andorra,91,0,4756,75
2020-11-01,Andorra,69,0,4825,75
2020-11-02,Andorra,63,0,4888,75
2020-11-03,Andorra,22,0,4910,75
2020-11-04,Andorra,135,0,5045,75
2020-11-05,Andorra,90,0,5135,75
2020-11-06,Andorra,0,0,5135,75
2020-11-07,Andorra,184,0,5319,75
2020-11-08,Andorra,64,0,5383,75
2020-11-09,Andorra,54,0,5437,75
2020-11-10,Andorra,40,0,5477,75
2020-11-11,Andorra,90,0,5567,75
2020-11-12,Andorra,49,0,5616,75
2020-11-13,Andorra,109,0,5725,75
2020-11-14,Andorra,0,0,5725,75
2020-11-15,Andorra,147,1,5872,76
2020-11-16,Andorra,42,0,5914,76
2020-11-17,Andorra,37,0,5951,76
2020-11-18,Andorra,67,0,6018,76
2020-11-19,Andorra,48,0,6066,76
2020-11-20,Andorra,76,0,6142,76
2020-11-21,Andorra,65,0,6207,76
2020-11-22,Andorra,49,0,6256,76
2020-11-23,Andorra,48,0,6304,76
2020-11-24,Andorra,47,0,6351,76
2020-11-25,Andorra,77,0,6428,76
2020-11-26,Andorra,106,0,6534,76
2020-11-27,Andorra,76,0,6610,76
2020-11-28,Andorra,0,0,6610,76
2020-11-29,Andorra,102,0,6712,76
2020-11-30,Andorra,33,0,6745,76
2020-12-01,Andorra,45,0,6790,76
2020-12-02,Andorra,52,0,6842,76
2020-12-03,Andorra,62,1,6904,77
2020-12-04,Andorra,51,0,6955,77
2020-12-05,Andorra,50,1,7005,78
2020-12-06,Andorra,45,0,7050,78
2020-12-07,Andorra,34,0,7084,78
2020-12-08,Andorra,43,0,7127,78
2020-12-09,Andorra,35,0,7162,78
2020-12-10,Andorra,28,0,7190,78
2020-12-11,Andorra,46,0,7236,78
2020-12-12,Andorra,52,0,7288,78
2020-12-13,Andorra,50,1,7338,79
2020-12-14,Andorra,44,0,7382,79
2020-12-15,Andorra,0,0,7382,79
2020-12-16,Andorra,64,0,7446,79
2020-12-17,Andorra,20,0,7466,79
2020-12-18,Andorra,53,1,7519,80
2020-12-19,Andorra,41,0,7560,80
2020-12-20,Andorra,17,1,7577,81
2020-12-21,Andorra,25,0,7602,81
2020-12-22,Andorra,31,1,7633,82
2020-12-23,Andorra,36,0,7669,82
2020-12-24,Andorra,30,1,7699,83
2020-12-25,Andorra,57,0,7756,83
2020-12-26,Andorra,50,0,7806,83
2020-12-27,Andorra,15,0,7821,83
2020-12-28,Andorra,54,0,7875,83
2020-12-29,Andorra,44,1,7919,84
2020-12-30,Andorra,64,0,7983,84
2020-12-31,Andorra,66,0,8049,84
2021-01-01,Andorra,68,0,8117,84
2021-01-02,Andorra,49,0,8166,84
2021-01-03,Andorra,26,0,8192,84
2021-01-04,Andorra,57,0,8249,84
2021-01-05,Andorra,59,0,8308,84
2021-01-06,Andorra,40,0,8348,84
2021-01-07,Andorra,0,0,8348,84
2021-01-08,Andorra,141,0,8489,84
2021-01-09,Andorra,97,1,8586,85
2021-01-10,Andorra,0,0,8586,85
2021-01-11,Andorra,0,0,8586,85
2021-01-12,Andorra,96,1,8682,86
2021-01-13,Andorra,136,1,8818,87
2021-01-14,Andorra,50,1,8868,88
2021-01-15,Andorra,78,0,8946,88
2021-01-16,Andorra,92,3,9038,91
2021-01-17,Andorra,45,0,9083,91
2021-01-18,Andorra,0,0,9083,91
2021-01-19,Andorra,111,1,9194,92
2021-01-20,Andorra,114,0,9308,92
2021-01-21,Andorra,71,1,9379,93
2021-01-22,Andorra,37,0,9416,93
2021-01-23,Andorra,83,3,9499,96
2021-01-24,Andorra,50,0,9549,96
2021-01-25,Andorra,47,1,9596,97
2021-01-26,Andorra,42,0,9638,97
2021-01-27,Andorra,78,1,9716,98
2021-01-28,Andorra,63,2,9779,100
2021-01-29,Andorra,58,0,9837,100
2021-01-30,Andorra,48,1,9885,101
2021-01-31,Andorra,52,0,9937,101
2021-02-01,Andorra,35,0,9972,101
2021-02-02,Andorra,45,1,10017,102
2021-02-03,Andorra,53,1,10070,103
2021-02-04,Andorra,67,0,10137,103
2021-02-05,Andorra,35,1,10172,104
2021-02-06,Andorra,34,1,10206,105
2021-02-07,Andorra,45,1,10251,106
2021-02-08,Andorra,24,0,10275,106
2021-02-09,Andorra,37,0,10312,106
2021-02-10,Andorra,40,0,10352,106
2021-02-11,Andorra,39,0,10391,106
2021-02-12,Andorra,36,0,10427,106
2021-02-13,Andorra,36,1,10463,107
2021-02-14,Andorra,40,0,10503,107
2021-02-15,Andorra,35,0,10538,107
2021-02-16,Andorra,17,0,10555,107
2021-02-17,Andorra,28,0,10583,107
2021-02-18,Andorra,27,0,10610,107
2021-02-19,Andorra,35,0,10645,107
2021-02-20,Andorra,27,0,10672,107
2021-02-21,Andorra,27,0,10699,107
2021-02-22,Andorra,13,2,10712,109
2021-02-23,Andorra,27,1,10739,110
2021-02-24,Andorra,36,0,10775,110
2021-02-25,Andorra,24,0,10799,110
2021-02-26,Andorra,23,0,10822,110
2021-02-27,Andorra,27,0,10849,110
2021-02-28,Andorra,17,0,10866,110
2021-03-01,Andorra,23,0,10889,110
2021-03-02,Andorra,19,0,10908,110
2021-03-03,Andorra,40,2,10948,112
2021-03-04,Andorra,28,0,10976,112
2021-03-05,Andorra,22,0,10998,112
2021-03-06,Andorra,21,0,11019,112
2021-03-07,Andorra,23,0,11042,112
2021-03-08,Andorra,27,0,11069,112
2021-03-09,Andorra,20,0,11089,112
2021-03-10,Andorra,41,0,11130,112
2021-03-11,Andorra,0,0,11130,112
2021-03-12,Andorra,69,0,11199,112
2021-03-13,Andorra,29,0,11228,112
2021-03-14,Andorra,38,1,11266,113
2021-03-15,Andorra,23,0,11289,113
2021-03-16,Andorra,30,0,11319,113
2021-03-17,Andorra,41,0,11360,113
2021-03-18,Andorra,33,0,11393,113
2021-03-19,Andorra,38,0,11431,113
2021-03-20,Andorra,50,0,11481,113
2021-03-21,Andorra,36,0,11517,113
2021-03-22,Andorra,28,0,11545,113
2021-03-23,Andorra,46,0,11591,113
2021-03-24,Andorra,47,1,11638,114
2021-03-25,Andorra,49,0,11687,114
2021-03-26,Andorra,45,0,11732,114
2021-03-27,Andorra,77,1,11809,115
2021-03-28,Andorra,41,0,11850,115
2021-03-29,Andorra,38,0,11888,115
2021-03-30,Andorra,56,0,11944,115
2021-03-31,Andorra,66,0,12010,115
2021-04-01,Andorra,43,0,12053,115
2021-04-02,Andorra,62,1,12115,116
2021-04-03,Andorra,59,1,12174,117
2021-04-04,Andorra,57,0,12231,117
2021-04-05,Andorra,55,0,12286,117
2021-04-06,Andorra,42,0,12328,117
2021-04-07,Andorra,35,2,12363,119
2021-04-08,Andorra,46,1,12409,120
2020-03-20,Angola,1,0,1,0
2020-03-21,Angola,1,0,2,0
2020-03-22,Angola,0,0,2,0
2020-03-23,Angola,1,0,3,0
2020-03-24,Angola,0,0,3,0
2020-03-25,Angola,0,0,3,0
2020-03-26,Angola,1,0,4,0
2020-03-27,Angola,0,0,4,0
2020-03-28,Angola,1,0,5,0
2020-03-29,Angola,2,2,7,2
2020-03-30,Angola,0,0,7,2
2020-03-31,Angola,0,0,7,2
2020-04-01,Angola,1,0,8,2
2020-04-02,Angola,0,0,8,2
2020-04-03,Angola,0,0,8,2
2020-04-04,Angola,2,0,10,2
2020-04-05,Angola,4,0,14,2
2020-04-06,Angola,2,0,16,2
2020-04-07,Angola,1,0,17,2
2020-04-08,Angola,2,0,19,2
2020-04-09,Angola,0,0,19,2
2020-04-10,Angola,0,0,19,2
2020-04-11,Angola,0,0,19,2
2020-04-12,Angola,0,0,19,2
2020-04-13,Angola,0,0,19,2
2020-04-14,Angola,0,0,19,2
2020-04-15,Angola,0,0,19,2
2020-04-16,Angola,0,0,19,2
2020-04-17,Angola,0,0,19,2
2020-04-18,Angola,5,0,24,2
2020-04-19,Angola,0,0,24,2
2020-04-20,Angola,0,0,24,2
2020-04-21,Angola,0,0,24,2
2020-04-22,Angola,1,0,25,2
2020-04-23,Angola,0,0,25,2
2020-04-24,Angola,0,0,25,2
2020-04-25,Angola,0,0,25,2
2020-04-26,Angola,1,0,26,2
2020-04-27,Angola,1,0,27,2
2020-04-28,Angola,0,0,27,2
2020-04-29,Angola,0,0,27,2
2020-04-30,Angola,0,0,27,2
2020-05-01,Angola,3,0,30,2
2020-05-02,Angola,5,0,35,2
2020-05-03,Angola,0,0,35,2
2020-05-04,Angola,0,0,35,2
2020-05-05,Angola,1,0,36,2
2020-05-06,Angola,0,0,36,2
2020-05-07,Angola,0,0,36,2
2020-05-08,Angola,7,0,43,2
2020-05-09,Angola,0,0,43,2
2020-05-10,Angola,2,0,45,2
2020-05-11,Angola,0,0,45,2
2020-05-12,Angola,0,0,45,2
2020-05-13,Angola,0,0,45,2
2020-05-14,Angola,3,0,48,2
2020-05-15,Angola,0,0,48,2
2020-05-16,Angola,0,0,48,2
2020-05-17,Angola,0,0,48,2
2020-05-18,Angola,2,1,50,3
2020-05-19,Angola,2,0,52,3
2020-05-20,Angola,0,0,52,3
2020-05-21,Angola,6,0,58,3
2020-05-22,Angola,2,0,60,3
2020-05-23,Angola,1,1,61,4
2020-05-24,Angola,8,0,69,4
2020-05-25,Angola,1,0,70,4
2020-05-26,Angola,0,0,70,4
2020-05-27,Angola,1,0,71,4
2020-05-28,Angola,3,0,74,4
2020-05-29,Angola,7,0,81,4
2020-05-30,Angola,3,0,84,4
2020-05-31,Angola,2,0,86,4
2020-06-01,Angola,0,0,86,4
2020-06-02,Angola,0,0,86,4
2020-06-03,Angola,0,0,86,4
2020-06-04,Angola,0,0,86,4
2020-06-05,Angola,0,0,86,4
2020-06-06,Angola,2,0,88,4
2020-06-07,Angola,3,0,91,4
2020-06-08,Angola,1,0,92,4
2020-06-09,Angola,4,0,96,4
2020-06-10,Angola,17,0,113,4
2020-06-11,Angola,5,1,118,5
2020-06-12,Angola,12,0,130,5
2020-06-13,Angola,8,1,138,6
2020-06-14,Angola,2,0,140,6
2020-06-15,Angola,2,0,142,6
2020-06-16,Angola,6,0,148,6
2020-06-17,Angola,7,1,155,7
2020-06-18,Angola,11,1,166,8
2020-06-19,Angola,6,0,172,8
2020-06-20,Angola,4,1,176,9
2020-06-21,Angola,7,0,183,9
2020-06-22,Angola,3,1,186,10
2020-06-23,Angola,3,0,189,10
2020-06-24,Angola,8,0,197,10
2020-06-25,Angola,15,0,212,10
2020-06-26,Angola,0,0,212,10
2020-06-27,Angola,47,0,259,10
2020-06-28,Angola,8,1,267,11
2020-06-29,Angola,9,0,276,11
2020-06-30,Angola,8,2,284,13
2020-07-01,Angola,7,2,291,15
2020-07-02,Angola,24,2,315,17
2020-07-03,Angola,13,1,328,18
2020-07-04,Angola,18,1,346,19
2020-07-05,Angola,0,0,346,19
2020-07-06,Angola,0,0,346,19
2020-07-07,Angola,40,2,386,21
2020-07-08,Angola,0,0,386,21
2020-07-09,Angola,10,1,396,22
2020-07-10,Angola,62,1,458,23
2020-07-11,Angola,4,0,462,23
2020-07-12,Angola,44,3,506,26
2020-07-13,Angola,19,0,525,26
2020-07-14,Angola,16,0,541,26
2020-07-15,Angola,35,1,576,27
2020-07-16,Angola,31,1,607,28
2020-07-17,Angola,31,1,638,29
2020-07-18,Angola,49,0,687,29
2020-07-19,Angola,18,0,705,29
2020-07-20,Angola,44,0,749,29
2020-07-21,Angola,30,1,779,30
2020-07-22,Angola,33,3,812,33
2020-07-23,Angola,39,0,851,33
2020-07-24,Angola,29,2,880,35
2020-07-25,Angola,36,4,916,39
2020-07-26,Angola,16,1,932,40
2020-07-27,Angola,18,1,950,41
2020-07-28,Angola,50,6,1000,47
2020-07-29,Angola,78,1,1078,48
2020-07-30,Angola,31,3,1109,51
2020-07-31,Angola,39,1,1148,52
2020-08-01,Angola,16,2,1164,54
2020-08-02,Angola,35,1,1199,55
2020-08-03,Angola,81,3,1280,58
2020-08-04,Angola,64,1,1344,59
2020-08-05,Angola,51,3,1395,62
2020-08-06,Angola,88,2,1483,64
2020-08-07,Angola,55,3,1538,67
2020-08-08,Angola,34,3,1572,70
2020-08-09,Angola,100,5,1672,75
2020-08-10,Angola,7,3,1679,78
2020-08-11,Angola,56,2,1735,80
2020-08-12,Angola,27,0,1762,80
2020-08-13,Angola,53,0,1815,80
2020-08-14,Angola,37,6,1852,86
2020-08-15,Angola,27,0,1879,86
2020-08-16,Angola,27,2,1906,88
2020-08-17,Angola,29,0,1935,88
2020-08-18,Angola,31,2,1966,90
2020-08-19,Angola,49,2,2015,92
2020-08-20,Angola,29,1,2044,93
2020-08-21,Angola,24,1,2068,94
2020-08-22,Angola,66,0,2134,94
2020-08-23,Angola,37,2,2171,96
2020-08-24,Angola,51,4,2222,100
2020-08-25,Angola,61,2,2283,102
2020-08-26,Angola,49,1,2332,103
2020-08-27,Angola,83,2,2415,105
2020-08-28,Angola,56,1,2471,106
2020-08-29,Angola,80,1,2551,107
2020-08-30,Angola,73,0,2624,107
2020-08-31,Angola,30,1,2654,108
2020-09-01,Angola,75,1,2729,109
2020-09-02,Angola,48,3,2777,112
2020-09-03,Angola,28,1,2805,113
2020-09-04,Angola,71,2,2876,115
2020-09-05,Angola,59,2,2935,117
2020-09-06,Angola,30,0,2965,117
2020-09-07,Angola,16,3,2981,120
2020-09-08,Angola,52,4,3033,124
2020-09-09,Angola,59,2,3092,126
2020-09-10,Angola,125,4,3217,130
2020-09-11,Angola,62,1,3279,131
2020-09-12,Angola,56,1,3335,132
2020-09-13,Angola,53,2,3388,134
2020-09-14,Angola,51,2,3439,136
2020-09-15,Angola,130,3,3569,139
2020-09-16,Angola,106,4,3675,143
2020-09-17,Angola,114,1,3789,144
2020-09-18,Angola,59,3,3848,147
2020-09-19,Angola,53,0,3901,147
2020-09-20,Angola,90,5,3991,152
2020-09-21,Angola,126,2,4117,154
2020-09-22,Angola,119,1,4236,155
2020-09-23,Angola,127,4,4363,159
2020-09-24,Angola,112,3,4475,162
2020-09-25,Angola,115,5,4590,167
2020-09-26,Angola,82,4,4672,171
2020-09-27,Angola,46,3,4718,174
2020-09-28,Angola,79,2,4797,176
2020-09-29,Angola,108,3,4905,179
2020-09-30,Angola,67,4,4972,183
2020-10-01,Angola,142,2,5114,185
2020-10-02,Angola,97,4,5211,189
2020-10-03,Angola,159,4,5370,193
2020-10-04,Angola,32,2,5402,195
2020-10-05,Angola,128,4,5530,199
2020-10-06,Angola,195,12,5725,211
2020-10-07,Angola,0,0,5725,211
2020-10-08,Angola,233,-3,5958,208
2020-10-09,Angola,73,4,6031,212
2020-10-10,Angola,215,6,6246,218
2020-10-11,Angola,120,0,6366,218
2020-10-12,Angola,122,1,6488,219
2020-10-13,Angola,192,3,6680,222
2020-10-14,Angola,166,5,6846,227
2020-10-15,Angola,250,1,7096,228
2020-10-16,Angola,126,6,7222,234
2020-10-17,Angola,240,7,7462,241
2020-10-18,Angola,160,6,7622,247
2020-10-19,Angola,207,1,7829,248
2020-10-20,Angola,220,3,8049,251
2020-10-21,Angola,289,4,8338,255
2020-10-22,Angola,244,5,8582,260
2020-10-23,Angola,247,5,8829,265
2020-10-24,Angola,197,2,9026,267
2020-10-25,Angola,355,1,9381,268
2020-10-26,Angola,263,2,9644,270
2020-10-27,Angola,227,1,9871,271
2020-10-28,Angola,203,4,10074,275
2020-10-29,Angola,195,0,10269,275
2020-10-30,Angola,289,4,10558,279
2020-10-31,Angola,247,5,10805,284
2020-11-01,Angola,230,2,11035,286
2020-11-02,Angola,193,3,11228,289
2020-11-03,Angola,349,2,11577,291
2020-11-04,Angola,236,5,11813,296
2020-11-05,Angola,289,3,12102,299
2020-11-06,Angola,121,1,12223,300
2020-11-07,Angola,112,3,12335,303
2020-11-08,Angola,98,4,12433,307
2020-11-09,Angola,247,1,12680,308
2020-11-10,Angola,136,0,12816,308
2020-11-11,Angola,137,4,12953,312
2020-11-12,Angola,100,3,13053,315
2020-11-13,Angola,175,2,13228,317
2020-11-14,Angola,146,5,13374,322
2020-11-15,Angola,77,0,13451,322
2020-11-16,Angola,164,2,13615,324
2020-11-17,Angola,203,4,13818,328
2020-11-18,Angola,104,4,13922,332
2020-11-19,Angola,212,1,14134,333
2020-11-20,Angola,133,1,14267,334
2020-11-21,Angola,146,2,14413,336
2020-11-22,Angola,80,1,14493,337
2020-11-23,Angola,141,0,14634,337
2020-11-24,Angola,108,1,14742,338
2020-11-25,Angola,79,2,14821,340
2020-11-26,Angola,99,1,14920,341
2020-11-27,Angola,88,1,15008,342
2020-11-28,Angola,79,3,15087,345
2020-11-29,Angola,16,1,15103,346
2020-11-30,Angola,36,2,15139,348
2020-12-01,Angola,112,2,15251,350
2020-12-02,Angola,68,1,15319,351
2020-12-03,Angola,42,1,15361,352
2020-12-04,Angola,132,1,15493,353
2020-12-05,Angola,43,1,15536,354
2020-12-06,Angola,55,0,15591,354
2020-12-07,Angola,57,0,15648,354
2020-12-08,Angola,81,1,15729,355
2020-12-09,Angola,75,3,15804,358
2020-12-10,Angola,121,4,15925,362
2020-12-11,Angola,136,3,16061,365
2020-12-12,Angola,100,1,16161,366
2020-12-13,Angola,27,5,16188,371
2020-12-14,Angola,89,1,16277,372
2020-12-15,Angola,85,0,16362,372
2020-12-16,Angola,45,7,16407,379
2020-12-17,Angola,77,3,16484,382
2020-12-18,Angola,78,2,16562,384
2020-12-19,Angola,64,2,16626,386
2020-12-20,Angola,18,1,16644,387
2020-12-21,Angola,42,3,16686,390
2020-12-22,Angola,116,3,16802,393
2020-12-23,Angola,129,0,16931,393
2020-12-24,Angola,98,0,17029,393
2020-12-25,Angola,70,3,17099,396
2020-12-26,Angola,50,3,17149,399
2020-12-27,Angola,91,0,17240,399
2020-12-28,Angola,56,4,17296,403
2020-12-29,Angola,75,0,17371,403
2020-12-30,Angola,62,2,17433,405
2020-12-31,Angola,120,0,17553,405
2021-01-01,Angola,15,0,17568,405
2021-01-02,Angola,40,2,17608,407
2021-01-03,Angola,34,1,17642,408
2021-01-04,Angola,42,0,17684,408
2021-01-05,Angola,72,2,17756,410
2021-01-06,Angola,108,3,17864,413
2021-01-07,Angola,110,0,17974,413
2021-01-08,Angola,92,2,18066,415
2021-01-09,Angola,90,1,18156,416
2021-01-10,Angola,37,0,18193,416
2021-01-11,Angola,61,4,18254,420
2021-01-12,Angola,89,2,18343,422
2021-01-13,Angola,82,2,18425,424
2021-01-14,Angola,188,1,18613,425
2021-01-15,Angola,66,3,18679,428
2021-01-16,Angola,86,3,18765,431
2021-01-17,Angola,110,5,18875,436
2021-01-18,Angola,51,3,18926,439
2021-01-19,Angola,85,3,19011,442
2021-01-20,Angola,82,2,19093,444
2021-01-21,Angola,84,4,19177,448
2021-01-22,Angola,92,4,19269,452
2021-01-23,Angola,98,5,19367,457
2021-01-24,Angola,32,2,19399,459
2021-01-25,Angola,77,2,19476,461
2021-01-26,Angola,77,1,19553,462
2021-01-27,Angola,27,0,19580,462
2021-01-28,Angola,92,2,19672,464
2021-01-29,Angola,51,0,19723,464
2021-01-30,Angola,59,0,19782,464
2021-01-31,Angola,14,2,19796,466
2021-02-01,Angola,33,0,19829,466
2021-02-02,Angola,71,2,19900,468
2021-02-03,Angola,37,2,19937,470
2021-02-04,Angola,59,3,19996,473
2021-02-05,Angola,34,1,20030,474
2021-02-06,Angola,32,1,20062,475
2021-02-07,Angola,24,0,20086,475
2021-02-08,Angola,26,0,20112,475
2021-02-09,Angola,51,3,20163,478
2021-02-10,Angola,47,9,20210,487
2021-02-11,Angola,51,0,20261,487
2021-02-12,Angola,33,3,20294,490
2021-02-13,Angola,35,1,20329,491
2021-02-14,Angola,37,1,20366,492
2021-02-15,Angola,15,1,20381,493
2021-02-16,Angola,8,1,20389,494
2021-02-17,Angola,11,2,20400,496
2021-02-18,Angola,52,2,20452,498
2021-02-19,Angola,26,0,20478,498
2021-02-20,Angola,21,0,20499,498
2021-02-21,Angola,20,1,20519,499
2021-02-22,Angola,29,0,20548,499
2021-02-23,Angola,36,1,20584,500
2021-02-24,Angola,56,1,20640,501
2021-02-25,Angola,55,1,20695,502
2021-02-26,Angola,64,2,20759,504
2021-02-27,Angola,23,2,20782,506
2021-02-28,Angola,25,2,20807,508
2021-03-01,Angola,47,0,20854,508
2021-03-02,Angola,28,2,20882,510
2021-03-03,Angola,41,0,20923,510
2021-03-04,Angola,58,1,20981,511
2021-03-05,Angola,45,0,21026,511
2021-03-06,Angola,29,1,21055,512
2021-03-07,Angola,31,2,21086,514
2021-03-08,Angola,22,1,21108,515
2021-03-09,Angola,6,1,21114,516
2021-03-10,Angola,47,0,21161,516
2021-03-11,Angola,44,1,21205,517
2021-03-12,Angola,60,2,21265,519
2021-03-13,Angola,58,1,21323,520
2021-03-14,Angola,57,1,21380,521
2021-03-15,Angola,27,0,21407,521
2021-03-16,Angola,39,1,21446,522
2021-03-17,Angola,43,0,21489,522
2021-03-18,Angola,69,0,21558,522
2021-03-19,Angola,84,2,21642,524
2021-03-20,Angola,54,2,21696,526
2021-03-21,Angola,37,1,21733,527
2021-03-22,Angola,24,3,21757,530
2021-03-23,Angola,17,0,21774,530
2021-03-24,Angola,62,2,21836,532
2021-03-25,Angola,78,0,21914,532
2021-03-26,Angola,47,0,21961,532
2021-03-27,Angola,70,1,22031,533
2021-03-28,Angola,32,0,22063,533
2021-03-29,Angola,69,1,22132,534
2021-03-30,Angola,50,2,22182,536
2021-03-31,Angola,129,1,22311,537
2021-04-01,Angola,88,1,22399,538
2021-04-02,Angola,68,0,22467,538
2021-04-03,Angola,112,2,22579,540
2021-04-04,Angola,52,2,22631,542
2021-04-05,Angola,86,1,22717,543
2021-04-06,Angola,168,4,22885,547
2021-04-07,Angola,125,0,23010,547
2021-04-08,Angola,98,2,23108,549
2020-03-13,Antigua and Barbuda,1,0,1,0
2020-03-14,Antigua and Barbuda,0,0,1,0
2020-03-15,Antigua and Barbuda,0,0,1,0
2020-03-16,Antigua and Barbuda,0,0,1,0
2020-03-17,Antigua and Barbuda,0,0,1,0
2020-03-18,Antigua and Barbuda,0,0,1,0
2020-03-19,Antigua and Barbuda,0,0,1,0
2020-03-20,Antigua and Barbuda,0,0,1,0
2020-03-21,Antigua and Barbuda,0,0,1,0
2020-03-22,Antigua and Barbuda,0,0,1,0
2020-03-23,Antigua and Barbuda,2,0,3,0
2020-03-24,Antigua and Barbuda,0,0,3,0
2020-03-25,Antigua and Barbuda,0,0,3,0
2020-03-26,Antigua and Barbuda,4,0,7,0
2020-03-27,Antigua and Barbuda,0,0,7,0
2020-03-28,Antigua and Barbuda,0,0,7,0
2020-03-29,Antigua and Barbuda,0,0,7,0
2020-03-30,Antigua and Barbuda,0,0,7,0
2020-03-31,Antigua and Barbuda,0,0,7,0
2020-04-01,Antigua and Barbuda,0,0,7,0
2020-04-02,Antigua and Barbuda,2,0,9,0
2020-04-03,Antigua and Barbuda,6,0,15,0
2020-04-04,Antigua and Barbuda,0,0,15,0
2020-04-05,Antigua and Barbuda,0,0,15,0
2020-04-06,Antigua and Barbuda,0,0,15,0
2020-04-07,Antigua and Barbuda,4,1,19,1
2020-04-08,Antigua and Barbuda,0,1,19,2
2020-04-09,Antigua and Barbuda,0,0,19,2
2020-04-10,Antigua and Barbuda,0,0,19,2
2020-04-11,Antigua and Barbuda,2,0,21,2
2020-04-12,Antigua and Barbuda,0,0,21,2
2020-04-13,Antigua and Barbuda,2,0,23,2
2020-04-14,Antigua and Barbuda,0,0,23,2
2020-04-15,Antigua and Barbuda,0,0,23,2
2020-04-16,Antigua and Barbuda,0,1,23,3
2020-04-17,Antigua and Barbuda,0,0,23,3
2020-04-18,Antigua and Barbuda,0,0,23,3
2020-04-19,Antigua and Barbuda,0,0,23,3
2020-04-20,Antigua and Barbuda,0,0,23,3
2020-04-21,Antigua and Barbuda,0,0,23,3
2020-04-22,Antigua and Barbuda,1,0,24,3
2020-04-23,Antigua and Barbuda,0,0,24,3
2020-04-24,Antigua and Barbuda,0,0,24,3
2020-04-25,Antigua and Barbuda,0,0,24,3
2020-04-26,Antigua and Barbuda,0,0,24,3
2020-04-27,Antigua and Barbuda,0,0,24,3
2020-04-28,Antigua and Barbuda,0,0,24,3
2020-04-29,Antigua and Barbuda,0,0,24,3
2020-04-30,Antigua and Barbuda,0,0,24,3
2020-05-01,Antigua and Barbuda,1,0,25,3
2020-05-02,Antigua and Barbuda,0,0,25,3
2020-05-03,Antigua and Barbuda,0,0,25,3
2020-05-04,Antigua and Barbuda,0,0,25,3
2020-05-05,Antigua and Barbuda,0,0,25,3
2020-05-06,Antigua and Barbuda,0,0,25,3
2020-05-07,Antigua and Barbuda,0,0,25,3
2020-05-08,Antigua and Barbuda,0,0,25,3
2020-05-09,Antigua and Barbuda,0,0,25,3
2020-05-10,Antigua and Barbuda,0,0,25,3
2020-05-11,Antigua and Barbuda,0,0,25,3
2020-05-12,Antigua and Barbuda,0,0,25,3
2020-05-13,Antigua and Barbuda,0,0,25,3
2020-05-14,Antigua and Barbuda,0,0,25,3
2020-05-15,Antigua and Barbuda,0,0,25,3
2020-05-16,Antigua and Barbuda,0,0,25,3
2020-05-17,Antigua and Barbuda,0,0,25,3
2020-05-18,Antigua and Barbuda,0,0,25,3
2020-05-19,Antigua and Barbuda,0,0,25,3
2020-05-20,Antigua and Barbuda,0,0,25,3
2020-05-21,Antigua and Barbuda,0,0,25,3
2020-05-22,Antigua and Barbuda,0,0,25,3
2020-05-23,Antigua and Barbuda,0,0,25,3
2020-05-24,Antigua and Barbuda,0,0,25,3
2020-05-25,Antigua and Barbuda,0,0,25,3
2020-05-26,Antigua and Barbuda,0,0,25,3
2020-05-27,Antigua and Barbuda,0,0,25,3
2020-05-28,Antigua and Barbuda,0,0,25,3
2020-05-29,Antigua and Barbuda,0,0,25,3
2020-05-30,Antigua and Barbuda,0,0,25,3
2020-05-31,Antigua and Barbuda,1,0,26,3
2020-06-01,Antigua and Barbuda,0,0,26,3
2020-06-02,Antigua and Barbuda,0,0,26,3
2020-06-03,Antigua and Barbuda,0,0,26,3
2020-06-04,Antigua and Barbuda,0,0,26,3
2020-06-05,Antigua and Barbuda,0,0,26,3
2020-06-06,Antigua and Barbuda,0,0,26,3
2020-06-07,Antigua and Barbuda,0,0,26,3
2020-06-08,Antigua and Barbuda,0,0,26,3
2020-06-09,Antigua and Barbuda,0,0,26,3
2020-06-10,Antigua and Barbuda,0,0,26,3
2020-06-11,Antigua and Barbuda,0,0,26,3
2020-06-12,Antigua and Barbuda,0,0,26,3
2020-06-13,Antigua and Barbuda,0,0,26,3
2020-06-14,Antigua and Barbuda,0,0,26,3
2020-06-15,Antigua and Barbuda,0,0,26,3
2020-06-16,Antigua and Barbuda,0,0,26,3
2020-06-17,Antigua and Barbuda,0,0,26,3
2020-06-18,Antigua and Barbuda,0,0,26,3
2020-06-19,Antigua and Barbuda,0,0,26,3
2020-06-20,Antigua and Barbuda,0,0,26,3
2020-06-21,Antigua and Barbuda,0,0,26,3
2020-06-22,Antigua and Barbuda,0,0,26,3
2020-06-23,Antigua and Barbuda,0,0,26,3
2020-06-24,Antigua and Barbuda,0,0,26,3
2020-06-25,Antigua and Barbuda,39,0,65,3
2020-06-26,Antigua and Barbuda,0,0,65,3
2020-06-27,Antigua and Barbuda,0,0,65,3
2020-06-28,Antigua and Barbuda,4,0,69,3
2020-06-29,Antigua and Barbuda,0,0,69,3
2020-06-30,Antigua and Barbuda,0,0,69,3
2020-07-01,Antigua and Barbuda,0,0,69,3
2020-07-02,Antigua and Barbuda,0,0,69,3
2020-07-03,Antigua and Barbuda,-1,0,68,3
2020-07-04,Antigua and Barbuda,0,0,68,3
2020-07-05,Antigua and Barbuda,0,0,68,3
2020-07-06,Antigua and Barbuda,2,0,70,3
2020-07-07,Antigua and Barbuda,0,0,70,3
2020-07-08,Antigua and Barbuda,0,0,70,3
2020-07-09,Antigua and Barbuda,3,0,73,3
2020-07-10,Antigua and Barbuda,1,0,74,3
2020-07-11,Antigua and Barbuda,0,0,74,3
2020-07-12,Antigua and Barbuda,0,0,74,3
2020-07-13,Antigua and Barbuda,0,0,74,3
2020-07-14,Antigua and Barbuda,0,0,74,3
2020-07-15,Antigua and Barbuda,0,0,74,3
2020-07-16,Antigua and Barbuda,0,0,74,3
2020-07-17,Antigua and Barbuda,2,0,76,3
2020-07-18,Antigua and Barbuda,0,0,76,3
2020-07-19,Antigua and Barbuda,0,0,76,3
2020-07-20,Antigua and Barbuda,0,0,76,3
2020-07-21,Antigua and Barbuda,0,0,76,3
2020-07-22,Antigua and Barbuda,0,0,76,3
2020-07-23,Antigua and Barbuda,0,0,76,3
2020-07-24,Antigua and Barbuda,6,0,82,3
2020-07-25,Antigua and Barbuda,0,0,82,3
2020-07-26,Antigua and Barbuda,0,0,82,3
2020-07-27,Antigua and Barbuda,4,0,86,3
2020-07-28,Antigua and Barbuda,0,0,86,3
2020-07-29,Antigua and Barbuda,5,0,91,3
2020-07-30,Antigua and Barbuda,0,0,91,3
2020-07-31,Antigua and Barbuda,0,0,91,3
2020-08-01,Antigua and Barbuda,0,0,91,3
2020-08-02,Antigua and Barbuda,0,0,91,3
2020-08-03,Antigua and Barbuda,1,0,92,3
2020-08-04,Antigua and Barbuda,0,0,92,3
2020-08-05,Antigua and Barbuda,0,0,92,3
2020-08-06,Antigua and Barbuda,0,0,92,3
2020-08-07,Antigua and Barbuda,0,0,92,3
2020-08-08,Antigua and Barbuda,0,0,92,3
2020-08-09,Antigua and Barbuda,0,0,92,3
2020-08-10,Antigua and Barbuda,0,0,92,3
2020-08-11,Antigua and Barbuda,0,0,92,3
2020-08-12,Antigua and Barbuda,0,0,92,3
2020-08-13,Antigua and Barbuda,0,0,92,3
2020-08-14,Antigua and Barbuda,1,0,93,3
2020-08-15,Antigua and Barbuda,0,0,93,3
2020-08-16,Antigua and Barbuda,0,0,93,3
2020-08-17,Antigua and Barbuda,0,0,93,3
2020-08-18,Antigua and Barbuda,0,0,93,3
2020-08-19,Antigua and Barbuda,1,0,94,3
2020-08-20,Antigua and Barbuda,0,0,94,3
2020-08-21,Antigua and Barbuda,0,0,94,3
2020-08-22,Antigua and Barbuda,0,0,94,3
2020-08-23,Antigua and Barbuda,0,0,94,3
2020-08-24,Antigua and Barbuda,0,0,94,3
2020-08-25,Antigua and Barbuda,0,0,94,3
2020-08-26,Antigua and Barbuda,0,0,94,3
2020-08-27,Antigua and Barbuda,0,0,94,3
2020-08-28,Antigua and Barbuda,0,0,94,3
2020-08-29,Antigua and Barbuda,0,0,94,3
2020-08-30,Antigua and Barbuda,0,0,94,3
2020-08-31,Antigua and Barbuda,0,0,94,3
2020-09-01,Antigua and Barbuda,0,0,94,3
2020-09-02,Antigua and Barbuda,0,0,94,3
2020-09-03,Antigua and Barbuda,1,0,95,3
2020-09-04,Antigua and Barbuda,0,0,95,3
2020-09-05,Antigua and Barbuda,0,0,95,3
2020-09-06,Antigua and Barbuda,0,0,95,3
2020-09-07,Antigua and Barbuda,0,0,95,3
2020-09-08,Antigua and Barbuda,0,0,95,3
2020-09-09,Antigua and Barbuda,0,0,95,3
2020-09-10,Antigua and Barbuda,0,0,95,3
2020-09-11,Antigua and Barbuda,0,0,95,3
2020-09-12,Antigua and Barbuda,0,0,95,3
2020-09-13,Antigua and Barbuda,0,0,95,3
2020-09-14,Antigua and Barbuda,0,0,95,3
2020-09-15,Antigua and Barbuda,0,0,95,3
2020-09-16,Antigua and Barbuda,0,0,95,3
2020-09-17,Antigua and Barbuda,0,0,95,3
2020-09-18,Antigua and Barbuda,0,0,95,3
2020-09-19,Antigua and Barbuda,1,0,96,3
2020-09-20,Antigua and Barbuda,0,0,96,3
2020-09-21,Antigua and Barbuda,0,0,96,3
2020-09-22,Antigua and Barbuda,0,0,96,3
2020-09-23,Antigua and Barbuda,1,0,97,3
2020-09-24,Antigua and Barbuda,0,0,97,3
2020-09-25,Antigua and Barbuda,1,0,98,3
2020-09-26,Antigua and Barbuda,0,0,98,3
2020-09-27,Antigua and Barbuda,3,0,101,3
2020-09-28,Antigua and Barbuda,0,0,101,3
2020-09-29,Antigua and Barbuda,0,0,101,3
2020-09-30,Antigua and Barbuda,0,0,101,3
2020-10-01,Antigua and Barbuda,0,0,101,3
2020-10-02,Antigua and Barbuda,5,0,106,3
2020-10-03,Antigua and Barbuda,1,0,107,3
2020-10-04,Antigua and Barbuda,0,0,107,3
2020-10-05,Antigua and Barbuda,0,0,107,3
2020-10-06,Antigua and Barbuda,0,0,107,3
2020-10-07,Antigua and Barbuda,1,0,108,3
2020-10-08,Antigua and Barbuda,3,0,111,3
2020-10-09,Antigua and Barbuda,0,0,111,3
2020-10-10,Antigua and Barbuda,0,0,111,3
2020-10-11,Antigua and Barbuda,0,0,111,3
2020-10-12,Antigua and Barbuda,0,0,111,3
2020-10-13,Antigua and Barbuda,0,0,111,3
2020-10-14,Antigua and Barbuda,1,0,112,3
2020-10-15,Antigua and Barbuda,0,0,112,3
2020-10-16,Antigua and Barbuda,0,0,112,3
2020-10-17,Antigua and Barbuda,7,0,119,3
2020-10-18,Antigua and Barbuda,0,0,119,3
2020-10-19,Antigua and Barbuda,0,0,119,3
2020-10-20,Antigua and Barbuda,0,0,119,3
2020-10-21,Antigua and Barbuda,3,0,122,3
2020-10-22,Antigua and Barbuda,0,0,122,3
2020-10-23,Antigua and Barbuda,0,0,122,3
2020-10-24,Antigua and Barbuda,2,0,124,3
2020-10-25,Antigua and Barbuda,0,0,124,3
2020-10-26,Antigua and Barbuda,0,0,124,3
2020-10-27,Antigua and Barbuda,0,0,124,3
2020-10-28,Antigua and Barbuda,0,0,124,3
2020-10-29,Antigua and Barbuda,0,0,124,3
2020-10-30,Antigua and Barbuda,3,0,127,3
2020-10-31,Antigua and Barbuda,1,0,128,3
2020-11-01,Antigua and Barbuda,0,0,128,3
2020-11-02,Antigua and Barbuda,0,0,128,3
2020-11-03,Antigua and Barbuda,0,0,128,3
2020-11-04,Antigua and Barbuda,2,0,130,3
2020-11-05,Antigua and Barbuda,0,0,130,3
2020-11-06,Antigua and Barbuda,0,0,130,3
2020-11-07,Antigua and Barbuda,1,0,131,3
2020-11-08,Antigua and Barbuda,0,0,131,3
2020-11-09,Antigua and Barbuda,0,0,131,3
2020-11-10,Antigua and Barbuda,0,0,131,3
2020-11-11,Antigua and Barbuda,0,0,131,3
2020-11-12,Antigua and Barbuda,0,0,131,3
2020-11-13,Antigua and Barbuda,2,0,133,3
2020-11-14,Antigua and Barbuda,1,1,134,4
2020-11-15,Antigua and Barbuda,0,0,134,4
2020-11-16,Antigua and Barbuda,0,0,134,4
2020-11-17,Antigua and Barbuda,0,0,134,4
2020-11-18,Antigua and Barbuda,5,0,139,4
2020-11-19,Antigua and Barbuda,0,0,139,4
2020-11-20,Antigua and Barbuda,0,0,139,4
2020-11-21,Antigua and Barbuda,0,0,139,4
2020-11-22,Antigua and Barbuda,0,0,139,4
2020-11-23,Antigua and Barbuda,0,0,139,4
2020-11-24,Antigua and Barbuda,0,0,139,4
2020-11-25,Antigua and Barbuda,1,0,140,4
2020-11-26,Antigua and Barbuda,1,0,141,4
2020-11-27,Antigua and Barbuda,0,0,141,4
2020-11-28,Antigua and Barbuda,0,0,141,4
2020-11-29,Antigua and Barbuda,0,0,141,4
2020-11-30,Antigua and Barbuda,0,0,141,4
2020-12-01,Antigua and Barbuda,1,0,142,4
2020-12-02,Antigua and Barbuda,2,0,144,4
2020-12-03,Antigua and Barbuda,0,0,144,4
2020-12-04,Antigua and Barbuda,0,0,144,4
2020-12-05,Antigua and Barbuda,0,0,144,4
2020-12-06,Antigua and Barbuda,0,0,144,4
2020-12-07,Antigua and Barbuda,2,0,146,4
2020-12-08,Antigua and Barbuda,0,0,146,4
2020-12-09,Antigua and Barbuda,0,0,146,4
2020-12-10,Antigua and Barbuda,0,0,146,4
2020-12-11,Antigua and Barbuda,1,0,147,4
2020-12-12,Antigua and Barbuda,1,0,148,4
2020-12-13,Antigua and Barbuda,0,1,148,5
2020-12-14,Antigua and Barbuda,0,0,148,5
2020-12-15,Antigua and Barbuda,0,0,148,5
2020-12-16,Antigua and Barbuda,3,0,151,5
2020-12-17,Antigua and Barbuda,0,0,151,5
2020-12-18,Antigua and Barbuda,1,0,152,5
2020-12-19,Antigua and Barbuda,0,0,152,5
2020-12-20,Antigua and Barbuda,1,0,153,5
2020-12-21,Antigua and Barbuda,0,0,153,5
2020-12-22,Antigua and Barbuda,0,0,153,5
2020-12-23,Antigua and Barbuda,1,0,154,5
2020-12-24,Antigua and Barbuda,0,0,154,5
2020-12-25,Antigua and Barbuda,1,0,155,5
2020-12-26,Antigua and Barbuda,0,0,155,5
2020-12-27,Antigua and Barbuda,0,0,155,5
2020-12-28,Antigua and Barbuda,3,0,158,5
2020-12-29,Antigua and Barbuda,0,0,158,5
2020-12-30,Antigua and Barbuda,0,0,158,5
2020-12-31,Antigua and Barbuda,1,0,159,5
2021-01-01,Antigua and Barbuda,0,0,159,5
2021-01-02,Antigua and Barbuda,0,0,159,5
2021-01-03,Antigua and Barbuda,1,0,160,5
2021-01-04,Antigua and Barbuda,0,0,160,5
2021-01-05,Antigua and Barbuda,0,0,160,5
2021-01-06,Antigua and Barbuda,3,0,163,5
2021-01-07,Antigua and Barbuda,0,0,163,5
2021-01-08,Antigua and Barbuda,4,0,167,5
2021-01-09,Antigua and Barbuda,2,0,169,5
2021-01-10,Antigua and Barbuda,7,0,176,5
2021-01-11,Antigua and Barbuda,0,0,176,5
2021-01-12,Antigua and Barbuda,0,0,176,5
2021-01-13,Antigua and Barbuda,0,0,176,5
2021-01-14,Antigua and Barbuda,8,1,184,6
2021-01-15,Antigua and Barbuda,0,0,184,6
2021-01-16,Antigua and Barbuda,3,0,187,6
2021-01-17,Antigua and Barbuda,2,0,189,6
2021-01-18,Antigua and Barbuda,0,0,189,6
2021-01-19,Antigua and Barbuda,1,0,190,6
2021-01-20,Antigua and Barbuda,0,0,190,6
2021-01-21,Antigua and Barbuda,2,0,192,6
2021-01-22,Antigua and Barbuda,3,0,195,6
2021-01-23,Antigua and Barbuda,0,0,195,6
2021-01-24,Antigua and Barbuda,3,0,198,6
2021-01-25,Antigua and Barbuda,3,0,201,6
2021-01-26,Antigua and Barbuda,0,0,201,6
2021-01-27,Antigua and Barbuda,14,0,215,6
2021-01-28,Antigua and Barbuda,0,0,215,6
2021-01-29,Antigua and Barbuda,3,0,218,6
2021-01-30,Antigua and Barbuda,0,1,218,7
2021-01-31,Antigua and Barbuda,16,0,234,7
2021-02-01,Antigua and Barbuda,0,0,234,7
2021-02-02,Antigua and Barbuda,15,0,249,7
2021-02-03,Antigua and Barbuda,0,0,249,7
2021-02-04,Antigua and Barbuda,19,0,268,7
2021-02-05,Antigua and Barbuda,9,0,277,7
2021-02-06,Antigua and Barbuda,11,0,288,7
2021-02-07,Antigua and Barbuda,11,0,299,7
2021-02-08,Antigua and Barbuda,17,0,316,7
2021-02-09,Antigua and Barbuda,0,1,316,8
2021-02-10,Antigua and Barbuda,34,1,350,9
2021-02-11,Antigua and Barbuda,31,0,381,9
2021-02-12,Antigua and Barbuda,38,0,419,9
2021-02-13,Antigua and Barbuda,8,0,427,9
2021-02-14,Antigua and Barbuda,0,0,427,9
2021-02-15,Antigua and Barbuda,16,0,443,9
2021-02-16,Antigua and Barbuda,0,0,443,9
2021-02-17,Antigua and Barbuda,82,1,525,10
2021-02-18,Antigua and Barbuda,23,0,548,10
2021-02-19,Antigua and Barbuda,0,0,548,10
2021-02-20,Antigua and Barbuda,50,1,598,11
2021-02-21,Antigua and Barbuda,0,2,598,13
2021-02-22,Antigua and Barbuda,16,1,614,14
2021-02-23,Antigua and Barbuda,22,0,636,14
2021-02-24,Antigua and Barbuda,10,0,646,14
2021-02-25,Antigua and Barbuda,55,0,701,14
2021-02-26,Antigua and Barbuda,0,0,701,14
2021-02-27,Antigua and Barbuda,25,0,726,14
2021-02-28,Antigua and Barbuda,4,0,730,14
2021-03-01,Antigua and Barbuda,39,0,769,14
2021-03-02,Antigua and Barbuda,0,0,769,14
2021-03-03,Antigua and Barbuda,0,5,769,19
2021-03-04,Antigua and Barbuda,44,2,813,21
2021-03-05,Antigua and Barbuda,0,0,813,21
2021-03-06,Antigua and Barbuda,0,0,813,21
2021-03-07,Antigua and Barbuda,35,0,848,21
2021-03-08,Antigua and Barbuda,0,0,848,21
2021-03-09,Antigua and Barbuda,14,1,862,22
2021-03-10,Antigua and Barbuda,20,1,882,23
2021-03-11,Antigua and Barbuda,0,0,882,23
2021-03-12,Antigua and Barbuda,63,2,945,25
2021-03-13,Antigua and Barbuda,17,2,962,27
2021-03-14,Antigua and Barbuda,1,0,963,27
2021-03-15,Antigua and Barbuda,0,0,963,27
2021-03-16,Antigua and Barbuda,29,0,992,27
2021-03-17,Antigua and Barbuda,0,0,992,27
2021-03-18,Antigua and Barbuda,16,0,1008,27
2021-03-19,Antigua and Barbuda,3,0,1011,27
2021-03-20,Antigua and Barbuda,22,1,1033,28
2021-03-21,Antigua and Barbuda,0,0,1033,28
2021-03-22,Antigua and Barbuda,39,0,1072,28
2021-03-23,Antigua and Barbuda,8,0,1080,28
2021-03-24,Antigua and Barbuda,0,0,1080,28
2021-03-25,Antigua and Barbuda,23,0,1103,28
2021-03-26,Antigua and Barbuda,19,0,1122,28
2021-03-27,Antigua and Barbuda,0,0,1122,28
2021-03-28,Antigua and Barbuda,6,0,1128,28
2021-03-29,Antigua and Barbuda,8,0,1136,28
2021-03-30,Antigua and Barbuda,0,0,1136,28
2021-03-31,Antigua and Barbuda,0,0,1136,28
2021-04-01,Antigua and Barbuda,11,0,1147,28
2021-04-02,Antigua and Barbuda,5,0,1152,28
2021-04-03,Antigua and Barbuda,18,0,1170,28
2021-04-04,Antigua and Barbuda,0,0,1170,28
2021-04-05,Antigua and Barbuda,3,1,1173,29
2021-04-06,Antigua and Barbuda,0,0,1173,29
2021-04-07,Antigua and Barbuda,4,0,1177,29
2021-04-08,Antigua and Barbuda,3,0,1180,29
2020-03-03,Argentina,1,0,1,0
2020-03-04,Argentina,0,0,1,0
2020-03-05,Argentina,0,0,1,0
2020-03-06,Argentina,1,0,2,0
2020-03-07,Argentina,6,0,8,0
2020-03-08,Argentina,4,1,12,1
2020-03-09,Argentina,0,0,12,1
2020-03-10,Argentina,5,0,17,1
2020-03-11,Argentina,2,0,19,1
2020-03-12,Argentina,0,0,19,1
2020-03-13,Argentina,12,1,31,2
2020-03-14,Argentina,3,0,34,2
2020-03-15,Argentina,11,0,45,2
2020-03-16,Argentina,11,0,56,2
2020-03-17,Argentina,12,0,68,2
2020-03-18,Argentina,11,0,79,2
2020-03-19,Argentina,18,1,97,3
2020-03-20,Argentina,31,0,128,3
2020-03-21,Argentina,30,1,158,4
2020-03-22,Argentina,108,0,266,4
2020-03-23,Argentina,35,0,301,4
2020-03-24,Argentina,86,2,387,6
2020-03-25,Argentina,0,2,387,8
2020-03-26,Argentina,115,1,502,9
2020-03-27,Argentina,87,4,589,13
2020-03-28,Argentina,101,5,690,18
2020-03-29,Argentina,55,1,745,19
2020-03-30,Argentina,75,4,820,23
2020-03-31,Argentina,234,4,1054,27
2020-04-01,Argentina,0,1,1054,28
2020-04-02,Argentina,79,8,1133,36
2020-04-03,Argentina,132,3,1265,39
2020-04-04,Argentina,186,4,1451,43
2020-04-05,Argentina,0,1,1451,44
2020-04-06,Argentina,103,4,1554,48
2020-04-07,Argentina,74,8,1628,56
2020-04-08,Argentina,87,7,1715,63
2020-04-09,Argentina,80,9,1795,72
2020-04-10,Argentina,180,10,1975,82
2020-04-11,Argentina,0,1,1975,83
2020-04-12,Argentina,167,7,2142,90
2020-04-13,Argentina,66,7,2208,97
2020-04-14,Argentina,69,5,2277,102
2020-04-15,Argentina,166,9,2443,111
2020-04-16,Argentina,128,4,2571,115
2020-04-17,Argentina,98,8,2669,123
2020-04-18,Argentina,89,6,2758,129
2020-04-19,Argentina,81,3,2839,132
2020-04-20,Argentina,102,4,2941,136
2020-04-21,Argentina,90,11,3031,147
2020-04-22,Argentina,113,5,3144,152
2020-04-23,Argentina,291,13,3435,165
2020-04-24,Argentina,172,11,3607,176
2020-04-25,Argentina,173,9,3780,185
2020-04-26,Argentina,112,7,3892,192
2020-04-27,Argentina,111,5,4003,197
2020-04-28,Argentina,124,10,4127,207
2020-04-29,Argentina,158,7,4285,214
2020-04-30,Argentina,143,4,4428,218
2020-05-01,Argentina,104,7,4532,225
2020-05-02,Argentina,149,12,4681,237
2020-05-03,Argentina,102,9,4783,246
2020-05-04,Argentina,104,14,4887,260
2020-05-05,Argentina,133,4,5020,264
2020-05-06,Argentina,188,9,5208,273
2020-05-07,Argentina,163,9,5371,282
2020-05-08,Argentina,240,11,5611,293
2020-05-09,Argentina,165,7,5776,300
2020-05-10,Argentina,258,5,6034,305
2020-05-11,Argentina,244,9,6278,314
2020-05-12,Argentina,285,5,6563,319
2020-05-13,Argentina,316,10,6879,329
2020-05-14,Argentina,255,24,7134,353
2020-05-15,Argentina,345,3,7479,356
2020-05-16,Argentina,326,7,7805,363
2020-05-17,Argentina,263,10,8068,373
2020-05-18,Argentina,303,9,8371,382
2020-05-19,Argentina,438,11,8809,393
2020-05-20,Argentina,474,10,9283,403
2020-05-21,Argentina,648,13,9931,416
2020-05-22,Argentina,718,17,10649,433
2020-05-23,Argentina,704,12,11353,445
2020-05-24,Argentina,723,7,12076,452
2020-05-25,Argentina,552,15,12628,467
2020-05-26,Argentina,600,17,13228,484
2020-05-27,Argentina,705,16,13933,500
2020-05-28,Argentina,769,8,14702,508
2020-05-29,Argentina,717,12,15419,520
2020-05-30,Argentina,795,8,16214,528
2020-05-31,Argentina,637,11,16851,539
2020-06-01,Argentina,564,17,17415,556
2020-06-02,Argentina,904,13,18319,569
2020-06-03,Argentina,949,14,19268,583
2020-06-04,Argentina,929,25,20197,608
2020-06-05,Argentina,840,24,21037,632
2020-06-06,Argentina,983,16,22020,648
2020-06-07,Argentina,774,16,22794,664
2020-06-08,Argentina,826,29,23620,693
2020-06-09,Argentina,1141,24,24761,717
2020-06-10,Argentina,1226,18,25987,735
2020-06-11,Argentina,1386,30,27373,765
2020-06-12,Argentina,1391,20,28764,785
2020-06-13,Argentina,1531,30,30295,815
2020-06-14,Argentina,1282,18,31577,833
2020-06-15,Argentina,1208,21,32785,854
2020-06-16,Argentina,1374,24,34159,878
2020-06-17,Argentina,1393,35,35552,913
2020-06-18,Argentina,1958,35,37510,948
2020-06-19,Argentina,2060,31,39570,979
2020-06-20,Argentina,1634,13,41204,992
2020-06-21,Argentina,1581,19,42785,1011
2020-06-22,Argentina,2146,32,44931,1043
2020-06-23,Argentina,2272,35,47203,1078
2020-06-24,Argentina,2648,38,49851,1116
2020-06-25,Argentina,2606,34,52457,1150
2020-06-26,Argentina,2886,34,55343,1184
2020-06-27,Argentina,2401,23,57744,1207
2020-06-28,Argentina,2189,25,59933,1232
2020-06-29,Argentina,2335,48,62268,1280
2020-06-30,Argentina,2262,27,64530,1307
2020-07-01,Argentina,2667,44,67197,1351
2020-07-02,Argentina,2744,34,69941,1385
2020-07-03,Argentina,2845,52,72786,1437
2020-07-04,Argentina,2590,44,75376,1481
2020-07-05,Argentina,2439,26,77815,1507
2020-07-06,Argentina,2632,75,80447,1582
2020-07-07,Argentina,2979,62,83426,1644
2020-07-08,Argentina,3604,50,87030,1694
2020-07-09,Argentina,3663,26,90693,1720
2020-07-10,Argentina,3367,54,94060,1774
2020-07-11,Argentina,3449,36,97509,1810
2020-07-12,Argentina,2657,35,100166,1845
2020-07-13,Argentina,3099,58,103265,1903
2020-07-14,Argentina,3645,65,106910,1968
2020-07-15,Argentina,4236,82,111146,2050
2020-07-16,Argentina,3637,62,114783,2112
2020-07-17,Argentina,4518,66,119301,2178
2020-07-18,Argentina,3223,42,122524,2220
2020-07-19,Argentina,4231,40,126755,2260
2020-07-20,Argentina,4019,113,130774,2373
2020-07-21,Argentina,5344,117,136118,2490
2020-07-22,Argentina,5782,98,141900,2588
2020-07-23,Argentina,6127,114,148027,2702
2020-07-24,Argentina,5493,105,153520,2807
2020-07-25,Argentina,4814,86,158334,2893
2020-07-26,Argentina,4192,46,162526,2939
2020-07-27,Argentina,4890,120,167416,3059
2020-07-28,Argentina,5939,120,173355,3179
2020-07-29,Argentina,5641,109,178996,3288
2020-07-30,Argentina,6377,153,185373,3441
2020-07-31,Argentina,5929,102,191302,3543
2020-08-01,Argentina,5241,53,196543,3596
2020-08-02,Argentina,5376,52,201919,3648
2020-08-03,Argentina,4824,165,206743,3813
2020-08-04,Argentina,6792,166,213535,3979
2020-08-05,Argentina,7147,127,220682,4106
2020-08-06,Argentina,7513,145,228195,4251
2020-08-07,Argentina,7482,160,235677,4411
2020-08-08,Argentina,6134,112,241811,4523
2020-08-09,Argentina,4688,83,246499,4606
2020-08-10,Argentina,7369,158,253868,4764
2020-08-11,Argentina,7043,240,260911,5004
2020-08-12,Argentina,7663,209,268574,5213
2020-08-13,Argentina,7498,149,276072,5362
2020-08-14,Argentina,6365,165,282437,5527
2020-08-15,Argentina,6663,110,289100,5637
2020-08-16,Argentina,5469,66,294569,5703
2020-08-17,Argentina,4557,111,299126,5814
2020-08-18,Argentina,6840,234,305966,6048
2020-08-19,Argentina,6693,282,312659,6330
2020-08-20,Argentina,8225,187,320884,6517
2020-08-21,Argentina,8159,213,329043,6730
2020-08-22,Argentina,7759,118,336802,6848
2020-08-23,Argentina,5352,137,342154,6985
2020-08-24,Argentina,8713,381,350867,7366
2020-08-25,Argentina,8771,197,359638,7563
2020-08-26,Argentina,10550,276,370188,7839
2020-08-27,Argentina,10104,211,380292,8050
2020-08-28,Argentina,11717,221,392009,8271
2020-08-29,Argentina,9230,82,401239,8353
2020-08-30,Argentina,7187,104,408426,8457
2020-08-31,Argentina,9309,203,417735,8660
2020-09-01,Argentina,10504,259,428239,8919
2020-09-02,Argentina,10933,199,439172,9118
2020-09-03,Argentina,12026,243,451198,9361
2020-09-04,Argentina,10684,262,461882,9623
2020-09-05,Argentina,9924,116,471806,9739
2020-09-06,Argentina,6986,120,478792,9859
2020-09-07,Argentina,9215,270,488007,10129
2020-09-08,Argentina,12027,276,500034,10405
2020-09-09,Argentina,12259,253,512293,10658
2020-09-10,Argentina,11905,249,524198,10907
2020-09-11,Argentina,11507,241,535705,11148
2020-09-12,Argentina,10776,115,546481,11263
2020-09-13,Argentina,9056,89,555537,11352
2020-09-14,Argentina,9909,315,565446,11667
2020-09-15,Argentina,11892,185,577338,11852
2020-09-16,Argentina,11674,264,589012,12116
2020-09-17,Argentina,12701,344,601713,12460
2020-09-18,Argentina,11945,196,613658,12656
2020-09-19,Argentina,9276,143,622934,12799
2020-09-20,Argentina,8431,254,631365,13053
2020-09-21,Argentina,8782,429,640147,13482
2020-09-22,Argentina,12027,470,652174,13952
2020-09-23,Argentina,12625,424,664799,14376
2020-09-24,Argentina,13467,390,678266,14766
2020-09-25,Argentina,12969,442,691235,15208
2020-09-26,Argentina,11249,335,702484,15543
2020-09-27,Argentina,8841,206,711325,15749
2020-09-28,Argentina,11807,364,723132,16113
2020-09-29,Argentina,13477,406,736609,16519
2020-09-30,Argentina,14392,418,751001,16937
2020-10-01,Argentina,14001,3351,765002,20288
2020-10-02,Argentina,14687,311,779689,20599
2020-10-03,Argentina,11129,196,790818,20795
2020-10-04,Argentina,7668,223,798486,21018
2020-10-05,Argentina,11242,450,809728,21468
2020-10-06,Argentina,14740,359,824468,21827
2020-10-07,Argentina,16447,399,840915,22226
2020-10-08,Argentina,15454,484,856369,22710
2020-10-09,Argentina,15099,515,871468,23225
2020-10-10,Argentina,12414,356,883882,23581
2020-10-11,Argentina,10324,287,894206,23868
2020-10-12,Argentina,9524,318,903730,24186
2020-10-13,Argentina,13305,386,917035,24572
2020-10-14,Argentina,14932,349,931967,24921
2020-10-15,Argentina,17096,421,949063,25342
2020-10-16,Argentina,16546,381,965609,25723
2020-10-17,Argentina,13510,384,979119,26107
2020-10-18,Argentina,10561,160,989680,26267
2020-10-19,Argentina,12982,449,1002662,26716
2020-10-20,Argentina,16337,384,1018999,27100
2020-10-21,Argentina,18326,419,1037325,27519
2020-10-22,Argentina,16325,438,1053650,27957
2020-10-23,Argentina,15718,381,1069368,28338
2020-10-24,Argentina,11968,275,1081336,28613
2020-10-25,Argentina,9253,283,1090589,28896
2020-10-26,Argentina,11712,405,1102301,29301
2020-10-27,Argentina,14308,429,1116609,29730
2020-10-28,Argentina,13924,341,1130533,30071
2020-10-29,Argentina,13267,371,1143800,30442
2020-10-30,Argentina,13379,350,1157179,30792
2020-10-31,Argentina,9745,210,1166924,31002
2020-11-01,Argentina,6609,138,1173533,31140
2020-11-02,Argentina,9598,483,1183131,31623
2020-11-03,Argentina,12145,429,1195276,32052
2020-11-04,Argentina,10652,468,1205928,32520
2020-11-05,Argentina,11100,246,1217028,32766
2020-11-06,Argentina,11786,370,1228814,33136
2020-11-07,Argentina,8037,212,1236851,33348
2020-11-08,Argentina,5331,212,1242182,33560
2020-11-09,Argentina,8317,347,1250499,33907
2020-11-10,Argentina,11977,276,1262476,34183
2020-11-11,Argentina,10880,348,1273356,34531
2020-11-12,Argentina,11163,251,1284519,34782
2020-11-13,Argentina,11859,263,1296378,35045
2020-11-14,Argentina,8468,262,1304846,35307
2020-11-15,Argentina,5645,129,1310491,35436
2020-11-16,Argentina,7893,291,1318384,35727
2020-11-17,Argentina,10621,379,1329005,36106
2020-11-18,Argentina,10332,241,1339337,36347
2020-11-19,Argentina,10097,185,1349434,36532
2020-11-20,Argentina,9608,258,1359042,36790
2020-11-21,Argentina,7140,112,1366182,36902
2020-11-22,Argentina,4184,100,1370366,37002
2020-11-23,Argentina,4265,120,1374631,37122
2020-11-24,Argentina,7164,310,1381795,37432
2020-11-25,Argentina,8593,282,1390388,37714
2020-11-26,Argentina,9043,227,1399431,37941
2020-11-27,Argentina,7846,275,1407277,38216
2020-11-28,Argentina,6098,106,1413375,38322
2020-11-29,Argentina,5432,151,1418807,38473
2020-11-30,Argentina,5726,257,1424533,38730
2020-12-01,Argentina,8037,198,1432570,38928
2020-12-02,Argentina,7533,228,1440103,39156
2020-12-03,Argentina,7629,149,1447732,39305
2020-12-04,Argentina,6899,207,1454631,39512
2020-12-05,Argentina,5201,120,1459832,39632
2020-12-06,Argentina,3278,138,1463110,39770
2020-12-07,Argentina,3199,118,1466309,39888
2020-12-08,Argentina,3610,121,1469919,40009
2020-12-09,Argentina,5303,213,1475222,40222
2020-12-10,Argentina,6994,209,1482216,40431
2020-12-11,Argentina,7112,175,1489328,40606
2020-12-12,Argentina,5274,62,1494602,40668
2020-12-13,Argentina,3558,98,1498160,40766
2020-12-14,Argentina,5062,275,1503222,41041
2020-12-15,Argentina,6981,163,1510203,41204
2020-12-16,Argentina,6843,161,1517046,41365
2020-12-17,Argentina,7326,169,1524372,41534
2020-12-18,Argentina,7002,138,1531374,41672
2020-12-19,Argentina,5795,91,1537169,41763
2020-12-20,Argentina,4116,50,1541285,41813
2020-12-21,Argentina,5853,184,1547138,41997
2020-12-22,Argentina,8141,257,1555279,42254
2020-12-23,Argentina,8586,60,1563865,42314
2020-12-24,Argentina,0,0,1563865,42314
2020-12-25,Argentina,10689,108,1574554,42422
2020-12-26,Argentina,3713,79,1578267,42501
2020-12-27,Argentina,5030,149,1583297,42650
2020-12-28,Argentina,7216,218,1590513,42868
2020-12-29,Argentina,11650,150,1602163,43018
2020-12-30,Argentina,11765,145,1613928,43163
2020-12-31,Argentina,11586,82,1625514,43245
2021-01-01,Argentina,4080,74,1629594,43319
2021-01-02,Argentina,5240,56,1634834,43375
2021-01-03,Argentina,5884,107,1640718,43482
2021-01-04,Argentina,8222,152,1648940,43634
2021-01-05,Argentina,13790,151,1662730,43785
2021-01-06,Argentina,13441,191,1676171,43976
2021-01-07,Argentina,13835,146,1690006,44122
2021-01-08,Argentina,13346,151,1703352,44273
2021-01-09,Argentina,11057,144,1714409,44417
2021-01-10,Argentina,7808,78,1722217,44495
2021-01-11,Argentina,8704,159,1730921,44654
2021-01-12,Argentina,13783,194,1744704,44848
2021-01-13,Argentina,12725,135,1757429,44983
2021-01-14,Argentina,13286,142,1770715,45125
2021-01-15,Argentina,12332,102,1783047,45227
2021-01-16,Argentina,8932,68,1791979,45295
2021-01-17,Argentina,7264,112,1799243,45407
2021-01-18,Argentina,8185,425,1807428,45832
2021-01-19,Argentina,12141,234,1819569,46066
2021-01-20,Argentina,12112,150,1831681,46216
2021-01-21,Argentina,11396,139,1843077,46355
2021-01-22,Argentina,10753,220,1853830,46575
2021-01-23,Argentina,8362,162,1862192,46737
2021-01-24,Argentina,5031,90,1867223,46827
2021-01-25,Argentina,7578,207,1874801,47034
2021-01-26,Argentina,10409,219,1885210,47253
2021-01-27,Argentina,10843,182,1896053,47435
2021-01-28,Argentina,9471,166,1905524,47601
2021-01-29,Argentina,9838,174,1915362,47775
2021-01-30,Argentina,6902,156,1922264,47931
2021-01-31,Argentina,4975,43,1927239,47974
2021-02-01,Argentina,6614,275,1933853,48249
2021-02-02,Argentina,9695,177,1943548,48426
2021-02-03,Argentina,9196,113,1952744,48539
2021-02-04,Argentina,8891,161,1961635,48700
2021-02-05,Argentina,8374,285,1970009,48985
2021-02-06,Argentina,6680,125,1976689,49110
2021-02-07,Argentina,3658,61,1980347,49171
2021-02-08,Argentina,5154,227,1985501,49398
2021-02-09,Argentina,7794,168,1993295,49566
2021-02-10,Argentina,7739,108,2001034,49674
2021-02-11,Argentina,7311,200,2008345,49874
2021-02-12,Argentina,7151,155,2015496,50029
2021-02-13,Argentina,6057,159,2021553,50188
2021-02-14,Argentina,4245,48,2025798,50236
2021-02-15,Argentina,3259,91,2029057,50327
2021-02-16,Argentina,4003,105,2033060,50432
2021-02-17,Argentina,6064,184,2039124,50616
2021-02-18,Argentina,7671,241,2046795,50857
2021-02-19,Argentina,7886,143,2054681,51000
2021-02-20,Argentina,5944,122,2060625,51122
2021-02-21,Argentina,3709,76,2064334,51198
2021-02-22,Argentina,5417,161,2069751,51359
2021-02-23,Argentina,7477,151,2077228,51510
2021-02-24,Argentina,8183,140,2085411,51650
2021-02-25,Argentina,8234,145,2093645,51795
2021-02-26,Argentina,5083,92,2098728,51887
2021-02-27,Argentina,5469,59,2104197,51946
2021-02-28,Argentina,3168,19,2107365,51965
2021-03-01,Argentina,4658,112,2112023,52077
2021-03-02,Argentina,6653,115,2118676,52192
2021-03-03,Argentina,7855,261,2126531,52453
2021-03-04,Argentina,7432,191,2133963,52644
2021-03-05,Argentina,7891,140,2141854,52784
2021-03-06,Argentina,4860,86,2146714,52870
2021-03-07,Argentina,2922,10,2149636,52880
2021-03-08,Argentina,5058,241,2154694,53121
2021-03-09,Argentina,7307,131,2162001,53252
2021-03-10,Argentina,7693,107,2169694,53359
2021-03-11,Argentina,8204,134,2177898,53493
2021-03-12,Argentina,7849,85,2185747,53578
2021-03-13,Argentina,6278,68,2192025,53646
2021-03-14,Argentina,3697,24,2195722,53670
2021-03-15,Argentina,6164,166,2201886,53836
2021-03-16,Argentina,8235,200,2210121,54036
2021-03-17,Argentina,8304,195,2218425,54231
2021-03-18,Argentina,8328,155,2226753,54386
2021-03-19,Argentina,8160,90,2234913,54476
2021-03-20,Argentina,6826,41,2241739,54517
2021-03-21,Argentina,4032,28,2245771,54545
2021-03-22,Argentina,6401,126,2252172,54671
2021-03-23,Argentina,9405,152,2261577,54823
2021-03-24,Argentina,8300,123,2269877,54946
2021-03-25,Argentina,8238,146,2278115,55092
2021-03-26,Argentina,12936,143,2291051,55235
2021-03-27,Argentina,10338,133,2301389,55368
2021-03-28,Argentina,7208,81,2308597,55449
2021-03-29,Argentina,14014,162,2322611,55611
2021-03-30,Argentina,10154,125,2332765,55736
2021-03-31,Argentina,16056,122,2348821,55858
2021-04-01,Argentina,14430,83,2363251,55941
2021-04-02,Argentina,9902,82,2373153,56023
2021-04-03,Argentina,10384,83,2383537,56106
2021-04-04,Argentina,9955,93,2393492,56199
2021-04-05,Argentina,13667,272,2407159,56471
2021-04-06,Argentina,20870,163,2428029,56634
2021-04-07,Argentina,22039,198,2450068,56832
2021-04-08,Argentina,23683,290,2473751,57122
2020-03-01,Armenia,1,0,1,0
2020-03-02,Armenia,0,0,1,0
2020-03-03,Armenia,0,0,1,0
2020-03-04,Armenia,0,0,1,0
2020-03-05,Armenia,0,0,1,0
2020-03-06,Armenia,0,0,1,0
2020-03-07,Armenia,0,0,1,0
2020-03-08,Armenia,0,0,1,0
2020-03-09,Armenia,0,0,1,0
2020-03-10,Armenia,0,0,1,0
2020-03-11,Armenia,0,0,1,0
2020-03-12,Armenia,3,0,4,0
2020-03-13,Armenia,4,0,8,0
2020-03-14,Armenia,10,0,18,0
2020-03-15,Armenia,8,0,26,0
2020-03-16,Armenia,26,0,52,0
2020-03-17,Armenia,26,0,78,0
2020-03-18,Armenia,6,0,84,0
2020-03-19,Armenia,31,0,115,0
2020-03-20,Armenia,21,0,136,0
2020-03-21,Armenia,24,0,160,0
2020-03-22,Armenia,34,0,194,0
2020-03-23,Armenia,41,0,235,0
2020-03-24,Armenia,14,0,249,0
2020-03-25,Armenia,16,0,265,0
2020-03-26,Armenia,25,1,290,1
2020-03-27,Armenia,39,0,329,1
2020-03-28,Armenia,78,0,407,1
2020-03-29,Armenia,17,2,424,3
2020-03-30,Armenia,58,0,482,3
2020-03-31,Armenia,50,0,532,3
2020-04-01,Armenia,39,1,571,4
2020-04-02,Armenia,92,3,663,7
2020-04-03,Armenia,73,0,736,7
2020-04-04,Armenia,34,0,770,7
2020-04-05,Armenia,52,0,822,7
2020-04-06,Armenia,11,1,833,8
2020-04-07,Armenia,20,0,853,8
2020-04-08,Armenia,28,1,881,9
2020-04-09,Armenia,40,1,921,10
2020-04-10,Armenia,16,2,937,12
2020-04-11,Armenia,30,1,967,13
2020-04-12,Armenia,46,0,1013,13
2020-04-13,Armenia,26,1,1039,14
2020-04-14,Armenia,28,2,1067,16
2020-04-15,Armenia,44,1,1111,17
2020-04-16,Armenia,48,1,1159,18
2020-04-17,Armenia,42,1,1201,19
2020-04-18,Armenia,47,1,1248,20
2020-04-19,Armenia,43,0,1291,20
2020-04-20,Armenia,48,2,1339,22
2020-04-21,Armenia,62,2,1401,24
2020-04-22,Armenia,72,0,1473,24
2020-04-23,Armenia,50,0,1523,24
2020-04-24,Armenia,73,3,1596,27
2020-04-25,Armenia,81,1,1677,28
2020-04-26,Armenia,69,0,1746,28
2020-04-27,Armenia,62,1,1808,29
2020-04-28,Armenia,59,1,1867,30
2020-04-29,Armenia,65,0,1932,30
2020-04-30,Armenia,134,2,2066,32
2020-05-01,Armenia,82,1,2148,33
2020-05-02,Armenia,125,0,2273,33
2020-05-03,Armenia,113,2,2386,35
2020-05-04,Armenia,121,4,2507,39
2020-05-05,Armenia,112,1,2619,40
2020-05-06,Armenia,163,0,2782,40
2020-05-07,Armenia,102,2,2884,42
2020-05-08,Armenia,145,1,3029,43
2020-05-09,Armenia,146,1,3175,44
2020-05-10,Armenia,138,1,3313,45
2020-05-11,Armenia,79,1,3392,46
2020-05-12,Armenia,146,1,3538,47
2020-05-13,Armenia,180,1,3718,48
2020-05-14,Armenia,142,1,3860,49
2020-05-15,Armenia,184,3,4044,52
2020-05-16,Armenia,239,3,4283,55
2020-05-17,Armenia,189,5,4472,60
2020-05-18,Armenia,351,1,4823,61
2020-05-19,Armenia,218,3,5041,64
2020-05-20,Armenia,230,3,5271,67
2020-05-21,Armenia,335,3,5606,70
2020-05-22,Armenia,322,4,5928,74
2020-05-23,Armenia,374,3,6302,77
2020-05-24,Armenia,359,4,6661,81
2020-05-25,Armenia,452,6,7113,87
2020-05-26,Armenia,289,4,7402,91
2020-05-27,Armenia,372,7,7774,98
2020-05-28,Armenia,442,15,8216,113
2020-05-29,Armenia,460,7,8676,120
2020-05-30,Armenia,251,7,8927,127
2020-05-31,Armenia,355,4,9282,131
2020-06-01,Armenia,210,8,9492,139
2020-06-02,Armenia,517,19,10009,158
2020-06-03,Armenia,515,12,10524,170
2020-06-04,Armenia,697,6,11221,176
2020-06-05,Armenia,596,7,11817,183
2020-06-06,Armenia,547,7,12364,190
2020-06-07,Armenia,766,10,13130,200
2020-06-08,Armenia,195,11,13325,211
2020-06-09,Armenia,350,6,13675,217
2020-06-10,Armenia,428,10,14103,227
2020-06-11,Armenia,566,18,14669,245
2020-06-12,Armenia,612,13,15281,258
2020-06-13,Armenia,723,6,16004,264
2020-06-14,Armenia,663,5,16667,269
2020-06-15,Armenia,397,16,17064,285
2020-06-16,Armenia,425,8,17489,293
2020-06-17,Armenia,544,9,18033,302
2020-06-18,Armenia,665,7,18698,309
2020-06-19,Armenia,459,10,19157,319
2020-06-20,Armenia,551,13,19708,332
2020-06-21,Armenia,560,18,20268,350
2020-06-22,Armenia,320,10,20588,360
2020-06-23,Armenia,418,12,21006,372
2020-06-24,Armenia,711,14,21717,386
2020-06-25,Armenia,771,11,22488,397
2020-06-26,Armenia,759,13,23247,410
2020-06-27,Armenia,662,11,23909,421
2020-06-28,Armenia,736,5,24645,426
2020-06-29,Armenia,482,7,25127,433
2020-06-30,Armenia,415,10,25542,443
2020-07-01,Armenia,523,10,26065,453
2020-07-02,Armenia,593,6,26658,459
2020-07-03,Armenia,662,10,27320,469
2020-07-04,Armenia,580,8,27900,477
2020-07-05,Armenia,706,7,28606,484
2020-07-06,Armenia,330,7,28936,491
2020-07-07,Armenia,349,12,29285,503
2020-07-08,Armenia,535,18,29820,521
2020-07-09,Armenia,526,14,30346,535
2020-07-10,Armenia,557,11,30903,546
2020-07-11,Armenia,489,13,31392,559
2020-07-12,Armenia,577,6,31969,565
2020-07-13,Armenia,182,8,32151,573
2020-07-14,Armenia,339,8,32490,581
2020-07-15,Armenia,515,11,33005,592
2020-07-16,Armenia,554,15,33559,607
2020-07-17,Armenia,442,13,34001,620
2020-07-18,Armenia,461,11,34462,631
2020-07-19,Armenia,415,10,34877,641
2020-07-20,Armenia,104,9,34981,650
2020-07-21,Armenia,273,12,35254,662
2020-07-22,Armenia,439,16,35693,678
2020-07-23,Armenia,469,10,36162,688
2020-07-24,Armenia,451,4,36613,692
2020-07-25,Armenia,383,8,36996,700
2020-07-26,Armenia,321,5,37317,705
2020-07-27,Armenia,73,6,37390,711
2020-07-28,Armenia,239,8,37629,719
2020-07-29,Armenia,308,4,37937,723
2020-07-30,Armenia,259,5,38196,728
2020-07-31,Armenia,354,10,38550,738
2020-08-01,Armenia,291,11,38841,749
2020-08-02,Armenia,209,5,39050,754
2020-08-03,Armenia,52,8,39102,762
2020-08-04,Armenia,196,6,39298,768
2020-08-05,Armenia,288,2,39586,770
2020-08-06,Armenia,233,2,39819,772
2020-08-07,Armenia,166,5,39985,777
2020-08-08,Armenia,200,8,40185,785
2020-08-09,Armenia,225,6,40410,791
2020-08-10,Armenia,23,5,40433,796
2020-08-11,Armenia,160,7,40593,803
2020-08-12,Armenia,201,3,40794,806
2020-08-13,Armenia,229,3,41023,809
2020-08-14,Armenia,276,5,41299,814
2020-08-15,Armenia,196,3,41495,817
2020-08-16,Armenia,168,1,41663,818
2020-08-17,Armenia,38,6,41701,824
2020-08-18,Armenia,145,8,41846,832
2020-08-19,Armenia,210,1,42056,833
2020-08-20,Armenia,263,3,42319,836
2020-08-21,Armenia,158,6,42477,842
2020-08-22,Armenia,139,8,42616,850
2020-08-23,Armenia,176,2,42792,852
2020-08-24,Armenia,33,2,42825,854
2020-08-25,Armenia,111,4,42936,858
2020-08-26,Armenia,131,3,43067,861
2020-08-27,Armenia,203,3,43270,864
2020-08-28,Armenia,181,5,43451,869
2020-08-29,Armenia,175,3,43626,872
2020-08-30,Armenia,124,5,43750,877
2020-08-31,Armenia,31,2,43781,879
2020-09-01,Armenia,97,2,43878,881
2020-09-02,Armenia,197,3,44075,884
2020-09-03,Armenia,196,3,44271,887
2020-09-04,Armenia,190,4,44461,891
2020-09-05,Armenia,188,4,44649,895
2020-09-06,Armenia,134,2,44783,897
2020-09-07,Armenia,62,3,44845,900
2020-09-08,Armenia,108,3,44953,903
2020-09-09,Armenia,199,2,45152,905
2020-09-10,Armenia,174,1,45326,906
2020-09-11,Armenia,177,3,45503,909
2020-09-12,Armenia,172,2,45675,911
2020-09-13,Armenia,187,5,45862,916
2020-09-14,Armenia,107,3,45969,919
2020-09-15,Armenia,150,1,46119,920
2020-09-16,Armenia,257,3,46376,923
2020-09-17,Armenia,295,2,46671,925
2020-09-18,Armenia,239,1,46910,926
2020-09-19,Armenia,244,2,47154,928
2020-09-20,Armenia,277,2,47431,930
2020-09-21,Armenia,121,6,47552,936
2020-09-22,Armenia,115,2,47667,938
2020-09-23,Armenia,210,4,47877,942
2020-09-24,Armenia,374,3,48251,945
2020-09-25,Armenia,392,2,48643,947
2020-09-26,Armenia,429,1,49072,948
2020-09-27,Armenia,328,3,49400,951
2020-09-28,Armenia,174,6,49574,957
2020-09-29,Armenia,327,1,49901,958
2020-09-30,Armenia,458,1,50359,959
2020-10-01,Armenia,491,4,50850,963
2020-10-02,Armenia,532,3,51382,966
2020-10-03,Armenia,543,6,51925,972
2020-10-04,Armenia,571,5,52496,977
2020-10-05,Armenia,181,7,52677,984
2020-10-06,Armenia,406,6,53083,990
2020-10-07,Armenia,672,5,53755,995
2020-10-08,Armenia,718,9,54473,1004
2020-10-09,Armenia,614,6,55087,1010
2020-10-10,Armenia,649,6,55736,1016
2020-10-11,Armenia,715,4,56451,1020
2020-10-12,Armenia,370,6,56821,1026
2020-10-13,Armenia,745,6,57566,1032
2020-10-14,Armenia,1058,7,58624,1039
2020-10-15,Armenia,1371,7,59995,1046
2020-10-16,Armenia,1465,10,61460,1056
2020-10-17,Armenia,1540,11,63000,1067
2020-10-18,Armenia,1694,14,64694,1081
2020-10-19,Armenia,766,10,65460,1091
2020-10-20,Armenia,1234,10,66694,1101
2020-10-21,Armenia,1836,20,68530,1121
2020-10-22,Armenia,2306,10,70836,1131
2020-10-23,Armenia,2474,14,73310,1145
2020-10-24,Armenia,2213,12,75523,1157
2020-10-25,Armenia,2314,23,77837,1180
2020-10-26,Armenia,973,16,78810,1196
2020-10-27,Armenia,1600,26,80410,1222
2020-10-28,Armenia,2241,21,82651,1243
2020-10-29,Armenia,2383,29,85034,1272
2020-10-30,Armenia,2398,28,87432,1300
2020-10-31,Armenia,2381,41,89813,1341
2020-11-01,Armenia,2441,22,92254,1363
2020-11-02,Armenia,1194,28,93448,1391
2020-11-03,Armenia,1328,22,94776,1413
2020-11-04,Armenia,2374,35,97150,1448
2020-11-05,Armenia,2413,28,99563,1476
2020-11-06,Armenia,2210,30,101773,1506
2020-11-07,Armenia,2476,27,104249,1533
2020-11-08,Armenia,2175,26,106424,1559
2020-11-09,Armenia,1042,21,107466,1580
2020-11-10,Armenia,1221,29,108687,1609
2020-11-11,Armenia,1861,27,110548,1636
2020-11-12,Armenia,2132,32,112680,1668
2020-11-13,Armenia,1703,29,114383,1697
2020-11-14,Armenia,1472,41,115855,1738
2020-11-15,Armenia,1482,25,117337,1763
2020-11-16,Armenia,549,25,117886,1788
2020-11-17,Armenia,984,23,118870,1811
2020-11-18,Armenia,1589,28,120459,1839
2020-11-19,Armenia,1520,31,121979,1870
2020-11-20,Armenia,1667,30,123646,1900
2020-11-21,Armenia,1193,31,124839,1931
2020-11-22,Armenia,1385,21,126224,1952
2020-11-23,Armenia,485,24,126709,1976
2020-11-24,Armenia,813,26,127522,2002
2020-11-25,Armenia,1563,38,129085,2040
2020-11-26,Armenia,1785,28,130870,2068
2020-11-27,Armenia,1476,22,132346,2090
2020-11-28,Armenia,1248,31,133594,2121
2020-11-29,Armenia,1174,21,134768,2142
2020-11-30,Armenia,356,22,135124,2164
2020-12-01,Armenia,843,29,135967,2193
2020-12-02,Armenia,1264,35,137231,2228
2020-12-03,Armenia,1277,26,138508,2254
2020-12-04,Armenia,1184,23,139692,2277
2020-12-05,Armenia,1267,32,140959,2309
2020-12-06,Armenia,978,17,141937,2326
2020-12-07,Armenia,407,18,142344,2344
2020-12-08,Armenia,584,28,142928,2372
2020-12-09,Armenia,1138,21,144066,2393
2020-12-10,Armenia,1174,23,145240,2416
2020-12-11,Armenia,1077,29,146317,2445
2020-12-12,Armenia,995,17,147312,2462
2020-12-13,Armenia,1013,24,148325,2486
2020-12-14,Armenia,357,17,148682,2503
2020-12-15,Armenia,438,26,149120,2529
2020-12-16,Armenia,1098,27,150218,2556
2020-12-17,Armenia,1174,25,151392,2581
2020-12-18,Armenia,861,15,152253,2596
2020-12-19,Armenia,920,20,153173,2616
2020-12-20,Armenia,652,14,153825,2630
2020-12-21,Armenia,240,26,154065,2656
2020-12-22,Armenia,537,17,154602,2673
2020-12-23,Armenia,838,18,155440,2691
2020-12-24,Armenia,702,23,156142,2714
2020-12-25,Armenia,621,19,156763,2733
2020-12-26,Armenia,586,19,157349,2752
2020-12-27,Armenia,485,16,157834,2768
2020-12-28,Armenia,114,7,157948,2775
2020-12-29,Armenia,348,22,158296,2797
2020-12-30,Armenia,582,10,158878,2807
2020-12-31,Armenia,531,16,159409,2823
2021-01-01,Armenia,329,5,159738,2828
2021-01-02,Armenia,60,8,159798,2836
2021-01-03,Armenia,229,14,160027,2850
2021-01-04,Armenia,193,14,160220,2864
2021-01-05,Armenia,324,14,160544,2878
2021-01-06,Armenia,309,12,160853,2890
2021-01-07,Armenia,201,11,161054,2901
2021-01-08,Armenia,361,7,161415,2908
2021-01-09,Armenia,379,14,161794,2922
2021-01-10,Armenia,337,7,162131,2929
2021-01-11,Armenia,157,2,162288,2931
2021-01-12,Armenia,355,10,162643,2941
2021-01-13,Armenia,485,10,163128,2951
2021-01-14,Armenia,448,12,163576,2963
2021-01-15,Armenia,396,11,163972,2974
2021-01-16,Armenia,263,13,164235,2987
2021-01-17,Armenia,351,5,164586,2992
2021-01-18,Armenia,90,6,164676,2998
2021-01-19,Armenia,236,9,164912,3007
2021-01-20,Armenia,309,9,165221,3016
2021-01-21,Armenia,307,5,165528,3021
2021-01-22,Armenia,183,9,165711,3030
2021-01-23,Armenia,198,4,165909,3034
2021-01-24,Armenia,127,5,166036,3039
2021-01-25,Armenia,58,8,166094,3047
2021-01-26,Armenia,138,5,166232,3052
2021-01-27,Armenia,195,4,166427,3056
2021-01-28,Armenia,242,11,166669,3067
2021-01-29,Armenia,59,2,166728,3069
2021-01-30,Armenia,173,2,166901,3071
2021-01-31,Armenia,125,9,167026,3080
2021-02-01,Armenia,62,4,167088,3084
2021-02-02,Armenia,143,5,167231,3089
2021-02-03,Armenia,190,7,167421,3096
2021-02-04,Armenia,147,11,167568,3107
2021-02-05,Armenia,158,2,167726,3109
2021-02-06,Armenia,211,5,167937,3114
2021-02-07,Armenia,151,3,168088,3117
2021-02-08,Armenia,89,6,168177,3123
2021-02-09,Armenia,123,3,168300,3126
2021-02-10,Armenia,196,4,168496,3130
2021-02-11,Armenia,180,5,168676,3135
2021-02-12,Armenia,154,3,168830,3138
2021-02-13,Armenia,192,2,169022,3140
2021-02-14,Armenia,145,1,169167,3141
2021-02-15,Armenia,88,6,169255,3147
2021-02-16,Armenia,136,3,169391,3150
2021-02-17,Armenia,206,5,169597,3155
2021-02-18,Armenia,223,1,169820,3156
2021-02-19,Armenia,191,2,170011,3158
2021-02-20,Armenia,223,1,170234,3159
2021-02-21,Armenia,168,5,170402,3164
2021-02-22,Armenia,104,3,170506,3167
2021-02-23,Armenia,166,4,170672,3171
2021-02-24,Armenia,273,4,170945,3175
2021-02-25,Armenia,282,4,171227,3179
2021-02-26,Armenia,283,4,171510,3183
2021-02-27,Armenia,283,7,171793,3190
2021-02-28,Armenia,265,2,172058,3192
2021-03-01,Armenia,158,3,172216,3195
2021-03-02,Armenia,240,5,172456,3200
2021-03-03,Armenia,360,2,172816,3202
2021-03-04,Armenia,491,6,173307,3208
2021-03-05,Armenia,442,7,173749,3215
2021-03-06,Armenia,508,4,174257,3219
2021-03-07,Armenia,422,2,174679,3221
2021-03-08,Armenia,337,4,175016,3225
2021-03-09,Armenia,182,7,175198,3232
2021-03-10,Armenia,340,5,175538,3237
2021-03-11,Armenia,748,2,176286,3239
2021-03-12,Armenia,818,4,177104,3243
2021-03-13,Armenia,795,10,177899,3253
2021-03-14,Armenia,486,2,178385,3255
2021-03-15,Armenia,317,10,178702,3265
2021-03-16,Armenia,585,12,179287,3277
2021-03-17,Armenia,854,5,180141,3282
2021-03-18,Armenia,1024,19,181165,3301
2021-03-19,Armenia,891,19,182056,3320
2021-03-20,Armenia,1071,12,183127,3332
2021-03-21,Armenia,586,16,183713,3348
2021-03-22,Armenia,506,12,184219,3360
2021-03-23,Armenia,801,24,185020,3384
2021-03-24,Armenia,1164,14,186184,3398
2021-03-25,Armenia,1257,18,187441,3416
2021-03-26,Armenia,1005,18,188446,3434
2021-03-27,Armenia,1094,16,189540,3450
2021-03-28,Armenia,777,14,190317,3464
2021-03-29,Armenia,424,12,190741,3476
2021-03-30,Armenia,750,21,191491,3497
2021-03-31,Armenia,1148,18,192639,3515
2021-04-01,Armenia,1097,18,193736,3533
2021-04-02,Armenia,1116,19,194852,3552
2021-04-03,Armenia,1192,23,196044,3575
2021-04-04,Armenia,590,17,196634,3592
2021-04-05,Armenia,479,22,197113,3614
2021-04-06,Armenia,760,13,197873,3627
2021-04-07,Armenia,1025,20,198898,3647
2021-04-08,Armenia,1231,28,200129,3675
2020-01-22,Asia,0,0,556,17
2020-01-23,Asia,98,1,654,18
2020-01-24,Asia,283,8,937,26
2020-01-25,Asia,491,16,1428,42
2020-01-26,Asia,677,14,2105,56
2020-01-27,Asia,807,26,2912,82
2020-01-28,Asia,2646,49,5558,131
2020-01-29,Asia,585,2,6143,133
2020-01-30,Asia,2065,38,8208,171
2020-01-31,Asia,1681,42,9889,213
2020-02-01,Asia,2102,46,11991,259
2020-02-02,Asia,4747,103,16738,362
2020-02-03,Asia,3089,64,19827,426
2020-02-04,Asia,4009,66,23836,492
2020-02-05,Asia,3743,72,27579,564
2020-02-06,Asia,3158,70,30737,634
2020-02-07,Asia,3527,85,34264,719
2020-02-08,Asia,2725,87,36989,806
2020-02-09,Asia,3024,100,40013,906
2020-02-10,Asia,2538,107,42551,1013
2020-02-11,Asia,2038,100,44589,1113
2020-02-12,Asia,377,5,44966,1118
2020-02-13,Asia,15151,253,60117,1371
2020-02-14,Asia,6482,152,66599,1523
2020-02-15,Asia,2075,142,68674,1665
2020-02-16,Asia,2113,104,70787,1769
2020-02-17,Asia,1934,98,72721,1867
2020-02-18,Asia,1794,140,74515,2007
2020-02-19,Asia,420,115,74935,2122
2020-02-20,Asia,545,123,75480,2245
2020-02-21,Asia,608,3,76088,2248
2020-02-22,Asia,1719,206,77807,2454
2020-02-23,Asia,223,9,78030,2463
2020-02-24,Asia,487,156,78517,2619
2020-02-25,Asia,743,77,79260,2696
2020-02-26,Asia,799,57,80059,2753
2020-02-27,Asia,1092,38,81151,2791
2020-02-28,Asia,1079,53,82230,2844
2020-02-29,Asia,1490,60,83720,2904
2020-03-01,Asia,1597,48,85317,2952
2020-03-02,Asia,1383,65,86700,3017
2020-03-03,Asia,1868,44,88568,3061
2020-03-04,Asia,1230,61,89798,3122
2020-03-05,Asia,1286,47,91084,3169
2020-03-06,Asia,2036,54,93120,3223
2020-03-07,Asia,1756,52,94876,3275
2020-03-08,Asia,1202,86,96078,3361
2020-03-09,Asia,908,71,96986,3432
2020-03-10,Asia,1189,76,98175,3508
2020-03-11,Asia,1721,97,99896,3605
2020-03-12,Asia,1359,98,101255,3703
2020-03-13,Asia,1821,104,103076,3807
2020-03-14,Asia,1908,122,104984,3929
2020-03-15,Asia,1943,131,106927,4060
2020-03-16,Asia,1723,151,108650,4211
2020-03-17,Asia,1994,159,110644,4370
2020-03-18,Asia,2137,188,112781,4558
2020-03-19,Asia,2140,175,114921,4733
2020-03-20,Asia,2703,176,117624,4909
2020-03-21,Asia,2557,156,120181,5065
2020-03-22,Asia,3234,209,123415,5274
2020-03-23,Asia,3075,156,126490,5430
2020-03-24,Asia,3619,170,130109,5600
2020-03-25,Asia,5412,194,135521,5794
2020-03-26,Asia,5722,244,141243,6038
2020-03-27,Asia,7111,213,148354,6251
2020-03-28,Asia,7200,213,155554,6464
2020-03-29,Asia,7240,216,162794,6680
2020-03-30,Asia,7256,210,170050,6890
2020-03-31,Asia,8983,246,179033,7136
2020-04-01,Asia,8586,303,187619,7439
2020-04-02,Asia,9140,292,196759,7731
2020-04-03,Asia,8740,286,205499,8017
2020-04-04,Asia,8983,311,214482,8328
2020-04-05,Asia,9917,306,224399,8634
2020-04-06,Asia,9995,314,234394,8948
2020-04-07,Asia,9567,288,243961,9236
2020-04-08,Asia,9905,307,253866,9543
2020-04-09,Asia,10221,362,264087,9905
2020-04-10,Asia,11127,357,275214,10262
2020-04-11,Asia,12001,362,287215,10624
2020-04-12,Asia,11630,400,298845,11024
2020-04-13,Asia,11549,334,310394,11358
2020-04-14,Asia,11471,396,321865,11754
2020-04-15,Asia,11381,323,333246,12077
2020-04-16,Asia,12372,362,345618,12439
2020-04-17,Asia,12770,1654,358388,14093
2020-04-18,Asia,12121,337,370509,14430
2020-04-19,Asia,12270,372,382779,14802
2020-04-20,Asia,13993,357,396772,15159
2020-04-21,Asia,13678,374,410450,15533
2020-04-22,Asia,12196,358,422646,15891
2020-04-23,Asia,12781,349,435427,16240
2020-04-24,Asia,13017,383,448444,16623
2020-04-25,Asia,12005,350,460449,16973
2020-04-26,Asia,11507,297,471956,17270
2020-04-27,Asia,11085,361,483041,17631
2020-04-28,Asia,11909,343,494950,17974
2020-04-29,Asia,12936,377,507886,18351
2020-04-30,Asia,13078,355,520964,18706
2020-05-01,Asia,13157,324,534121,19030
2020-05-02,Asia,12077,379,546198,19409
2020-05-03,Asia,12676,290,558874,19699
2020-05-04,Asia,14257,453,573131,20152
2020-05-05,Asia,15203,372,588334,20524
2020-05-06,Asia,15422,360,603756,20884
2020-05-07,Asia,15666,362,619422,21246
2020-05-08,Asia,16809,322,636231,21568
2020-05-09,Asia,15413,342,651644,21910
2020-05-10,Asia,17955,355,669599,22265
2020-05-11,Asia,16570,305,686169,22570
2020-05-12,Asia,17022,356,703191,22926
2020-05-13,Asia,17232,376,720423,23302
2020-05-14,Asia,20615,385,741038,23687
2020-05-15,Asia,17464,341,758502,24028
2020-05-16,Asia,19934,353,778436,24381
2020-05-17,Asia,20819,414,799255,24795
2020-05-18,Asia,20821,384,820076,25179
2020-05-19,Asia,21952,389,842028,25568
2020-05-20,Asia,22583,350,864611,25918
2020-05-21,Asia,24215,411,888826,26329
2020-05-22,Asia,24194,407,913020,26736
2020-05-23,Asia,24391,387,937411,27123
2020-05-24,Asia,23903,386,961314,27509
2020-05-25,Asia,21820,338,983134,27847
2020-05-26,Asia,20189,400,1003323,28247
2020-05-27,Asia,23908,470,1027231,28717
2020-05-28,Asia,25848,461,1053079,29178
2020-05-29,Asia,28818,565,1081897,29743
2020-05-30,Asia,27649,548,1109546,30291
2020-05-31,Asia,29232,540,1138778,30831
2020-06-01,Asia,27964,514,1166742,31345
2020-06-02,Asia,30573,551,1197315,31896
2020-06-03,Asia,33386,645,1230701,32541
2020-06-04,Asia,32311,582,1263012,33123
2020-06-05,Asia,32939,648,1295951,33771
2020-06-06,Asia,34432,653,1330383,34424
2020-06-07,Asia,34586,658,1364969,35082
2020-06-08,Asia,31149,655,1396118,35737
2020-06-09,Asia,33943,668,1430061,36405
2020-06-10,Asia,36520,764,1466581,37169
2020-06-11,Asia,37842,826,1504423,37995
2020-06-12,Asia,32688,726,1537111,38721
2020-06-13,Asia,38916,743,1576027,39464
2020-06-14,Asia,44950,874,1620977,40338
2020-06-15,Asia,37260,910,1658237,41248
2020-06-16,Asia,38536,2529,1696773,43777
2020-06-17,Asia,41023,869,1737796,44646
2020-06-18,Asia,41108,902,1778904,45548
2020-06-19,Asia,42860,950,1821764,46498
2020-06-20,Asia,41910,880,1863674,47378
2020-06-21,Asia,39751,955,1903425,48333
2020-06-22,Asia,40548,801,1943973,49134
2020-06-23,Asia,42375,959,1986348,50093
2020-06-24,Asia,43891,1015,2030239,51108
2020-06-25,Asia,44266,955,2074505,52063
2020-06-26,Asia,46358,937,2120863,53000
2020-06-27,Asia,46260,948,2167123,53948
2020-06-28,Asia,46970,875,2214093,54823
2020-06-29,Asia,44458,1035,2258551,55858
2020-06-30,Asia,46653,1125,2305204,56983
2020-07-01,Asia,66783,1016,2371987,57999
2020-07-02,Asia,50578,958,2422565,58957
2020-07-03,Asia,50678,925,2473243,59882
2020-07-04,Asia,53774,1160,2527017,61042
2020-07-05,Asia,56132,1158,2583149,62200
2020-07-06,Asia,50182,1162,2633331,63362
2020-07-07,Asia,50107,1159,2683438,64521
2020-07-08,Asia,53878,1048,2737316,65569
2020-07-09,Asia,57878,1124,2795194,66693
2020-07-10,Asia,56150,1081,2851344,67774
2020-07-11,Asia,55405,1140,2906749,68914
2020-07-12,Asia,54832,1445,2961581,70359
2020-07-13,Asia,56541,1179,3018122,71538
2020-07-14,Asia,54884,1159,3073006,72697
2020-07-15,Asia,60814,1226,3133820,73923
2020-07-16,Asia,60561,1280,3194381,75203
2020-07-17,Asia,64087,1351,3258468,76554
2020-07-18,Asia,74284,1919,3332752,78473
2020-07-19,Asia,68454,1495,3401206,79968
2020-07-20,Asia,61351,1403,3462557,81371
2020-07-21,Asia,65575,1291,3528132,82662
2020-07-22,Asia,71615,1826,3599747,84488
2020-07-23,Asia,79839,1527,3679586,86015
2020-07-24,Asia,75031,1339,3754617,87354
2020-07-25,Asia,74341,1279,3828958,88633
2020-07-26,Asia,72869,1316,3901827,89949
2020-07-27,Asia,69237,1207,3971064,91156
2020-07-28,Asia,77967,1554,4049031,92710
2020-07-29,Asia,77915,1293,4126946,94003
2020-07-30,Asia,81360,1371,4208306,95374
2020-07-31,Asia,88212,1352,4296518,96726
2020-08-01,Asia,77438,1348,4373956,98074
2020-08-02,Asia,81734,1293,4455690,99367
2020-08-03,Asia,75236,1658,4530926,101025
2020-08-04,Asia,79322,1416,4610248,102441
2020-08-05,Asia,85754,1474,4696002,103915
2020-08-06,Asia,90743,1394,4786745,105309
2020-08-07,Asia,90732,1431,4877477,106740
2020-08-08,Asia,90993,1349,4968470,108089
2020-08-09,Asia,86601,1548,5055071,109637
2020-08-10,Asia,81419,1703,5136490,111340
2020-08-11,Asia,85712,1358,5222202,112698
2020-08-12,Asia,95418,1557,5317620,114255
2020-08-13,Asia,92508,1505,5410128,115760
2020-08-14,Asia,94813,1473,5504941,117233
2020-08-15,Asia,91339,1597,5596280,118830
2020-08-16,Asia,83767,1492,5680047,120322
2020-08-17,Asia,77920,1365,5757967,121687
2020-08-18,Asia,93075,1775,5851042,123462
2020-08-19,Asia,98425,1584,5949467,125046
2020-08-20,Asia,96920,1549,6046387,126595
2020-08-21,Asia,97176,1009,6143563,127604
2020-08-22,Asia,95111,1417,6238674,129021
2020-08-23,Asia,84047,1337,6322721,130358
2020-08-24,Asia,86293,1478,6409014,131836
2020-08-25,Asia,82066,1499,6491080,133335
2020-08-26,Asia,112975,1682,6604055,135017
2020-08-27,Asia,103592,1642,6707647,136659
2020-08-28,Asia,103903,1594,6811550,138253
2020-08-29,Asia,104677,1489,6916227,139742
2020-08-30,Asia,103448,1549,7019675,141291
2020-08-31,Asia,94202,1316,7113877,142607
2020-09-01,Asia,103828,1591,7217705,144198
2020-09-02,Asia,110448,1666,7328153,145864
2020-09-03,Asia,111534,1691,7439687,147555
2020-09-04,Asia,115310,1625,7554997,149180
2020-09-05,Asia,115186,1591,7670183,150771
2020-09-06,Asia,117005,1630,7787188,152401
2020-09-07,Asia,101108,1663,7888296,154064
2020-09-08,Asia,118467,1671,8006763,155735
2020-09-09,Asia,125634,1811,8132397,157546
2020-09-10,Asia,127900,1829,8260297,159375
2020-09-11,Asia,129060,1710,8389357,161085
2020-09-12,Asia,124316,1780,8513673,162865
2020-09-13,Asia,120881,1711,8634554,164576
2020-09-14,Asia,115833,1902,8750387,166478
2020-09-15,Asia,122377,1898,8872764,168376
2020-09-16,Asia,131132,1880,9003896,170256
2020-09-17,Asia,129591,1841,9133487,172097
2020-09-18,Asia,126625,1853,9260112,173950
2020-09-19,Asia,123815,1805,9383927,175755
2020-09-20,Asia,117422,1777,9501349,177532
2020-09-21,Asia,105947,1692,9607296,179224
2020-09-22,Asia,117694,1754,9724990,180978
2020-09-23,Asia,123848,1851,9848838,182829
2020-09-24,Asia,123626,1783,9972464,184612
2020-09-25,Asia,122511,1770,10094975,186382
2020-09-26,Asia,121956,1787,10216931,188169
2020-09-27,Asia,113383,1705,10330314,189874
2020-09-28,Asia,98518,1424,10428832,191298
2020-09-29,Asia,114131,1922,10542963,193220
2020-09-30,Asia,125691,1897,10668654,195117
2020-10-01,Asia,119470,1777,10788124,196894
2020-10-02,Asia,117003,1757,10905127,198651
2020-10-03,Asia,107538,1554,11012665,200205
2020-10-04,Asia,108147,1639,11120812,201844
2020-10-05,Asia,97336,1618,11218148,203462
2020-10-06,Asia,108624,1711,11326772,205173
2020-10-07,Asia,116789,1740,11443561,206913
2020-10-08,Asia,108861,1795,11552422,208708
2020-10-09,Asia,107154,1653,11659576,210361
2020-10-10,Asia,108095,1615,11767671,211976
2020-10-11,Asia,98877,1612,11866548,213588
2020-10-12,Asia,90422,1406,11956970,214994
2020-10-13,Asia,99781,1472,12056751,216466
2020-10-14,Asia,104784,1547,12161535,218013
2020-10-15,Asia,101840,1662,12263375,219675
2020-10-16,Asia,100670,1592,12364045,221267
2020-10-17,Asia,96536,1797,12460581,223064
2020-10-18,Asia,91337,1337,12551918,224401
2020-10-19,Asia,82337,1444,12634255,225845
2020-10-20,Asia,90794,1526,12725049,227371
2020-10-21,Asia,98445,1608,12823494,228979
2020-10-22,Asia,97135,1532,12920629,230511
2020-10-23,Asia,97524,1589,13018153,232100
2020-10-24,Asia,88718,1398,13106871,233498
2020-10-25,Asia,85125,1296,13191996,234794
2020-10-26,Asia,72645,1385,13264641,236179
2020-10-27,Asia,84773,1380,13349414,237559
2020-10-28,Asia,93174,1492,13442588,239051
2020-10-29,Asia,93203,1475,13535791,240526
2020-10-30,Asia,92002,1397,13627793,241923
2020-10-31,Asia,86834,1405,13714627,243328
2020-11-01,Asia,87501,1433,13802128,244761
2020-11-02,Asia,83162,1472,13885290,246233
2020-11-03,Asia,92990,1570,13978280,247803
2020-11-04,Asia,97230,1746,14075510,249549
2020-11-05,Asia,96532,1620,14172042,251169
2020-11-06,Asia,101563,1588,14273605,252757
2020-11-07,Asia,93734,1477,14367339,254234
2020-11-08,Asia,94807,1491,14462146,255725
2020-11-09,Asia,85597,1536,14547743,257261
2020-11-10,Asia,95465,1539,14643208,258800
2020-11-11,Asia,100897,1619,14744105,260419
2020-11-12,Asia,99160,1641,14843265,262060
2020-11-13,Asia,99475,1586,14942740,263646
2020-11-14,Asia,94073,1512,15036813,265158
2020-11-15,Asia,81910,1463,15118723,266621
2020-11-16,Asia,80715,1498,15199438,268119
2020-11-17,Asia,94303,1591,15293741,269710
2020-11-18,Asia,106789,1812,15400530,271522
2020-11-19,Asia,106999,2024,15507529,273546
2020-11-20,Asia,108445,1693,15615974,275239
2020-11-21,Asia,103617,1621,15719591,276860
2020-11-22,Asia,104998,1700,15824589,278560
2020-11-23,Asia,96857,1654,15921446,280214
2020-11-24,Asia,107278,1708,16028724,281922
2020-11-25,Asia,109645,1815,16138369,283737
2020-11-26,Asia,138441,1768,16276810,285505
2020-11-27,Asia,146056,1658,16422866,287163
2020-11-28,Asia,127578,1678,16550444,288841
2020-11-29,Asia,125422,1682,16675866,290523
2020-11-30,Asia,115422,1638,16791288,292161
2020-12-01,Asia,122821,1737,16914109,293898
2020-12-02,Asia,127191,1654,17041300,295552
2020-12-03,Asia,131192,1711,17172492,297263
2020-12-04,Asia,126252,1667,17298744,298930
2020-12-05,Asia,123449,1551,17422193,300481
2020-12-06,Asia,119639,1469,17541832,301950
2020-12-07,Asia,108370,1520,17650202,303470
2020-12-08,Asia,118382,1649,17768584,305119
2020-12-09,Asia,118215,1551,17886799,306670
2020-12-10,Asia,85319,1550,18795343,308220
2020-12-11,Asia,114464,1525,18909807,309745
2020-12-12,Asia,109920,1446,19019727,311191
2020-12-13,Asia,99457,1354,19119184,312545
2020-12-14,Asia,94301,1464,19213485,314009
2020-12-15,Asia,107535,1629,19321020,315638
2020-12-16,Asia,106635,1445,19427655,317083
2020-12-17,Asia,101869,1416,19529524,318499
2020-12-18,Asia,100404,1371,19629928,319870
2020-12-19,Asia,96067,1396,19725995,321266
2020-12-20,Asia,87308,1454,19813303,322720
2020-12-21,Asia,79508,1445,19892811,324165
2020-12-22,Asia,89485,1494,19982296,325659
2020-12-23,Asia,90092,1423,20072388,327082
2020-12-24,Asia,88670,1350,20161058,328432
2020-12-25,Asia,85980,1314,20247038,329746
2020-12-26,Asia,75795,1221,20322833,330967
2020-12-27,Asia,71622,1329,20394455,332296
2020-12-28,Asia,70021,1305,20464476,333601
2020-12-29,Asia,81741,1439,20546217,335040
2020-12-30,Asia,83545,1400,20629762,336440
2020-12-31,Asia,65275,972,20695037,337412
2021-01-01,Asia,76089,1347,20771126,338759
2021-01-02,Asia,89867,1352,20860993,340111
2021-01-03,Asia,69533,1061,20930526,341172
2021-01-04,Asia,73454,1110,21003980,342282
2021-01-05,Asia,82482,1226,21086462,343508
2021-01-06,Asia,87477,1070,21173939,344578
2021-01-07,Asia,87620,1142,21261559,345720
2021-01-08,Asia,67431,953,21328990,346673
2021-01-09,Asia,104961,1305,21433951,347978
2021-01-10,Asia,76478,933,21510429,348911
2021-01-11,Asia,74376,997,21584805,349908
2021-01-12,Asia,81981,1418,21666786,351326
2021-01-13,Asia,86941,1326,21753727,352652
2021-01-14,Asia,86556,1171,21840283,353823
2021-01-15,Asia,82588,1204,21922871,355027
2021-01-16,Asia,85733,1112,22008604,356139
2021-01-17,Asia,75180,978,22083784,357117
2021-01-18,Asia,64552,1072,22148336,358189
2021-01-19,Asia,74752,1229,22223088,359418
2021-01-20,Asia,81734,1244,22304822,360662
2021-01-21,Asia,76339,1249,22381161,361911
2021-01-22,Asia,75658,1050,22456819,362961
2021-01-23,Asia,73180,1048,22529999,364009
2021-01-24,Asia,66904,945,22596903,364954
2021-01-25,Asia,59715,1123,22656618,366077
2021-01-26,Asia,75215,1296,22731833,367373
2021-01-27,Asia,79976,1270,22811809,368643
2021-01-28,Asia,82912,1360,22894721,370003
2021-01-29,Asia,76797,972,22971518,370975
2021-01-30,Asia,74274,1274,23045792,372249
2021-01-31,Asia,67489,995,23113281,373244
2021-02-01,Asia,65867,985,23179148,374229
2021-02-02,Asia,69287,1120,23248435,375349
2021-02-03,Asia,76350,1001,23324785,376350
2021-02-04,Asia,72857,1091,23397642,377441
2021-02-05,Asia,68761,913,23466403,378354
2021-02-06,Asia,69700,868,23536103,379222
2021-02-07,Asia,66056,823,23602159,380045
2021-02-08,Asia,59428,892,23661587,380937
2021-02-09,Asia,68005,942,23729592,381879
2021-02-10,Asia,71053,974,23800645,382853
2021-02-11,Asia,64988,847,23865633,383700
2021-02-12,Asia,66795,884,23932428,384584
2021-02-13,Asia,63055,857,23995483,385441
2021-02-14,Asia,58675,743,24054158,386184
2021-02-15,Asia,59368,701,24113526,386885
2021-02-16,Asia,68749,923,24182275,387808
2021-02-17,Asia,69490,865,24251765,388673
2021-02-18,Asia,66719,886,24318484,389559
2021-02-19,Asia,67228,894,24385712,390453
2021-02-20,Asia,62703,909,24448415,391362
2021-02-21,Asia,67481,717,24515896,392079
2021-02-22,Asia,67249,754,24583145,392833
2021-02-23,Asia,73701,941,24656846,393774
2021-02-24,Asia,76428,1511,24733274,395285
2021-02-25,Asia,75983,951,24809257,396236
2021-02-26,Asia,74903,969,24884160,397205
2021-02-27,Asia,70034,785,24954194,397990
2021-02-28,Asia,67989,751,25022183,398741
2021-03-01,Asia,69008,742,25091191,399483
2021-03-02,Asia,76550,883,25167741,400366
2021-03-03,Asia,80712,828,25248453,401194
2021-03-04,Asia,81081,808,25329534,402002
2021-03-05,Asia,81041,949,25410575,402951
2021-03-06,Asia,76829,661,25487404,403612
2021-03-07,Asia,78118,728,25565522,404340
2021-03-08,Asia,79286,888,25644808,405228
2021-03-09,Asia,83204,842,25728012,406070
2021-03-10,Asia,89729,803,25817741,406873
2021-03-11,Asia,91851,819,25909592,407692
2021-03-12,Asia,93811,880,26003403,408572
2021-03-13,Asia,88620,814,26092023,409386
2021-03-14,Asia,90699,752,26182722,410138
2021-03-15,Asia,93798,843,26276520,410981
2021-03-16,Asia,102257,979,26378777,411960
2021-03-17,Asia,115480,867,26494257,412827
2021-03-18,Asia,120225,963,26614482,413790
2021-03-19,Asia,121659,940,26736141,414730
2021-03-20,Asia,119682,883,26855823,415613
2021-03-21,Asia,125343,889,26981166,416502
2021-03-22,Asia,120637,1058,27101803,417560
2021-03-23,Asia,134284,1076,27236087,418636
2021-03-24,Asia,146664,1123,27382751,419759
2021-03-25,Asia,154999,1118,27537750,420877
2021-03-26,Asia,156385,1111,27694135,421988
2021-03-27,Asia,152603,1172,27846738,423160
2021-03-28,Asia,162999,1058,28009737,424218
2021-03-29,Asia,152824,1148,28162561,425366
2021-03-30,Asia,161222,1262,28323783,426628
2021-03-31,Asia,183350,1466,28507133,428094
2021-04-01,Asia,198133,1426,28705266,429520
2021-04-02,Asia,205700,1523,28910966,431043
2021-04-03,Asia,213440,1583,29124406,432626
2021-04-04,Asia,224608,1672,29349014,434298
2021-04-05,Asia,209594,1496,29558608,435794
2021-04-06,Asia,245560,2089,29804168,437883
2021-04-07,Asia,268501,2009,30072669,439892
2021-04-08,Asia,280475,2014,30353144,441906
2020-01-26,Australia,4,0,4,0
2020-01-27,Australia,1,0,5,0
2020-01-28,Australia,0,0,5,0
2020-01-29,Australia,1,0,6,0
2020-01-30,Australia,3,0,9,0
2020-01-31,Australia,0,0,9,0
2020-02-01,Australia,3,0,12,0
2020-02-02,Australia,0,0,12,0
2020-02-03,Australia,0,0,12,0
2020-02-04,Australia,1,0,13,0
2020-02-05,Australia,0,0,13,0
2020-02-06,Australia,1,0,14,0
2020-02-07,Australia,1,0,15,0
2020-02-08,Australia,0,0,15,0
2020-02-09,Australia,0,0,15,0
2020-02-10,Australia,0,0,15,0
2020-02-11,Australia,0,0,15,0
2020-02-12,Australia,0,0,15,0
2020-02-13,Australia,0,0,15,0
2020-02-14,Australia,0,0,15,0
2020-02-15,Australia,0,0,15,0
2020-02-16,Australia,0,0,15,0
2020-02-17,Australia,0,0,15,0
2020-02-18,Australia,0,0,15,0
2020-02-19,Australia,0,0,15,0
2020-02-20,Australia,0,0,15,0
2020-02-21,Australia,0,0,15,0
2020-02-22,Australia,0,0,15,0
2020-02-23,Australia,0,0,15,0
2020-02-24,Australia,0,0,15,0
2020-02-25,Australia,0,0,15,0
2020-02-26,Australia,0,0,15,0
2020-02-27,Australia,0,0,15,0
2020-02-28,Australia,0,0,15,0
2020-02-29,Australia,10,0,25,0
2020-03-01,Australia,2,1,27,1
2020-03-02,Australia,3,0,30,1
2020-03-03,Australia,9,0,39,1
2020-03-04,Australia,13,1,52,2
2020-03-05,Australia,3,0,55,2
2020-03-06,Australia,5,0,60,2
2020-03-07,Australia,3,0,63,2
2020-03-08,Australia,13,1,76,3
2020-03-09,Australia,15,0,91,3
2020-03-10,Australia,16,0,107,3
2020-03-11,Australia,21,0,128,3
2020-03-12,Australia,0,0,128,3
2020-03-13,Australia,72,0,200,3
2020-03-14,Australia,50,0,250,3
2020-03-15,Australia,47,0,297,3
2020-03-16,Australia,80,0,377,3
2020-03-17,Australia,75,2,452,5
2020-03-18,Australia,116,1,568,6
2020-03-19,Australia,113,0,681,6
2020-03-20,Australia,110,1,791,7
2020-03-21,Australia,280,0,1071,7
2020-03-22,Australia,478,0,1549,7
2020-03-23,Australia,133,0,1682,7
2020-03-24,Australia,362,1,2044,8
2020-03-25,Australia,320,0,2364,8
2020-03-26,Australia,446,5,2810,13
2020-03-27,Australia,333,0,3143,13
2020-03-28,Australia,497,1,3640,14
2020-03-29,Australia,344,2,3984,16
2020-03-30,Australia,377,1,4361,17
2020-03-31,Australia,198,1,4559,18
2020-04-01,Australia,303,2,4862,20
2020-04-02,Australia,254,4,5116,24
2020-04-03,Australia,214,4,5330,28
2020-04-04,Australia,220,2,5550,30
2020-04-05,Australia,137,5,5687,35
2020-04-06,Australia,110,5,5797,40
2020-04-07,Australia,98,5,5895,45
2020-04-08,Australia,115,5,6010,50
2020-04-09,Australia,98,1,6108,51
2020-04-10,Australia,107,3,6215,54
2020-04-11,Australia,88,3,6303,57
2020-04-12,Australia,12,3,6315,60
2020-04-13,Australia,36,1,6351,61
2020-04-14,Australia,64,1,6415,62
2020-04-15,Australia,25,1,6440,63
2020-04-16,Australia,22,0,6462,63
2020-04-17,Australia,60,3,6522,66
2020-04-18,Australia,46,1,6568,67
2020-04-19,Australia,42,0,6610,67
2020-04-20,Australia,13,0,6623,67
2020-04-21,Australia,22,0,6645,67
2020-04-22,Australia,7,0,6652,67
2020-04-23,Australia,10,8,6662,75
2020-04-24,Australia,15,4,6677,79
2020-04-25,Australia,17,1,6694,80
2020-04-26,Australia,20,3,6714,83
2020-04-27,Australia,7,0,6721,83
2020-04-28,Australia,23,6,6744,89
2020-04-29,Australia,8,2,6752,91
2020-04-30,Australia,14,2,6766,93
2020-05-01,Australia,12,0,6778,93
2020-05-02,Australia,21,1,6799,94
2020-05-03,Australia,23,1,6822,95
2020-05-04,Australia,25,1,6847,96
2020-05-05,Australia,28,1,6875,97
2020-05-06,Australia,19,0,6894,97
2020-05-07,Australia,19,0,6913,97
2020-05-08,Australia,5,0,6918,97
2020-05-09,Australia,21,0,6939,97
2020-05-10,Australia,9,0,6948,97
2020-05-11,Australia,22,0,6970,97
2020-05-12,Australia,10,1,6980,98
2020-05-13,Australia,9,0,6989,98
2020-05-14,Australia,30,0,7019,98
2020-05-15,Australia,16,0,7035,98
2020-05-16,Australia,9,0,7044,98
2020-05-17,Australia,10,1,7054,99
2020-05-18,Australia,14,0,7068,99
2020-05-19,Australia,4,1,7072,100
2020-05-20,Australia,9,0,7081,100
2020-05-21,Australia,14,1,7095,101
2020-05-22,Australia,4,0,7099,101
2020-05-23,Australia,15,1,7114,102
2020-05-24,Australia,0,0,7114,102
2020-05-25,Australia,12,0,7126,102
2020-05-26,Australia,13,1,7139,103
2020-05-27,Australia,11,0,7150,103
2020-05-28,Australia,15,0,7165,103
2020-05-29,Australia,19,0,7184,103
2020-05-30,Australia,8,0,7192,103
2020-05-31,Australia,10,0,7202,103
2020-06-01,Australia,19,-1,7221,102
2020-06-02,Australia,8,0,7229,102
2020-06-03,Australia,11,0,7240,102
2020-06-04,Australia,7,0,7247,102
2020-06-05,Australia,5,0,7252,102
2020-06-06,Australia,7,0,7259,102
2020-06-07,Australia,6,0,7265,102
2020-06-08,Australia,2,0,7267,102
2020-06-09,Australia,7,0,7274,102
2020-06-10,Australia,11,0,7285,102
2020-06-11,Australia,4,0,7289,102
2020-06-12,Australia,5,0,7294,102
2020-06-13,Australia,26,0,7320,102
2020-06-14,Australia,15,0,7335,102
2020-06-15,Australia,12,0,7347,102
2020-06-16,Australia,23,0,7370,102
2020-06-17,Australia,21,0,7391,102
2020-06-18,Australia,18,0,7409,102
2020-06-19,Australia,2,0,7411,102
2020-06-20,Australia,50,0,7461,102
2020-06-21,Australia,13,0,7474,102
2020-06-22,Australia,18,0,7492,102
2020-06-23,Australia,29,1,7521,103
2020-06-24,Australia,37,1,7558,104
2020-06-25,Australia,37,0,7595,104
2020-06-26,Australia,6,0,7601,104
2020-06-27,Australia,85,0,7686,104
2020-06-28,Australia,78,0,7764,104
2020-06-29,Australia,70,0,7834,104
2020-06-30,Australia,86,0,7920,104
2020-07-01,Australia,81,0,8001,104
2020-07-02,Australia,65,0,8066,104
2020-07-03,Australia,194,0,8260,104
2020-07-04,Australia,183,0,8443,104
2020-07-05,Australia,140,2,8583,106
2020-07-06,Australia,172,0,8755,106
2020-07-07,Australia,131,0,8886,106
2020-07-08,Australia,170,0,9056,106
2020-07-09,Australia,318,0,9374,106
2020-07-10,Australia,179,1,9553,107
2020-07-11,Australia,244,1,9797,108
2020-07-12,Australia,183,0,9980,108
2020-07-13,Australia,271,0,10251,108
2020-07-14,Australia,236,3,10487,111
2020-07-15,Australia,323,2,10810,113
2020-07-16,Australia,423,3,11233,116
2020-07-17,Australia,208,2,11441,118
2020-07-18,Australia,361,4,11802,122
2020-07-19,Australia,267,1,12069,123
2020-07-20,Australia,359,3,12428,126
2020-07-21,Australia,466,2,12894,128
2020-07-22,Australia,408,5,13302,133
2020-07-23,Australia,293,6,13595,139
2020-07-24,Australia,355,6,13950,145
2020-07-25,Australia,453,10,14403,155
2020-07-26,Australia,532,6,14935,161
2020-07-27,Australia,368,6,15303,167
2020-07-28,Australia,279,9,15582,176
2020-07-29,Australia,716,13,16298,189
2020-07-30,Australia,605,7,16903,196
2020-07-31,Australia,377,5,17280,201
2020-08-01,Australia,615,7,17895,208
2020-08-02,Australia,423,13,18318,221
2020-08-03,Australia,412,11,18730,232
2020-08-04,Australia,715,15,19445,247
2020-08-05,Australia,445,8,19890,255
2020-08-06,Australia,382,11,20272,266
2020-08-07,Australia,426,12,20698,278
2020-08-08,Australia,386,17,21084,295
2020-08-09,Australia,313,18,21397,313
2020-08-10,Australia,316,18,21713,331
2020-08-11,Australia,414,21,22127,352
2020-08-12,Australia,231,9,22358,361
2020-08-13,Australia,384,14,22742,375
2020-08-14,Australia,293,4,23035,379
2020-08-15,Australia,252,17,23287,396
2020-08-16,Australia,271,25,23558,421
2020-08-17,Australia,215,17,23773,438
2020-08-18,Australia,216,12,23989,450
2020-08-19,Australia,247,13,24236,463
2020-08-20,Australia,171,9,24407,472
2020-08-21,Australia,195,13,24602,485
2020-08-22,Australia,209,17,24811,502
2020-08-23,Australia,104,15,24915,517
2020-08-24,Australia,138,8,25053,525
2020-08-25,Australia,151,24,25204,549
2020-08-26,Australia,118,23,25322,572
2020-08-27,Australia,126,11,25448,583
2020-08-28,Australia,99,17,25547,600
2020-08-29,Australia,123,11,25670,611
2020-08-30,Australia,76,41,25746,652
2020-08-31,Australia,73,5,25819,657
2020-09-01,Australia,104,6,25923,663
2020-09-02,Australia,126,15,26049,678
2020-09-03,Australia,87,59,26136,737
2020-09-04,Australia,71,11,26207,748
2020-09-05,Australia,71,5,26278,753
2020-09-06,Australia,43,9,26321,762
2020-09-07,Australia,52,8,26373,770
2020-09-08,Australia,92,11,26465,781
2020-09-09,Australia,59,7,26524,788
2020-09-10,Australia,40,9,26564,797
2020-09-11,Australia,43,6,26607,803
2020-09-12,Australia,44,7,26651,810
2020-09-13,Australia,41,6,26692,816
2020-09-14,Australia,47,0,26739,816
2020-09-15,Australia,39,8,26778,824
2020-09-16,Australia,35,8,26813,832
2020-09-17,Australia,48,5,26861,837
2020-09-18,Australia,24,7,26885,844
2020-09-19,Australia,13,5,26898,849
2020-09-20,Australia,14,2,26912,851
2020-09-21,Australia,30,3,26942,854
2020-09-22,Australia,30,5,26972,859
2020-09-23,Australia,8,2,26980,861
2020-09-24,Australia,20,8,27000,869
2020-09-25,Australia,16,1,27016,870
2020-09-26,Australia,24,2,27040,872
2020-09-27,Australia,4,3,27044,875
2020-09-28,Australia,11,7,27055,882
2020-09-29,Australia,23,4,27078,886
2020-09-30,Australia,18,2,27096,888
2020-10-01,Australia,13,2,27109,890
2020-10-02,Australia,12,3,27121,893
2020-10-03,Australia,14,1,27135,894
2020-10-04,Australia,13,0,27148,894
2020-10-05,Australia,25,1,27173,895
2020-10-06,Australia,8,2,27181,897
2020-10-07,Australia,25,0,27206,897
2020-10-08,Australia,20,0,27226,897
2020-10-09,Australia,18,0,27244,897
2020-10-10,Australia,19,1,27263,898
2020-10-11,Australia,22,0,27285,898
2020-10-12,Australia,25,1,27310,899
2020-10-13,Australia,27,5,27337,904
2020-10-14,Australia,20,0,27357,904
2020-10-15,Australia,14,0,27371,904
2020-10-16,Australia,7,0,27378,904
2020-10-17,Australia,12,0,27390,904
2020-10-18,Australia,9,1,27399,905
2020-10-19,Australia,6,0,27405,905
2020-10-20,Australia,38,0,27443,905
2020-10-21,Australia,15,0,27458,905
2020-10-22,Australia,18,0,27476,905
2020-10-23,Australia,19,0,27495,905
2020-10-24,Australia,18,0,27513,905
2020-10-25,Australia,12,0,27525,905
2020-10-26,Australia,14,0,27539,905
2020-10-27,Australia,14,2,27553,907
2020-10-28,Australia,12,0,27565,907
2020-10-29,Australia,14,0,27579,907
2020-10-30,Australia,6,0,27585,907
2020-10-31,Australia,10,0,27595,907
2020-11-01,Australia,6,0,27601,907
2020-11-02,Australia,9,0,27610,907
2020-11-03,Australia,12,0,27622,907
2020-11-04,Australia,8,0,27630,907
2020-11-05,Australia,14,0,27644,907
2020-11-06,Australia,8,0,27652,907
2020-11-07,Australia,6,0,27658,907
2020-11-08,Australia,7,0,27665,907
2020-11-09,Australia,4,0,27669,907
2020-11-10,Australia,2,0,27671,907
2020-11-11,Australia,4,0,27675,907
2020-11-12,Australia,1,0,27676,907
2020-11-13,Australia,6,0,27682,907
2020-11-14,Australia,29,0,27711,907
2020-11-15,Australia,38,0,27749,907
2020-11-16,Australia,9,0,27758,907
2020-11-17,Australia,19,0,27777,907
2020-11-18,Australia,8,0,27785,907
2020-11-19,Australia,7,0,27792,907
2020-11-20,Australia,14,0,27806,907
2020-11-21,Australia,15,0,27821,907
2020-11-22,Australia,13,0,27834,907
2020-11-23,Australia,9,0,27843,907
2020-11-24,Australia,10,0,27853,907
2020-11-25,Australia,12,0,27865,907
2020-11-26,Australia,8,0,27873,907
2020-11-27,Australia,13,0,27886,907
2020-11-28,Australia,6,0,27892,907
2020-11-29,Australia,10,1,27902,908
2020-11-30,Australia,10,0,27912,908
2020-12-01,Australia,11,0,27923,908
2020-12-02,Australia,16,0,27939,908
2020-12-03,Australia,10,0,27949,908
2020-12-04,Australia,7,0,27956,908
2020-12-05,Australia,9,0,27965,908
2020-12-06,Australia,7,0,27972,908
2020-12-07,Australia,15,0,27987,908
2020-12-08,Australia,6,0,27993,908
2020-12-09,Australia,7,0,28000,908
2020-12-10,Australia,11,0,28011,908
2020-12-11,Australia,14,0,28025,908
2020-12-12,Australia,5,0,28030,908
2020-12-13,Australia,7,0,28037,908
2020-12-14,Australia,11,0,28048,908
2020-12-15,Australia,12,0,28060,908
2020-12-16,Australia,12,0,28072,908
2020-12-17,Australia,21,0,28093,908
2020-12-18,Australia,33,0,28126,908
2020-12-19,Australia,42,0,28168,908
2020-12-20,Australia,30,0,28198,908
2020-12-21,Australia,21,0,28219,908
2020-12-22,Australia,18,0,28237,908
2020-12-23,Australia,25,0,28262,908
2020-12-24,Australia,12,0,28274,908
2020-12-25,Australia,23,0,28297,908
2020-12-26,Australia,11,0,28308,908
2020-12-27,Australia,29,1,28337,909
2020-12-28,Australia,12,0,28349,909
2020-12-29,Australia,32,0,28381,909
2020-12-30,Australia,24,0,28405,909
2020-12-31,Australia,20,0,28425,909
2021-01-01,Australia,35,0,28460,909
2021-01-02,Australia,24,0,28484,909
2021-01-03,Australia,20,0,28504,909
2021-01-04,Australia,13,0,28517,909
2021-01-05,Australia,19,0,28536,909
2021-01-06,Australia,10,0,28546,909
2021-01-07,Australia,25,0,28571,909
2021-01-08,Australia,11,0,28582,909
2021-01-09,Australia,13,0,28595,909
2021-01-10,Australia,19,0,28614,909
2021-01-11,Australia,20,0,28634,909
2021-01-12,Australia,16,0,28650,909
2021-01-13,Australia,10,0,28660,909
2021-01-14,Australia,9,0,28669,909
2021-01-15,Australia,20,0,28689,909
2021-01-16,Australia,19,0,28708,909
2021-01-17,Australia,13,0,28721,909
2021-01-18,Australia,10,0,28731,909
2021-01-19,Australia,9,0,28740,909
2021-01-20,Australia,9,0,28749,909
2021-01-21,Australia,6,0,28755,909
2021-01-22,Australia,5,0,28760,909
2021-01-23,Australia,6,0,28766,909
2021-01-24,Australia,11,0,28777,909
2021-01-25,Australia,3,0,28780,909
2021-01-26,Australia,6,0,28786,909
2021-01-27,Australia,8,0,28794,909
2021-01-28,Australia,5,0,28799,909
2021-01-29,Australia,7,0,28806,909
2021-01-30,Australia,5,0,28811,909
2021-01-31,Australia,7,0,28818,909
2021-02-01,Australia,5,0,28823,909
2021-02-02,Australia,6,0,28829,909
2021-02-03,Australia,9,0,28838,909
2021-02-04,Australia,4,0,28842,909
2021-02-05,Australia,6,0,28848,909
2021-02-06,Australia,3,0,28851,909
2021-02-07,Australia,6,0,28857,909
2021-02-08,Australia,3,0,28860,909
2021-02-09,Australia,11,0,28871,909
2021-02-10,Australia,8,0,28879,909
2021-02-11,Australia,8,0,28887,909
2021-02-12,Australia,5,0,28892,909
2021-02-13,Australia,6,0,28898,909
2021-02-14,Australia,2,0,28900,909
2021-02-15,Australia,5,0,28905,909
2021-02-16,Australia,6,0,28911,909
2021-02-17,Australia,1,0,28912,909
2021-02-18,Australia,6,0,28918,909
2021-02-19,Australia,2,0,28920,909
2021-02-20,Australia,6,0,28926,909
2021-02-21,Australia,4,0,28930,909
2021-02-22,Australia,7,0,28937,909
2021-02-23,Australia,2,0,28939,909
2021-02-24,Australia,8,0,28947,909
2021-02-25,Australia,10,0,28957,909
2021-02-26,Australia,8,0,28965,909
2021-02-27,Australia,5,0,28970,909
2021-02-28,Australia,8,0,28978,909
2021-03-01,Australia,8,0,28986,909
2021-03-02,Australia,10,0,28996,909
2021-03-03,Australia,11,0,29007,909
2021-03-04,Australia,14,0,29021,909
2021-03-05,Australia,8,0,29029,909
2021-03-06,Australia,5,0,29034,909
2021-03-07,Australia,12,0,29046,909
2021-03-08,Australia,15,0,29061,909
2021-03-09,Australia,13,0,29074,909
2021-03-10,Australia,16,0,29090,909
2021-03-11,Australia,12,0,29102,909
2021-03-12,Australia,10,0,29112,909
2021-03-13,Australia,5,0,29117,909
2021-03-14,Australia,13,0,29130,909
2021-03-15,Australia,7,0,29137,909
2021-03-16,Australia,17,0,29154,909
2021-03-17,Australia,12,0,29166,909
2021-03-18,Australia,17,0,29183,909
2021-03-19,Australia,9,0,29192,909
2021-03-20,Australia,4,0,29196,909
2021-03-21,Australia,10,0,29206,909
2021-03-22,Australia,5,0,29211,909
2021-03-23,Australia,10,0,29221,909
2021-03-24,Australia,9,0,29230,909
2021-03-25,Australia,9,0,29239,909
2021-03-26,Australia,13,0,29252,909
2021-03-27,Australia,7,0,29259,909
2021-03-28,Australia,17,0,29276,909
2021-03-29,Australia,20,0,29296,909
2021-03-30,Australia,8,0,29304,909
2021-03-31,Australia,18,0,29322,909
2021-04-01,Australia,11,0,29333,909
2021-04-02,Australia,8,0,29341,909
2021-04-03,Australia,7,0,29348,909
2021-04-04,Australia,9,0,29357,909
2021-04-05,Australia,8,0,29365,909
2021-04-06,Australia,14,0,29379,909
2021-04-07,Australia,6,0,29385,909
2021-04-08,Australia,5,0,29390,909
2020-02-25,Austria,2,0,2,0
2020-02-26,Austria,0,0,2,0
2020-02-27,Austria,1,0,3,0
2020-02-28,Austria,0,0,3,0
2020-02-29,Austria,6,0,9,0
2020-03-01,Austria,5,0,14,0
2020-03-02,Austria,4,0,18,0
2020-03-03,Austria,3,0,21,0
2020-03-04,Austria,8,0,29,0
2020-03-05,Austria,12,0,41,0
2020-03-06,Austria,14,0,55,0
2020-03-07,Austria,24,0,79,0
2020-03-08,Austria,25,0,104,0
2020-03-09,Austria,27,0,131,0
2020-03-10,Austria,51,0,182,0
2020-03-11,Austria,64,0,246,0
2020-03-12,Austria,56,1,302,1
2020-03-13,Austria,202,0,504,1
2020-03-14,Austria,151,0,655,1
2020-03-15,Austria,205,0,860,1
2020-03-16,Austria,158,2,1018,3
2020-03-17,Austria,314,0,1332,3
2020-03-18,Austria,314,1,1646,4
2020-03-19,Austria,367,2,2013,6
2020-03-20,Austria,375,0,2388,6
2020-03-21,Austria,426,2,2814,8
2020-03-22,Austria,768,8,3582,16
2020-03-23,Austria,892,5,4474,21
2020-03-24,Austria,809,7,5283,28
2020-03-25,Austria,305,2,5588,30
2020-03-26,Austria,1321,19,6909,49
2020-03-27,Austria,748,9,7657,58
2020-03-28,Austria,614,10,8271,68
2020-03-29,Austria,517,18,8788,86
2020-03-30,Austria,830,22,9618,108
2020-03-31,Austria,562,20,10180,128
2020-04-01,Austria,531,18,10711,146
2020-04-02,Austria,418,12,11129,158
2020-04-03,Austria,395,10,11524,168
2020-04-04,Austria,257,18,11781,186
2020-04-05,Austria,270,18,12051,204
2020-04-06,Austria,246,16,12297,220
2020-04-07,Austria,342,23,12639,243
2020-04-08,Austria,303,30,12942,273
2020-04-09,Austria,302,22,13244,295
2020-04-10,Austria,311,24,13555,319
2020-04-11,Austria,251,18,13806,337
2020-04-12,Austria,139,13,13945,350
2020-04-13,Austria,96,18,14041,368
2020-04-14,Austria,185,16,14226,384
2020-04-15,Austria,110,9,14336,393
2020-04-16,Austria,140,17,14476,410
2020-04-17,Austria,119,21,14595,431
2020-04-18,Austria,76,12,14671,443
2020-04-19,Austria,78,9,14749,452
2020-04-20,Austria,46,18,14795,470
2020-04-21,Austria,78,21,14873,491
2020-04-22,Austria,52,19,14925,510
2020-04-23,Austria,77,12,15002,522
2020-04-24,Austria,69,8,15071,530
2020-04-25,Austria,77,6,15148,536
2020-04-26,Austria,77,6,15225,542
2020-04-27,Austria,49,7,15274,549
2020-04-28,Austria,83,20,15357,569
2020-04-29,Austria,45,11,15402,580
2020-04-30,Austria,50,4,15452,584
2020-05-01,Austria,79,5,15531,589
2020-05-02,Austria,27,7,15558,596
2020-05-03,Austria,39,2,15597,598
2020-05-04,Austria,24,2,15621,600
2020-05-05,Austria,29,6,15650,606
2020-05-06,Austria,34,2,15684,608
2020-05-07,Austria,68,1,15752,609
2020-05-08,Austria,22,5,15774,614
2020-05-09,Austria,59,1,15833,615
2020-05-10,Austria,38,3,15871,618
2020-05-11,Austria,11,2,15882,620
2020-05-12,Austria,79,3,15961,623
2020-05-13,Austria,36,1,15997,624
2020-05-14,Austria,61,2,16058,626
2020-05-15,Austria,51,2,16109,628
2020-05-16,Austria,92,1,16201,629
2020-05-17,Austria,41,0,16242,629
2020-05-18,Austria,27,0,16269,629
2020-05-19,Austria,52,3,16321,632
2020-05-20,Austria,32,1,16353,633
2020-05-21,Austria,51,0,16404,633
2020-05-22,Austria,32,2,16436,635
2020-05-23,Austria,50,4,16486,639
2020-05-24,Austria,17,1,16503,640
2020-05-25,Austria,36,1,16539,641
2020-05-26,Austria,18,2,16557,643
2020-05-27,Austria,34,2,16591,645
2020-05-28,Austria,37,23,16628,668
2020-05-29,Austria,27,0,16655,668
2020-05-30,Austria,30,0,16685,668
2020-05-31,Austria,46,0,16731,668
2020-06-01,Austria,2,0,16733,668
2020-06-02,Austria,26,1,16759,669
2020-06-03,Austria,12,1,16771,670
2020-06-04,Austria,34,0,16805,670
2020-06-05,Austria,38,2,16843,672
2020-06-06,Austria,55,0,16898,672
2020-06-07,Austria,4,0,16902,672
2020-06-08,Austria,66,0,16968,672
2020-06-09,Austria,11,0,16979,672
2020-06-10,Austria,26,1,17005,673
2020-06-11,Austria,29,1,17034,674
2020-06-12,Austria,30,1,17064,675
2020-06-13,Austria,14,2,17078,677
2020-06-14,Austria,31,0,17109,677
2020-06-15,Austria,26,1,17135,678
2020-06-16,Austria,54,3,17189,681
2020-06-17,Austria,14,6,17203,687
2020-06-18,Austria,20,1,17223,688
2020-06-19,Austria,48,0,17271,688
2020-06-20,Austria,52,0,17323,688
2020-06-21,Austria,18,2,17341,690
2020-06-22,Austria,39,0,17380,690
2020-06-23,Austria,28,3,17408,693
2020-06-24,Austria,41,0,17449,693
2020-06-25,Austria,28,5,17477,698
2020-06-26,Austria,45,0,17522,698
2020-06-27,Austria,58,2,17580,700
2020-06-28,Austria,74,2,17654,702
2020-06-29,Austria,69,1,17723,703
2020-06-30,Austria,43,2,17766,705
2020-07-01,Austria,107,0,17873,705
2020-07-02,Austria,68,0,17941,705
2020-07-03,Austria,109,0,18050,705
2020-07-04,Austria,115,0,18165,705
2020-07-05,Austria,115,1,18280,706
2020-07-06,Austria,85,0,18365,706
2020-07-07,Austria,56,0,18421,706
2020-07-08,Austria,92,0,18513,706
2020-07-09,Austria,102,0,18615,706
2020-07-10,Austria,94,0,18709,706
2020-07-11,Austria,74,0,18783,706
2020-07-12,Austria,114,2,18897,708
2020-07-13,Austria,51,0,18948,708
2020-07-14,Austria,73,1,19021,709
2020-07-15,Austria,133,1,19154,710
2020-07-16,Austria,116,1,19270,711
2020-07-17,Austria,169,0,19439,711
2020-07-18,Austria,134,0,19573,711
2020-07-19,Austria,82,0,19655,711
2020-07-20,Austria,88,0,19743,711
2020-07-21,Austria,84,-1,19827,710
2020-07-22,Austria,102,1,19929,711
2020-07-23,Austria,170,0,20099,711
2020-07-24,Austria,115,0,20214,711
2020-07-25,Austria,124,1,20338,712
2020-07-26,Austria,134,0,20472,712
2020-07-27,Austria,86,1,20558,713
2020-07-28,Austria,119,0,20677,713
2020-07-29,Austria,173,3,20850,716
2020-07-30,Austria,105,2,20955,718
2020-07-31,Austria,175,0,21130,718
2020-08-01,Austria,82,0,21212,718
2020-08-02,Austria,92,0,21304,718
2020-08-03,Austria,81,0,21385,718
2020-08-04,Austria,96,1,21481,719
2020-08-05,Austria,85,0,21566,719
2020-08-06,Austria,130,0,21696,719
2020-08-07,Austria,141,1,21837,720
2020-08-08,Austria,82,1,21919,721
2020-08-09,Austria,114,0,22033,721
2020-08-10,Austria,73,2,22106,723
2020-08-11,Austria,139,0,22245,723
2020-08-12,Austria,194,1,22439,724
2020-08-13,Austria,155,1,22594,725
2020-08-14,Austria,282,0,22876,725
2020-08-15,Austria,303,3,23179,728
2020-08-16,Austria,191,0,23370,728
2020-08-17,Austria,164,1,23534,729
2020-08-18,Austria,295,0,23829,729
2020-08-19,Austria,255,0,24084,729
2020-08-20,Austria,347,0,24431,729
2020-08-21,Austria,331,1,24762,730
2020-08-22,Austria,300,2,25062,732
2020-08-23,Austria,191,0,25253,732
2020-08-24,Austria,242,1,25495,733
2020-08-25,Austria,211,0,25706,733
2020-08-26,Austria,327,0,26033,733
2020-08-27,Austria,328,0,26361,733
2020-08-28,Austria,229,0,26590,733
2020-08-29,Austria,395,0,26985,733
2020-08-30,Austria,181,0,27166,733
2020-08-31,Austria,272,0,27438,733
2020-09-01,Austria,204,1,27642,734
2020-09-02,Austria,327,0,27969,734
2020-09-03,Austria,403,1,28372,735
2020-09-04,Austria,357,0,28729,735
2020-09-05,Austria,358,0,29087,735
2020-09-06,Austria,184,1,29271,736
2020-09-07,Austria,290,10,29561,746
2020-09-08,Austria,520,1,30081,747
2020-09-09,Austria,502,0,30583,747
2020-09-10,Austria,664,1,31247,748
2020-09-11,Austria,580,2,31827,750
2020-09-12,Austria,869,4,32696,754
2020-09-13,Austria,463,2,33159,756
2020-09-14,Austria,382,1,33541,757
2020-09-15,Austria,764,0,34305,757
2020-09-16,Austria,768,1,35073,758
2020-09-17,Austria,780,0,35853,758
2020-09-18,Austria,808,5,36661,763
2020-09-19,Austria,813,2,37474,765
2020-09-20,Austria,621,1,38095,766
2020-09-21,Austria,563,1,38658,767
2020-09-22,Austria,645,4,39303,771
2020-09-23,Austria,681,6,39984,777
2020-09-24,Austria,832,6,40816,783
2020-09-25,Austria,684,3,41500,786
2020-09-26,Austria,714,1,42214,787
2020-09-27,Austria,662,0,42876,787
2020-09-28,Austria,556,3,43432,790
2020-09-29,Austria,609,6,44041,796
2020-09-30,Austria,772,3,44813,799
2020-10-01,Austria,873,3,45686,802
2020-10-02,Austria,688,1,46374,803
2020-10-03,Austria,1058,6,47432,809
2020-10-04,Austria,714,4,48146,813
2020-10-05,Austria,750,5,48896,818
2020-10-06,Austria,923,4,49819,822
2020-10-07,Austria,1029,8,50848,830
2020-10-08,Austria,1209,8,52057,838
2020-10-09,Austria,1131,4,53188,842
2020-10-10,Austria,1235,10,54423,852
2020-10-11,Austria,896,-1,55319,851
2020-10-12,Austria,979,4,56298,855
2020-10-13,Austria,1028,6,57326,861
2020-10-14,Austria,1346,11,58672,872
2020-10-15,Austria,1552,5,60224,877
2020-10-16,Austria,1163,5,61387,882
2020-10-17,Austria,1747,7,63134,889
2020-10-18,Austria,1672,4,64806,893
2020-10-19,Austria,1121,11,65927,904
2020-10-20,Austria,1524,10,67451,914
2020-10-21,Austria,1958,11,69409,925
2020-10-22,Austria,2435,16,71844,941
2020-10-23,Austria,2571,13,74415,954
2020-10-24,Austria,3614,11,78029,965
2020-10-25,Austria,2782,14,80811,979
2020-10-26,Austria,2456,13,83267,992
2020-10-27,Austria,2835,13,86102,1005
2020-10-28,Austria,3394,22,89496,1027
2020-10-29,Austria,4453,29,93949,1056
2020-10-30,Austria,5627,26,99576,1082
2020-10-31,Austria,5349,27,104925,1109
2020-11-01,Austria,4956,21,109881,1130
2020-11-02,Austria,4135,29,114016,1159
2020-11-03,Austria,4182,33,118198,1192
2020-11-04,Austria,6901,35,125099,1227
2020-11-05,Austria,7416,41,132515,1268
2020-11-06,Austria,6464,72,138979,1340
2020-11-07,Austria,8241,37,147220,1377
2020-11-08,Austria,5933,34,153153,1411
2020-11-09,Austria,5593,43,158746,1454
2020-11-10,Austria,6120,45,164866,1499
2020-11-11,Austria,7514,65,172380,1564
2020-11-12,Austria,9262,44,181642,1608
2020-11-13,Austria,9586,53,191228,1661
2020-11-14,Austria,7063,85,198291,1746
2020-11-15,Austria,5665,83,203956,1829
2020-11-16,Austria,4657,58,208613,1887
2020-11-17,Austria,5984,58,214597,1945
2020-11-18,Austria,7091,109,221688,2054
2020-11-19,Austria,6995,62,228683,2116
2020-11-20,Austria,6668,108,235351,2224
2020-11-21,Austria,6611,104,241962,2328
2020-11-22,Austria,5226,60,247188,2388
2020-11-23,Austria,3145,71,250333,2459
2020-11-24,Austria,4377,118,254710,2577
2020-11-25,Austria,5802,90,260512,2667
2020-11-26,Austria,5526,106,266038,2773
2020-11-27,Austria,4954,113,270992,2886
2020-11-28,Austria,4669,132,275661,3018
2020-11-29,Austria,4047,87,279708,3105
2020-11-30,Austria,2748,79,282456,3184
2020-12-01,Austria,3033,141,285489,3325
2020-12-02,Austria,3972,121,289461,3446
2020-12-03,Austria,3969,92,293430,3538
2020-12-04,Austria,3815,113,297245,3651
2020-12-05,Austria,3444,106,300689,3757
2020-12-06,Austria,2741,83,303430,3840
2020-12-07,Austria,2263,57,305693,3897
2020-12-08,Austria,2377,105,308070,4002
2020-12-09,Austria,2932,54,311002,4056
2020-12-10,Austria,2686,107,313688,4163
2020-12-11,Austria,2893,126,316581,4289
2020-12-12,Austria,3241,126,319822,4415
2020-12-13,Austria,2641,58,322463,4473
2020-12-14,Austria,2588,57,325051,4530
2020-12-15,Austria,2628,118,327679,4648
2020-12-16,Austria,2664,116,330343,4764
2020-12-17,Austria,2485,218,332828,4982
2020-12-18,Austria,2085,145,334913,5127
2020-12-19,Austria,2296,82,337209,5209
2020-12-20,Austria,1645,142,338854,5351
2020-12-21,Austria,1519,84,340373,5435
2020-12-22,Austria,1853,105,342226,5540
2020-12-23,Austria,2131,114,344357,5654
2020-12-24,Austria,2847,91,347204,5745
2020-12-25,Austria,1851,38,349055,5783
2020-12-26,Austria,1429,60,350484,5843
2020-12-27,Austria,1408,38,351892,5881
2020-12-28,Austria,1592,50,353484,5931
2020-12-29,Austria,1868,128,355352,6059
2020-12-30,Austria,2550,90,357902,6149
2020-12-31,Austria,2913,73,360815,6222
2021-01-01,Austria,2096,39,362911,6261
2021-01-02,Austria,1391,14,364302,6275
2021-01-03,Austria,1466,49,365768,6324
2021-01-04,Austria,1642,33,367410,6357
2021-01-05,Austria,2311,100,369721,6457
2021-01-06,Austria,2469,68,372190,6525
2021-01-07,Austria,2540,43,374730,6568
2021-01-08,Austria,2063,73,376793,6641
2021-01-09,Austria,2278,46,379071,6687
2021-01-10,Austria,1651,36,380722,6723
2021-01-11,Austria,1536,24,382258,6747
2021-01-12,Austria,1575,72,383833,6819
2021-01-13,Austria,1917,49,385750,6868
2021-01-14,Austria,3510,53,389260,6921
2021-01-15,Austria,1528,66,390788,6987
2021-01-16,Austria,1723,66,392511,7053
2021-01-17,Austria,1267,29,393778,7082
2021-01-18,Austria,1161,40,394939,7122
2021-01-19,Austria,1486,77,396425,7199
2021-01-20,Austria,1671,38,398096,7237
2021-01-21,Austria,1702,51,399798,7288
2021-01-22,Austria,2088,42,401886,7330
2021-01-23,Austria,1626,59,403512,7389
2021-01-24,Austria,1202,29,404714,7418
2021-01-25,Austria,1009,33,405723,7451
2021-01-26,Austria,1417,64,407140,7515
2021-01-27,Austria,1641,49,408781,7564
2021-01-28,Austria,1449,43,410230,7607
2021-01-29,Austria,1500,51,411730,7658
2021-01-30,Austria,1478,45,413208,7703
2021-01-31,Austria,1190,18,414398,7721
2021-02-01,Austria,1124,57,415522,7778
2021-02-02,Austria,1241,69,416763,7847
2021-02-03,Austria,1520,55,418283,7902
2021-02-04,Austria,1518,34,419801,7936
2021-02-05,Austria,1388,37,421189,7973
2021-02-06,Austria,1333,21,422522,7994
2021-02-07,Austria,1317,18,423839,8012
2021-02-08,Austria,1057,20,424896,8032
2021-02-09,Austria,1197,39,426093,8071
2021-02-10,Austria,1469,43,427562,8114
2021-02-11,Austria,1577,24,429139,8138
2021-02-12,Austria,1731,32,430870,8170
2021-02-13,Austria,1433,25,432303,8195
2021-02-14,Austria,1184,16,433487,8211
2021-02-15,Austria,1225,10,434712,8221
2021-02-16,Austria,1427,39,436139,8260
2021-02-17,Austria,1735,30,437874,8290
2021-02-18,Austria,1967,22,439841,8312
2021-02-19,Austria,1818,36,441659,8348
2021-02-20,Austria,1877,20,443536,8368
2021-02-21,Austria,1838,18,445374,8386
2021-02-22,Austria,1270,11,446644,8397
2021-02-23,Austria,1727,37,448371,8434
2021-02-24,Austria,2005,36,450376,8470
2021-02-25,Austria,2391,23,452767,8493
2021-02-26,Austria,2093,22,454860,8515
2021-02-27,Austria,2457,23,457317,8538
2021-02-28,Austria,2123,23,459440,8561
2021-03-01,Austria,1409,13,460849,8574
2021-03-02,Austria,1920,31,462769,8605
2021-03-03,Austria,2553,20,465322,8625
2021-03-04,Austria,2324,27,467646,8652
2021-03-05,Austria,2668,17,470314,8669
2021-03-06,Austria,2557,25,472871,8694
2021-03-07,Austria,2199,19,475070,8713
2021-03-08,Austria,1910,19,476980,8732
2021-03-09,Austria,2411,25,479391,8757
2021-03-10,Austria,2528,19,481919,8776
2021-03-11,Austria,2997,22,484916,8798
2021-03-12,Austria,3126,33,488042,8831
2021-03-13,Austria,3023,25,491065,8856
2021-03-14,Austria,2503,17,493568,8873
2021-03-15,Austria,1896,19,495464,8892
2021-03-16,Austria,2425,33,497889,8925
2021-03-17,Austria,3335,31,501224,8956
2021-03-18,Austria,3357,26,504581,8982
2021-03-19,Austria,3515,42,508096,9024
2021-03-20,Austria,3344,28,511440,9052
2021-03-21,Austria,2713,22,514153,9074
2021-03-22,Austria,2412,15,516565,9089
2021-03-23,Austria,3415,32,519980,9121
2021-03-24,Austria,3289,30,523269,9151
2021-03-25,Austria,3124,27,526393,9178
2021-03-26,Austria,3895,22,530288,9200
2021-03-27,Austria,3498,31,533786,9231
2021-03-28,Austria,2679,25,536465,9256
2021-03-29,Austria,3076,19,539541,9275
2021-03-30,Austria,3001,33,542542,9308
2021-03-31,Austria,3687,31,546229,9339
2021-04-01,Austria,3363,29,549592,9368
2021-04-02,Austria,3137,29,552729,9397
2021-04-03,Austria,3283,37,556012,9434
2021-04-04,Austria,2743,15,558755,9449
2021-04-05,Austria,2217,33,560972,9482
2021-04-06,Austria,1935,35,562907,9517
2021-04-07,Austria,3101,29,566008,9546
2021-04-08,Austria,2906,40,568914,9586
2020-03-01,Azerbaijan,3,0,3,0
2020-03-02,Azerbaijan,0,0,3,0
2020-03-03,Azerbaijan,0,0,3,0
2020-03-04,Azerbaijan,0,0,3,0
2020-03-05,Azerbaijan,3,0,6,0
2020-03-06,Azerbaijan,0,0,6,0
2020-03-07,Azerbaijan,3,0,9,0
2020-03-08,Azerbaijan,0,0,9,0
2020-03-09,Azerbaijan,0,0,9,0
2020-03-10,Azerbaijan,2,0,11,0
2020-03-11,Azerbaijan,0,0,11,0
2020-03-12,Azerbaijan,0,0,11,0
2020-03-13,Azerbaijan,4,1,15,1
2020-03-14,Azerbaijan,0,0,15,1
2020-03-15,Azerbaijan,8,0,23,1
2020-03-16,Azerbaijan,5,0,28,1
2020-03-17,Azerbaijan,0,0,28,1
2020-03-18,Azerbaijan,0,0,28,1
2020-03-19,Azerbaijan,16,0,44,1
2020-03-20,Azerbaijan,0,0,44,1
2020-03-21,Azerbaijan,9,0,53,1
2020-03-22,Azerbaijan,12,0,65,1
2020-03-23,Azerbaijan,7,0,72,1
2020-03-24,Azerbaijan,15,0,87,1
2020-03-25,Azerbaijan,6,1,93,2
2020-03-26,Azerbaijan,29,1,122,3
2020-03-27,Azerbaijan,43,0,165,3
2020-03-28,Azerbaijan,17,1,182,4
2020-03-29,Azerbaijan,27,0,209,4
2020-03-30,Azerbaijan,64,0,273,4
2020-03-31,Azerbaijan,25,1,298,5
2020-04-01,Azerbaijan,61,0,359,5
2020-04-02,Azerbaijan,41,0,400,5
2020-04-03,Azerbaijan,43,0,443,5
2020-04-04,Azerbaijan,78,0,521,5
2020-04-05,Azerbaijan,63,2,584,7
2020-04-06,Azerbaijan,57,0,641,7
2020-04-07,Azerbaijan,76,1,717,8
2020-04-08,Azerbaijan,105,0,822,8
2020-04-09,Azerbaijan,104,1,926,9
2020-04-10,Azerbaijan,65,1,991,10
2020-04-11,Azerbaijan,67,1,1058,11
2020-04-12,Azerbaijan,40,0,1098,11
2020-04-13,Azerbaijan,50,1,1148,12
2020-04-14,Azerbaijan,49,1,1197,13
2020-04-15,Azerbaijan,56,0,1253,13
2020-04-16,Azerbaijan,30,2,1283,15
2020-04-17,Azerbaijan,57,0,1340,15
2020-04-18,Azerbaijan,33,3,1373,18
2020-04-19,Azerbaijan,25,1,1398,19
2020-04-20,Azerbaijan,38,0,1436,19
2020-04-21,Azerbaijan,44,1,1480,20
2020-04-22,Azerbaijan,38,0,1518,20
2020-04-23,Azerbaijan,30,0,1548,20
2020-04-24,Azerbaijan,44,1,1592,21
2020-04-25,Azerbaijan,25,0,1617,21
2020-04-26,Azerbaijan,28,0,1645,21
2020-04-27,Azerbaijan,33,1,1678,22
2020-04-28,Azerbaijan,39,0,1717,22
2020-04-29,Azerbaijan,49,1,1766,23
2020-04-30,Azerbaijan,38,1,1804,24
2020-05-01,Azerbaijan,50,1,1854,25
2020-05-02,Azerbaijan,40,0,1894,25
2020-05-03,Azerbaijan,38,0,1932,25
2020-05-04,Azerbaijan,52,1,1984,26
2020-05-05,Azerbaijan,76,0,2060,26
2020-05-06,Azerbaijan,67,2,2127,28
2020-05-07,Azerbaijan,77,0,2204,28
2020-05-08,Azerbaijan,75,0,2279,28
2020-05-09,Azerbaijan,143,3,2422,31
2020-05-10,Azerbaijan,97,1,2519,32
2020-05-11,Azerbaijan,70,0,2589,32
2020-05-12,Azerbaijan,104,1,2693,33
2020-05-13,Azerbaijan,65,2,2758,35
2020-05-14,Azerbaijan,121,0,2879,35
2020-05-15,Azerbaijan,101,1,2980,36
2020-05-16,Azerbaijan,158,0,3138,36
2020-05-17,Azerbaijan,136,3,3274,39
2020-05-18,Azerbaijan,113,1,3387,40
2020-05-19,Azerbaijan,131,1,3518,41
2020-05-20,Azerbaijan,113,2,3631,43
2020-05-21,Azerbaijan,118,1,3749,44
2020-05-22,Azerbaijan,106,2,3855,46
2020-05-23,Azerbaijan,127,3,3982,49
2020-05-24,Azerbaijan,140,0,4122,49
2020-05-25,Azerbaijan,149,2,4271,51
2020-05-26,Azerbaijan,132,1,4403,52
2020-05-27,Azerbaijan,165,2,4568,54
2020-05-28,Azerbaijan,191,2,4759,56
2020-05-29,Azerbaijan,230,2,4989,58
2020-05-30,Azerbaijan,257,3,5246,61
2020-05-31,Azerbaijan,248,2,5494,63
2020-06-01,Azerbaijan,168,5,5662,68
2020-06-02,Azerbaijan,273,3,5935,71
2020-06-03,Azerbaijan,325,5,6260,76
2020-06-04,Azerbaijan,262,2,6522,78
2020-06-05,Azerbaijan,338,4,6860,82
2020-06-06,Azerbaijan,379,2,7239,84
2020-06-07,Azerbaijan,314,4,7553,88
2020-06-08,Azerbaijan,323,5,7876,93
2020-06-09,Azerbaijan,315,5,8191,98
2020-06-10,Azerbaijan,339,4,8530,102
2020-06-11,Azerbaijan,352,6,8882,108
2020-06-12,Azerbaijan,336,5,9218,113
2020-06-13,Azerbaijan,352,2,9570,115
2020-06-14,Azerbaijan,387,4,9957,119
2020-06-15,Azerbaijan,367,3,10324,122
2020-06-16,Azerbaijan,338,4,10662,126
2020-06-17,Azerbaijan,329,7,10991,133
2020-06-18,Azerbaijan,338,6,11329,139
2020-06-19,Azerbaijan,438,4,11767,143
2020-06-20,Azerbaijan,471,5,12238,148
2020-06-21,Azerbaijan,491,6,12729,154
2020-06-22,Azerbaijan,478,7,13207,161
2020-06-23,Azerbaijan,508,6,13715,167
2020-06-24,Azerbaijan,590,7,14305,174
2020-06-25,Azerbaijan,547,6,14852,180
2020-06-26,Azerbaijan,517,7,15369,187
2020-06-27,Azerbaijan,521,6,15890,193
2020-06-28,Azerbaijan,534,5,16424,198
2020-06-29,Azerbaijan,544,8,16968,206
2020-06-30,Azerbaijan,556,7,17524,213
2020-07-01,Azerbaijan,588,7,18112,220
2020-07-02,Azerbaijan,572,8,18684,228
2020-07-03,Azerbaijan,583,7,19267,235
2020-07-04,Azerbaijan,534,6,19801,241
2020-07-05,Azerbaijan,523,9,20324,250
2020-07-06,Azerbaijan,513,8,20837,258
2020-07-07,Azerbaijan,537,7,21374,265
2020-07-08,Azerbaijan,542,9,21916,274
2020-07-09,Azerbaijan,548,10,22464,284
2020-07-10,Azerbaijan,526,8,22990,292
2020-07-11,Azerbaijan,531,6,23521,298
2020-07-12,Azerbaijan,520,8,24041,306
2020-07-13,Azerbaijan,529,7,24570,313
2020-07-14,Azerbaijan,543,6,25113,319
2020-07-15,Azerbaijan,559,7,25672,326
2020-07-16,Azerbaijan,493,8,26165,334
2020-07-17,Azerbaijan,471,7,26636,341
2020-07-18,Azerbaijan,497,8,27133,349
2020-07-19,Azerbaijan,388,5,27521,354
2020-07-20,Azerbaijan,369,9,27890,363
2020-07-21,Azerbaijan,352,13,28242,376
2020-07-22,Azerbaijan,391,9,28633,385
2020-07-23,Azerbaijan,347,6,28980,391
2020-07-24,Azerbaijan,332,9,29312,400
2020-07-25,Azerbaijan,321,8,29633,408
2020-07-26,Azerbaijan,417,9,30050,417
2020-07-27,Azerbaijan,396,6,30446,423
2020-07-28,Azerbaijan,412,7,30858,430
2020-07-29,Azerbaijan,363,8,31221,438
2020-07-30,Azerbaijan,339,3,31560,441
2020-07-31,Azerbaijan,318,7,31878,448
2020-08-01,Azerbaijan,279,6,32157,454
2020-08-02,Azerbaijan,286,8,32443,462
2020-08-03,Azerbaijan,241,6,32684,468
2020-08-04,Azerbaijan,226,5,32910,473
2020-08-05,Azerbaijan,193,3,33103,476
2020-08-06,Azerbaijan,144,3,33247,479
2020-08-07,Azerbaijan,129,4,33376,483
2020-08-08,Azerbaijan,105,5,33481,488
2020-08-09,Azerbaijan,87,2,33568,490
2020-08-10,Azerbaijan,79,2,33647,492
2020-08-11,Azerbaijan,84,3,33731,495
2020-08-12,Azerbaijan,93,2,33824,497
2020-08-13,Azerbaijan,91,3,33915,500
2020-08-14,Azerbaijan,103,4,34018,504
2020-08-15,Azerbaijan,89,2,34107,506
2020-08-16,Azerbaijan,112,0,34219,506
2020-08-17,Azerbaijan,124,2,34343,508
2020-08-18,Azerbaijan,131,1,34474,509
2020-08-19,Azerbaijan,146,1,34620,510
2020-08-20,Azerbaijan,139,0,34759,510
2020-08-21,Azerbaijan,162,2,34921,512
2020-08-22,Azerbaijan,184,3,35105,515
2020-08-23,Azerbaijan,169,3,35274,518
2020-08-24,Azerbaijan,152,1,35426,519
2020-08-25,Azerbaijan,133,2,35559,521
2020-08-26,Azerbaijan,148,1,35707,522
2020-08-27,Azerbaijan,137,2,35844,524
2020-08-28,Azerbaijan,142,3,35986,527
2020-08-29,Azerbaijan,188,2,36174,529
2020-08-30,Azerbaijan,135,2,36309,531
2020-08-31,Azerbaijan,126,3,36435,534
2020-09-01,Azerbaijan,143,2,36578,536
2020-09-02,Azerbaijan,154,2,36732,538
2020-09-03,Azerbaijan,167,3,36899,541
2020-09-04,Azerbaijan,132,2,37031,543
2020-09-05,Azerbaijan,161,2,37192,545
2020-09-06,Azerbaijan,137,3,37329,548
2020-09-07,Azerbaijan,89,3,37418,551
2020-09-08,Azerbaijan,139,1,37557,552
2020-09-09,Azerbaijan,175,3,37732,555
2020-09-10,Azerbaijan,142,1,37874,556
2020-09-11,Azerbaijan,163,1,38037,557
2020-09-12,Azerbaijan,135,2,38172,559
2020-09-13,Azerbaijan,155,3,38327,562
2020-09-14,Azerbaijan,76,2,38403,564
2020-09-15,Azerbaijan,114,2,38517,566
2020-09-16,Azerbaijan,141,3,38658,569
2020-09-17,Azerbaijan,119,2,38777,571
2020-09-18,Azerbaijan,117,1,38894,572
2020-09-19,Azerbaijan,148,2,39042,574
2020-09-20,Azerbaijan,146,1,39188,575
2020-09-21,Azerbaijan,92,1,39280,576
2020-09-22,Azerbaijan,98,2,39378,578
2020-09-23,Azerbaijan,146,2,39524,580
2020-09-24,Azerbaijan,162,1,39686,581
2020-09-25,Azerbaijan,101,2,39787,583
2020-09-26,Azerbaijan,108,2,39895,585
2020-09-27,Azerbaijan,128,1,40023,586
2020-09-28,Azerbaijan,38,2,40061,588
2020-09-29,Azerbaijan,58,2,40119,590
2020-09-30,Azerbaijan,110,1,40229,591
2020-10-01,Azerbaijan,80,2,40309,593
2020-10-02,Azerbaijan,144,1,40453,594
2020-10-03,Azerbaijan,108,1,40561,595
2020-10-04,Azerbaijan,130,1,40691,596
2020-10-05,Azerbaijan,97,2,40788,598
2020-10-06,Azerbaijan,143,2,40931,600
2020-10-07,Azerbaijan,182,2,41113,602
2020-10-08,Azerbaijan,191,1,41304,603
2020-10-09,Azerbaijan,215,2,41519,605
2020-10-10,Azerbaijan,233,3,41752,608
2020-10-11,Azerbaijan,230,1,41982,609
2020-10-12,Azerbaijan,122,0,42104,609
2020-10-13,Azerbaijan,277,3,42381,612
2020-10-14,Azerbaijan,369,4,42750,616
2020-10-15,Azerbaijan,530,3,43280,619
2020-10-16,Azerbaijan,509,2,43789,621
2020-10-17,Azerbaijan,528,2,44317,623
2020-10-18,Azerbaijan,647,3,44964,626
2020-10-19,Azerbaijan,331,4,45295,630
2020-10-20,Azerbaijan,584,5,45879,635
2020-10-21,Azerbaijan,714,7,46593,642
2020-10-22,Azerbaijan,825,6,47418,648
2020-10-23,Azerbaijan,803,8,48221,656
2020-10-24,Azerbaijan,792,8,49013,664
2020-10-25,Azerbaijan,946,7,49959,671
2020-10-26,Azerbaijan,527,8,50486,679
2020-10-27,Azerbaijan,663,9,51149,688
2020-10-28,Azerbaijan,988,11,52137,699
2020-10-29,Azerbaijan,1015,9,53152,708
2020-10-30,Azerbaijan,1022,10,54174,718
2020-10-31,Azerbaijan,1095,12,55269,730
2020-11-01,Azerbaijan,1175,10,56444,740
2020-11-02,Azerbaijan,596,13,57040,753
2020-11-03,Azerbaijan,1242,15,58282,768
2020-11-04,Azerbaijan,1227,12,59509,780
2020-11-05,Azerbaijan,1364,14,60873,794
2020-11-06,Azerbaijan,1465,17,62338,811
2020-11-07,Azerbaijan,1410,13,63748,824
2020-11-08,Azerbaijan,1663,16,65411,840
2020-11-09,Azerbaijan,635,12,66046,852
2020-11-10,Azerbaijan,1346,15,67392,867
2020-11-11,Azerbaijan,1202,18,68594,885
2020-11-12,Azerbaijan,1622,20,70216,905
2020-11-13,Azerbaijan,1364,22,71580,927
2020-11-14,Azerbaijan,1849,19,73429,946
2020-11-15,Azerbaijan,2259,21,75688,967
2020-11-16,Azerbaijan,1395,18,77083,985
2020-11-17,Azerbaijan,2075,20,79158,1005
2020-11-18,Azerbaijan,2239,25,81397,1030
2020-11-19,Azerbaijan,2597,23,83994,1053
2020-11-20,Azerbaijan,3169,26,87163,1079
2020-11-21,Azerbaijan,2735,28,89898,1107
2020-11-22,Azerbaijan,3196,24,93094,1131
2020-11-23,Azerbaijan,2187,29,95281,1160
2020-11-24,Azerbaijan,3646,34,98927,1194
2020-11-25,Azerbaijan,3469,30,102396,1224
2020-11-26,Azerbaijan,3705,32,106101,1256
2020-11-27,Azerbaijan,3712,35,109813,1291
2020-11-28,Azerbaijan,4212,32,114025,1323
2020-11-29,Azerbaijan,4170,38,118195,1361
2020-11-30,Azerbaijan,2981,31,121176,1392
2020-12-01,Azerbaijan,4426,41,125602,1433
2020-12-02,Azerbaijan,3942,37,129544,1470
2020-12-03,Azerbaijan,4189,40,133733,1510
2020-12-04,Azerbaijan,4267,41,138000,1551
2020-12-05,Azerbaijan,4323,42,142323,1593
2020-12-06,Azerbaijan,4356,39,146679,1632
2020-12-07,Azerbaijan,3086,43,149765,1675
2020-12-08,Azerbaijan,4387,38,154152,1713
2020-12-09,Azerbaijan,4403,42,158555,1755
2020-12-10,Azerbaijan,4219,38,162774,1793
2020-12-11,Azerbaijan,4381,47,167155,1840
2020-12-12,Azerbaijan,4268,43,171423,1883
2020-12-13,Azerbaijan,4451,39,175874,1922
2020-12-14,Azerbaijan,3112,44,178986,1966
2020-12-15,Azerbaijan,4273,41,183259,2007
2020-12-16,Azerbaijan,4077,43,187336,2050
2020-12-17,Azerbaijan,4124,38,191460,2088
2020-12-18,Azerbaijan,3962,45,195422,2133
2020-12-19,Azerbaijan,3705,42,199127,2175
2020-12-20,Azerbaijan,2961,35,202088,2210
2020-12-21,Azerbaijan,1505,43,203593,2253
2020-12-22,Azerbaijan,2284,41,205877,2294
2020-12-23,Azerbaijan,2334,46,208211,2340
2020-12-24,Azerbaijan,1850,40,210061,2380
2020-12-25,Azerbaijan,1703,36,211764,2416
2020-12-26,Azerbaijan,1428,38,213192,2454
2020-12-27,Azerbaijan,1519,45,214711,2499
2020-12-28,Azerbaijan,772,39,215483,2538
2020-12-29,Azerbaijan,1101,37,216584,2575
2020-12-30,Azerbaijan,1052,34,217636,2609
2020-12-31,Azerbaijan,1064,32,218700,2641
2021-01-01,Azerbaijan,341,29,219041,2670
2021-01-02,Azerbaijan,421,33,219462,2703
2021-01-03,Azerbaijan,803,30,220265,2733
2021-01-04,Azerbaijan,334,28,220599,2761
2021-01-05,Azerbaijan,802,31,221401,2792
2021-01-06,Azerbaijan,799,26,222200,2818
2021-01-07,Azerbaijan,685,27,222885,2845
2021-01-08,Azerbaijan,532,24,223417,2869
2021-01-09,Azerbaijan,633,21,224050,2890
2021-01-10,Azerbaijan,601,19,224651,2909
2021-01-11,Azerbaijan,176,17,224827,2926
2021-01-12,Azerbaijan,519,15,225346,2941
2021-01-13,Azerbaijan,474,16,225820,2957
2021-01-14,Azerbaijan,380,14,226200,2971
2021-01-15,Azerbaijan,349,12,226549,2983
2021-01-16,Azerbaijan,402,15,226951,2998
2021-01-17,Azerbaijan,322,11,227273,3009
2021-01-18,Azerbaijan,118,13,227391,3022
2021-01-19,Azerbaijan,305,10,227696,3032
2021-01-20,Azerbaijan,332,12,228028,3044
2021-01-21,Azerbaijan,218,9,228246,3053
2021-01-22,Azerbaijan,280,11,228526,3064
2021-01-23,Azerbaijan,162,8,228688,3072
2021-01-24,Azerbaijan,287,10,228975,3082
2021-01-25,Azerbaijan,57,11,229032,3093
2021-01-26,Azerbaijan,326,7,229358,3100
2021-01-27,Azerbaijan,226,5,229584,3105
2021-01-28,Azerbaijan,209,8,229793,3113
2021-01-29,Azerbaijan,142,6,229935,3119
2021-01-30,Azerbaijan,131,7,230066,3126
2021-01-31,Azerbaijan,153,6,230219,3132
2021-02-01,Azerbaijan,77,4,230296,3136
2021-02-02,Azerbaijan,159,5,230455,3141
2021-02-03,Azerbaijan,162,4,230617,3145
2021-02-04,Azerbaijan,152,3,230769,3148
2021-02-05,Azerbaijan,138,5,230907,3153
2021-02-06,Azerbaijan,115,3,231022,3156
2021-02-07,Azerbaijan,132,2,231154,3158
2021-02-08,Azerbaijan,44,3,231198,3161
2021-02-09,Azerbaijan,164,2,231362,3163
2021-02-10,Azerbaijan,147,4,231509,3167
2021-02-11,Azerbaijan,140,3,231649,3170
2021-02-12,Azerbaijan,191,3,231840,3173
2021-02-13,Azerbaijan,155,5,231995,3178
2021-02-14,Azerbaijan,128,2,232123,3180
2021-02-15,Azerbaijan,74,3,232197,3183
2021-02-16,Azerbaijan,140,2,232337,3185
2021-02-17,Azerbaijan,154,2,232491,3187
2021-02-18,Azerbaijan,145,3,232636,3190
2021-02-19,Azerbaijan,193,3,232829,3193
2021-02-20,Azerbaijan,144,2,232973,3195
2021-02-21,Azerbaijan,156,3,233129,3198
2021-02-22,Azerbaijan,72,4,233201,3202
2021-02-23,Azerbaijan,223,2,233424,3204
2021-02-24,Azerbaijan,220,2,233644,3206
2021-02-25,Azerbaijan,126,3,233770,3209
2021-02-26,Azerbaijan,219,4,233989,3213
2021-02-27,Azerbaijan,278,5,234267,3218
2021-02-28,Azerbaijan,270,2,234537,3220
2021-03-01,Azerbaijan,125,3,234662,3223
2021-03-02,Azerbaijan,352,2,235014,3225
2021-03-03,Azerbaijan,319,5,235333,3230
2021-03-04,Azerbaijan,314,2,235647,3232
2021-03-05,Azerbaijan,365,3,236012,3235
2021-03-06,Azerbaijan,353,3,236365,3238
2021-03-07,Azerbaijan,403,3,236768,3241
2021-03-08,Azerbaijan,195,6,236963,3247
2021-03-09,Azerbaijan,297,3,237260,3250
2021-03-10,Azerbaijan,515,7,237775,3257
2021-03-11,Azerbaijan,608,5,238383,3262
2021-03-12,Azerbaijan,576,6,238959,3268
2021-03-13,Azerbaijan,733,8,239692,3276
2021-03-14,Azerbaijan,603,6,240295,3282
2021-03-15,Azerbaijan,376,4,240671,3286
2021-03-16,Azerbaijan,980,12,241651,3298
2021-03-17,Azerbaijan,840,9,242491,3307
2021-03-18,Azerbaijan,933,7,243424,3314
2021-03-19,Azerbaijan,879,11,244303,3325
2021-03-20,Azerbaijan,1187,14,245490,3339
2021-03-21,Azerbaijan,814,12,246304,3351
2021-03-22,Azerbaijan,670,15,246974,3366
2021-03-23,Azerbaijan,1333,18,248307,3384
2021-03-24,Azerbaijan,1185,20,249492,3404
2021-03-25,Azerbaijan,1429,17,250921,3421
2021-03-26,Azerbaijan,1759,24,252680,3445
2021-03-27,Azerbaijan,1690,19,254370,3464
2021-03-28,Azerbaijan,1831,27,256201,3491
2021-03-29,Azerbaijan,1129,22,257330,3513
2021-03-30,Azerbaijan,2146,25,259476,3538
2021-03-31,Azerbaijan,2237,29,261713,3567
2021-04-01,Azerbaijan,2248,26,263961,3593
2021-04-02,Azerbaijan,2361,24,266322,3617
2021-04-03,Azerbaijan,1852,31,268174,3648
2021-04-04,Azerbaijan,2561,29,270735,3677
2021-04-05,Azerbaijan,1099,34,271834,3711
2021-04-06,Azerbaijan,2035,32,273869,3743
2021-04-07,Azerbaijan,2595,37,276464,3780
2021-04-08,Azerbaijan,2717,31,279181,3811
2020-03-16,Bahamas,1,0,1,0
2020-03-17,Bahamas,0,0,1,0
2020-03-18,Bahamas,0,0,1,0
2020-03-19,Bahamas,2,0,3,0
2020-03-20,Bahamas,0,0,3,0
2020-03-21,Bahamas,1,0,4,0
2020-03-22,Bahamas,0,0,4,0
2020-03-23,Bahamas,0,0,4,0
2020-03-24,Bahamas,1,0,5,0
2020-03-25,Bahamas,0,0,5,0
2020-03-26,Bahamas,4,0,9,0
2020-03-27,Bahamas,1,0,10,0
2020-03-28,Bahamas,0,0,10,0
2020-03-29,Bahamas,1,0,11,0
2020-03-30,Bahamas,3,0,14,0
2020-03-31,Bahamas,0,0,14,0
2020-04-01,Bahamas,7,1,21,1
2020-04-02,Bahamas,3,0,24,1
2020-04-03,Bahamas,0,0,24,1
2020-04-04,Bahamas,4,3,28,4
2020-04-05,Bahamas,0,0,28,4
2020-04-06,Bahamas,1,1,29,5
2020-04-07,Bahamas,4,1,33,6
2020-04-08,Bahamas,7,1,40,7
2020-04-09,Bahamas,1,1,41,8
2020-04-10,Bahamas,1,0,42,8
2020-04-11,Bahamas,4,0,46,8
2020-04-12,Bahamas,0,0,46,8
2020-04-13,Bahamas,1,0,47,8
2020-04-14,Bahamas,2,0,49,8
2020-04-15,Bahamas,0,0,49,8
2020-04-16,Bahamas,4,0,53,8
2020-04-17,Bahamas,1,1,54,9
2020-04-18,Bahamas,1,0,55,9
2020-04-19,Bahamas,0,0,55,9
2020-04-20,Bahamas,5,0,60,9
2020-04-21,Bahamas,5,0,65,9
2020-04-22,Bahamas,0,0,65,9
2020-04-23,Bahamas,7,2,72,11
2020-04-24,Bahamas,1,0,73,11
2020-04-25,Bahamas,5,0,78,11
2020-04-26,Bahamas,2,0,80,11
2020-04-27,Bahamas,0,0,80,11
2020-04-28,Bahamas,0,0,80,11
2020-04-29,Bahamas,0,0,80,11
2020-04-30,Bahamas,1,0,81,11
2020-05-01,Bahamas,0,0,81,11
2020-05-02,Bahamas,2,0,83,11
2020-05-03,Bahamas,0,0,83,11
2020-05-04,Bahamas,0,0,83,11
2020-05-05,Bahamas,6,0,89,11
2020-05-06,Bahamas,3,0,92,11
2020-05-07,Bahamas,0,0,92,11
2020-05-08,Bahamas,0,0,92,11
2020-05-09,Bahamas,0,0,92,11
2020-05-10,Bahamas,0,0,92,11
2020-05-11,Bahamas,1,0,93,11
2020-05-12,Bahamas,0,0,93,11
2020-05-13,Bahamas,1,0,94,11
2020-05-14,Bahamas,2,0,96,11
2020-05-15,Bahamas,0,0,96,11
2020-05-16,Bahamas,0,0,96,11
2020-05-17,Bahamas,0,0,96,11
2020-05-18,Bahamas,0,0,96,11
2020-05-19,Bahamas,0,0,96,11
2020-05-20,Bahamas,1,0,97,11
2020-05-21,Bahamas,0,0,97,11
2020-05-22,Bahamas,0,0,97,11
2020-05-23,Bahamas,3,0,100,11
2020-05-24,Bahamas,0,0,100,11
2020-05-25,Bahamas,0,0,100,11
2020-05-26,Bahamas,0,0,100,11
2020-05-27,Bahamas,0,0,100,11
2020-05-28,Bahamas,1,0,101,11
2020-05-29,Bahamas,1,0,102,11
2020-05-30,Bahamas,0,0,102,11
2020-05-31,Bahamas,0,0,102,11
2020-06-01,Bahamas,0,0,102,11
2020-06-02,Bahamas,0,0,102,11
2020-06-03,Bahamas,0,0,102,11
2020-06-04,Bahamas,0,0,102,11
2020-06-05,Bahamas,0,0,102,11
2020-06-06,Bahamas,1,0,103,11
2020-06-07,Bahamas,0,0,103,11
2020-06-08,Bahamas,0,0,103,11
2020-06-09,Bahamas,0,0,103,11
2020-06-10,Bahamas,0,0,103,11
2020-06-11,Bahamas,0,0,103,11
2020-06-12,Bahamas,0,0,103,11
2020-06-13,Bahamas,0,0,103,11
2020-06-14,Bahamas,0,0,103,11
2020-06-15,Bahamas,0,0,103,11
2020-06-16,Bahamas,1,0,104,11
2020-06-17,Bahamas,0,0,104,11
2020-06-18,Bahamas,0,0,104,11
2020-06-19,Bahamas,0,0,104,11
2020-06-20,Bahamas,0,0,104,11
2020-06-21,Bahamas,0,0,104,11
2020-06-22,Bahamas,0,0,104,11
2020-06-23,Bahamas,0,0,104,11
2020-06-24,Bahamas,0,0,104,11
2020-06-25,Bahamas,0,0,104,11
2020-06-26,Bahamas,0,0,104,11
2020-06-27,Bahamas,0,0,104,11
2020-06-28,Bahamas,0,0,104,11
2020-06-29,Bahamas,0,0,104,11
2020-06-30,Bahamas,0,0,104,11
2020-07-01,Bahamas,0,0,104,11
2020-07-02,Bahamas,0,0,104,11
2020-07-03,Bahamas,0,0,104,11
2020-07-04,Bahamas,0,0,104,11
2020-07-05,Bahamas,0,0,104,11
2020-07-06,Bahamas,0,0,104,11
2020-07-07,Bahamas,0,0,104,11
2020-07-08,Bahamas,2,0,106,11
2020-07-09,Bahamas,1,0,107,11
2020-07-10,Bahamas,1,0,108,11
2020-07-11,Bahamas,3,0,111,11
2020-07-12,Bahamas,0,0,111,11
2020-07-13,Bahamas,2,0,113,11
2020-07-14,Bahamas,3,0,116,11
2020-07-15,Bahamas,3,0,119,11
2020-07-16,Bahamas,5,0,124,11
2020-07-17,Bahamas,5,0,129,11
2020-07-18,Bahamas,9,0,138,11
2020-07-19,Bahamas,15,0,153,11
2020-07-20,Bahamas,21,0,174,11
2020-07-21,Bahamas,20,0,194,11
2020-07-22,Bahamas,25,0,219,11
2020-07-23,Bahamas,55,0,274,11
2020-07-24,Bahamas,42,0,316,11
2020-07-25,Bahamas,10,0,326,11
2020-07-26,Bahamas,16,0,342,11
2020-07-27,Bahamas,40,0,382,11
2020-07-28,Bahamas,65,0,447,11
2020-07-29,Bahamas,37,0,484,11
2020-07-30,Bahamas,24,3,508,14
2020-07-31,Bahamas,66,0,574,14
2020-08-01,Bahamas,25,0,599,14
2020-08-02,Bahamas,49,0,648,14
2020-08-03,Bahamas,31,0,679,14
2020-08-04,Bahamas,36,0,715,14
2020-08-05,Bahamas,36,0,751,14
2020-08-06,Bahamas,10,0,761,14
2020-08-07,Bahamas,69,0,830,14
2020-08-08,Bahamas,48,0,878,14
2020-08-09,Bahamas,20,1,898,15
2020-08-10,Bahamas,47,0,945,15
2020-08-11,Bahamas,44,0,989,15
2020-08-12,Bahamas,47,0,1036,15
2020-08-13,Bahamas,53,0,1089,15
2020-08-14,Bahamas,30,2,1119,17
2020-08-15,Bahamas,133,0,1252,17
2020-08-16,Bahamas,63,1,1315,18
2020-08-17,Bahamas,14,1,1329,19
2020-08-18,Bahamas,95,1,1424,20
2020-08-19,Bahamas,107,2,1531,22
2020-08-20,Bahamas,79,1,1610,23
2020-08-21,Bahamas,93,4,1703,27
2020-08-22,Bahamas,62,0,1765,27
2020-08-23,Bahamas,19,2,1784,29
2020-08-24,Bahamas,14,15,1798,44
2020-08-25,Bahamas,15,2,1813,46
2020-08-26,Bahamas,110,2,1923,48
2020-08-27,Bahamas,97,0,2020,48
2020-08-28,Bahamas,37,2,2057,50
2020-08-29,Bahamas,78,0,2135,50
2020-08-30,Bahamas,32,0,2167,50
2020-08-31,Bahamas,50,0,2217,50
2020-09-01,Bahamas,59,0,2276,50
2020-09-02,Bahamas,61,0,2337,50
2020-09-03,Bahamas,49,0,2386,50
2020-09-04,Bahamas,0,0,2386,50
2020-09-05,Bahamas,90,5,2476,55
2020-09-06,Bahamas,30,1,2506,56
2020-09-07,Bahamas,40,2,2546,58
2020-09-08,Bahamas,39,1,2585,59
2020-09-09,Bahamas,136,4,2721,63
2020-09-10,Bahamas,0,0,2721,63
2020-09-11,Bahamas,93,2,2814,65
2020-09-12,Bahamas,114,2,2928,67
2020-09-13,Bahamas,0,0,2928,67
2020-09-14,Bahamas,80,1,3008,68
2020-09-15,Bahamas,24,1,3032,69
2020-09-16,Bahamas,55,0,3087,69
2020-09-17,Bahamas,90,0,3177,69
2020-09-18,Bahamas,0,0,3177,69
2020-09-19,Bahamas,37,4,3214,73
2020-09-20,Bahamas,101,1,3315,74
2020-09-21,Bahamas,103,1,3418,75
2020-09-22,Bahamas,49,2,3467,77
2020-09-23,Bahamas,151,3,3618,80
2020-09-24,Bahamas,81,6,3699,86
2020-09-25,Bahamas,91,3,3790,89
2020-09-26,Bahamas,0,0,3790,89
2020-09-27,Bahamas,48,0,3838,89
2020-09-28,Bahamas,0,0,3838,89
2020-09-29,Bahamas,65,2,3903,91
2020-09-30,Bahamas,220,5,4123,96
2020-10-01,Bahamas,0,0,4123,96
2020-10-02,Bahamas,97,0,4220,96
2020-10-03,Bahamas,112,0,4332,96
2020-10-04,Bahamas,77,0,4409,96
2020-10-05,Bahamas,43,0,4452,96
2020-10-06,Bahamas,107,4,4559,100
2020-10-07,Bahamas,154,2,4713,102
2020-10-08,Bahamas,0,0,4713,102
2020-10-09,Bahamas,0,0,4713,102
2020-10-10,Bahamas,310,4,5023,106
2020-10-11,Bahamas,55,1,5078,107
2020-10-12,Bahamas,85,1,5163,108
2020-10-13,Bahamas,0,0,5163,108
2020-10-14,Bahamas,28,1,5191,109
2020-10-15,Bahamas,194,3,5385,112
2020-10-16,Bahamas,132,2,5517,114
2020-10-17,Bahamas,111,2,5628,116
2020-10-18,Bahamas,75,6,5703,122
2020-10-19,Bahamas,70,1,5773,123
2020-10-20,Bahamas,150,1,5923,124
2020-10-21,Bahamas,128,3,6051,127
2020-10-22,Bahamas,84,3,6135,130
2020-10-23,Bahamas,133,0,6268,130
2020-10-24,Bahamas,0,0,6268,130
2020-10-25,Bahamas,142,2,6410,132
2020-10-26,Bahamas,0,0,6410,132
2020-10-27,Bahamas,92,4,6502,136
2020-10-28,Bahamas,47,0,6549,136
2020-10-29,Bahamas,58,2,6607,138
2020-10-30,Bahamas,37,4,6644,142
2020-10-31,Bahamas,70,2,6714,144
2020-11-01,Bahamas,0,0,6714,144
2020-11-02,Bahamas,21,2,6735,146
2020-11-03,Bahamas,55,3,6790,149
2020-11-04,Bahamas,53,1,6843,150
2020-11-05,Bahamas,39,0,6882,150
2020-11-06,Bahamas,0,0,6882,150
2020-11-07,Bahamas,65,2,6947,152
2020-11-08,Bahamas,0,0,6947,152
2020-11-09,Bahamas,17,2,6964,154
2020-11-10,Bahamas,48,0,7012,154
2020-11-11,Bahamas,48,0,7060,154
2020-11-12,Bahamas,64,1,7124,155
2020-11-13,Bahamas,39,0,7163,155
2020-11-14,Bahamas,0,0,7163,155
2020-11-15,Bahamas,23,1,7186,156
2020-11-16,Bahamas,70,7,7256,163
2020-11-17,Bahamas,56,0,7312,163
2020-11-18,Bahamas,11,0,7323,163
2020-11-19,Bahamas,25,0,7348,163
2020-11-20,Bahamas,19,0,7367,163
2020-11-21,Bahamas,28,0,7395,163
2020-11-22,Bahamas,18,0,7413,163
2020-11-23,Bahamas,18,0,7431,163
2020-11-24,Bahamas,29,0,7460,163
2020-11-25,Bahamas,9,0,7469,163
2020-11-26,Bahamas,13,0,7482,163
2020-11-27,Bahamas,14,0,7496,163
2020-11-28,Bahamas,0,0,7496,163
2020-11-29,Bahamas,21,0,7517,163
2020-11-30,Bahamas,24,0,7541,163
2020-12-01,Bahamas,2,0,7543,163
2020-12-02,Bahamas,0,0,7543,163
2020-12-03,Bahamas,6,0,7549,163
2020-12-04,Bahamas,16,0,7565,163
2020-12-05,Bahamas,5,0,7570,163
2020-12-06,Bahamas,0,0,7570,163
2020-12-07,Bahamas,9,0,7579,163
2020-12-08,Bahamas,0,0,7579,163
2020-12-09,Bahamas,6,0,7585,163
2020-12-10,Bahamas,0,0,7585,163
2020-12-11,Bahamas,38,0,7623,163
2020-12-12,Bahamas,25,0,7648,163
2020-12-13,Bahamas,11,0,7659,163
2020-12-14,Bahamas,15,0,7674,163
2020-12-15,Bahamas,24,1,7698,164
2020-12-16,Bahamas,16,0,7714,164
2020-12-17,Bahamas,11,0,7725,164
2020-12-18,Bahamas,8,0,7733,164
2020-12-19,Bahamas,0,0,7733,164
2020-12-20,Bahamas,13,0,7746,164
2020-12-21,Bahamas,19,0,7765,164
2020-12-22,Bahamas,7,5,7772,169
2020-12-23,Bahamas,16,0,7788,169
2020-12-24,Bahamas,0,0,7788,169
2020-12-25,Bahamas,0,0,7788,169
2020-12-26,Bahamas,0,0,7788,169
2020-12-27,Bahamas,46,1,7834,170
2020-12-28,Bahamas,0,0,7834,170
2020-12-29,Bahamas,12,0,7846,170
2020-12-30,Bahamas,11,0,7857,170
2020-12-31,Bahamas,14,0,7871,170
2021-01-01,Bahamas,16,1,7887,171
2021-01-02,Bahamas,0,0,7887,171
2021-01-03,Bahamas,27,4,7914,175
2021-01-04,Bahamas,10,0,7924,175
2021-01-05,Bahamas,4,0,7928,175
2021-01-06,Bahamas,17,0,7945,175
2021-01-07,Bahamas,14,0,7959,175
2021-01-08,Bahamas,10,0,7969,175
2021-01-09,Bahamas,0,0,7969,175
2021-01-10,Bahamas,0,0,7969,175
2021-01-11,Bahamas,35,0,8004,175
2021-01-12,Bahamas,0,0,8004,175
2021-01-13,Bahamas,7,0,8011,175
2021-01-14,Bahamas,0,0,8011,175
2021-01-15,Bahamas,10,0,8021,175
2021-01-16,Bahamas,11,0,8032,175
2021-01-17,Bahamas,0,0,8032,175
2021-01-18,Bahamas,35,0,8067,175
2021-01-19,Bahamas,1,0,8068,175
2021-01-20,Bahamas,7,0,8075,175
2021-01-21,Bahamas,13,0,8088,175
2021-01-22,Bahamas,13,0,8101,175
2021-01-23,Bahamas,0,0,8101,175
2021-01-24,Bahamas,0,0,8101,175
2021-01-25,Bahamas,32,0,8133,175
2021-01-26,Bahamas,7,0,8140,175
2021-01-27,Bahamas,21,0,8161,175
2021-01-28,Bahamas,0,0,8161,175
2021-01-29,Bahamas,6,0,8167,175
2021-01-30,Bahamas,7,1,8174,176
2021-01-31,Bahamas,0,0,8174,176
2021-02-01,Bahamas,0,0,8174,176
2021-02-02,Bahamas,49,0,8223,176
2021-02-03,Bahamas,8,0,8231,176
2021-02-04,Bahamas,16,0,8247,176
2021-02-05,Bahamas,9,0,8256,176
2021-02-06,Bahamas,0,0,8256,176
2021-02-07,Bahamas,0,0,8256,176
2021-02-08,Bahamas,33,0,8289,176
2021-02-09,Bahamas,0,0,8289,176
2021-02-10,Bahamas,0,0,8289,176
2021-02-11,Bahamas,22,2,8311,178
2021-02-12,Bahamas,0,0,8311,178
2021-02-13,Bahamas,0,0,8311,178
2021-02-14,Bahamas,0,0,8311,178
2021-02-15,Bahamas,0,0,8311,178
2021-02-16,Bahamas,72,1,8383,179
2021-02-17,Bahamas,0,0,8383,179
2021-02-18,Bahamas,20,0,8403,179
2021-02-19,Bahamas,0,0,8403,179
2021-02-20,Bahamas,0,0,8403,179
2021-02-21,Bahamas,0,0,8403,179
2021-02-22,Bahamas,68,0,8471,179
2021-02-23,Bahamas,6,0,8477,179
2021-02-24,Bahamas,19,0,8496,179
2021-02-25,Bahamas,0,0,8496,179
2021-02-26,Bahamas,23,0,8519,179
2021-02-27,Bahamas,0,0,8519,179
2021-02-28,Bahamas,0,0,8519,179
2021-03-01,Bahamas,0,0,8519,179
2021-03-02,Bahamas,0,0,8519,179
2021-03-03,Bahamas,54,2,8573,181
2021-03-04,Bahamas,0,0,8573,181
2021-03-05,Bahamas,27,0,8600,181
2021-03-06,Bahamas,0,0,8600,181
2021-03-07,Bahamas,0,0,8600,181
2021-03-08,Bahamas,0,0,8600,181
2021-03-09,Bahamas,42,4,8642,185
2021-03-10,Bahamas,0,0,8642,185
2021-03-11,Bahamas,0,0,8642,185
2021-03-12,Bahamas,16,0,8658,185
2021-03-13,Bahamas,0,0,8658,185
2021-03-14,Bahamas,0,0,8658,185
2021-03-15,Bahamas,107,1,8765,186
2021-03-16,Bahamas,11,0,8776,186
2021-03-17,Bahamas,24,0,8800,186
2021-03-18,Bahamas,0,0,8800,186
2021-03-19,Bahamas,0,0,8800,186
2021-03-20,Bahamas,0,0,8800,186
2021-03-21,Bahamas,0,0,8800,186
2021-03-22,Bahamas,123,2,8923,188
2021-03-23,Bahamas,12,0,8935,188
2021-03-24,Bahamas,0,0,8935,188
2021-03-25,Bahamas,0,0,8935,188
2021-03-26,Bahamas,0,0,8935,188
2021-03-27,Bahamas,0,0,8935,188
2021-03-28,Bahamas,0,0,8935,188
2021-03-29,Bahamas,65,0,9000,188
2021-03-30,Bahamas,119,0,9119,188
2021-03-31,Bahamas,0,0,9119,188
2021-04-01,Bahamas,52,0,9171,188
2021-04-02,Bahamas,0,0,9171,188
2021-04-03,Bahamas,0,0,9171,188
2021-04-04,Bahamas,0,0,9171,188
2021-04-05,Bahamas,0,0,9171,188
2021-04-06,Bahamas,99,1,9270,189
2021-04-07,Bahamas,26,0,9296,189
2021-04-08,Bahamas,43,0,9339,189
2020-02-24,Bahrain,1,0,1,0
2020-02-25,Bahrain,22,0,23,0
2020-02-26,Bahrain,10,0,33,0
2020-02-27,Bahrain,0,0,33,0
2020-02-28,Bahrain,3,0,36,0
2020-02-29,Bahrain,5,0,41,0
2020-03-01,Bahrain,6,0,47,0
2020-03-02,Bahrain,2,0,49,0
2020-03-03,Bahrain,0,0,49,0
2020-03-04,Bahrain,3,0,52,0
2020-03-05,Bahrain,3,0,55,0
2020-03-06,Bahrain,5,0,60,0
2020-03-07,Bahrain,25,0,85,0
2020-03-08,Bahrain,0,0,85,0
2020-03-09,Bahrain,10,0,95,0
2020-03-10,Bahrain,15,0,110,0
2020-03-11,Bahrain,85,0,195,0
2020-03-12,Bahrain,0,0,195,0
2020-03-13,Bahrain,0,0,195,0
2020-03-14,Bahrain,15,0,210,0
2020-03-15,Bahrain,4,0,214,0
2020-03-16,Bahrain,0,1,214,1
2020-03-17,Bahrain,14,0,228,1
2020-03-18,Bahrain,28,0,256,1
2020-03-19,Bahrain,22,0,278,1
2020-03-20,Bahrain,7,0,285,1
2020-03-21,Bahrain,20,0,305,1
2020-03-22,Bahrain,29,1,334,2
2020-03-23,Bahrain,43,0,377,2
2020-03-24,Bahrain,15,1,392,3
2020-03-25,Bahrain,27,1,419,4
2020-03-26,Bahrain,39,0,458,4
2020-03-27,Bahrain,8,0,466,4
2020-03-28,Bahrain,10,0,476,4
2020-03-29,Bahrain,23,0,499,4
2020-03-30,Bahrain,16,0,515,4
2020-03-31,Bahrain,52,0,567,4
2020-04-01,Bahrain,2,0,569,4
2020-04-02,Bahrain,74,0,643,4
2020-04-03,Bahrain,29,0,672,4
2020-04-04,Bahrain,16,0,688,4
2020-04-05,Bahrain,12,0,700,4
2020-04-06,Bahrain,56,0,756,4
2020-04-07,Bahrain,55,1,811,5
2020-04-08,Bahrain,12,0,823,5
2020-04-09,Bahrain,64,0,887,5
2020-04-10,Bahrain,38,1,925,6
2020-04-11,Bahrain,115,0,1040,6
2020-04-12,Bahrain,96,0,1136,6
2020-04-13,Bahrain,225,0,1361,6
2020-04-14,Bahrain,167,1,1528,7
2020-04-15,Bahrain,143,0,1671,7
2020-04-16,Bahrain,29,0,1700,7
2020-04-17,Bahrain,40,0,1740,7
2020-04-18,Bahrain,33,0,1773,7
2020-04-19,Bahrain,108,0,1881,7
2020-04-20,Bahrain,26,0,1907,7
2020-04-21,Bahrain,66,0,1973,7
2020-04-22,Bahrain,54,0,2027,7
2020-04-23,Bahrain,190,1,2217,8
2020-04-24,Bahrain,301,0,2518,8
2020-04-25,Bahrain,70,0,2588,8
2020-04-26,Bahrain,59,0,2647,8
2020-04-27,Bahrain,76,0,2723,8
2020-04-28,Bahrain,88,0,2811,8
2020-04-29,Bahrain,110,0,2921,8
2020-04-30,Bahrain,119,0,3040,8
2020-05-01,Bahrain,130,0,3170,8
2020-05-02,Bahrain,114,0,3284,8
2020-05-03,Bahrain,99,0,3383,8
2020-05-04,Bahrain,150,0,3533,8
2020-05-05,Bahrain,187,0,3720,8
2020-05-06,Bahrain,214,0,3934,8
2020-05-07,Bahrain,265,0,4199,8
2020-05-08,Bahrain,245,0,4444,8
2020-05-09,Bahrain,330,0,4774,8
2020-05-10,Bahrain,167,0,4941,8
2020-05-11,Bahrain,295,0,5236,8
2020-05-12,Bahrain,295,1,5531,9
2020-05-13,Bahrain,285,1,5816,10
2020-05-14,Bahrain,382,0,6198,10
2020-05-15,Bahrain,385,2,6583,12
2020-05-16,Bahrain,164,0,6747,12
2020-05-17,Bahrain,209,0,6956,12
2020-05-18,Bahrain,228,0,7184,12
2020-05-19,Bahrain,348,0,7532,12
2020-05-20,Bahrain,356,0,7888,12
2020-05-21,Bahrain,286,0,8174,12
2020-05-22,Bahrain,240,0,8414,12
2020-05-23,Bahrain,388,1,8802,13
2020-05-24,Bahrain,336,1,9138,14
2020-05-25,Bahrain,33,0,9171,14
2020-05-26,Bahrain,195,0,9366,14
2020-05-27,Bahrain,326,1,9692,15
2020-05-28,Bahrain,360,0,10052,15
2020-05-29,Bahrain,397,0,10449,15
2020-05-30,Bahrain,344,2,10793,17
2020-05-31,Bahrain,605,2,11398,19
2020-06-01,Bahrain,473,0,11871,19
2020-06-02,Bahrain,440,0,12311,19
2020-06-03,Bahrain,504,1,12815,20
2020-06-04,Bahrain,481,1,13296,21
2020-06-05,Bahrain,539,1,13835,22
2020-06-06,Bahrain,548,2,14383,24
2020-06-07,Bahrain,380,2,14763,26
2020-06-08,Bahrain,654,1,15417,27
2020-06-09,Bahrain,314,2,15731,29
2020-06-10,Bahrain,469,2,16200,31
2020-06-11,Bahrain,467,3,16667,34
2020-06-12,Bahrain,602,2,17269,36
2020-06-13,Bahrain,444,1,17713,37
2020-06-14,Bahrain,514,5,18227,42
2020-06-15,Bahrain,786,4,19013,46
2020-06-16,Bahrain,540,1,19553,47
2020-06-17,Bahrain,408,2,19961,49
2020-06-18,Bahrain,469,6,20430,55
2020-06-19,Bahrain,486,2,20916,57
2020-06-20,Bahrain,415,3,21331,60
2020-06-21,Bahrain,433,3,21764,63
2020-06-22,Bahrain,643,2,22407,65
2020-06-23,Bahrain,655,2,23062,67
2020-06-24,Bahrain,508,2,23570,69
2020-06-25,Bahrain,511,2,24081,71
2020-06-26,Bahrain,724,2,24805,73
2020-06-27,Bahrain,462,5,25267,78
2020-06-28,Bahrain,438,5,25705,83
2020-06-29,Bahrain,534,1,26239,84
2020-06-30,Bahrain,519,3,26758,87
2020-07-01,Bahrain,656,5,27414,92
2020-07-02,Bahrain,423,2,27837,94
2020-07-03,Bahrain,573,1,28410,95
2020-07-04,Bahrain,447,1,28857,96
2020-07-05,Bahrain,510,1,29367,97
2020-07-06,Bahrain,454,1,29821,98
2020-07-07,Bahrain,500,0,30321,98
2020-07-08,Bahrain,610,0,30931,98
2020-07-09,Bahrain,597,5,31528,103
2020-07-10,Bahrain,511,1,32039,104
2020-07-11,Bahrain,431,0,32470,104
2020-07-12,Bahrain,471,4,32941,108
2020-07-13,Bahrain,535,1,33476,109
2020-07-14,Bahrain,602,2,34078,111
2020-07-15,Bahrain,482,6,34560,117
2020-07-16,Bahrain,524,4,35084,121
2020-07-17,Bahrain,389,3,35473,124
2020-07-18,Bahrain,531,0,36004,124
2020-07-19,Bahrain,418,2,36422,126
2020-07-20,Bahrain,514,2,36936,128
2020-07-21,Bahrain,380,1,37316,129
2020-07-22,Bahrain,321,1,37637,130
2020-07-23,Bahrain,359,4,37996,134
2020-07-24,Bahrain,462,2,38458,136
2020-07-25,Bahrain,289,1,38747,137
2020-07-26,Bahrain,384,3,39131,140
2020-07-27,Bahrain,351,1,39482,141
2020-07-28,Bahrain,439,0,39921,141
2020-07-29,Bahrain,390,3,40311,144
2020-07-30,Bahrain,444,2,40755,146
2020-07-31,Bahrain,227,1,40982,147
2020-08-01,Bahrain,208,0,41190,147
2020-08-02,Bahrain,346,0,41536,147
2020-08-03,Bahrain,299,3,41835,150
2020-08-04,Bahrain,297,1,42132,151
2020-08-05,Bahrain,382,3,42514,154
2020-08-06,Bahrain,375,2,42889,156
2020-08-07,Bahrain,418,3,43307,159
2020-08-08,Bahrain,322,2,43629,161
2020-08-09,Bahrain,382,1,44011,162
2020-08-10,Bahrain,386,1,44397,163
2020-08-11,Bahrain,407,2,44804,165
2020-08-12,Bahrain,460,1,45264,166
2020-08-13,Bahrain,462,1,45726,167
2020-08-14,Bahrain,326,1,46052,168
2020-08-15,Bahrain,378,2,46430,170
2020-08-16,Bahrain,405,0,46835,170
2020-08-17,Bahrain,350,3,47185,173
2020-08-18,Bahrain,396,2,47581,175
2020-08-19,Bahrain,369,3,47950,178
2020-08-20,Bahrain,353,1,48303,179
2020-08-21,Bahrain,358,2,48661,181
2020-08-22,Bahrain,377,2,49038,183
2020-08-23,Bahrain,292,1,49330,184
2020-08-24,Bahrain,389,1,49719,185
2020-08-25,Bahrain,357,1,50076,186
2020-08-26,Bahrain,317,0,50393,186
2020-08-27,Bahrain,363,2,50756,188
2020-08-28,Bahrain,357,1,51113,189
2020-08-29,Bahrain,278,0,51391,189
2020-08-30,Bahrain,183,0,51574,189
2020-08-31,Bahrain,398,1,51972,190
2020-09-01,Bahrain,468,0,52440,190
2020-09-02,Bahrain,367,0,52807,190
2020-09-03,Bahrain,626,0,53433,190
2020-09-04,Bahrain,662,5,54095,195
2020-09-05,Bahrain,676,1,54771,196
2020-09-06,Bahrain,644,3,55415,199
2020-09-07,Bahrain,661,1,56076,200
2020-09-08,Bahrain,702,2,56778,202
2020-09-09,Bahrain,672,1,57450,203
2020-09-10,Bahrain,757,4,58207,207
2020-09-11,Bahrain,632,1,58839,208
2020-09-12,Bahrain,747,3,59586,211
2020-09-13,Bahrain,721,1,60307,212
2020-09-14,Bahrain,658,1,60965,213
2020-09-15,Bahrain,678,0,61643,213
2020-09-16,Bahrain,841,3,62484,216
2020-09-17,Bahrain,705,1,63189,217
2020-09-18,Bahrain,690,3,63879,220
2020-09-19,Bahrain,620,1,64499,221
2020-09-20,Bahrain,540,0,65039,221
2020-09-21,Bahrain,713,3,65752,224
2020-09-22,Bahrain,650,3,66402,227
2020-09-23,Bahrain,612,4,67014,231
2020-09-24,Bahrain,687,0,67701,231
2020-09-25,Bahrain,489,5,68190,236
2020-09-26,Bahrain,585,3,68775,239
2020-09-27,Bahrain,586,3,69361,242
2020-09-28,Bahrain,487,3,69848,245
2020-09-29,Bahrain,574,1,70422,246
2020-09-30,Bahrain,442,5,70864,251
2020-10-01,Bahrain,510,3,71374,254
2020-10-02,Bahrain,429,1,71803,255
2020-10-03,Bahrain,507,3,72310,258
2020-10-04,Bahrain,352,2,72662,260
2020-10-05,Bahrain,454,1,73116,261
2020-10-06,Bahrain,360,1,73476,262
2020-10-07,Bahrain,456,0,73932,262
2020-10-08,Bahrain,490,2,74422,264
2020-10-09,Bahrain,438,7,74860,271
2020-10-10,Bahrain,427,2,75287,273
2020-10-11,Bahrain,327,2,75614,275
2020-10-12,Bahrain,334,5,75948,280
2020-10-13,Bahrain,324,5,76272,285
2020-10-14,Bahrain,349,2,76621,287
2020-10-15,Bahrain,333,2,76954,289
2020-10-16,Bahrain,371,3,77325,292
2020-10-17,Bahrain,246,1,77571,293
2020-10-18,Bahrain,331,7,77902,300
2020-10-19,Bahrain,322,2,78224,302
2020-10-20,Bahrain,309,3,78533,305
2020-10-21,Bahrain,374,3,78907,308
2020-10-22,Bahrain,304,0,79211,308
2020-10-23,Bahrain,363,3,79574,311
2020-10-24,Bahrain,401,1,79975,312
2020-10-25,Bahrain,280,0,80255,312
2020-10-26,Bahrain,278,4,80533,316
2020-10-27,Bahrain,232,0,80765,316
2020-10-28,Bahrain,257,1,81022,317
2020-10-29,Bahrain,240,0,81262,317
2020-10-30,Bahrain,204,2,81466,319
2020-10-31,Bahrain,179,2,81645,321
2020-11-01,Bahrain,278,0,81923,321
2020-11-02,Bahrain,210,1,82133,322
2020-11-03,Bahrain,230,2,82363,324
2020-11-04,Bahrain,261,3,82624,327
2020-11-05,Bahrain,162,1,82786,328
2020-11-06,Bahrain,237,0,83023,328
2020-11-07,Bahrain,241,1,83264,329
2020-11-08,Bahrain,192,0,83456,329
2020-11-09,Bahrain,176,0,83632,329
2020-11-10,Bahrain,179,2,83811,331
2020-11-11,Bahrain,231,1,84042,332
2020-11-12,Bahrain,150,0,84192,332
2020-11-13,Bahrain,157,0,84349,332
2020-11-14,Bahrain,174,1,84523,333
2020-11-15,Bahrain,180,1,84703,334
2020-11-16,Bahrain,179,3,84882,337
2020-11-17,Bahrain,126,0,85008,337
2020-11-18,Bahrain,174,0,85182,337
2020-11-19,Bahrain,135,0,85317,337
2020-11-20,Bahrain,150,1,85467,338
2020-11-21,Bahrain,124,0,85591,338
2020-11-22,Bahrain,114,0,85705,338
2020-11-23,Bahrain,181,1,85886,339
2020-11-24,Bahrain,130,1,86016,340
2020-11-25,Bahrain,169,0,86185,340
2020-11-26,Bahrain,162,1,86347,341
2020-11-27,Bahrain,168,0,86515,341
2020-11-28,Bahrain,130,0,86645,341
2020-11-29,Bahrain,142,0,86787,341
2020-11-30,Bahrain,169,0,86956,341
2020-12-01,Bahrain,181,0,87137,341
2020-12-02,Bahrain,133,0,87270,341
2020-12-03,Bahrain,162,0,87432,341
2020-12-04,Bahrain,168,0,87600,341
2020-12-05,Bahrain,132,0,87732,341
2020-12-06,Bahrain,198,0,87930,341
2020-12-07,Bahrain,181,0,88111,341
2020-12-08,Bahrain,183,2,88294,343
2020-12-09,Bahrain,201,4,88495,347
2020-12-10,Bahrain,137,0,88632,347
2020-12-11,Bahrain,188,0,88820,347
2020-12-12,Bahrain,145,1,88965,348
2020-12-13,Bahrain,178,0,89143,348
2020-12-14,Bahrain,125,0,89268,348
2020-12-15,Bahrain,176,0,89444,348
2020-12-16,Bahrain,156,1,89600,349
2020-12-17,Bahrain,143,0,89743,349
2020-12-18,Bahrain,140,0,89883,349
2020-12-19,Bahrain,179,0,90062,349
2020-12-20,Bahrain,220,0,90282,349
2020-12-21,Bahrain,168,1,90450,350
2020-12-22,Bahrain,184,0,90634,350
2020-12-23,Bahrain,183,0,90817,350
2020-12-24,Bahrain,253,0,91070,350
2020-12-25,Bahrain,234,1,91304,351
2020-12-26,Bahrain,214,0,91518,351
2020-12-27,Bahrain,215,0,91733,351
2020-12-28,Bahrain,202,0,91935,351
2020-12-29,Bahrain,234,0,92169,351
2020-12-30,Bahrain,256,1,92425,352
2020-12-31,Bahrain,250,0,92675,352
2021-01-01,Bahrain,238,0,92913,352
2021-01-02,Bahrain,271,0,93184,352
2021-01-03,Bahrain,294,0,93478,352
2021-01-04,Bahrain,288,0,93766,352
2021-01-05,Bahrain,229,0,93995,352
2021-01-06,Bahrain,289,1,94284,353
2021-01-07,Bahrain,349,0,94633,353
2021-01-08,Bahrain,397,1,95030,354
2021-01-09,Bahrain,287,1,95317,355
2021-01-10,Bahrain,241,1,95558,356
2021-01-11,Bahrain,321,0,95879,356
2021-01-12,Bahrain,316,0,96195,356
2021-01-13,Bahrain,275,0,96470,356
2021-01-14,Bahrain,342,0,96812,356
2021-01-15,Bahrain,208,1,97020,357
2021-01-16,Bahrain,248,1,97268,358
2021-01-17,Bahrain,339,2,97607,360
2021-01-18,Bahrain,333,0,97940,360
2021-01-19,Bahrain,320,2,98260,362
2021-01-20,Bahrain,313,4,98573,366
2021-01-21,Bahrain,305,0,98878,366
2021-01-22,Bahrain,332,0,99210,366
2021-01-23,Bahrain,246,1,99456,367
2021-01-24,Bahrain,361,0,99817,367
2021-01-25,Bahrain,413,2,100230,369
2021-01-26,Bahrain,459,1,100689,370
2021-01-27,Bahrain,427,1,101116,371
2021-01-28,Bahrain,387,1,101503,372
2021-01-29,Bahrain,468,0,101971,372
2021-01-30,Bahrain,655,0,102626,372
2021-01-31,Bahrain,431,3,103057,375
2021-02-01,Bahrain,525,1,103582,376
2021-02-02,Bahrain,657,0,104239,376
2021-02-03,Bahrain,553,0,104792,376
2021-02-04,Bahrain,704,1,105496,377
2021-02-05,Bahrain,702,0,106198,377
2021-02-06,Bahrain,515,2,106713,379
2021-02-07,Bahrain,616,1,107329,380
2021-02-08,Bahrain,719,3,108048,383
2021-02-09,Bahrain,759,4,108807,387
2021-02-10,Bahrain,797,4,109604,391
2021-02-11,Bahrain,812,2,110416,393
2021-02-12,Bahrain,896,2,111312,395
2021-02-13,Bahrain,790,3,112102,398
2021-02-14,Bahrain,640,5,112742,403
2021-02-15,Bahrain,848,3,113590,406
2021-02-16,Bahrain,771,4,114361,410
2021-02-17,Bahrain,696,0,115057,410
2021-02-18,Bahrain,648,4,115705,414
2021-02-19,Bahrain,777,4,116482,418
2021-02-20,Bahrain,752,2,117234,420
2021-02-21,Bahrain,575,3,117809,423
2021-02-22,Bahrain,721,6,118530,429
2021-02-23,Bahrain,675,4,119205,433
2021-02-24,Bahrain,653,4,119858,437
2021-02-25,Bahrain,637,2,120495,439
2021-02-26,Bahrain,632,3,121127,442
2021-02-27,Bahrain,651,2,121778,444
2021-02-28,Bahrain,616,5,122394,449
2021-03-01,Bahrain,645,3,123039,452
2021-03-02,Bahrain,492,1,123531,453
2021-03-03,Bahrain,738,5,124269,458
2021-03-04,Bahrain,588,4,124857,462
2021-03-05,Bahrain,657,6,125514,468
2021-03-06,Bahrain,612,1,126126,469
2021-03-07,Bahrain,476,3,126602,472
2021-03-08,Bahrain,653,1,127255,473
2021-03-09,Bahrain,545,1,127800,474
2021-03-10,Bahrain,628,2,128428,476
2021-03-11,Bahrain,653,2,129081,478
2021-03-12,Bahrain,744,2,129825,480
2021-03-13,Bahrain,579,1,130404,481
2021-03-14,Bahrain,597,3,131001,484
2021-03-15,Bahrain,682,1,131683,485
2021-03-16,Bahrain,686,2,132369,487
2021-03-17,Bahrain,768,2,133137,489
2021-03-18,Bahrain,642,2,133779,491
2021-03-19,Bahrain,731,2,134510,493
2021-03-20,Bahrain,816,5,135326,498
2021-03-21,Bahrain,656,2,135982,500
2021-03-22,Bahrain,759,2,136741,502
2021-03-23,Bahrain,809,1,137550,503
2021-03-24,Bahrain,733,4,138283,507
2021-03-25,Bahrain,841,1,139124,508
2021-03-26,Bahrain,829,4,139953,512
2021-03-27,Bahrain,865,1,140818,513
2021-03-28,Bahrain,1027,0,141845,513
2021-03-29,Bahrain,824,2,142669,515
2021-03-30,Bahrain,905,2,143574,517
2021-03-31,Bahrain,871,4,144445,521
2021-04-01,Bahrain,935,2,145380,523
2021-04-02,Bahrain,1074,4,146454,527
2021-04-03,Bahrain,1316,4,147770,531
2021-04-04,Bahrain,1047,5,148817,536
2021-04-05,Bahrain,974,5,149791,541
2021-04-06,Bahrain,1020,4,150811,545
2021-04-07,Bahrain,1120,2,151931,547
2021-04-08,Bahrain,1143,1,153074,548
2020-03-08,Bangladesh,3,0,3,0
2020-03-09,Bangladesh,0,0,3,0
2020-03-10,Bangladesh,0,0,3,0
2020-03-11,Bangladesh,0,0,3,0
2020-03-12,Bangladesh,0,0,3,0
2020-03-13,Bangladesh,0,0,3,0
2020-03-14,Bangladesh,0,0,3,0
2020-03-15,Bangladesh,2,0,5,0
2020-03-16,Bangladesh,3,0,8,0
2020-03-17,Bangladesh,2,0,10,0
2020-03-18,Bangladesh,4,1,14,1
2020-03-19,Bangladesh,3,0,17,1
2020-03-20,Bangladesh,3,0,20,1
2020-03-21,Bangladesh,5,1,25,2
2020-03-22,Bangladesh,2,0,27,2
2020-03-23,Bangladesh,6,1,33,3
2020-03-24,Bangladesh,6,1,39,4
2020-03-25,Bangladesh,0,1,39,5
2020-03-26,Bangladesh,5,0,44,5
2020-03-27,Bangladesh,4,0,48,5
2020-03-28,Bangladesh,0,0,48,5
2020-03-29,Bangladesh,0,0,48,5
2020-03-30,Bangladesh,1,0,49,5
2020-03-31,Bangladesh,2,0,51,5
2020-04-01,Bangladesh,3,1,54,6
2020-04-02,Bangladesh,2,0,56,6
2020-04-03,Bangladesh,5,0,61,6
2020-04-04,Bangladesh,9,2,70,8
2020-04-05,Bangladesh,18,1,88,9
2020-04-06,Bangladesh,35,3,123,12
2020-04-07,Bangladesh,41,5,164,17
2020-04-08,Bangladesh,54,3,218,20
2020-04-09,Bangladesh,112,1,330,21
2020-04-10,Bangladesh,94,6,424,27
2020-04-11,Bangladesh,58,3,482,30
2020-04-12,Bangladesh,139,4,621,34
2020-04-13,Bangladesh,182,5,803,39
2020-04-14,Bangladesh,209,7,1012,46
2020-04-15,Bangladesh,219,4,1231,50
2020-04-16,Bangladesh,341,10,1572,60
2020-04-17,Bangladesh,266,15,1838,75
2020-04-18,Bangladesh,306,9,2144,84
2020-04-19,Bangladesh,312,7,2456,91
2020-04-20,Bangladesh,492,10,2948,101
2020-04-21,Bangladesh,434,9,3382,110
2020-04-22,Bangladesh,390,10,3772,120
2020-04-23,Bangladesh,414,7,4186,127
2020-04-24,Bangladesh,503,4,4689,131
2020-04-25,Bangladesh,309,9,4998,140
2020-04-26,Bangladesh,418,5,5416,145
2020-04-27,Bangladesh,497,7,5913,152
2020-04-28,Bangladesh,549,3,6462,155
2020-04-29,Bangladesh,641,8,7103,163
2020-04-30,Bangladesh,564,5,7667,168
2020-05-01,Bangladesh,571,2,8238,170
2020-05-02,Bangladesh,552,5,8790,175
2020-05-03,Bangladesh,665,2,9455,177
2020-05-04,Bangladesh,688,5,10143,182
2020-05-05,Bangladesh,786,1,10929,183
2020-05-06,Bangladesh,790,3,11719,186
2020-05-07,Bangladesh,706,13,12425,199
2020-05-08,Bangladesh,709,7,13134,206
2020-05-09,Bangladesh,636,8,13770,214
2020-05-10,Bangladesh,887,14,14657,228
2020-05-11,Bangladesh,1034,11,15691,239
2020-05-12,Bangladesh,969,11,16660,250
2020-05-13,Bangladesh,1162,19,17822,269
2020-05-14,Bangladesh,1041,14,18863,283
2020-05-15,Bangladesh,1202,15,20065,298
2020-05-16,Bangladesh,930,16,20995,314
2020-05-17,Bangladesh,1273,14,22268,328
2020-05-18,Bangladesh,1602,21,23870,349
2020-05-19,Bangladesh,1251,21,25121,370
2020-05-20,Bangladesh,1617,16,26738,386
2020-05-21,Bangladesh,1773,22,28511,408
2020-05-22,Bangladesh,1694,24,30205,432
2020-05-23,Bangladesh,1873,20,32078,452
2020-05-24,Bangladesh,1532,28,33610,480
2020-05-25,Bangladesh,1975,21,35585,501
2020-05-26,Bangladesh,1166,21,36751,522
2020-05-27,Bangladesh,1541,22,38292,544
2020-05-28,Bangladesh,2029,15,40321,559
2020-05-29,Bangladesh,2523,23,42844,582
2020-05-30,Bangladesh,1764,28,44608,610
2020-05-31,Bangladesh,2545,40,47153,650
2020-06-01,Bangladesh,2381,22,49534,672
2020-06-02,Bangladesh,2911,37,52445,709
2020-06-03,Bangladesh,2695,37,55140,746
2020-06-04,Bangladesh,2423,35,57563,781
2020-06-05,Bangladesh,2828,30,60391,811
2020-06-06,Bangladesh,2635,35,63026,846
2020-06-07,Bangladesh,2743,42,65769,888
2020-06-08,Bangladesh,2735,42,68504,930
2020-06-09,Bangladesh,3171,45,71675,975
2020-06-10,Bangladesh,3190,37,74865,1012
2020-06-11,Bangladesh,3187,37,78052,1049
2020-06-12,Bangladesh,3471,46,81523,1095
2020-06-13,Bangladesh,2856,44,84379,1139
2020-06-14,Bangladesh,3141,32,87520,1171
2020-06-15,Bangladesh,3099,38,90619,1209
2020-06-16,Bangladesh,3862,53,94481,1262
2020-06-17,Bangladesh,4008,43,98489,1305
2020-06-18,Bangladesh,3803,38,102292,1343
2020-06-19,Bangladesh,3243,45,105535,1388
2020-06-20,Bangladesh,3240,37,108775,1425
2020-06-21,Bangladesh,3531,39,112306,1464
2020-06-22,Bangladesh,3480,38,115786,1502
2020-06-23,Bangladesh,3412,43,119198,1545
2020-06-24,Bangladesh,3462,37,122660,1582
2020-06-25,Bangladesh,3946,39,126606,1621
2020-06-26,Bangladesh,3868,40,130474,1661
2020-06-27,Bangladesh,3504,34,133978,1695
2020-06-28,Bangladesh,3809,43,137787,1738
2020-06-29,Bangladesh,4014,45,141801,1783
2020-06-30,Bangladesh,3682,64,145483,1847
2020-07-01,Bangladesh,3775,41,149258,1888
2020-07-02,Bangladesh,4019,38,153277,1926
2020-07-03,Bangladesh,3114,42,156391,1968
2020-07-04,Bangladesh,3288,29,159679,1997
2020-07-05,Bangladesh,2738,55,162417,2052
2020-07-06,Bangladesh,3201,44,165618,2096
2020-07-07,Bangladesh,3027,55,168645,2151
2020-07-08,Bangladesh,3489,46,172134,2197
2020-07-09,Bangladesh,3360,41,175494,2238
2020-07-10,Bangladesh,2949,37,178443,2275
2020-07-11,Bangladesh,2686,30,181129,2305
2020-07-12,Bangladesh,2666,47,183795,2352
2020-07-13,Bangladesh,3099,39,186894,2391
2020-07-14,Bangladesh,3163,33,190057,2424
2020-07-15,Bangladesh,3533,33,193590,2457
2020-07-16,Bangladesh,2733,39,196323,2496
2020-07-17,Bangladesh,3034,51,199357,2547
2020-07-18,Bangladesh,2709,34,202066,2581
2020-07-19,Bangladesh,2459,37,204525,2618
2020-07-20,Bangladesh,2928,50,207453,2668
2020-07-21,Bangladesh,3057,41,210510,2709
2020-07-22,Bangladesh,2744,42,213254,2751
2020-07-23,Bangladesh,2856,50,216110,2801
2020-07-24,Bangladesh,2548,35,218658,2836
2020-07-25,Bangladesh,2520,38,221178,2874
2020-07-26,Bangladesh,2275,54,223453,2928
2020-07-27,Bangladesh,2772,37,226225,2965
2020-07-28,Bangladesh,2960,35,229185,3000
2020-07-29,Bangladesh,3009,35,232194,3035
2020-07-30,Bangladesh,2695,48,234889,3083
2020-07-31,Bangladesh,2772,28,237661,3111
2020-08-01,Bangladesh,2199,21,239860,3132
2020-08-02,Bangladesh,886,22,240746,3154
2020-08-03,Bangladesh,1356,30,242102,3184
2020-08-04,Bangladesh,1918,50,244020,3234
2020-08-05,Bangladesh,2654,33,246674,3267
2020-08-06,Bangladesh,2977,39,249651,3306
2020-08-07,Bangladesh,2851,27,252502,3333
2020-08-08,Bangladesh,2611,32,255113,3365
2020-08-09,Bangladesh,2487,34,257600,3399
2020-08-10,Bangladesh,2907,39,260507,3438
2020-08-11,Bangladesh,2996,33,263503,3471
2020-08-12,Bangladesh,2995,42,266498,3513
2020-08-13,Bangladesh,2617,44,269115,3557
2020-08-14,Bangladesh,2766,34,271881,3591
2020-08-15,Bangladesh,2644,34,274525,3625
2020-08-16,Bangladesh,2024,32,276549,3657
2020-08-17,Bangladesh,2595,37,279144,3694
2020-08-18,Bangladesh,3200,46,282344,3740
2020-08-19,Bangladesh,2747,41,285091,3781
2020-08-20,Bangladesh,2868,41,287959,3822
2020-08-21,Bangladesh,2401,39,290360,3861
2020-08-22,Bangladesh,2265,46,292625,3907
2020-08-23,Bangladesh,1973,34,294598,3941
2020-08-24,Bangladesh,2485,42,297083,3983
2020-08-25,Bangladesh,2545,45,299628,4028
2020-08-26,Bangladesh,2519,54,302147,4082
2020-08-27,Bangladesh,2436,45,304583,4127
2020-08-28,Bangladesh,2211,47,306794,4174
2020-08-29,Bangladesh,2131,32,308925,4206
2020-08-30,Bangladesh,1897,42,310822,4248
2020-08-31,Bangladesh,2174,33,312996,4281
2020-09-01,Bangladesh,1950,35,314946,4316
2020-09-02,Bangladesh,2582,35,317528,4351
2020-09-03,Bangladesh,2158,32,319686,4383
2020-09-04,Bangladesh,1929,29,321615,4412
2020-09-05,Bangladesh,1950,35,323565,4447
2020-09-06,Bangladesh,1592,32,325157,4479
2020-09-07,Bangladesh,2202,37,327359,4516
2020-09-08,Bangladesh,1892,36,329251,4552
2020-09-09,Bangladesh,1827,41,331078,4593
2020-09-10,Bangladesh,1892,41,332970,4634
2020-09-11,Bangladesh,1792,34,334762,4668
2020-09-12,Bangladesh,1282,34,336044,4702
2020-09-13,Bangladesh,1476,31,337520,4733
2020-09-14,Bangladesh,1812,26,339332,4759
2020-09-15,Bangladesh,1724,43,341056,4802
2020-09-16,Bangladesh,1615,21,342671,4823
2020-09-17,Bangladesh,1593,36,344264,4859
2020-09-18,Bangladesh,1541,22,345805,4881
2020-09-19,Bangladesh,1567,32,347372,4913
2020-09-20,Bangladesh,1546,26,348918,4939
2020-09-21,Bangladesh,1703,40,350621,4979
2020-09-22,Bangladesh,1557,28,352178,5007
2020-09-23,Bangladesh,1666,37,353844,5044
2020-09-24,Bangladesh,1540,28,355384,5072
2020-09-25,Bangladesh,1383,21,356767,5093
2020-09-26,Bangladesh,1106,36,357873,5129
2020-09-27,Bangladesh,1275,32,359148,5161
2020-09-28,Bangladesh,1407,32,360555,5193
2020-09-29,Bangladesh,1488,26,362043,5219
2020-09-30,Bangladesh,1436,32,363479,5251
2020-10-01,Bangladesh,1508,21,364987,5272
2020-10-02,Bangladesh,1396,33,366383,5305
2020-10-03,Bangladesh,1182,20,367565,5325
2020-10-04,Bangladesh,1125,23,368690,5348
2020-10-05,Bangladesh,1442,27,370132,5375
2020-10-06,Bangladesh,1499,30,371631,5405
2020-10-07,Bangladesh,1520,35,373151,5440
2020-10-08,Bangladesh,1441,20,374592,5460
2020-10-09,Bangladesh,1278,17,375870,5477
2020-10-10,Bangladesh,1203,23,377073,5500
2020-10-11,Bangladesh,1193,24,378266,5524
2020-10-12,Bangladesh,1472,31,379738,5555
2020-10-13,Bangladesh,1537,22,381275,5577
2020-10-14,Bangladesh,1684,16,382959,5593
2020-10-15,Bangladesh,1600,15,384559,5608
2020-10-16,Bangladesh,1527,15,386086,5623
2020-10-17,Bangladesh,1209,23,387295,5646
2020-10-18,Bangladesh,1274,14,388569,5660
2020-10-19,Bangladesh,1637,21,390206,5681
2020-10-20,Bangladesh,1380,18,391586,5699
2020-10-21,Bangladesh,1545,24,393131,5723
2020-10-22,Bangladesh,1696,24,394827,5747
2020-10-23,Bangladesh,1586,14,396413,5761
2020-10-24,Bangladesh,1094,19,397507,5780
2020-10-25,Bangladesh,1308,23,398815,5803
2020-10-26,Bangladesh,1436,15,400251,5818
2020-10-27,Bangladesh,1335,20,401586,5838
2020-10-28,Bangladesh,1493,23,403079,5861
2020-10-29,Bangladesh,1681,25,404760,5886
2020-10-30,Bangladesh,1604,19,406364,5905
2020-10-31,Bangladesh,1320,18,407684,5923
2020-11-01,Bangladesh,1568,18,409252,5941
2020-11-02,Bangladesh,1736,25,410988,5966
2020-11-03,Bangladesh,1659,17,412647,5983
2020-11-04,Bangladesh,1517,21,414164,6004
2020-11-05,Bangladesh,1842,17,416006,6021
2020-11-06,Bangladesh,1469,15,417475,6036
2020-11-07,Bangladesh,1289,13,418764,6049
2020-11-08,Bangladesh,1474,18,420238,6067
2020-11-09,Bangladesh,1683,25,421921,6092
2020-11-10,Bangladesh,1699,16,423620,6108
2020-11-11,Bangladesh,1733,19,425353,6127
2020-11-12,Bangladesh,1845,13,427198,6140
2020-11-13,Bangladesh,1767,19,428965,6159
2020-11-14,Bangladesh,1531,14,430496,6173
2020-11-15,Bangladesh,1837,21,432333,6194
2020-11-16,Bangladesh,2139,21,434472,6215
2020-11-17,Bangladesh,2212,39,436684,6254
2020-11-18,Bangladesh,2111,21,438795,6275
2020-11-19,Bangladesh,2364,30,441159,6305
2020-11-20,Bangladesh,2275,17,443434,6322
2020-11-21,Bangladesh,1847,28,445281,6350
2020-11-22,Bangladesh,2060,38,447341,6388
2020-11-23,Bangladesh,2419,28,449760,6416
2020-11-24,Bangladesh,2230,32,451990,6448
2020-11-25,Bangladesh,2156,39,454146,6487
2020-11-26,Bangladesh,2292,37,456438,6524
2020-11-27,Bangladesh,2273,20,458711,6544
2020-11-28,Bangladesh,1908,36,460619,6580
2020-11-29,Bangladesh,1788,29,462407,6609
2020-11-30,Bangladesh,2525,35,464932,6644
2020-12-01,Bangladesh,2293,31,467225,6675
2020-12-02,Bangladesh,2198,38,469423,6713
2020-12-03,Bangladesh,2316,35,471739,6748
2020-12-04,Bangladesh,2252,24,473991,6772
2020-12-05,Bangladesh,1798,35,475789,6807
2020-12-06,Bangladesh,1756,31,477545,6838
2020-12-07,Bangladesh,2198,36,479743,6874
2020-12-08,Bangladesh,2202,32,481945,6906
2020-12-09,Bangladesh,2159,24,484104,6930
2020-12-10,Bangladesh,1861,37,485965,6967
2020-12-11,Bangladesh,1884,19,487849,6986
2020-12-12,Bangladesh,1329,34,489178,7020
2020-12-13,Bangladesh,1355,32,490533,7052
2020-12-14,Bangladesh,1799,37,492332,7089
2020-12-15,Bangladesh,1877,40,494209,7129
2020-12-16,Bangladesh,1632,27,495841,7156
2020-12-17,Bangladesh,1134,36,496975,7192
2020-12-18,Bangladesh,1318,25,498293,7217
2020-12-19,Bangladesh,1267,25,499560,7242
2020-12-20,Bangladesh,1153,38,500713,7280
2020-12-21,Bangladesh,1470,32,502183,7312
2020-12-22,Bangladesh,1318,17,503501,7329
2020-12-23,Bangladesh,1367,30,504868,7359
2020-12-24,Bangladesh,1234,19,506102,7378
2020-12-25,Bangladesh,1163,20,507265,7398
2020-12-26,Bangladesh,834,30,508099,7428
2020-12-27,Bangladesh,1049,24,509148,7452
2020-12-28,Bangladesh,932,27,510080,7479
2020-12-29,Bangladesh,1181,30,511261,7509
2020-12-30,Bangladesh,1235,22,512496,7531
2020-12-31,Bangladesh,1014,28,513510,7559
2021-01-01,Bangladesh,990,17,514500,7576
2021-01-02,Bangladesh,684,23,515184,7599
2021-01-03,Bangladesh,835,27,516019,7626
2021-01-04,Bangladesh,910,24,516929,7650
2021-01-05,Bangladesh,991,20,517920,7670
2021-01-06,Bangladesh,978,17,518898,7687
2021-01-07,Bangladesh,1007,31,519905,7718
2021-01-08,Bangladesh,785,16,520690,7734
2021-01-09,Bangladesh,692,22,521382,7756
2021-01-10,Bangladesh,1071,25,522453,7781
2021-01-11,Bangladesh,849,22,523302,7803
2021-01-12,Bangladesh,718,16,524020,7819
2021-01-13,Bangladesh,890,14,524910,7833
2021-01-14,Bangladesh,813,16,525723,7849
2021-01-15,Bangladesh,762,13,526485,7862
2021-01-16,Bangladesh,578,21,527063,7883
2021-01-17,Bangladesh,569,23,527632,7906
2021-01-18,Bangladesh,697,16,528329,7922
2021-01-19,Bangladesh,702,20,529031,7942
2021-01-20,Bangladesh,656,8,529687,7950
2021-01-21,Bangladesh,584,16,530271,7966
2021-01-22,Bangladesh,619,15,530890,7981
2021-01-23,Bangladesh,436,22,531326,8003
2021-01-24,Bangladesh,473,20,531799,8023
2021-01-25,Bangladesh,602,18,532401,8041
2021-01-26,Bangladesh,515,14,532916,8055
2021-01-27,Bangladesh,528,17,533444,8072
2021-01-28,Bangladesh,509,15,533953,8087
2021-01-29,Bangladesh,454,7,534407,8094
2021-01-30,Bangladesh,363,17,534770,8111
2021-01-31,Bangladesh,369,16,535139,8127
2021-02-01,Bangladesh,443,10,535582,8137
2021-02-02,Bangladesh,525,12,536107,8149
2021-02-03,Bangladesh,438,13,536545,8162
2021-02-04,Bangladesh,485,13,537030,8175
2021-02-05,Bangladesh,435,7,537465,8182
2021-02-06,Bangladesh,305,8,537770,8190
2021-02-07,Bangladesh,292,15,538062,8205
2021-02-08,Bangladesh,316,16,538378,8221
2021-02-09,Bangladesh,387,8,538765,8229
2021-02-10,Bangladesh,388,10,539153,8239
2021-02-11,Bangladesh,378,9,539531,8248
2021-02-12,Bangladesh,444,5,539975,8253
2021-02-13,Bangladesh,291,13,540266,8266
2021-02-14,Bangladesh,326,8,540592,8274
2021-02-15,Bangladesh,446,11,541038,8285
2021-02-16,Bangladesh,396,13,541434,8298
2021-02-17,Bangladesh,443,16,541877,8314
2021-02-18,Bangladesh,391,15,542268,8329
2021-02-19,Bangladesh,406,8,542674,8337
2021-02-20,Bangladesh,350,5,543024,8342
2021-02-21,Bangladesh,327,7,543351,8349
2021-02-22,Bangladesh,366,7,543717,8356
2021-02-23,Bangladesh,399,18,544116,8374
2021-02-24,Bangladesh,428,5,544544,8379
2021-02-25,Bangladesh,410,5,544954,8384
2021-02-26,Bangladesh,470,11,545424,8395
2021-02-27,Bangladesh,407,5,545831,8400
2021-02-28,Bangladesh,385,8,546216,8408
2021-03-01,Bangladesh,585,8,546801,8416
2021-03-02,Bangladesh,515,7,547316,8423
2021-03-03,Bangladesh,614,5,547930,8428
2021-03-04,Bangladesh,619,7,548549,8435
2021-03-05,Bangladesh,635,6,549184,8441
2021-03-06,Bangladesh,540,10,549724,8451
2021-03-07,Bangladesh,606,11,550330,8462
2021-03-08,Bangladesh,845,14,551175,8476
2021-03-09,Bangladesh,912,13,552087,8489
2021-03-10,Bangladesh,1018,7,553105,8496
2021-03-11,Bangladesh,1051,6,554156,8502
2021-03-12,Bangladesh,1066,13,555222,8515
2021-03-13,Bangladesh,1014,12,556236,8527
2021-03-14,Bangladesh,1159,18,557395,8545
2021-03-15,Bangladesh,1773,26,559168,8571
2021-03-16,Bangladesh,1719,26,560887,8597
2021-03-17,Bangladesh,1865,11,562752,8608
2021-03-18,Bangladesh,2187,16,564939,8624
2021-03-19,Bangladesh,1899,18,566838,8642
2021-03-20,Bangladesh,1868,26,568706,8668
2021-03-21,Bangladesh,2172,22,570878,8690
2021-03-22,Bangladesh,2809,30,573687,8720
2021-03-23,Bangladesh,3554,18,577241,8738
2021-03-24,Bangladesh,3567,25,580808,8763
2021-03-25,Bangladesh,3587,34,584395,8797
2021-03-26,Bangladesh,3737,33,588132,8830
2021-03-27,Bangladesh,3674,39,591806,8869
2021-03-28,Bangladesh,3908,35,595714,8904
2021-03-29,Bangladesh,5181,45,600895,8949
2021-03-30,Bangladesh,5042,45,605937,8994
2021-03-31,Bangladesh,5358,52,611295,9046
2021-04-01,Bangladesh,6469,59,617764,9105
2021-04-02,Bangladesh,6830,50,624594,9155
2021-04-03,Bangladesh,5683,58,630277,9213
2021-04-04,Bangladesh,7087,53,637364,9266
2021-04-05,Bangladesh,7075,52,644439,9318
2021-04-06,Bangladesh,7213,66,651652,9384
2021-04-07,Bangladesh,7626,63,659278,9447
2021-04-08,Bangladesh,6854,74,666132,9521
2020-03-17,Barbados,2,0,2,0
2020-03-18,Barbados,0,0,2,0
2020-03-19,Barbados,3,0,5,0
2020-03-20,Barbados,0,0,5,0
2020-03-21,Barbados,1,0,6,0
2020-03-22,Barbados,8,0,14,0
2020-03-23,Barbados,3,0,17,0
2020-03-24,Barbados,1,0,18,0
2020-03-25,Barbados,0,0,18,0
2020-03-26,Barbados,0,0,18,0
2020-03-27,Barbados,6,0,24,0
2020-03-28,Barbados,2,0,26,0
2020-03-29,Barbados,7,0,33,0
2020-03-30,Barbados,0,0,33,0
2020-03-31,Barbados,1,0,34,0
2020-04-01,Barbados,0,0,34,0
2020-04-02,Barbados,12,0,46,0
2020-04-03,Barbados,5,0,51,0
2020-04-04,Barbados,1,0,52,0
2020-04-05,Barbados,4,1,56,1
2020-04-06,Barbados,4,1,60,2
2020-04-07,Barbados,3,1,63,3
2020-04-08,Barbados,0,0,63,3
2020-04-09,Barbados,3,0,66,3
2020-04-10,Barbados,1,1,67,4
2020-04-11,Barbados,1,0,68,4
2020-04-12,Barbados,3,0,71,4
2020-04-13,Barbados,1,0,72,4
2020-04-14,Barbados,0,0,72,4
2020-04-15,Barbados,1,1,73,5
2020-04-16,Barbados,2,0,75,5
2020-04-17,Barbados,0,0,75,5
2020-04-18,Barbados,0,0,75,5
2020-04-19,Barbados,0,0,75,5
2020-04-20,Barbados,0,0,75,5
2020-04-21,Barbados,0,0,75,5
2020-04-22,Barbados,0,0,75,5
2020-04-23,Barbados,1,1,76,6
2020-04-24,Barbados,1,0,77,6
2020-04-25,Barbados,2,0,79,6
2020-04-26,Barbados,0,0,79,6
2020-04-27,Barbados,1,0,80,6
2020-04-28,Barbados,0,0,80,6
2020-04-29,Barbados,0,1,80,7
2020-04-30,Barbados,1,0,81,7
2020-05-01,Barbados,0,0,81,7
2020-05-02,Barbados,0,0,81,7
2020-05-03,Barbados,1,0,82,7
2020-05-04,Barbados,0,0,82,7
2020-05-05,Barbados,0,0,82,7
2020-05-06,Barbados,0,0,82,7
2020-05-07,Barbados,0,0,82,7
2020-05-08,Barbados,1,0,83,7
2020-05-09,Barbados,1,0,84,7
2020-05-10,Barbados,0,0,84,7
2020-05-11,Barbados,0,0,84,7
2020-05-12,Barbados,1,0,85,7
2020-05-13,Barbados,0,0,85,7
2020-05-14,Barbados,0,0,85,7
2020-05-15,Barbados,0,0,85,7
2020-05-16,Barbados,1,0,86,7
2020-05-17,Barbados,2,0,88,7
2020-05-18,Barbados,0,0,88,7
2020-05-19,Barbados,2,0,90,7
2020-05-20,Barbados,0,0,90,7
2020-05-21,Barbados,0,0,90,7
2020-05-22,Barbados,0,0,90,7
2020-05-23,Barbados,2,0,92,7
2020-05-24,Barbados,0,0,92,7
2020-05-25,Barbados,0,0,92,7
2020-05-26,Barbados,0,0,92,7
2020-05-27,Barbados,0,0,92,7
2020-05-28,Barbados,0,0,92,7
2020-05-29,Barbados,0,0,92,7
2020-05-30,Barbados,0,0,92,7
2020-05-31,Barbados,0,0,92,7
2020-06-01,Barbados,0,0,92,7
2020-06-02,Barbados,0,0,92,7
2020-06-03,Barbados,0,0,92,7
2020-06-04,Barbados,0,0,92,7
2020-06-05,Barbados,0,0,92,7
2020-06-06,Barbados,0,0,92,7
2020-06-07,Barbados,0,0,92,7
2020-06-08,Barbados,0,0,92,7
2020-06-09,Barbados,0,0,92,7
2020-06-10,Barbados,4,0,96,7
2020-06-11,Barbados,0,0,96,7
2020-06-12,Barbados,0,0,96,7
2020-06-13,Barbados,0,0,96,7
2020-06-14,Barbados,0,0,96,7
2020-06-15,Barbados,1,0,97,7
2020-06-16,Barbados,0,0,97,7
2020-06-17,Barbados,0,0,97,7
2020-06-18,Barbados,0,0,97,7
2020-06-19,Barbados,0,0,97,7
2020-06-20,Barbados,0,0,97,7
2020-06-21,Barbados,0,0,97,7
2020-06-22,Barbados,0,0,97,7
2020-06-23,Barbados,0,0,97,7
2020-06-24,Barbados,0,0,97,7
2020-06-25,Barbados,0,0,97,7
2020-06-26,Barbados,0,0,97,7
2020-06-27,Barbados,0,0,97,7
2020-06-28,Barbados,0,0,97,7
2020-06-29,Barbados,0,0,97,7
2020-06-30,Barbados,0,0,97,7
2020-07-01,Barbados,0,0,97,7
2020-07-02,Barbados,0,0,97,7
2020-07-03,Barbados,0,0,97,7
2020-07-04,Barbados,0,0,97,7
2020-07-05,Barbados,1,0,98,7
2020-07-06,Barbados,0,0,98,7
2020-07-07,Barbados,0,0,98,7
2020-07-08,Barbados,0,0,98,7
2020-07-09,Barbados,0,0,98,7
2020-07-10,Barbados,0,0,98,7
2020-07-11,Barbados,5,0,103,7
2020-07-12,Barbados,0,0,103,7
2020-07-13,Barbados,0,0,103,7
2020-07-14,Barbados,0,0,103,7
2020-07-15,Barbados,1,0,104,7
2020-07-16,Barbados,0,0,104,7
2020-07-17,Barbados,0,0,104,7
2020-07-18,Barbados,0,0,104,7
2020-07-19,Barbados,1,0,105,7
2020-07-20,Barbados,1,0,106,7
2020-07-21,Barbados,0,0,106,7
2020-07-22,Barbados,0,0,106,7
2020-07-23,Barbados,0,0,106,7
2020-07-24,Barbados,2,0,108,7
2020-07-25,Barbados,0,0,108,7
2020-07-26,Barbados,2,0,110,7
2020-07-27,Barbados,0,0,110,7
2020-07-28,Barbados,0,0,110,7
2020-07-29,Barbados,0,0,110,7
2020-07-30,Barbados,0,0,110,7
2020-07-31,Barbados,0,0,110,7
2020-08-01,Barbados,12,0,122,7
2020-08-02,Barbados,10,0,132,7
2020-08-03,Barbados,0,0,132,7
2020-08-04,Barbados,0,0,132,7
2020-08-05,Barbados,1,0,133,7
2020-08-06,Barbados,0,0,133,7
2020-08-07,Barbados,5,0,138,7
2020-08-08,Barbados,0,0,138,7
2020-08-09,Barbados,4,0,142,7
2020-08-10,Barbados,0,0,142,7
2020-08-11,Barbados,1,0,143,7
2020-08-12,Barbados,1,0,144,7
2020-08-13,Barbados,0,0,144,7
2020-08-14,Barbados,4,0,148,7
2020-08-15,Barbados,2,0,150,7
2020-08-16,Barbados,1,0,151,7
2020-08-17,Barbados,1,0,152,7
2020-08-18,Barbados,1,0,153,7
2020-08-19,Barbados,2,0,155,7
2020-08-20,Barbados,1,0,156,7
2020-08-21,Barbados,1,0,157,7
2020-08-22,Barbados,1,0,158,7
2020-08-23,Barbados,3,0,161,7
2020-08-24,Barbados,0,0,161,7
2020-08-25,Barbados,3,0,164,7
2020-08-26,Barbados,1,0,165,7
2020-08-27,Barbados,0,0,165,7
2020-08-28,Barbados,1,0,166,7
2020-08-29,Barbados,4,0,170,7
2020-08-30,Barbados,3,0,173,7
2020-08-31,Barbados,1,0,174,7
2020-09-01,Barbados,2,0,176,7
2020-09-02,Barbados,0,0,176,7
2020-09-03,Barbados,1,0,177,7
2020-09-04,Barbados,1,0,178,7
2020-09-05,Barbados,0,0,178,7
2020-09-06,Barbados,0,0,178,7
2020-09-07,Barbados,1,0,179,7
2020-09-08,Barbados,1,0,180,7
2020-09-09,Barbados,0,0,180,7
2020-09-10,Barbados,0,0,180,7
2020-09-11,Barbados,0,0,180,7
2020-09-12,Barbados,0,0,180,7
2020-09-13,Barbados,1,0,181,7
2020-09-14,Barbados,2,0,183,7
2020-09-15,Barbados,1,0,184,7
2020-09-16,Barbados,1,0,185,7
2020-09-17,Barbados,0,0,185,7
2020-09-18,Barbados,0,0,185,7
2020-09-19,Barbados,0,0,185,7
2020-09-20,Barbados,4,0,189,7
2020-09-21,Barbados,0,0,189,7
2020-09-22,Barbados,0,0,189,7
2020-09-23,Barbados,0,0,189,7
2020-09-24,Barbados,0,0,189,7
2020-09-25,Barbados,1,0,190,7
2020-09-26,Barbados,0,0,190,7
2020-09-27,Barbados,0,0,190,7
2020-09-28,Barbados,0,0,190,7
2020-09-29,Barbados,0,0,190,7
2020-09-30,Barbados,0,0,190,7
2020-10-01,Barbados,3,0,193,7
2020-10-02,Barbados,0,0,193,7
2020-10-03,Barbados,3,0,196,7
2020-10-04,Barbados,3,0,199,7
2020-10-05,Barbados,1,0,200,7
2020-10-06,Barbados,0,0,200,7
2020-10-07,Barbados,3,0,203,7
2020-10-08,Barbados,0,0,203,7
2020-10-09,Barbados,1,0,204,7
2020-10-10,Barbados,2,0,206,7
2020-10-11,Barbados,2,0,208,7
2020-10-12,Barbados,0,0,208,7
2020-10-13,Barbados,2,0,210,7
2020-10-14,Barbados,5,0,215,7
2020-10-15,Barbados,3,0,218,7
2020-10-16,Barbados,1,0,219,7
2020-10-17,Barbados,0,0,219,7
2020-10-18,Barbados,2,0,221,7
2020-10-19,Barbados,1,0,222,7
2020-10-20,Barbados,0,0,222,7
2020-10-21,Barbados,0,0,222,7
2020-10-22,Barbados,2,0,224,7
2020-10-23,Barbados,2,0,226,7
2020-10-24,Barbados,1,0,227,7
2020-10-25,Barbados,0,0,227,7
2020-10-26,Barbados,6,0,233,7
2020-10-27,Barbados,0,0,233,7
2020-10-28,Barbados,1,0,234,7
2020-10-29,Barbados,0,0,234,7
2020-10-30,Barbados,2,0,236,7
2020-10-31,Barbados,1,0,237,7
2020-11-01,Barbados,0,0,237,7
2020-11-02,Barbados,1,0,238,7
2020-11-03,Barbados,0,0,238,7
2020-11-04,Barbados,1,0,239,7
2020-11-05,Barbados,0,0,239,7
2020-11-06,Barbados,3,0,242,7
2020-11-07,Barbados,0,0,242,7
2020-11-08,Barbados,0,0,242,7
2020-11-09,Barbados,1,0,243,7
2020-11-10,Barbados,0,0,243,7
2020-11-11,Barbados,6,0,249,7
2020-11-12,Barbados,0,0,249,7
2020-11-13,Barbados,0,0,249,7
2020-11-14,Barbados,0,0,249,7
2020-11-15,Barbados,1,0,250,7
2020-11-16,Barbados,0,0,250,7
2020-11-17,Barbados,0,0,250,7
2020-11-18,Barbados,2,0,252,7
2020-11-19,Barbados,1,0,253,7
2020-11-20,Barbados,0,0,253,7
2020-11-21,Barbados,2,0,255,7
2020-11-22,Barbados,4,0,259,7
2020-11-23,Barbados,1,0,260,7
2020-11-24,Barbados,2,0,262,7
2020-11-25,Barbados,1,0,263,7
2020-11-26,Barbados,3,0,266,7
2020-11-27,Barbados,4,0,270,7
2020-11-28,Barbados,0,0,270,7
2020-11-29,Barbados,5,0,275,7
2020-11-30,Barbados,1,0,276,7
2020-12-01,Barbados,2,0,278,7
2020-12-02,Barbados,1,0,279,7
2020-12-03,Barbados,2,0,281,7
2020-12-04,Barbados,3,0,284,7
2020-12-05,Barbados,1,0,285,7
2020-12-06,Barbados,0,0,285,7
2020-12-07,Barbados,2,0,287,7
2020-12-08,Barbados,2,0,289,7
2020-12-09,Barbados,1,0,290,7
2020-12-10,Barbados,1,0,291,7
2020-12-11,Barbados,1,0,292,7
2020-12-12,Barbados,0,0,292,7
2020-12-13,Barbados,0,0,292,7
2020-12-14,Barbados,4,0,296,7
2020-12-15,Barbados,1,0,297,7
2020-12-16,Barbados,4,0,301,7
2020-12-17,Barbados,4,0,305,7
2020-12-18,Barbados,2,0,307,7
2020-12-19,Barbados,0,0,307,7
2020-12-20,Barbados,0,0,307,7
2020-12-21,Barbados,14,0,321,7
2020-12-22,Barbados,6,0,327,7
2020-12-23,Barbados,2,0,329,7
2020-12-24,Barbados,16,0,345,7
2020-12-25,Barbados,2,0,347,7
2020-12-26,Barbados,5,0,352,7
2020-12-27,Barbados,4,0,356,7
2020-12-28,Barbados,9,0,365,7
2020-12-29,Barbados,6,0,371,7
2020-12-30,Barbados,1,0,372,7
2020-12-31,Barbados,11,0,383,7
2021-01-01,Barbados,12,0,395,7
2021-01-02,Barbados,0,0,395,7
2021-01-03,Barbados,161,0,556,7
2021-01-04,Barbados,50,0,606,7
2021-01-05,Barbados,37,0,643,7
2021-01-06,Barbados,100,0,743,7
2021-01-07,Barbados,0,0,743,7
2021-01-08,Barbados,37,0,780,7
2021-01-09,Barbados,28,0,808,7
2021-01-10,Barbados,70,0,878,7
2021-01-11,Barbados,6,0,884,7
2021-01-12,Barbados,84,0,968,7
2021-01-13,Barbados,39,0,1007,7
2021-01-14,Barbados,29,0,1036,7
2021-01-15,Barbados,0,0,1036,7
2021-01-16,Barbados,59,0,1095,7
2021-01-17,Barbados,0,0,1095,7
2021-01-18,Barbados,0,0,1095,7
2021-01-19,Barbados,0,0,1095,7
2021-01-20,Barbados,61,2,1156,9
2021-01-21,Barbados,0,0,1156,9
2021-01-22,Barbados,0,0,1156,9
2021-01-23,Barbados,185,0,1341,9
2021-01-24,Barbados,46,0,1387,9
2021-01-25,Barbados,14,1,1401,10
2021-01-26,Barbados,0,0,1401,10
2021-01-27,Barbados,42,1,1443,11
2021-01-28,Barbados,34,0,1477,11
2021-01-29,Barbados,21,1,1498,12
2021-01-30,Barbados,25,0,1523,12
2021-01-31,Barbados,22,2,1545,14
2021-02-01,Barbados,13,0,1558,14
2021-02-02,Barbados,28,0,1586,14
2021-02-03,Barbados,25,0,1611,14
2021-02-04,Barbados,30,1,1641,15
2021-02-05,Barbados,15,2,1656,17
2021-02-06,Barbados,20,1,1676,18
2021-02-07,Barbados,33,0,1709,18
2021-02-08,Barbados,23,0,1732,18
2021-02-09,Barbados,82,2,1814,20
2021-02-10,Barbados,43,0,1857,20
2021-02-11,Barbados,47,0,1904,20
2021-02-12,Barbados,43,1,1947,21
2021-02-13,Barbados,114,2,2061,23
2021-02-14,Barbados,0,0,2061,23
2021-02-15,Barbados,207,1,2268,24
2021-02-16,Barbados,63,1,2331,25
2021-02-17,Barbados,126,3,2457,28
2021-02-18,Barbados,190,1,2647,29
2021-02-19,Barbados,30,1,2677,30
2021-02-20,Barbados,38,1,2715,31
2021-02-21,Barbados,57,0,2772,31
2021-02-22,Barbados,19,0,2791,31
2021-02-23,Barbados,61,0,2852,31
2021-02-24,Barbados,55,1,2907,32
2021-02-25,Barbados,42,0,2949,32
2021-02-26,Barbados,45,1,2994,33
2021-02-27,Barbados,44,0,3038,33
2021-02-28,Barbados,30,0,3068,33
2021-03-01,Barbados,47,3,3115,36
2021-03-02,Barbados,25,0,3140,36
2021-03-03,Barbados,23,1,3163,37
2021-03-04,Barbados,23,0,3186,37
2021-03-05,Barbados,31,0,3217,37
2021-03-06,Barbados,47,0,3264,37
2021-03-07,Barbados,21,0,3285,37
2021-03-08,Barbados,18,0,3303,37
2021-03-09,Barbados,30,0,3333,37
2021-03-10,Barbados,20,0,3353,37
2021-03-11,Barbados,19,0,3372,37
2021-03-12,Barbados,19,0,3391,37
2021-03-13,Barbados,13,0,3404,37
2021-03-14,Barbados,17,0,3421,37
2021-03-15,Barbados,21,1,3442,38
2021-03-16,Barbados,16,1,3458,39
2021-03-17,Barbados,13,0,3471,39
2021-03-18,Barbados,21,0,3492,39
2021-03-19,Barbados,20,0,3512,39
2021-03-20,Barbados,21,0,3533,39
2021-03-21,Barbados,18,0,3551,39
2021-03-22,Barbados,8,1,3559,40
2021-03-23,Barbados,15,0,3574,40
2021-03-24,Barbados,8,0,3582,40
2021-03-25,Barbados,11,0,3593,40
2021-03-26,Barbados,10,1,3603,41
2021-03-27,Barbados,6,0,3609,41
2021-03-28,Barbados,20,0,3629,41
2021-03-29,Barbados,5,0,3634,41
2021-03-30,Barbados,8,1,3642,42
2021-03-31,Barbados,10,0,3652,42
2021-04-01,Barbados,7,0,3659,42
2021-04-02,Barbados,6,0,3665,42
2021-04-03,Barbados,3,1,3668,43
2021-04-04,Barbados,0,0,3668,43
2021-04-05,Barbados,11,0,3679,43
2021-04-06,Barbados,12,0,3691,43
2021-04-07,Barbados,0,0,3691,43
2021-04-08,Barbados,13,1,3704,44
2020-02-28,Belarus,1,0,1,0
2020-02-29,Belarus,0,0,1,0
2020-03-01,Belarus,0,0,1,0
2020-03-02,Belarus,0,0,1,0
2020-03-03,Belarus,0,0,1,0
2020-03-04,Belarus,5,0,6,0
2020-03-05,Belarus,0,0,6,0
2020-03-06,Belarus,0,0,6,0
2020-03-07,Belarus,0,0,6,0
2020-03-08,Belarus,0,0,6,0
2020-03-09,Belarus,0,0,6,0
2020-03-10,Belarus,3,0,9,0
2020-03-11,Belarus,0,0,9,0
2020-03-12,Belarus,3,0,12,0
2020-03-13,Belarus,15,0,27,0
2020-03-14,Belarus,0,0,27,0
2020-03-15,Belarus,0,0,27,0
2020-03-16,Belarus,9,0,36,0
2020-03-17,Belarus,0,0,36,0
2020-03-18,Belarus,15,0,51,0
2020-03-19,Belarus,0,0,51,0
2020-03-20,Belarus,18,0,69,0
2020-03-21,Belarus,7,0,76,0
2020-03-22,Belarus,0,0,76,0
2020-03-23,Belarus,5,0,81,0
2020-03-24,Belarus,0,0,81,0
2020-03-25,Belarus,5,0,86,0
2020-03-26,Belarus,0,0,86,0
2020-03-27,Belarus,8,0,94,0
2020-03-28,Belarus,0,0,94,0
2020-03-29,Belarus,0,0,94,0
2020-03-30,Belarus,58,0,152,0
2020-03-31,Belarus,0,1,152,1
2020-04-01,Belarus,11,1,163,2
2020-04-02,Belarus,141,2,304,4
2020-04-03,Belarus,47,0,351,4
2020-04-04,Belarus,89,1,440,5
2020-04-05,Belarus,122,3,562,8
2020-04-06,Belarus,138,5,700,13
2020-04-07,Belarus,161,0,861,13
2020-04-08,Belarus,205,0,1066,13
2020-04-09,Belarus,420,3,1486,16
2020-04-10,Belarus,495,3,1981,19
2020-04-11,Belarus,245,4,2226,23
2020-04-12,Belarus,352,3,2578,26
2020-04-13,Belarus,341,3,2919,29
2020-04-14,Belarus,362,4,3281,33
2020-04-15,Belarus,447,3,3728,36
2020-04-16,Belarus,476,4,4204,40
2020-04-17,Belarus,575,2,4779,42
2020-04-18,Belarus,518,3,5297,45
2020-04-19,Belarus,510,2,5807,47
2020-04-20,Belarus,457,4,6264,51
2020-04-21,Belarus,459,4,6723,55
2020-04-22,Belarus,558,3,7281,58
2020-04-23,Belarus,741,2,8022,60
2020-04-24,Belarus,751,3,8773,63
2020-04-25,Belarus,817,4,9590,67
2020-04-26,Belarus,873,5,10463,72
2020-04-27,Belarus,826,3,11289,75
2020-04-28,Belarus,919,4,12208,79
2020-04-29,Belarus,973,5,13181,84
2020-04-30,Belarus,846,5,14027,89
2020-05-01,Belarus,890,4,14917,93
2020-05-02,Belarus,911,4,15828,97
2020-05-03,Belarus,877,2,16705,99
2020-05-04,Belarus,784,4,17489,103
2020-05-05,Belarus,861,4,18350,107
2020-05-06,Belarus,905,5,19255,112
2020-05-07,Belarus,913,4,20168,116
2020-05-08,Belarus,933,5,21101,121
2020-05-09,Belarus,951,5,22052,126
2020-05-10,Belarus,921,5,22973,131
2020-05-11,Belarus,933,4,23906,135
2020-05-12,Belarus,967,7,24873,142
2020-05-13,Belarus,952,4,25825,146
2020-05-14,Belarus,947,5,26772,151
2020-05-15,Belarus,958,5,27730,156
2020-05-16,Belarus,951,4,28681,160
2020-05-17,Belarus,969,5,29650,165
2020-05-18,Belarus,922,6,30572,171
2020-05-19,Belarus,936,4,31508,175
2020-05-20,Belarus,918,4,32426,179
2020-05-21,Belarus,945,6,33371,185
2020-05-22,Belarus,932,5,34303,190
2020-05-23,Belarus,941,4,35244,194
2020-05-24,Belarus,954,5,36198,199
2020-05-25,Belarus,946,5,37144,204
2020-05-26,Belarus,915,4,38059,208
2020-05-27,Belarus,897,6,38956,214
2020-05-28,Belarus,902,5,39858,219
2020-05-29,Belarus,906,5,40764,224
2020-05-30,Belarus,894,5,41658,229
2020-05-31,Belarus,898,6,42556,235
2020-06-01,Belarus,847,5,43403,240
2020-06-02,Belarus,852,3,44255,243
2020-06-03,Belarus,861,5,45116,248
2020-06-04,Belarus,865,5,45981,253
2020-06-05,Belarus,887,6,46868,259
2020-06-06,Belarus,883,4,47751,263
2020-06-07,Belarus,879,6,48630,269
2020-06-08,Belarus,823,7,49453,276
2020-06-09,Belarus,812,6,50265,282
2020-06-10,Belarus,801,6,51066,288
2020-06-11,Belarus,750,5,51816,293
2020-06-12,Belarus,704,5,52520,298
2020-06-13,Belarus,721,5,53241,303
2020-06-14,Belarus,732,5,53973,308
2020-06-15,Belarus,707,4,54680,312
2020-06-16,Belarus,689,6,55369,318
2020-06-17,Belarus,663,6,56032,324
2020-06-18,Belarus,625,7,56657,331
2020-06-19,Belarus,676,6,57333,337
2020-06-20,Belarus,603,6,57936,343
2020-06-21,Belarus,569,3,58505,346
2020-06-22,Belarus,518,5,59023,351
2020-06-23,Belarus,464,6,59487,357
2020-06-24,Belarus,458,5,59945,362
2020-06-25,Belarus,437,5,60382,367
2020-06-26,Belarus,331,6,60713,373
2020-06-27,Belarus,382,4,61095,377
2020-06-28,Belarus,380,6,61475,383
2020-06-29,Belarus,315,4,61790,387
2020-06-30,Belarus,328,5,62118,392
2020-07-01,Belarus,306,6,62424,398
2020-07-02,Belarus,274,7,62698,405
2020-07-03,Belarus,299,7,62997,412
2020-07-04,Belarus,273,6,63270,418
2020-07-05,Belarus,284,5,63554,423
2020-07-06,Belarus,250,6,63804,429
2020-07-07,Belarus,199,7,64003,436
2020-07-08,Belarus,221,7,64224,443
2020-07-09,Belarus,187,6,64411,449
2020-07-10,Belarus,193,5,64604,454
2020-07-11,Belarus,163,5,64767,459
2020-07-12,Belarus,165,5,64932,464
2020-07-13,Belarus,182,4,65114,468
2020-07-14,Belarus,155,6,65269,474
2020-07-15,Belarus,174,6,65443,480
2020-07-16,Belarus,180,5,65623,485
2020-07-17,Belarus,159,6,65782,491
2020-07-18,Belarus,171,4,65953,495
2020-07-19,Belarus,142,4,66095,499
2020-07-20,Belarus,118,4,66213,503
2020-07-21,Belarus,135,4,66348,507
2020-07-22,Belarus,173,6,66521,513
2020-07-23,Belarus,167,6,66688,519
2020-07-24,Belarus,158,5,66846,524
2020-07-25,Belarus,156,6,67002,530
2020-07-26,Belarus,130,4,67132,534
2020-07-27,Belarus,119,4,67251,538
2020-07-28,Belarus,115,5,67366,543
2020-07-29,Belarus,152,5,67518,548
2020-07-30,Belarus,147,5,67665,553
2020-07-31,Belarus,143,6,67808,559
2020-08-01,Belarus,138,4,67946,563
2020-08-02,Belarus,121,4,68067,567
2020-08-03,Belarus,99,4,68166,571
2020-08-04,Belarus,84,3,68250,574
2020-08-05,Belarus,126,3,68376,577
2020-08-06,Belarus,127,3,68503,580
2020-08-07,Belarus,111,3,68614,583
2020-08-08,Belarus,124,2,68738,585
2020-08-09,Belarus,112,2,68850,587
2020-08-10,Belarus,97,2,68947,589
2020-08-11,Belarus,58,3,69005,592
2020-08-12,Belarus,97,3,69102,595
2020-08-13,Belarus,101,4,69203,599
2020-08-14,Belarus,105,4,69308,603
2020-08-15,Belarus,0,0,69308,603
2020-08-16,Belarus,208,7,69516,610
2020-08-17,Belarus,73,3,69589,613
2020-08-18,Belarus,84,4,69673,617
2020-08-19,Belarus,128,5,69801,622
2020-08-20,Belarus,149,5,69950,627
2020-08-21,Belarus,161,5,70111,632
2020-08-22,Belarus,174,5,70285,637
2020-08-23,Belarus,183,5,70468,642
2020-08-24,Belarus,177,4,70645,646
2020-08-25,Belarus,82,6,70727,652
2020-08-26,Belarus,247,5,70974,657
2020-08-27,Belarus,191,5,71165,662
2020-08-28,Belarus,181,5,71346,667
2020-08-29,Belarus,177,4,71523,671
2020-08-30,Belarus,164,5,71687,676
2020-08-31,Belarus,156,5,71843,681
2020-09-01,Belarus,119,5,71962,686
2020-09-02,Belarus,179,5,72141,691
2020-09-03,Belarus,161,5,72302,696
2020-09-04,Belarus,183,5,72485,701
2020-09-05,Belarus,178,4,72663,705
2020-09-06,Belarus,196,6,72859,711
2020-09-07,Belarus,172,5,73031,716
2020-09-08,Belarus,177,5,73208,721
2020-09-09,Belarus,194,5,73402,726
2020-09-10,Belarus,189,6,73591,732
2020-09-11,Belarus,193,6,73784,738
2020-09-12,Belarus,191,6,73975,744
2020-09-13,Belarus,198,6,74173,750
2020-09-14,Belarus,187,6,74360,756
2020-09-15,Belarus,192,5,74552,761
2020-09-16,Belarus,211,6,74763,767
2020-09-17,Belarus,224,4,74987,771
2020-09-18,Belarus,243,2,75230,773
2020-09-19,Belarus,231,3,75461,776
2020-09-20,Belarus,213,4,75674,780
2020-09-21,Belarus,224,5,75898,785
2020-09-22,Belarus,206,6,76104,791
2020-09-23,Belarus,253,5,76357,796
2020-09-24,Belarus,294,6,76651,802
2020-09-25,Belarus,306,5,76957,807
2020-09-26,Belarus,332,6,77289,813
2020-09-27,Belarus,320,5,77609,818
2020-09-28,Belarus,337,4,77946,822
2020-09-29,Belarus,314,6,78260,828
2020-09-30,Belarus,371,5,78631,833
2020-10-01,Belarus,388,6,79019,839
2020-10-02,Belarus,402,5,79421,844
2020-10-03,Belarus,431,7,79852,851
2020-10-04,Belarus,0,0,79852,851
2020-10-05,Belarus,844,11,80696,862
2020-10-06,Belarus,394,6,81090,868
2020-10-07,Belarus,415,6,81505,874
2020-10-08,Belarus,477,6,81982,880
2020-10-09,Belarus,489,5,82471,885
2020-10-10,Belarus,0,0,82471,885
2020-10-11,Belarus,1063,11,83534,896
2020-10-12,Belarus,464,5,83998,901
2020-10-13,Belarus,526,5,84524,906
2020-10-14,Belarus,597,5,85121,911
2020-10-15,Belarus,613,5,85734,916
2020-10-16,Belarus,658,5,86392,921
2020-10-17,Belarus,671,4,87063,925
2020-10-18,Belarus,635,4,87698,929
2020-10-19,Belarus,592,4,88290,933
2020-10-20,Belarus,619,4,88909,937
2020-10-21,Belarus,733,4,89642,941
2020-10-22,Belarus,738,4,90380,945
2020-10-23,Belarus,787,0,91167,945
2020-10-24,Belarus,811,8,91978,953
2020-10-25,Belarus,845,4,92823,957
2020-10-26,Belarus,884,4,93707,961
2020-10-27,Belarus,902,4,94609,965
2020-10-28,Belarus,936,4,95545,969
2020-10-29,Belarus,984,4,96529,973
2020-10-30,Belarus,970,4,97499,977
2020-10-31,Belarus,983,3,98482,980
2020-11-01,Belarus,977,5,99459,985
2020-11-02,Belarus,941,4,100400,989
2020-11-03,Belarus,929,3,101329,992
2020-11-04,Belarus,984,3,102313,995
2020-11-05,Belarus,982,3,103295,998
2020-11-06,Belarus,991,3,104286,1001
2020-11-07,Belarus,997,3,105283,1004
2020-11-08,Belarus,996,3,106279,1007
2020-11-09,Belarus,983,4,107262,1011
2020-11-10,Belarus,1038,5,108300,1016
2020-11-11,Belarus,1057,6,109357,1022
2020-11-12,Belarus,1098,5,110455,1027
2020-11-13,Belarus,1167,6,111622,1033
2020-11-14,Belarus,1248,6,112870,1039
2020-11-15,Belarus,1315,7,114185,1046
2020-11-16,Belarus,1263,7,115448,1053
2020-11-17,Belarus,1251,7,116699,1060
2020-11-18,Belarus,1309,7,118008,1067
2020-11-19,Belarus,1382,7,119390,1074
2020-11-20,Belarus,1457,7,120847,1081
2020-11-21,Belarus,1588,8,122435,1089
2020-11-22,Belarus,1564,7,123999,1096
2020-11-23,Belarus,1483,8,125482,1104
2020-11-24,Belarus,1471,8,126953,1112
2020-11-25,Belarus,1496,7,128449,1119
2020-11-26,Belarus,1563,9,130012,1128
2020-11-27,Belarus,1621,8,131633,1136
2020-11-28,Belarus,1691,7,133324,1143
2020-11-29,Belarus,1684,8,135008,1151
2020-11-30,Belarus,1639,7,136647,1158
2020-12-01,Belarus,1572,8,138219,1166
2020-12-02,Belarus,1689,8,139908,1174
2020-12-03,Belarus,1701,7,141609,1181
2020-12-04,Belarus,1774,9,143383,1190
2020-12-05,Belarus,1896,8,145279,1198
2020-12-06,Belarus,1878,9,147157,1207
2020-12-07,Belarus,1796,8,148953,1215
2020-12-08,Belarus,1649,7,150602,1222
2020-12-09,Belarus,1851,8,152453,1230
2020-12-10,Belarus,1939,8,154392,1238
2020-12-11,Belarus,1967,8,156359,1246
2020-12-12,Belarus,1975,8,158334,1254
2020-12-13,Belarus,1961,9,160295,1263
2020-12-14,Belarus,1853,10,162148,1273
2020-12-15,Belarus,1911,9,164059,1282
2020-12-16,Belarus,1838,9,165897,1291
2020-12-17,Belarus,1834,8,167731,1299
2020-12-18,Belarus,1917,9,169648,1308
2020-12-19,Belarus,1931,8,171579,1316
2020-12-20,Belarus,1944,8,173523,1324
2020-12-21,Belarus,1893,9,175416,1333
2020-12-22,Belarus,1858,8,177274,1341
2020-12-23,Belarus,1922,8,179196,1349
2020-12-24,Belarus,1917,9,181113,1358
2020-12-25,Belarus,1893,9,183006,1367
2020-12-26,Belarus,1916,9,184922,1376
2020-12-27,Belarus,1825,9,186747,1385
2020-12-28,Belarus,1841,9,188588,1394
2020-12-29,Belarus,1816,10,190404,1404
2020-12-30,Belarus,1957,10,192361,1414
2020-12-31,Belarus,1923,10,194284,1424
2021-01-01,Belarus,1939,9,196223,1433
2021-01-02,Belarus,1902,9,198125,1442
2021-01-03,Belarus,1837,9,199962,1451
2021-01-04,Belarus,1869,10,201831,1461
2021-01-05,Belarus,1273,10,203104,1471
2021-01-06,Belarus,1854,9,204958,1480
2021-01-07,Belarus,1838,9,206796,1489
2021-01-08,Belarus,1805,9,208601,1498
2021-01-09,Belarus,1767,9,210368,1507
2021-01-10,Belarus,1833,10,212201,1517
2021-01-11,Belarus,1792,9,213993,1526
2021-01-12,Belarus,1731,9,215724,1535
2021-01-13,Belarus,1972,9,217696,1544
2021-01-14,Belarus,1967,10,219663,1554
2021-01-15,Belarus,1941,10,221604,1564
2021-01-16,Belarus,1933,9,223537,1573
2021-01-17,Belarus,1924,9,225461,1582
2021-01-18,Belarus,1899,9,227360,1591
2021-01-19,Belarus,1356,10,228716,1601
2021-01-20,Belarus,1778,9,230494,1610
2021-01-21,Belarus,1804,9,232298,1619
2021-01-22,Belarus,1813,9,234111,1628
2021-01-23,Belarus,1748,11,235859,1639
2021-01-24,Belarus,1752,10,237611,1649
2021-01-25,Belarus,1024,9,238635,1658
2021-01-26,Belarus,847,10,239482,1668
2021-01-27,Belarus,1651,10,241133,1678
2021-01-28,Belarus,1718,10,242851,1688
2021-01-29,Belarus,1867,10,244718,1698
2021-01-30,Belarus,1852,10,246570,1708
2021-01-31,Belarus,1766,10,248336,1718
2021-02-01,Belarus,959,10,249295,1728
2021-02-02,Belarus,699,9,249994,1737
2021-02-03,Belarus,1711,9,251705,1746
2021-02-04,Belarus,1708,9,253413,1755
2021-02-05,Belarus,1759,9,255172,1764
2021-02-06,Belarus,1787,9,256959,1773
2021-02-07,Belarus,1732,10,258691,1783
2021-02-08,Belarus,808,9,259499,1792
2021-02-09,Belarus,561,9,260060,1801
2021-02-10,Belarus,1799,10,261859,1811
2021-02-11,Belarus,1692,9,263551,1820
2021-02-12,Belarus,1733,10,265284,1830
2021-02-13,Belarus,1745,10,267029,1840
2021-02-14,Belarus,1658,9,268687,1849
2021-02-15,Belarus,1100,9,269787,1858
2021-02-16,Belarus,1134,9,270921,1867
2021-02-17,Belarus,1352,9,272273,1876
2021-02-18,Belarus,1386,9,273659,1885
2021-02-19,Belarus,1663,9,275322,1894
2021-02-20,Belarus,1668,9,276990,1903
2021-02-21,Belarus,1322,9,278312,1912
2021-02-22,Belarus,1144,9,279456,1921
2021-02-23,Belarus,972,9,280428,1930
2021-02-24,Belarus,1279,9,281707,1939
2021-02-25,Belarus,1191,9,282898,1948
2021-02-26,Belarus,1602,9,284500,1957
2021-02-27,Belarus,1459,9,285959,1966
2021-02-28,Belarus,1347,10,287306,1976
2021-03-01,Belarus,961,9,288267,1985
2021-03-02,Belarus,869,8,289136,1993
2021-03-03,Belarus,1311,9,290447,2002
2021-03-04,Belarus,1174,9,291621,2011
2021-03-05,Belarus,1482,9,293103,2020
2021-03-06,Belarus,1329,9,294432,2029
2021-03-07,Belarus,1079,9,295511,2038
2021-03-08,Belarus,930,9,296441,2047
2021-03-09,Belarus,1073,8,297514,2055
2021-03-10,Belarus,609,8,298123,2063
2021-03-11,Belarus,837,7,298960,2070
2021-03-12,Belarus,1186,8,300146,2078
2021-03-13,Belarus,1182,9,301328,2087
2021-03-14,Belarus,995,8,302323,2095
2021-03-15,Belarus,947,8,303270,2103
2021-03-16,Belarus,876,9,304146,2112
2021-03-17,Belarus,1124,9,305270,2121
2021-03-18,Belarus,1254,9,306524,2130
2021-03-19,Belarus,1414,9,307938,2139
2021-03-20,Belarus,1355,9,309293,2148
2021-03-21,Belarus,1152,9,310445,2157
2021-03-22,Belarus,983,9,311428,2166
2021-03-23,Belarus,1046,9,312474,2175
2021-03-24,Belarus,1378,9,313852,2184
2021-03-25,Belarus,1141,9,314993,2193
2021-03-26,Belarus,1425,9,316418,2202
2021-03-27,Belarus,1213,9,317631,2211
2021-03-28,Belarus,1050,8,318681,2219
2021-03-29,Belarus,918,8,319599,2227
2021-03-30,Belarus,995,10,320594,2237
2021-03-31,Belarus,1213,10,321807,2247
2021-04-01,Belarus,1236,10,323043,2257
2021-04-02,Belarus,1651,10,324694,2267
2021-04-03,Belarus,1371,9,326065,2276
2021-04-04,Belarus,1239,9,327304,2285
2021-04-05,Belarus,986,9,328290,2294
2021-04-06,Belarus,968,10,329258,2304
2021-04-07,Belarus,1278,10,330536,2314
2021-04-08,Belarus,1272,10,331808,2324
2020-02-04,Belgium,1,0,1,0
2020-02-05,Belgium,0,0,1,0
2020-02-06,Belgium,0,0,1,0
2020-02-07,Belgium,0,0,1,0
2020-02-08,Belgium,0,0,1,0
2020-02-09,Belgium,0,0,1,0
2020-02-10,Belgium,0,0,1,0
2020-02-11,Belgium,0,0,1,0
2020-02-12,Belgium,0,0,1,0
2020-02-13,Belgium,0,0,1,0
2020-02-14,Belgium,0,0,1,0
2020-02-15,Belgium,0,0,1,0
2020-02-16,Belgium,0,0,1,0
2020-02-17,Belgium,0,0,1,0
2020-02-18,Belgium,0,0,1,0
2020-02-19,Belgium,0,0,1,0
2020-02-20,Belgium,0,0,1,0
2020-02-21,Belgium,0,0,1,0
2020-02-22,Belgium,0,0,1,0
2020-02-23,Belgium,0,0,1,0
2020-02-24,Belgium,0,0,1,0
2020-02-25,Belgium,0,0,1,0
2020-02-26,Belgium,0,0,1,0
2020-02-27,Belgium,0,0,1,0
2020-02-28,Belgium,0,0,1,0
2020-02-29,Belgium,0,0,1,0
2020-03-01,Belgium,1,0,2,0
2020-03-02,Belgium,6,0,8,0
2020-03-03,Belgium,5,0,13,0
2020-03-04,Belgium,10,0,23,0
2020-03-05,Belgium,27,0,50,0
2020-03-06,Belgium,59,0,109,0
2020-03-07,Belgium,60,0,169,0
2020-03-08,Belgium,31,0,200,0
2020-03-09,Belgium,39,0,239,0
2020-03-10,Belgium,28,0,267,0
2020-03-11,Belgium,47,3,314,3
2020-03-12,Belgium,0,0,314,3
2020-03-13,Belgium,245,0,559,3
2020-03-14,Belgium,130,1,689,4
2020-03-15,Belgium,197,0,886,4
2020-03-16,Belgium,172,1,1058,5
2020-03-17,Belgium,185,5,1243,10
2020-03-18,Belgium,243,4,1486,14
2020-03-19,Belgium,309,7,1795,21
2020-03-20,Belgium,462,16,2257,37
2020-03-21,Belgium,558,30,2815,67
2020-03-22,Belgium,586,8,3401,75
2020-03-23,Belgium,342,13,3743,88
2020-03-24,Belgium,526,34,4269,122
2020-03-25,Belgium,668,56,4937,178
2020-03-26,Belgium,1298,42,6235,220
2020-03-27,Belgium,1049,69,7284,289
2020-03-28,Belgium,1850,64,9134,353
2020-03-29,Belgium,1702,78,10836,431
2020-03-30,Belgium,1063,82,11899,513
2020-03-31,Belgium,876,192,12775,705
2020-04-01,Belgium,1189,123,13964,828
2020-04-02,Belgium,1384,183,15348,1011
2020-04-03,Belgium,1422,132,16770,1143
2020-04-04,Belgium,1661,140,18431,1283
2020-04-05,Belgium,1260,164,19691,1447
2020-04-06,Belgium,1123,185,20814,1632
2020-04-07,Belgium,1380,403,22194,2035
2020-04-08,Belgium,1209,205,23403,2240
2020-04-09,Belgium,1580,283,24983,2523
2020-04-10,Belgium,1684,496,26667,3019
2020-04-11,Belgium,1351,327,28018,3346
2020-04-12,Belgium,1629,254,29647,3600
2020-04-13,Belgium,942,303,30589,3903
2020-04-14,Belgium,530,254,31119,4157
2020-04-15,Belgium,2454,283,33573,4440
2020-04-16,Belgium,1236,417,34809,4857
2020-04-17,Belgium,1329,306,36138,5163
2020-04-18,Belgium,1045,290,37183,5453
2020-04-19,Belgium,1313,230,38496,5683
2020-04-20,Belgium,1487,145,39983,5828
2020-04-21,Belgium,973,170,40956,5998
2020-04-22,Belgium,933,264,41889,6262
2020-04-23,Belgium,908,228,42797,6490
2020-04-24,Belgium,1496,189,44293,6679
2020-04-25,Belgium,1032,238,45325,6917
2020-04-26,Belgium,809,177,46134,7094
2020-04-27,Belgium,553,113,46687,7207
2020-04-28,Belgium,647,124,47334,7331
2020-04-29,Belgium,525,170,47859,7501
2020-04-30,Belgium,660,93,48519,7594
2020-05-01,Belgium,513,109,49032,7703
2020-05-02,Belgium,485,62,49517,7765
2020-05-03,Belgium,389,79,49906,7844
2020-05-04,Belgium,361,80,50267,7924
2020-05-05,Belgium,242,92,50509,8016
2020-05-06,Belgium,272,323,50781,8339
2020-05-07,Belgium,639,76,51420,8415
2020-05-08,Belgium,591,106,52011,8521
2020-05-09,Belgium,585,60,52596,8581
2020-05-10,Belgium,485,75,53081,8656
2020-05-11,Belgium,368,51,53449,8707
2020-05-12,Belgium,330,54,53779,8761
2020-05-13,Belgium,202,82,53981,8843
2020-05-14,Belgium,307,60,54288,8903
2020-05-15,Belgium,356,56,54644,8959
2020-05-16,Belgium,345,46,54989,9005
2020-05-17,Belgium,291,47,55280,9052
2020-05-18,Belgium,279,28,55559,9080
2020-05-19,Belgium,232,28,55791,9108
2020-05-20,Belgium,192,42,55983,9150
2020-05-21,Belgium,252,36,56235,9186
2020-05-22,Belgium,276,26,56511,9212
2020-05-23,Belgium,299,25,56810,9237
2020-05-24,Belgium,282,43,57092,9280
2020-05-25,Belgium,250,32,57342,9312
2020-05-26,Belgium,113,22,57455,9334
2020-05-27,Belgium,137,30,57592,9364
2020-05-28,Belgium,257,24,57849,9388
2020-05-29,Belgium,212,42,58061,9430
2020-05-30,Belgium,125,23,58186,9453
2020-05-31,Belgium,195,14,58381,9467
2020-06-01,Belgium,136,19,58517,9486
2020-06-02,Belgium,98,19,58615,9505
2020-06-03,Belgium,70,17,58685,9522
2020-06-04,Belgium,82,26,58767,9548
2020-06-05,Belgium,140,18,58907,9566
2020-06-06,Belgium,165,14,59072,9580
2020-06-07,Belgium,154,15,59226,9595
2020-06-08,Belgium,122,11,59348,9606
2020-06-09,Belgium,89,13,59437,9619
2020-06-10,Belgium,132,10,59569,9629
2020-06-11,Belgium,142,7,59711,9636
2020-06-12,Belgium,108,10,59819,9646
2020-06-13,Belgium,99,4,59918,9650
2020-06-14,Belgium,111,5,60029,9655
2020-06-15,Belgium,71,6,60100,9661
2020-06-16,Belgium,55,2,60155,9663
2020-06-17,Belgium,89,12,60244,9675
2020-06-18,Belgium,104,8,60348,9683
2020-06-19,Belgium,128,12,60476,9695
2020-06-20,Belgium,74,1,60550,9696
2020-06-21,Belgium,0,0,60550,9696
2020-06-22,Belgium,0,0,60550,9696
2020-06-23,Belgium,260,17,60810,9713
2020-06-24,Belgium,88,9,60898,9722
2020-06-25,Belgium,109,4,61007,9726
2020-06-26,Belgium,99,5,61106,9731
2020-06-27,Belgium,103,1,61209,9732
2020-06-28,Belgium,86,0,61295,9732
2020-06-29,Belgium,66,0,61361,9732
2020-06-30,Belgium,66,15,61427,9747
2020-07-01,Belgium,82,7,61509,9754
2020-07-02,Belgium,89,7,61598,9761
2020-07-03,Belgium,129,4,61727,9765
2020-07-04,Belgium,111,6,61838,9771
2020-07-05,Belgium,178,0,62016,9771
2020-07-06,Belgium,42,3,62058,9774
2020-07-07,Belgium,0,0,62058,9774
2020-07-08,Belgium,65,2,62123,9776
2020-07-09,Belgium,87,2,62210,9778
2020-07-10,Belgium,147,3,62357,9781
2020-07-11,Belgium,112,1,62469,9782
2020-07-12,Belgium,238,0,62707,9782
2020-07-13,Belgium,0,0,62707,9782
2020-07-14,Belgium,74,5,62781,9787
2020-07-15,Belgium,91,1,62872,9788
2020-07-16,Belgium,366,7,63238,9795
2020-07-17,Belgium,261,5,63499,9800
2020-07-18,Belgium,207,0,63706,9800
2020-07-19,Belgium,0,0,63706,9800
2020-07-20,Belgium,388,5,64094,9805
2020-07-21,Belgium,164,0,64258,9805
2020-07-22,Belgium,369,3,64627,9808
2020-07-23,Belgium,220,4,64847,9812
2020-07-24,Belgium,352,5,65199,9817
2020-07-25,Belgium,528,4,65727,9821
2020-07-26,Belgium,299,0,66026,9821
2020-07-27,Belgium,402,1,66428,9822
2020-07-28,Belgium,234,11,66662,9833
2020-07-29,Belgium,673,3,67335,9836
2020-07-30,Belgium,671,4,68006,9840
2020-07-31,Belgium,745,1,68751,9841
2020-08-01,Belgium,651,4,69402,9845
2020-08-02,Belgium,447,0,69849,9845
2020-08-03,Belgium,465,5,70314,9850
2020-08-04,Belgium,334,2,70648,9852
2020-08-05,Belgium,510,7,71158,9859
2020-08-06,Belgium,858,2,72016,9861
2020-08-07,Belgium,768,5,72784,9866
2020-08-08,Belgium,617,4,73401,9870
2020-08-09,Belgium,751,2,74152,9872
2020-08-10,Belgium,468,7,74620,9879
2020-08-11,Belgium,388,6,75008,9885
2020-08-12,Belgium,639,15,75647,9900
2020-08-13,Belgium,544,16,76191,9916
2020-08-14,Belgium,922,8,77113,9924
2020-08-15,Belgium,756,11,77869,9935
2020-08-16,Belgium,454,4,78323,9939
2020-08-17,Belgium,211,5,78534,9944
2020-08-18,Belgium,363,15,78897,9959
2020-08-19,Belgium,582,10,79479,9969
2020-08-20,Belgium,699,7,80178,9976
2020-08-21,Belgium,716,9,80894,9985
2020-08-22,Belgium,574,3,81468,9988
2020-08-23,Belgium,468,4,81936,9992
2020-08-24,Belgium,156,4,82092,9996
2020-08-25,Belgium,355,0,82447,9996
2020-08-26,Belgium,583,-117,83030,9879
2020-08-27,Belgium,470,5,83500,9884
2020-08-28,Belgium,452,2,83952,9886
2020-08-29,Belgium,647,5,84599,9891
2020-08-30,Belgium,443,3,85042,9894
2020-08-31,Belgium,194,1,85236,9895
2020-09-01,Belgium,251,2,85487,9897
2020-09-02,Belgium,424,1,85911,9898
2020-09-03,Belgium,633,1,86544,9899
2020-09-04,Belgium,630,2,87174,9901
2020-09-05,Belgium,651,5,87825,9906
2020-09-06,Belgium,542,1,88367,9907
2020-09-07,Belgium,402,2,88769,9909
2020-09-08,Belgium,372,3,89141,9912
2020-09-09,Belgium,550,5,89691,9917
2020-09-10,Belgium,877,0,90568,9917
2020-09-11,Belgium,969,2,91537,9919
2020-09-12,Belgium,941,4,92478,9923
2020-09-13,Belgium,977,2,93455,9925
2020-09-14,Belgium,851,2,94306,9927
2020-09-15,Belgium,489,3,94795,9930
2020-09-16,Belgium,1153,5,95948,9935
2020-09-17,Belgium,2028,1,97976,9936
2020-09-18,Belgium,1673,1,99649,9937
2020-09-19,Belgium,1099,7,100748,9944
2020-09-20,Belgium,1547,4,102295,9948
2020-09-21,Belgium,1097,2,103392,9950
2020-09-22,Belgium,1834,5,105226,9955
2020-09-23,Belgium,1661,4,106887,9959
2020-09-24,Belgium,1881,6,108768,9965
2020-09-25,Belgium,2208,4,110976,9969
2020-09-26,Belgium,1827,5,112803,9974
2020-09-27,Belgium,1376,6,114179,9980
2020-09-28,Belgium,1174,7,115353,9987
2020-09-29,Belgium,1762,14,117115,10001
2020-09-30,Belgium,1337,15,118452,10016
2020-10-01,Belgium,2607,7,121059,10023
2020-10-02,Belgium,3175,14,124234,10037
2020-10-03,Belgium,3389,7,127623,10044
2020-10-04,Belgium,2612,20,130235,10064
2020-10-05,Belgium,1968,14,132203,10078
2020-10-06,Belgium,2088,14,134291,10092
2020-10-07,Belgium,3577,16,137868,10108
2020-10-08,Belgium,5728,18,143596,10126
2020-10-09,Belgium,5385,25,148981,10151
2020-10-10,Belgium,7950,24,156931,10175
2020-10-11,Belgium,5327,16,162258,10191
2020-10-12,Belgium,3622,20,165880,10211
2020-10-13,Belgium,7360,33,173240,10244
2020-10-14,Belgium,8271,34,181511,10278
2020-10-15,Belgium,10448,49,191959,10327
2020-10-16,Belgium,10192,32,202151,10359
2020-10-17,Belgium,10964,33,213115,10392
2020-10-18,Belgium,9138,21,222253,10413
2020-10-19,Belgium,8227,30,230480,10443
2020-10-20,Belgium,9679,46,240159,10489
2020-10-21,Belgium,13227,50,253386,10539
2020-10-22,Belgium,16746,49,270132,10588
2020-10-23,Belgium,17568,70,287700,10658
2020-10-24,Belgium,17709,79,305409,10737
2020-10-25,Belgium,15622,73,321031,10810
2020-10-26,Belgium,12687,89,333718,10899
2020-10-27,Belgium,13571,139,347289,11038
2020-10-28,Belgium,21048,132,368337,11170
2020-10-29,Belgium,23921,138,392258,11308
2020-10-30,Belgium,20056,144,412314,11452
2020-10-31,Belgium,16915,173,429229,11625
2020-11-01,Belgium,11789,112,441018,11737
2020-11-02,Belgium,6337,121,447355,11858
2020-11-03,Belgium,5186,268,452541,12126
2020-11-04,Belgium,15672,205,468213,12331
2020-11-05,Belgium,11128,189,479341,12520
2020-11-06,Belgium,8703,188,488044,12708
2020-11-07,Belgium,6124,199,494168,12907
2020-11-08,Belgium,6621,148,500789,13055
2020-11-09,Belgium,2393,161,503182,13216
2020-11-10,Belgium,4293,345,507475,13561
2020-11-11,Belgium,7916,197,515391,13758
2020-11-12,Belgium,5002,133,520393,13891
2020-11-13,Belgium,4619,215,525012,14106
2020-11-14,Belgium,6268,197,531280,14303
2020-11-15,Belgium,4659,118,535939,14421
2020-11-16,Belgium,1932,195,537871,14616
2020-11-17,Belgium,2734,223,540605,14839
2020-11-18,Belgium,5182,186,545787,15025
2020-11-19,Belgium,4477,171,550264,15196
2020-11-20,Belgium,3416,156,553680,15352
2020-11-21,Belgium,3224,170,556904,15522
2020-11-22,Belgium,1875,96,558779,15618
2020-11-23,Belgium,1123,137,559902,15755
2020-11-24,Belgium,1901,183,561803,15938
2020-11-25,Belgium,3164,139,564967,16077
2020-11-26,Belgium,2565,142,567532,16219
2020-11-27,Belgium,3297,120,570829,16339
2020-11-28,Belgium,3619,122,574448,16461
2020-11-29,Belgium,2151,86,576599,16547
2020-11-30,Belgium,746,98,577345,16645
2020-12-01,Belgium,1867,141,579212,16786
2020-12-02,Belgium,3040,125,582252,16911
2020-12-03,Belgium,2605,122,584857,17033
2020-12-04,Belgium,2582,109,587439,17142
2020-12-05,Belgium,2503,112,589942,17254
2020-12-06,Belgium,1814,66,591756,17320
2020-12-07,Belgium,859,66,592615,17386
2020-12-08,Belgium,1957,121,594572,17507
2020-12-09,Belgium,3071,96,597643,17603
2020-12-10,Belgium,2754,89,600397,17692
2020-12-11,Belgium,0,0,600397,17692
2020-12-12,Belgium,2762,100,603159,17792
2020-12-13,Belgium,4978,159,608137,17951
2020-12-14,Belgium,1074,103,609211,18054
2020-12-15,Belgium,2211,124,611422,18178
2020-12-16,Belgium,3636,100,615058,18278
2020-12-17,Belgium,3146,93,618204,18371
2020-12-18,Belgium,2835,84,621039,18455
2020-12-19,Belgium,2721,90,623760,18545
2020-12-20,Belgium,2170,81,625930,18626
2020-12-21,Belgium,981,71,626911,18697
2020-12-22,Belgium,2198,124,629109,18821
2020-12-23,Belgium,3212,118,632321,18939
2020-12-24,Belgium,2583,99,634904,19038
2020-12-25,Belgium,2342,51,637246,19089
2020-12-26,Belgium,784,69,638030,19158
2020-12-27,Belgium,847,42,638877,19200
2020-12-28,Belgium,857,34,639734,19234
2020-12-29,Belgium,1677,127,641411,19361
2020-12-30,Belgium,2831,80,644242,19441
2020-12-31,Belgium,2254,87,646496,19528
2021-01-01,Belgium,1793,53,648289,19581
2021-01-02,Belgium,880,63,649169,19644
2021-01-03,Belgium,842,57,650011,19701
2021-01-04,Belgium,876,49,650887,19750
2021-01-05,Belgium,1848,77,652735,19827
2021-01-06,Belgium,2997,56,655732,19883
2021-01-07,Belgium,2923,53,658655,19936
2021-01-08,Belgium,2048,56,660703,19992
2021-01-09,Belgium,1991,46,662694,20038
2021-01-10,Belgium,1569,40,664263,20078
2021-01-11,Belgium,960,44,665223,20122
2021-01-12,Belgium,2099,72,667322,20194
2021-01-13,Belgium,2927,56,670249,20250
2021-01-14,Belgium,2637,44,672886,20294
2021-01-15,Belgium,2203,58,675089,20352
2021-01-16,Belgium,2120,44,677209,20396
2021-01-17,Belgium,1630,39,678839,20435
2021-01-18,Belgium,932,37,679771,20472
2021-01-19,Belgium,1479,82,681250,20554
2021-01-20,Belgium,3006,18,684256,20572
2021-01-21,Belgium,2571,48,686827,20620
2021-01-22,Belgium,2444,55,689271,20675
2021-01-23,Belgium,2583,51,691854,20726
2021-01-24,Belgium,1812,53,693666,20779
2021-01-25,Belgium,1192,35,694858,20814
2021-01-26,Belgium,1784,65,696642,20879
2021-01-27,Belgium,3020,54,699662,20933
2021-01-28,Belgium,2775,49,702437,20982
2021-01-29,Belgium,2683,36,705120,21018
2021-01-30,Belgium,2717,48,707837,21066
2021-01-31,Belgium,2316,26,710153,21092
2021-02-01,Belgium,1264,32,711417,21124
2021-02-02,Belgium,1854,49,713271,21173
2021-02-03,Belgium,3124,43,716395,21216
2021-02-04,Belgium,2452,44,718847,21260
2021-02-05,Belgium,2585,35,721432,21295
2021-02-06,Belgium,2438,57,723870,21352
2021-02-07,Belgium,1740,37,725610,21389
2021-02-08,Belgium,873,34,726483,21423
2021-02-09,Belgium,1851,49,728334,21472
2021-02-10,Belgium,2617,40,730951,21512
2021-02-11,Belgium,2149,39,733100,21551
2021-02-12,Belgium,2120,48,735220,21599
2021-02-13,Belgium,1895,35,737115,21634
2021-02-14,Belgium,1516,28,738631,21662
2021-02-15,Belgium,857,40,739488,21702
2021-02-16,Belgium,1717,48,741205,21750
2021-02-17,Belgium,2677,43,743882,21793
2021-02-18,Belgium,2420,28,746302,21821
2021-02-19,Belgium,3437,38,749739,21859
2021-02-20,Belgium,2640,28,752379,21887
2021-02-21,Belgium,2094,16,754473,21903
2021-02-22,Belgium,1121,20,755594,21923
2021-02-23,Belgium,2102,33,757696,21956
2021-02-24,Belgium,3113,32,760809,21988
2021-02-25,Belgium,3076,18,763885,22006
2021-02-26,Belgium,2769,28,766654,22034
2021-02-27,Belgium,2760,18,769414,22052
2021-02-28,Belgium,2097,25,771511,22077
2021-03-01,Belgium,783,29,772294,22106
2021-03-02,Belgium,2050,35,774344,22141
2021-03-03,Belgium,3264,28,777608,22169
2021-03-04,Belgium,2643,27,780251,22196
2021-03-05,Belgium,2759,19,783010,22215
2021-03-06,Belgium,2799,25,785809,22240
2021-03-07,Belgium,2082,21,787891,22261
2021-03-08,Belgium,1117,31,789008,22292
2021-03-09,Belgium,2163,35,791171,22327
2021-03-10,Belgium,3434,20,794605,22347
2021-03-11,Belgium,3503,23,798108,22370
2021-03-12,Belgium,3615,27,801723,22397
2021-03-13,Belgium,3598,24,805321,22421
2021-03-14,Belgium,2962,20,808283,22441
2021-03-15,Belgium,1578,104,809861,22545
2021-03-16,Belgium,3165,27,813026,22572
2021-03-17,Belgium,5116,28,818142,22600
2021-03-18,Belgium,4659,24,822801,22624
2021-03-19,Belgium,5140,26,827941,22650
2021-03-20,Belgium,0,0,827941,22650
2021-03-21,Belgium,9065,57,837006,22707
2021-03-22,Belgium,2232,21,839238,22728
2021-03-23,Belgium,3537,35,842775,22763
2021-03-24,Belgium,6315,23,849090,22786
2021-03-25,Belgium,5518,30,854608,22816
2021-03-26,Belgium,6123,36,860731,22852
2021-03-27,Belgium,5332,18,866063,22870
2021-03-28,Belgium,4694,27,870757,22897
2021-03-29,Belgium,2179,24,872936,22921
2021-03-30,Belgium,3906,45,876842,22966
2021-03-31,Belgium,5611,50,882453,23016
2021-04-01,Belgium,5467,29,887920,23045
2021-04-02,Belgium,4665,38,892585,23083
2021-04-03,Belgium,4889,47,897474,23130
2021-04-04,Belgium,3522,39,900996,23169
2021-04-05,Belgium,1968,33,902964,23202
2021-04-06,Belgium,1709,45,904673,23247
2021-04-07,Belgium,3539,54,908212,23301
2021-04-08,Belgium,4845,47,913057,23348
2020-03-23,Belize,1,0,1,0
2020-03-24,Belize,0,0,1,0
2020-03-25,Belize,1,0,2,0
2020-03-26,Belize,0,0,2,0
2020-03-27,Belize,0,0,2,0
2020-03-28,Belize,0,0,2,0
2020-03-29,Belize,0,0,2,0
2020-03-30,Belize,1,0,3,0
2020-03-31,Belize,0,0,3,0
2020-04-01,Belize,0,0,3,0
2020-04-02,Belize,0,0,3,0
2020-04-03,Belize,1,0,4,0
2020-04-04,Belize,0,0,4,0
2020-04-05,Belize,1,0,5,0
2020-04-06,Belize,2,1,7,1
2020-04-07,Belize,0,0,7,1
2020-04-08,Belize,1,0,8,1
2020-04-09,Belize,1,0,9,1
2020-04-10,Belize,1,1,10,2
2020-04-11,Belize,3,0,13,2
2020-04-12,Belize,1,0,14,2
2020-04-13,Belize,4,0,18,2
2020-04-14,Belize,0,0,18,2
2020-04-15,Belize,0,0,18,2
2020-04-16,Belize,0,0,18,2
2020-04-17,Belize,0,0,18,2
2020-04-18,Belize,0,0,18,2
2020-04-19,Belize,0,0,18,2
2020-04-20,Belize,0,0,18,2
2020-04-21,Belize,0,0,18,2
2020-04-22,Belize,0,0,18,2
2020-04-23,Belize,0,0,18,2
2020-04-24,Belize,0,0,18,2
2020-04-25,Belize,0,0,18,2
2020-04-26,Belize,0,0,18,2
2020-04-27,Belize,0,0,18,2
2020-04-28,Belize,0,0,18,2
2020-04-29,Belize,0,0,18,2
2020-04-30,Belize,0,0,18,2
2020-05-01,Belize,0,0,18,2
2020-05-02,Belize,0,0,18,2
2020-05-03,Belize,0,0,18,2
2020-05-04,Belize,0,0,18,2
2020-05-05,Belize,0,0,18,2
2020-05-06,Belize,0,0,18,2
2020-05-07,Belize,0,0,18,2
2020-05-08,Belize,0,0,18,2
2020-05-09,Belize,0,0,18,2
2020-05-10,Belize,0,0,18,2
2020-05-11,Belize,0,0,18,2
2020-05-12,Belize,0,0,18,2
2020-05-13,Belize,0,0,18,2
2020-05-14,Belize,0,0,18,2
2020-05-15,Belize,0,0,18,2
2020-05-16,Belize,0,0,18,2
2020-05-17,Belize,0,0,18,2
2020-05-18,Belize,0,0,18,2
2020-05-19,Belize,0,0,18,2
2020-05-20,Belize,0,0,18,2
2020-05-21,Belize,0,0,18,2
2020-05-22,Belize,0,0,18,2
2020-05-23,Belize,0,0,18,2
2020-05-24,Belize,0,0,18,2
2020-05-25,Belize,0,0,18,2
2020-05-26,Belize,0,0,18,2
2020-05-27,Belize,0,0,18,2
2020-05-28,Belize,0,0,18,2
2020-05-29,Belize,0,0,18,2
2020-05-30,Belize,0,0,18,2
2020-05-31,Belize,0,0,18,2
2020-06-01,Belize,0,0,18,2
2020-06-02,Belize,0,0,18,2
2020-06-03,Belize,0,0,18,2
2020-06-04,Belize,0,0,18,2
2020-06-05,Belize,1,0,19,2
2020-06-06,Belize,0,0,19,2
2020-06-07,Belize,0,0,19,2
2020-06-08,Belize,0,0,19,2
2020-06-09,Belize,1,0,20,2
2020-06-10,Belize,0,0,20,2
2020-06-11,Belize,0,0,20,2
2020-06-12,Belize,0,0,20,2
2020-06-13,Belize,0,0,20,2
2020-06-14,Belize,0,0,20,2
2020-06-15,Belize,1,0,21,2
2020-06-16,Belize,1,0,22,2
2020-06-17,Belize,0,0,22,2
2020-06-18,Belize,0,0,22,2
2020-06-19,Belize,0,0,22,2
2020-06-20,Belize,0,0,22,2
2020-06-21,Belize,0,0,22,2
2020-06-22,Belize,1,0,23,2
2020-06-23,Belize,0,0,23,2
2020-06-24,Belize,0,0,23,2
2020-06-25,Belize,0,0,23,2
2020-06-26,Belize,1,0,24,2
2020-06-27,Belize,0,0,24,2
2020-06-28,Belize,0,0,24,2
2020-06-29,Belize,0,0,24,2
2020-06-30,Belize,0,0,24,2
2020-07-01,Belize,4,0,28,2
2020-07-02,Belize,0,0,28,2
2020-07-03,Belize,2,0,30,2
2020-07-04,Belize,0,0,30,2
2020-07-05,Belize,0,0,30,2
2020-07-06,Belize,0,0,30,2
2020-07-07,Belize,0,0,30,2
2020-07-08,Belize,0,0,30,2
2020-07-09,Belize,0,0,30,2
2020-07-10,Belize,7,0,37,2
2020-07-11,Belize,0,0,37,2
2020-07-12,Belize,0,0,37,2
2020-07-13,Belize,0,0,37,2
2020-07-14,Belize,2,0,39,2
2020-07-15,Belize,0,0,39,2
2020-07-16,Belize,1,0,40,2
2020-07-17,Belize,0,0,40,2
2020-07-18,Belize,0,0,40,2
2020-07-19,Belize,0,0,40,2
2020-07-20,Belize,0,0,40,2
2020-07-21,Belize,2,0,42,2
2020-07-22,Belize,1,0,43,2
2020-07-23,Belize,4,0,47,2
2020-07-24,Belize,1,0,48,2
2020-07-25,Belize,0,0,48,2
2020-07-26,Belize,0,0,48,2
2020-07-27,Belize,0,0,48,2
2020-07-28,Belize,0,0,48,2
2020-07-29,Belize,0,0,48,2
2020-07-30,Belize,0,0,48,2
2020-07-31,Belize,0,0,48,2
2020-08-01,Belize,8,0,56,2
2020-08-02,Belize,1,0,57,2
2020-08-03,Belize,0,0,57,2
2020-08-04,Belize,0,0,57,2
2020-08-05,Belize,29,0,86,2
2020-08-06,Belize,28,0,114,2
2020-08-07,Belize,0,0,114,2
2020-08-08,Belize,32,0,146,2
2020-08-09,Belize,7,0,153,2
2020-08-10,Belize,24,0,177,2
2020-08-11,Belize,0,0,177,2
2020-08-12,Belize,33,0,210,2
2020-08-13,Belize,86,0,296,2
2020-08-14,Belize,60,1,356,3
2020-08-15,Belize,32,0,388,3
2020-08-16,Belize,64,0,452,3
2020-08-17,Belize,23,1,475,4
2020-08-18,Belize,0,0,475,4
2020-08-19,Belize,78,0,553,4
2020-08-20,Belize,52,1,605,5
2020-08-21,Belize,43,0,648,5
2020-08-22,Belize,20,1,668,6
2020-08-23,Belize,18,0,686,6
2020-08-24,Belize,27,4,713,10
2020-08-25,Belize,17,0,730,10
2020-08-26,Belize,30,1,760,11
2020-08-27,Belize,58,1,818,12
2020-08-28,Belize,52,0,870,12
2020-08-29,Belize,94,1,964,13
2020-08-30,Belize,29,0,993,13
2020-08-31,Belize,14,0,1007,13
2020-09-01,Belize,43,0,1050,13
2020-09-02,Belize,51,0,1101,13
2020-09-03,Belize,0,0,1101,13
2020-09-04,Belize,51,2,1152,15
2020-09-05,Belize,42,0,1194,15
2020-09-06,Belize,0,0,1194,15
2020-09-07,Belize,113,1,1307,16
2020-09-08,Belize,54,0,1361,16
2020-09-09,Belize,4,2,1365,18
2020-09-10,Belize,0,0,1365,18
2020-09-11,Belize,70,1,1435,19
2020-09-12,Belize,23,0,1458,19
2020-09-13,Belize,22,0,1480,19
2020-09-14,Belize,21,0,1501,19
2020-09-15,Belize,27,0,1528,19
2020-09-16,Belize,8,0,1536,19
2020-09-17,Belize,31,0,1567,19
2020-09-18,Belize,23,1,1590,20
2020-09-19,Belize,16,0,1606,20
2020-09-20,Belize,21,1,1627,21
2020-09-21,Belize,8,0,1635,21
2020-09-22,Belize,0,0,1635,21
2020-09-23,Belize,71,1,1706,22
2020-09-24,Belize,0,0,1706,22
2020-09-25,Belize,102,1,1808,23
2020-09-26,Belize,17,1,1825,24
2020-09-27,Belize,0,0,1825,24
2020-09-28,Belize,66,0,1891,24
2020-09-29,Belize,0,0,1891,24
2020-09-30,Belize,101,3,1992,27
2020-10-01,Belize,0,0,1992,27
2020-10-02,Belize,88,1,2080,28
2020-10-03,Belize,0,0,2080,28
2020-10-04,Belize,51,1,2131,29
2020-10-05,Belize,65,1,2196,30
2020-10-06,Belize,47,4,2243,34
2020-10-07,Belize,67,0,2310,34
2020-10-08,Belize,63,0,2373,34
2020-10-09,Belize,54,1,2427,35
2020-10-10,Belize,0,0,2427,35
2020-10-11,Belize,104,2,2531,37
2020-10-12,Belize,38,0,2569,37
2020-10-13,Belize,16,2,2585,39
2020-10-14,Belize,34,1,2619,40
2020-10-15,Belize,63,1,2682,41
2020-10-16,Belize,46,2,2728,43
2020-10-17,Belize,47,0,2775,43
2020-10-18,Belize,38,1,2813,44
2020-10-19,Belize,20,1,2833,45
2020-10-20,Belize,53,0,2886,45
2020-10-21,Belize,51,1,2937,46
2020-10-22,Belize,58,0,2995,46
2020-10-23,Belize,55,0,3050,46
2020-10-24,Belize,56,2,3106,48
2020-10-25,Belize,39,2,3145,50
2020-10-26,Belize,0,0,3145,50
2020-10-27,Belize,55,1,3200,51
2020-10-28,Belize,61,1,3261,52
2020-10-29,Belize,0,0,3261,52
2020-10-30,Belize,201,6,3462,58
2020-10-31,Belize,25,1,3487,59
2020-11-01,Belize,90,0,3577,59
2020-11-02,Belize,47,0,3624,59
2020-11-03,Belize,166,2,3790,61
2020-11-04,Belize,115,3,3905,64
2020-11-05,Belize,72,2,3977,66
2020-11-06,Belize,39,1,4016,67
2020-11-07,Belize,60,1,4076,68
2020-11-08,Belize,100,2,4176,70
2020-11-09,Belize,54,1,4230,71
2020-11-10,Belize,184,2,4414,73
2020-11-11,Belize,106,2,4520,75
2020-11-12,Belize,76,0,4596,75
2020-11-13,Belize,119,10,4715,85
2020-11-14,Belize,68,3,4783,88
2020-11-15,Belize,78,2,4861,90
2020-11-16,Belize,22,4,4883,94
2020-11-17,Belize,37,2,4920,96
2020-11-18,Belize,38,4,4958,100
2020-11-19,Belize,60,2,5018,102
2020-11-20,Belize,38,5,5056,107
2020-11-21,Belize,54,5,5110,112
2020-11-22,Belize,73,4,5183,116
2020-11-23,Belize,66,4,5249,120
2020-11-24,Belize,86,5,5335,125
2020-11-25,Belize,88,4,5423,129
2020-11-26,Belize,92,2,5515,131
2020-11-27,Belize,72,10,5587,141
2020-11-28,Belize,60,3,5647,144
2020-11-29,Belize,96,3,5743,147
2020-11-30,Belize,111,1,5854,148
2020-12-01,Belize,0,0,5854,148
2020-12-02,Belize,0,0,5854,148
2020-12-03,Belize,1382,16,7236,164
2020-12-04,Belize,147,6,7383,170
2020-12-05,Belize,218,2,7601,172
2020-12-06,Belize,168,1,7769,173
2020-12-07,Belize,184,3,7953,176
2020-12-08,Belize,60,3,8013,179
2020-12-09,Belize,506,4,8519,183
2020-12-10,Belize,286,0,8805,183
2020-12-11,Belize,160,2,8965,185
2020-12-12,Belize,208,7,9173,192
2020-12-13,Belize,122,3,9295,195
2020-12-14,Belize,82,2,9377,197
2020-12-15,Belize,134,14,9511,211
2020-12-16,Belize,161,1,9672,212
2020-12-17,Belize,119,1,9791,213
2020-12-18,Belize,0,0,9791,213
2020-12-19,Belize,0,0,9791,213
2020-12-20,Belize,0,0,9791,213
2020-12-21,Belize,354,11,10145,224
2020-12-22,Belize,112,2,10257,226
2020-12-23,Belize,113,0,10370,226
2020-12-24,Belize,120,2,10490,228
2020-12-25,Belize,0,0,10490,228
2020-12-26,Belize,0,0,10490,228
2020-12-27,Belize,71,5,10561,233
2020-12-28,Belize,30,3,10591,236
2020-12-29,Belize,77,5,10668,241
2020-12-30,Belize,56,1,10724,242
2020-12-31,Belize,52,6,10776,248
2021-01-01,Belize,0,0,10776,248
2021-01-02,Belize,31,1,10807,249
2021-01-03,Belize,94,1,10901,250
2021-01-04,Belize,37,7,10938,257
2021-01-05,Belize,80,1,11018,258
2021-01-06,Belize,90,2,11108,260
2021-01-07,Belize,44,7,11152,267
2021-01-08,Belize,50,4,11202,271
2021-01-09,Belize,64,0,11266,271
2021-01-10,Belize,37,3,11303,274
2021-01-11,Belize,29,1,11332,275
2021-01-12,Belize,34,2,11366,277
2021-01-13,Belize,53,1,11419,278
2021-01-14,Belize,37,2,11456,280
2021-01-15,Belize,73,1,11529,281
2021-01-16,Belize,0,0,11529,281
2021-01-17,Belize,51,0,11580,281
2021-01-18,Belize,12,1,11592,282
2021-01-19,Belize,23,1,11615,283
2021-01-20,Belize,27,3,11642,286
2021-01-21,Belize,34,3,11676,289
2021-01-22,Belize,24,1,11700,290
2021-01-23,Belize,22,0,11722,290
2021-01-24,Belize,28,0,11750,290
2021-01-25,Belize,20,3,11770,293
2021-01-26,Belize,18,0,11788,293
2021-01-27,Belize,28,1,11816,294
2021-01-28,Belize,29,4,11845,298
2021-01-29,Belize,32,3,11877,301
2021-01-30,Belize,31,0,11908,301
2021-01-31,Belize,0,0,11908,301
2021-02-01,Belize,37,1,11945,302
2021-02-02,Belize,12,1,11957,303
2021-02-03,Belize,21,3,11978,306
2021-02-04,Belize,30,0,12008,306
2021-02-05,Belize,5,0,12013,306
2021-02-06,Belize,24,0,12037,306
2021-02-07,Belize,0,0,12037,306
2021-02-08,Belize,33,1,12070,307
2021-02-09,Belize,9,3,12079,310
2021-02-10,Belize,28,3,12107,313
2021-02-11,Belize,7,0,12114,313
2021-02-12,Belize,20,0,12134,313
2021-02-13,Belize,11,0,12145,313
2021-02-14,Belize,0,0,12145,313
2021-02-15,Belize,30,0,12175,313
2021-02-16,Belize,13,0,12188,313
2021-02-17,Belize,7,1,12195,314
2021-02-18,Belize,12,0,12207,314
2021-02-19,Belize,20,0,12227,314
2021-02-20,Belize,17,0,12244,314
2021-02-21,Belize,0,0,12244,314
2021-02-22,Belize,11,0,12255,314
2021-02-23,Belize,9,0,12264,314
2021-02-24,Belize,7,1,12271,315
2021-02-25,Belize,9,0,12280,315
2021-02-26,Belize,13,0,12293,315
2021-02-27,Belize,0,0,12293,315
2021-02-28,Belize,0,0,12293,315
2021-03-01,Belize,20,0,12313,315
2021-03-02,Belize,7,0,12320,315
2021-03-03,Belize,8,0,12328,315
2021-03-04,Belize,1,-1,12329,314
2021-03-05,Belize,6,1,12335,315
2021-03-06,Belize,0,0,12335,315
2021-03-07,Belize,0,0,12335,315
2021-03-08,Belize,0,0,12335,315
2021-03-09,Belize,10,1,12345,316
2021-03-10,Belize,10,0,12355,316
2021-03-11,Belize,4,0,12359,316
2021-03-12,Belize,11,0,12370,316
2021-03-13,Belize,0,0,12370,316
2021-03-14,Belize,0,0,12370,316
2021-03-15,Belize,13,0,12383,316
2021-03-16,Belize,6,0,12389,316
2021-03-17,Belize,7,0,12396,316
2021-03-18,Belize,3,0,12399,316
2021-03-19,Belize,1,0,12400,316
2021-03-20,Belize,0,0,12400,316
2021-03-21,Belize,0,0,12400,316
2021-03-22,Belize,7,0,12407,316
2021-03-23,Belize,3,0,12410,316
2021-03-24,Belize,0,1,12410,317
2021-03-25,Belize,1,0,12411,317
2021-03-26,Belize,4,0,12415,317
2021-03-27,Belize,0,0,12415,317
2021-03-28,Belize,0,0,12415,317
2021-03-29,Belize,0,0,12415,317
2021-03-30,Belize,0,0,12415,317
2021-03-31,Belize,41,0,12456,317
2021-04-01,Belize,0,0,12456,317
2021-04-02,Belize,0,0,12456,317
2021-04-03,Belize,0,0,12456,317
2021-04-04,Belize,0,0,12456,317
2021-04-05,Belize,0,0,12456,317
2021-04-06,Belize,21,1,12477,318
2021-04-07,Belize,8,0,12485,318
2021-04-08,Belize,0,0,12485,318
2020-03-16,Benin,1,0,1,0
2020-03-17,Benin,0,0,1,0
2020-03-18,Benin,1,0,2,0
2020-03-19,Benin,0,0,2,0
2020-03-20,Benin,0,0,2,0
2020-03-21,Benin,0,0,2,0
2020-03-22,Benin,0,0,2,0
2020-03-23,Benin,3,0,5,0
2020-03-24,Benin,1,0,6,0
2020-03-25,Benin,0,0,6,0
2020-03-26,Benin,0,0,6,0
2020-03-27,Benin,0,0,6,0
2020-03-28,Benin,0,0,6,0
2020-03-29,Benin,0,0,6,0
2020-03-30,Benin,0,0,6,0
2020-03-31,Benin,3,0,9,0
2020-04-01,Benin,4,0,13,0
2020-04-02,Benin,0,0,13,0
2020-04-03,Benin,3,0,16,0
2020-04-04,Benin,0,0,16,0
2020-04-05,Benin,6,0,22,0
2020-04-06,Benin,4,1,26,1
2020-04-07,Benin,0,0,26,1
2020-04-08,Benin,0,0,26,1
2020-04-09,Benin,0,0,26,1
2020-04-10,Benin,9,0,35,1
2020-04-11,Benin,0,0,35,1
2020-04-12,Benin,0,0,35,1
2020-04-13,Benin,0,0,35,1
2020-04-14,Benin,0,0,35,1
2020-04-15,Benin,0,0,35,1
2020-04-16,Benin,0,0,35,1
2020-04-17,Benin,0,0,35,1
2020-04-18,Benin,0,0,35,1
2020-04-19,Benin,0,0,35,1
2020-04-20,Benin,19,0,54,1
2020-04-21,Benin,0,0,54,1
2020-04-22,Benin,0,0,54,1
2020-04-23,Benin,0,0,54,1
2020-04-24,Benin,0,0,54,1
2020-04-25,Benin,0,0,54,1
2020-04-26,Benin,10,0,64,1
2020-04-27,Benin,0,0,64,1
2020-04-28,Benin,0,0,64,1
2020-04-29,Benin,0,0,64,1
2020-04-30,Benin,0,0,64,1
2020-05-01,Benin,26,1,90,2
2020-05-02,Benin,0,0,90,2
2020-05-03,Benin,0,0,90,2
2020-05-04,Benin,6,0,96,2
2020-05-05,Benin,0,0,96,2
2020-05-06,Benin,0,0,96,2
2020-05-07,Benin,44,0,140,2
2020-05-08,Benin,102,0,242,2
2020-05-09,Benin,42,0,284,2
2020-05-10,Benin,35,0,319,2
2020-05-11,Benin,0,0,319,2
2020-05-12,Benin,8,0,327,2
2020-05-13,Benin,0,0,327,2
2020-05-14,Benin,12,0,339,2
2020-05-15,Benin,0,0,339,2
2020-05-16,Benin,0,0,339,2
2020-05-17,Benin,0,0,339,2
2020-05-18,Benin,0,0,339,2
2020-05-19,Benin,-209,0,130,2
2020-05-20,Benin,0,0,130,2
2020-05-21,Benin,5,1,135,3
2020-05-22,Benin,0,0,135,3
2020-05-23,Benin,0,0,135,3
2020-05-24,Benin,56,0,191,3
2020-05-25,Benin,0,0,191,3
2020-05-26,Benin,17,0,208,3
2020-05-27,Benin,2,0,210,3
2020-05-28,Benin,0,0,210,3
2020-05-29,Benin,14,0,224,3
2020-05-30,Benin,0,0,224,3
2020-05-31,Benin,8,0,232,3
2020-06-01,Benin,11,0,243,3
2020-06-02,Benin,1,0,244,3
2020-06-03,Benin,0,0,244,3
2020-06-04,Benin,17,0,261,3
2020-06-05,Benin,0,0,261,3
2020-06-06,Benin,0,0,261,3
2020-06-07,Benin,0,0,261,3
2020-06-08,Benin,27,1,288,4
2020-06-09,Benin,17,0,305,4
2020-06-10,Benin,0,0,305,4
2020-06-11,Benin,0,0,305,4
2020-06-12,Benin,83,1,388,5
2020-06-13,Benin,24,1,412,6
2020-06-14,Benin,30,0,442,6
2020-06-15,Benin,41,3,483,9
2020-06-16,Benin,49,0,532,9
2020-06-17,Benin,40,0,572,9
2020-06-18,Benin,25,2,597,11
2020-06-19,Benin,53,0,650,11
2020-06-20,Benin,0,0,650,11
2020-06-21,Benin,115,2,765,13
2020-06-22,Benin,42,0,807,13
2020-06-23,Benin,43,0,850,13
2020-06-24,Benin,52,0,902,13
2020-06-25,Benin,115,1,1017,14
2020-06-26,Benin,36,0,1053,14
2020-06-27,Benin,71,0,1124,14
2020-06-28,Benin,25,2,1149,16
2020-06-29,Benin,38,3,1187,19
2020-06-30,Benin,12,2,1199,21
2020-07-01,Benin,0,0,1199,21
2020-07-02,Benin,0,0,1199,21
2020-07-03,Benin,0,0,1199,21
2020-07-04,Benin,0,0,1199,21
2020-07-05,Benin,0,0,1199,21
2020-07-06,Benin,0,0,1199,21
2020-07-07,Benin,0,0,1199,21
2020-07-08,Benin,0,0,1199,21
2020-07-09,Benin,86,2,1285,23
2020-07-10,Benin,0,0,1285,23
2020-07-11,Benin,93,3,1378,26
2020-07-12,Benin,0,0,1378,26
2020-07-13,Benin,0,0,1378,26
2020-07-14,Benin,0,0,1378,26
2020-07-15,Benin,0,0,1378,26
2020-07-16,Benin,85,2,1463,28
2020-07-17,Benin,139,3,1602,31
2020-07-18,Benin,0,0,1602,31
2020-07-19,Benin,0,0,1602,31
2020-07-20,Benin,0,0,1602,31
2020-07-21,Benin,0,0,1602,31
2020-07-22,Benin,88,3,1690,34
2020-07-23,Benin,4,0,1694,34
2020-07-24,Benin,0,0,1694,34
2020-07-25,Benin,0,0,1694,34
2020-07-26,Benin,76,1,1770,35
2020-07-27,Benin,0,0,1770,35
2020-07-28,Benin,0,0,1770,35
2020-07-29,Benin,35,1,1805,36
2020-07-30,Benin,0,0,1805,36
2020-07-31,Benin,0,0,1805,36
2020-08-01,Benin,0,0,1805,36
2020-08-02,Benin,0,0,1805,36
2020-08-03,Benin,0,0,1805,36
2020-08-04,Benin,109,2,1914,38
2020-08-05,Benin,22,0,1936,38
2020-08-06,Benin,0,0,1936,38
2020-08-07,Benin,0,0,1936,38
2020-08-08,Benin,0,0,1936,38
2020-08-09,Benin,0,0,1936,38
2020-08-10,Benin,0,0,1936,38
2020-08-11,Benin,65,0,2001,38
2020-08-12,Benin,13,0,2014,38
2020-08-13,Benin,0,0,2014,38
2020-08-14,Benin,0,0,2014,38
2020-08-15,Benin,49,1,2063,39
2020-08-16,Benin,0,0,2063,39
2020-08-17,Benin,0,0,2063,39
2020-08-18,Benin,0,0,2063,39
2020-08-19,Benin,32,0,2095,39
2020-08-20,Benin,0,0,2095,39
2020-08-21,Benin,0,0,2095,39
2020-08-22,Benin,20,0,2115,39
2020-08-23,Benin,0,0,2115,39
2020-08-24,Benin,0,0,2115,39
2020-08-25,Benin,0,0,2115,39
2020-08-26,Benin,30,1,2145,40
2020-08-27,Benin,0,0,2145,40
2020-08-28,Benin,0,0,2145,40
2020-08-29,Benin,0,0,2145,40
2020-08-30,Benin,0,0,2145,40
2020-08-31,Benin,0,0,2145,40
2020-09-01,Benin,0,0,2145,40
2020-09-02,Benin,49,0,2194,40
2020-09-03,Benin,0,0,2194,40
2020-09-04,Benin,0,0,2194,40
2020-09-05,Benin,19,0,2213,40
2020-09-06,Benin,0,0,2213,40
2020-09-07,Benin,0,0,2213,40
2020-09-08,Benin,0,0,2213,40
2020-09-09,Benin,29,0,2242,40
2020-09-10,Benin,0,0,2242,40
2020-09-11,Benin,0,0,2242,40
2020-09-12,Benin,0,0,2242,40
2020-09-13,Benin,25,0,2267,40
2020-09-14,Benin,0,0,2267,40
2020-09-15,Benin,0,0,2267,40
2020-09-16,Benin,13,0,2280,40
2020-09-17,Benin,0,0,2280,40
2020-09-18,Benin,0,0,2280,40
2020-09-19,Benin,0,0,2280,40
2020-09-20,Benin,0,0,2280,40
2020-09-21,Benin,14,0,2294,40
2020-09-22,Benin,0,0,2294,40
2020-09-23,Benin,31,0,2325,40
2020-09-24,Benin,0,0,2325,40
2020-09-25,Benin,0,0,2325,40
2020-09-26,Benin,0,0,2325,40
2020-09-27,Benin,15,0,2340,40
2020-09-28,Benin,0,0,2340,40
2020-09-29,Benin,0,0,2340,40
2020-09-30,Benin,17,1,2357,41
2020-10-01,Benin,0,0,2357,41
2020-10-02,Benin,0,0,2357,41
2020-10-03,Benin,0,0,2357,41
2020-10-04,Benin,0,0,2357,41
2020-10-05,Benin,0,0,2357,41
2020-10-06,Benin,0,0,2357,41
2020-10-07,Benin,54,0,2411,41
2020-10-08,Benin,0,0,2411,41
2020-10-09,Benin,0,0,2411,41
2020-10-10,Benin,0,0,2411,41
2020-10-11,Benin,0,0,2411,41
2020-10-12,Benin,0,0,2411,41
2020-10-13,Benin,0,0,2411,41
2020-10-14,Benin,67,0,2478,41
2020-10-15,Benin,18,0,2496,41
2020-10-16,Benin,0,0,2496,41
2020-10-17,Benin,0,0,2496,41
2020-10-18,Benin,0,0,2496,41
2020-10-19,Benin,0,0,2496,41
2020-10-20,Benin,0,0,2496,41
2020-10-21,Benin,61,0,2557,41
2020-10-22,Benin,0,0,2557,41
2020-10-23,Benin,0,0,2557,41
2020-10-24,Benin,0,0,2557,41
2020-10-25,Benin,0,0,2557,41
2020-10-26,Benin,0,0,2557,41
2020-10-27,Benin,0,0,2557,41
2020-10-28,Benin,86,0,2643,41
2020-10-29,Benin,0,0,2643,41
2020-10-30,Benin,0,0,2643,41
2020-10-31,Benin,0,0,2643,41
2020-11-01,Benin,40,0,2683,41
2020-11-02,Benin,0,0,2683,41
2020-11-03,Benin,0,0,2683,41
2020-11-04,Benin,62,2,2745,43
2020-11-05,Benin,0,0,2745,43
2020-11-06,Benin,0,0,2745,43
2020-11-07,Benin,0,0,2745,43
2020-11-08,Benin,0,0,2745,43
2020-11-09,Benin,36,0,2781,43
2020-11-10,Benin,0,0,2781,43
2020-11-11,Benin,63,0,2844,43
2020-11-12,Benin,0,0,2844,43
2020-11-13,Benin,0,0,2844,43
2020-11-14,Benin,0,0,2844,43
2020-11-15,Benin,0,0,2844,43
2020-11-16,Benin,40,0,2884,43
2020-11-17,Benin,0,0,2884,43
2020-11-18,Benin,32,0,2916,43
2020-11-19,Benin,0,0,2916,43
2020-11-20,Benin,0,0,2916,43
2020-11-21,Benin,0,0,2916,43
2020-11-22,Benin,0,0,2916,43
2020-11-23,Benin,0,0,2916,43
2020-11-24,Benin,0,0,2916,43
2020-11-25,Benin,58,0,2974,43
2020-11-26,Benin,0,0,2974,43
2020-11-27,Benin,0,0,2974,43
2020-11-28,Benin,0,0,2974,43
2020-11-29,Benin,0,0,2974,43
2020-11-30,Benin,41,0,3015,43
2020-12-01,Benin,0,0,3015,43
2020-12-02,Benin,40,1,3055,44
2020-12-03,Benin,0,0,3055,44
2020-12-04,Benin,0,0,3055,44
2020-12-05,Benin,0,0,3055,44
2020-12-06,Benin,0,0,3055,44
2020-12-07,Benin,18,0,3073,44
2020-12-08,Benin,0,0,3073,44
2020-12-09,Benin,17,0,3090,44
2020-12-10,Benin,0,0,3090,44
2020-12-11,Benin,0,0,3090,44
2020-12-12,Benin,0,0,3090,44
2020-12-13,Benin,0,0,3090,44
2020-12-14,Benin,0,0,3090,44
2020-12-15,Benin,0,0,3090,44
2020-12-16,Benin,62,0,3152,44
2020-12-17,Benin,0,0,3152,44
2020-12-18,Benin,0,0,3152,44
2020-12-19,Benin,0,0,3152,44
2020-12-20,Benin,15,0,3167,44
2020-12-21,Benin,0,0,3167,44
2020-12-22,Benin,0,0,3167,44
2020-12-23,Benin,38,0,3205,44
2020-12-24,Benin,0,0,3205,44
2020-12-25,Benin,0,0,3205,44
2020-12-26,Benin,0,0,3205,44
2020-12-27,Benin,0,0,3205,44
2020-12-28,Benin,0,0,3205,44
2020-12-29,Benin,0,0,3205,44
2020-12-30,Benin,46,0,3251,44
2020-12-31,Benin,0,0,3251,44
2021-01-01,Benin,0,0,3251,44
2021-01-02,Benin,0,0,3251,44
2021-01-03,Benin,0,0,3251,44
2021-01-04,Benin,0,0,3251,44
2021-01-05,Benin,53,0,3304,44
2021-01-06,Benin,0,0,3304,44
2021-01-07,Benin,0,0,3304,44
2021-01-08,Benin,0,0,3304,44
2021-01-09,Benin,0,0,3304,44
2021-01-10,Benin,0,0,3304,44
2021-01-11,Benin,59,2,3363,46
2021-01-12,Benin,0,0,3363,46
2021-01-13,Benin,50,0,3413,46
2021-01-14,Benin,0,0,3413,46
2021-01-15,Benin,0,0,3413,46
2021-01-16,Benin,0,0,3413,46
2021-01-17,Benin,0,0,3413,46
2021-01-18,Benin,0,0,3413,46
2021-01-19,Benin,0,0,3413,46
2021-01-20,Benin,144,0,3557,46
2021-01-21,Benin,25,2,3582,48
2021-01-22,Benin,61,0,3643,48
2021-01-23,Benin,0,0,3643,48
2021-01-24,Benin,0,0,3643,48
2021-01-25,Benin,0,0,3643,48
2021-01-26,Benin,0,0,3643,48
2021-01-27,Benin,143,0,3786,48
2021-01-28,Benin,0,0,3786,48
2021-01-29,Benin,0,0,3786,48
2021-01-30,Benin,0,0,3786,48
2021-01-31,Benin,107,4,3893,52
2021-02-01,Benin,0,0,3893,52
2021-02-02,Benin,0,0,3893,52
2021-02-03,Benin,226,2,4119,54
2021-02-04,Benin,0,0,4119,54
2021-02-05,Benin,74,1,4193,55
2021-02-06,Benin,0,0,4193,55
2021-02-07,Benin,0,0,4193,55
2021-02-08,Benin,0,0,4193,55
2021-02-09,Benin,0,0,4193,55
2021-02-10,Benin,367,1,4560,56
2021-02-11,Benin,0,0,4560,56
2021-02-12,Benin,0,0,4560,56
2021-02-13,Benin,0,0,4560,56
2021-02-14,Benin,0,0,4560,56
2021-02-15,Benin,479,6,5039,62
2021-02-16,Benin,0,0,5039,62
2021-02-17,Benin,104,3,5143,65
2021-02-18,Benin,0,0,5143,65
2021-02-19,Benin,0,0,5143,65
2021-02-20,Benin,0,0,5143,65
2021-02-21,Benin,291,5,5434,70
2021-02-22,Benin,0,0,5434,70
2021-02-23,Benin,0,0,5434,70
2021-02-24,Benin,0,0,5434,70
2021-02-25,Benin,0,0,5434,70
2021-02-26,Benin,0,0,5434,70
2021-02-27,Benin,0,0,5434,70
2021-02-28,Benin,0,0,5434,70
2021-03-01,Benin,0,0,5434,70
2021-03-02,Benin,0,0,5434,70
2021-03-03,Benin,637,5,6071,75
2021-03-04,Benin,0,0,6071,75
2021-03-05,Benin,0,0,6071,75
2021-03-06,Benin,0,0,6071,75
2021-03-07,Benin,0,0,6071,75
2021-03-08,Benin,267,6,6338,81
2021-03-09,Benin,0,0,6338,81
2021-03-10,Benin,163,0,6501,81
2021-03-11,Benin,0,0,6501,81
2021-03-12,Benin,0,0,6501,81
2021-03-13,Benin,0,0,6501,81
2021-03-14,Benin,0,0,6501,81
2021-03-15,Benin,0,0,6501,81
2021-03-16,Benin,0,0,6501,81
2021-03-17,Benin,0,0,6501,81
2021-03-18,Benin,0,0,6501,81
2021-03-19,Benin,317,9,6818,90
2021-03-20,Benin,0,0,6818,90
2021-03-21,Benin,0,0,6818,90
2021-03-22,Benin,0,0,6818,90
2021-03-23,Benin,0,0,6818,90
2021-03-24,Benin,282,0,7100,90
2021-03-25,Benin,0,0,7100,90
2021-03-26,Benin,0,0,7100,90
2021-03-27,Benin,0,0,7100,90
2021-03-28,Benin,0,0,7100,90
2021-03-29,Benin,0,0,7100,90
2021-03-30,Benin,0,0,7100,90
2021-03-31,Benin,0,0,7100,90
2021-04-01,Benin,213,3,7313,93
2021-04-02,Benin,0,0,7313,93
2021-04-03,Benin,0,0,7313,93
2021-04-04,Benin,0,0,7313,93
2021-04-05,Benin,0,0,7313,93
2021-04-06,Benin,0,0,7313,93
2021-04-07,Benin,0,0,7313,93
2021-04-08,Benin,202,0,7515,93
2020-03-06,Bhutan,1,0,1,0
2020-03-07,Bhutan,0,0,1,0
2020-03-08,Bhutan,0,0,1,0
2020-03-09,Bhutan,0,0,1,0
2020-03-10,Bhutan,0,0,1,0
2020-03-11,Bhutan,0,0,1,0
2020-03-12,Bhutan,0,0,1,0
2020-03-13,Bhutan,0,0,1,0
2020-03-14,Bhutan,0,0,1,0
2020-03-15,Bhutan,0,0,1,0
2020-03-16,Bhutan,0,0,1,0
2020-03-17,Bhutan,0,0,1,0
2020-03-18,Bhutan,0,0,1,0
2020-03-19,Bhutan,0,0,1,0
2020-03-20,Bhutan,1,0,2,0
2020-03-21,Bhutan,0,0,2,0
2020-03-22,Bhutan,0,0,2,0
2020-03-23,Bhutan,0,0,2,0
2020-03-24,Bhutan,0,0,2,0
2020-03-25,Bhutan,0,0,2,0
2020-03-26,Bhutan,0,0,2,0
2020-03-27,Bhutan,1,0,3,0
2020-03-28,Bhutan,0,0,3,0
2020-03-29,Bhutan,1,0,4,0
2020-03-30,Bhutan,0,0,4,0
2020-03-31,Bhutan,0,0,4,0
2020-04-01,Bhutan,0,0,4,0
2020-04-02,Bhutan,1,0,5,0
2020-04-03,Bhutan,0,0,5,0
2020-04-04,Bhutan,0,0,5,0
2020-04-05,Bhutan,0,0,5,0
2020-04-06,Bhutan,0,0,5,0
2020-04-07,Bhutan,0,0,5,0
2020-04-08,Bhutan,0,0,5,0
2020-04-09,Bhutan,0,0,5,0
2020-04-10,Bhutan,0,0,5,0
2020-04-11,Bhutan,0,0,5,0
2020-04-12,Bhutan,0,0,5,0
2020-04-13,Bhutan,0,0,5,0
2020-04-14,Bhutan,0,0,5,0
2020-04-15,Bhutan,0,0,5,0
2020-04-16,Bhutan,0,0,5,0
2020-04-17,Bhutan,0,0,5,0
2020-04-18,Bhutan,0,0,5,0
2020-04-19,Bhutan,0,0,5,0
2020-04-20,Bhutan,0,0,5,0
2020-04-21,Bhutan,1,0,6,0
2020-04-22,Bhutan,0,0,6,0
2020-04-23,Bhutan,1,0,7,0
2020-04-24,Bhutan,0,0,7,0
2020-04-25,Bhutan,0,0,7,0
2020-04-26,Bhutan,0,0,7,0
2020-04-27,Bhutan,0,0,7,0
2020-04-28,Bhutan,0,0,7,0
2020-04-29,Bhutan,0,0,7,0
2020-04-30,Bhutan,0,0,7,0
2020-05-01,Bhutan,0,0,7,0
2020-05-02,Bhutan,0,0,7,0
2020-05-03,Bhutan,0,0,7,0
2020-05-04,Bhutan,0,0,7,0
2020-05-05,Bhutan,0,0,7,0
2020-05-06,Bhutan,0,0,7,0
2020-05-07,Bhutan,0,0,7,0
2020-05-08,Bhutan,0,0,7,0
2020-05-09,Bhutan,0,0,7,0
2020-05-10,Bhutan,0,0,7,0
2020-05-11,Bhutan,2,0,9,0
2020-05-12,Bhutan,2,0,11,0
2020-05-13,Bhutan,4,0,15,0
2020-05-14,Bhutan,5,0,20,0
2020-05-15,Bhutan,1,0,21,0
2020-05-16,Bhutan,0,0,21,0
2020-05-17,Bhutan,0,0,21,0
2020-05-18,Bhutan,0,0,21,0
2020-05-19,Bhutan,0,0,21,0
2020-05-20,Bhutan,0,0,21,0
2020-05-21,Bhutan,0,0,21,0
2020-05-22,Bhutan,0,0,21,0
2020-05-23,Bhutan,3,0,24,0
2020-05-24,Bhutan,0,0,24,0
2020-05-25,Bhutan,3,0,27,0
2020-05-26,Bhutan,0,0,27,0
2020-05-27,Bhutan,1,0,28,0
2020-05-28,Bhutan,3,0,31,0
2020-05-29,Bhutan,0,0,31,0
2020-05-30,Bhutan,2,0,33,0
2020-05-31,Bhutan,10,0,43,0
2020-06-01,Bhutan,0,0,43,0
2020-06-02,Bhutan,4,0,47,0
2020-06-03,Bhutan,0,0,47,0
2020-06-04,Bhutan,0,0,47,0
2020-06-05,Bhutan,1,0,48,0
2020-06-06,Bhutan,0,0,48,0
2020-06-07,Bhutan,11,0,59,0
2020-06-08,Bhutan,0,0,59,0
2020-06-09,Bhutan,0,0,59,0
2020-06-10,Bhutan,0,0,59,0
2020-06-11,Bhutan,3,0,62,0
2020-06-12,Bhutan,0,0,62,0
2020-06-13,Bhutan,4,0,66,0
2020-06-14,Bhutan,0,0,66,0
2020-06-15,Bhutan,1,0,67,0
2020-06-16,Bhutan,0,0,67,0
2020-06-17,Bhutan,0,0,67,0
2020-06-18,Bhutan,0,0,67,0
2020-06-19,Bhutan,1,0,68,0
2020-06-20,Bhutan,0,0,68,0
2020-06-21,Bhutan,0,0,68,0
2020-06-22,Bhutan,0,0,68,0
2020-06-23,Bhutan,2,0,70,0
2020-06-24,Bhutan,0,0,70,0
2020-06-25,Bhutan,0,0,70,0
2020-06-26,Bhutan,0,0,70,0
2020-06-27,Bhutan,5,0,75,0
2020-06-28,Bhutan,1,0,76,0
2020-06-29,Bhutan,1,0,77,0
2020-06-30,Bhutan,0,0,77,0
2020-07-01,Bhutan,0,0,77,0
2020-07-02,Bhutan,0,0,77,0
2020-07-03,Bhutan,0,0,77,0
2020-07-04,Bhutan,1,0,78,0
2020-07-05,Bhutan,2,0,80,0
2020-07-06,Bhutan,0,0,80,0
2020-07-07,Bhutan,0,0,80,0
2020-07-08,Bhutan,0,0,80,0
2020-07-09,Bhutan,0,0,80,0
2020-07-10,Bhutan,0,0,80,0
2020-07-11,Bhutan,2,0,82,0
2020-07-12,Bhutan,2,0,84,0
2020-07-13,Bhutan,0,0,84,0
2020-07-14,Bhutan,0,0,84,0
2020-07-15,Bhutan,0,0,84,0
2020-07-16,Bhutan,2,0,86,0
2020-07-17,Bhutan,1,0,87,0
2020-07-18,Bhutan,0,0,87,0
2020-07-19,Bhutan,2,0,89,0
2020-07-20,Bhutan,1,0,90,0
2020-07-21,Bhutan,2,0,92,0
2020-07-22,Bhutan,0,0,92,0
2020-07-23,Bhutan,0,0,92,0
2020-07-24,Bhutan,0,0,92,0
2020-07-25,Bhutan,0,0,92,0
2020-07-26,Bhutan,3,0,95,0
2020-07-27,Bhutan,4,0,99,0
2020-07-28,Bhutan,0,0,99,0
2020-07-29,Bhutan,0,0,99,0
2020-07-30,Bhutan,2,0,101,0
2020-07-31,Bhutan,0,0,101,0
2020-08-01,Bhutan,1,0,102,0
2020-08-02,Bhutan,0,0,102,0
2020-08-03,Bhutan,1,0,103,0
2020-08-04,Bhutan,2,0,105,0
2020-08-05,Bhutan,0,0,105,0
2020-08-06,Bhutan,3,0,108,0
2020-08-07,Bhutan,0,0,108,0
2020-08-08,Bhutan,0,0,108,0
2020-08-09,Bhutan,2,0,110,0
2020-08-10,Bhutan,0,0,110,0
2020-08-11,Bhutan,3,0,113,0
2020-08-12,Bhutan,0,0,113,0
2020-08-13,Bhutan,15,0,128,0
2020-08-14,Bhutan,5,0,133,0
2020-08-15,Bhutan,0,0,133,0
2020-08-16,Bhutan,5,0,138,0
2020-08-17,Bhutan,3,0,141,0
2020-08-18,Bhutan,6,0,147,0
2020-08-19,Bhutan,0,0,147,0
2020-08-20,Bhutan,6,0,153,0
2020-08-21,Bhutan,1,0,154,0
2020-08-22,Bhutan,1,0,155,0
2020-08-23,Bhutan,0,0,155,0
2020-08-24,Bhutan,1,0,156,0
2020-08-25,Bhutan,17,0,173,0
2020-08-26,Bhutan,0,0,173,0
2020-08-27,Bhutan,11,0,184,0
2020-08-28,Bhutan,11,0,195,0
2020-08-29,Bhutan,0,0,195,0
2020-08-30,Bhutan,29,0,224,0
2020-08-31,Bhutan,1,0,225,0
2020-09-01,Bhutan,2,0,227,0
2020-09-02,Bhutan,0,0,227,0
2020-09-03,Bhutan,0,0,227,0
2020-09-04,Bhutan,1,0,228,0
2020-09-05,Bhutan,0,0,228,0
2020-09-06,Bhutan,0,0,228,0
2020-09-07,Bhutan,5,0,233,0
2020-09-08,Bhutan,1,0,234,0
2020-09-09,Bhutan,0,0,234,0
2020-09-10,Bhutan,4,0,238,0
2020-09-11,Bhutan,3,0,241,0
2020-09-12,Bhutan,3,0,244,0
2020-09-13,Bhutan,1,0,245,0
2020-09-14,Bhutan,0,0,245,0
2020-09-15,Bhutan,1,0,246,0
2020-09-16,Bhutan,0,0,246,0
2020-09-17,Bhutan,0,0,246,0
2020-09-18,Bhutan,6,0,252,0
2020-09-19,Bhutan,7,0,259,0
2020-09-20,Bhutan,2,0,261,0
2020-09-21,Bhutan,0,0,261,0
2020-09-22,Bhutan,0,0,261,0
2020-09-23,Bhutan,0,0,261,0
2020-09-24,Bhutan,2,0,263,0
2020-09-25,Bhutan,0,0,263,0
2020-09-26,Bhutan,8,0,271,0
2020-09-27,Bhutan,2,0,273,0
2020-09-28,Bhutan,7,0,280,0
2020-09-29,Bhutan,1,0,281,0
2020-09-30,Bhutan,1,0,282,0
2020-10-01,Bhutan,0,0,282,0
2020-10-02,Bhutan,1,0,283,0
2020-10-03,Bhutan,0,0,283,0
2020-10-04,Bhutan,15,0,298,0
2020-10-05,Bhutan,1,0,299,0
2020-10-06,Bhutan,1,0,300,0
2020-10-07,Bhutan,4,0,304,0
2020-10-08,Bhutan,0,0,304,0
2020-10-09,Bhutan,2,0,306,0
2020-10-10,Bhutan,0,0,306,0
2020-10-11,Bhutan,3,0,309,0
2020-10-12,Bhutan,0,0,309,0
2020-10-13,Bhutan,4,0,313,0
2020-10-14,Bhutan,3,0,316,0
2020-10-15,Bhutan,0,0,316,0
2020-10-16,Bhutan,0,0,316,0
2020-10-17,Bhutan,9,0,325,0
2020-10-18,Bhutan,2,0,327,0
2020-10-19,Bhutan,3,0,330,0
2020-10-20,Bhutan,1,0,331,0
2020-10-21,Bhutan,1,0,332,0
2020-10-22,Bhutan,4,0,336,0
2020-10-23,Bhutan,0,0,336,0
2020-10-24,Bhutan,4,0,340,0
2020-10-25,Bhutan,2,0,342,0
2020-10-26,Bhutan,0,0,342,0
2020-10-27,Bhutan,3,0,345,0
2020-10-28,Bhutan,1,0,346,0
2020-10-29,Bhutan,0,0,346,0
2020-10-30,Bhutan,2,0,348,0
2020-10-31,Bhutan,1,0,349,0
2020-11-01,Bhutan,5,0,354,0
2020-11-02,Bhutan,2,0,356,0
2020-11-03,Bhutan,2,0,358,0
2020-11-04,Bhutan,0,0,358,0
2020-11-05,Bhutan,0,0,358,0
2020-11-06,Bhutan,0,0,358,0
2020-11-07,Bhutan,1,0,359,0
2020-11-08,Bhutan,0,0,359,0
2020-11-09,Bhutan,5,0,364,0
2020-11-10,Bhutan,0,0,364,0
2020-11-11,Bhutan,0,0,364,0
2020-11-12,Bhutan,5,0,369,0
2020-11-13,Bhutan,0,0,369,0
2020-11-14,Bhutan,6,0,375,0
2020-11-15,Bhutan,0,0,375,0
2020-11-16,Bhutan,2,0,377,0
2020-11-17,Bhutan,1,0,378,0
2020-11-18,Bhutan,0,0,378,0
2020-11-19,Bhutan,0,0,378,0
2020-11-20,Bhutan,0,0,378,0
2020-11-21,Bhutan,1,0,379,0
2020-11-22,Bhutan,3,0,382,0
2020-11-23,Bhutan,4,0,386,0
2020-11-24,Bhutan,0,0,386,0
2020-11-25,Bhutan,0,0,386,0
2020-11-26,Bhutan,3,0,389,0
2020-11-27,Bhutan,6,0,395,0
2020-11-28,Bhutan,1,0,396,0
2020-11-29,Bhutan,0,0,396,0
2020-11-30,Bhutan,14,0,410,0
2020-12-01,Bhutan,4,0,414,0
2020-12-02,Bhutan,1,0,415,0
2020-12-03,Bhutan,3,0,418,0
2020-12-04,Bhutan,6,0,424,0
2020-12-05,Bhutan,2,0,426,0
2020-12-06,Bhutan,4,0,430,0
2020-12-07,Bhutan,2,0,432,0
2020-12-08,Bhutan,1,0,433,0
2020-12-09,Bhutan,0,0,433,0
2020-12-10,Bhutan,1,0,434,0
2020-12-11,Bhutan,2,0,436,0
2020-12-12,Bhutan,1,0,437,0
2020-12-13,Bhutan,1,0,438,0
2020-12-14,Bhutan,0,0,438,0
2020-12-15,Bhutan,1,0,439,0
2020-12-16,Bhutan,1,0,440,0
2020-12-17,Bhutan,0,0,440,0
2020-12-18,Bhutan,3,0,443,0
2020-12-19,Bhutan,0,0,443,0
2020-12-20,Bhutan,3,0,446,0
2020-12-21,Bhutan,33,0,479,0
2020-12-22,Bhutan,0,0,479,0
2020-12-23,Bhutan,40,0,519,0
2020-12-24,Bhutan,0,0,519,0
2020-12-25,Bhutan,57,0,576,0
2020-12-26,Bhutan,21,0,597,0
2020-12-27,Bhutan,26,0,623,0
2020-12-28,Bhutan,0,0,623,0
2020-12-29,Bhutan,13,0,636,0
2020-12-30,Bhutan,19,0,655,0
2020-12-31,Bhutan,15,0,670,0
2021-01-01,Bhutan,19,0,689,0
2021-01-02,Bhutan,21,0,710,0
2021-01-03,Bhutan,6,0,716,0
2021-01-04,Bhutan,18,0,734,0
2021-01-05,Bhutan,0,0,734,0
2021-01-06,Bhutan,21,0,755,0
2021-01-07,Bhutan,12,0,767,0
2021-01-08,Bhutan,4,1,771,1
2021-01-09,Bhutan,39,0,810,1
2021-01-10,Bhutan,3,0,813,1
2021-01-11,Bhutan,12,0,825,1
2021-01-12,Bhutan,6,0,831,1
2021-01-13,Bhutan,2,0,833,1
2021-01-14,Bhutan,1,0,834,1
2021-01-15,Bhutan,3,0,837,1
2021-01-16,Bhutan,5,0,842,1
2021-01-17,Bhutan,0,0,842,1
2021-01-18,Bhutan,1,0,843,1
2021-01-19,Bhutan,5,0,848,1
2021-01-20,Bhutan,2,0,850,1
2021-01-21,Bhutan,0,0,850,1
2021-01-22,Bhutan,1,0,851,1
2021-01-23,Bhutan,3,0,854,1
2021-01-24,Bhutan,1,0,855,1
2021-01-25,Bhutan,1,0,856,1
2021-01-26,Bhutan,0,0,856,1
2021-01-27,Bhutan,0,0,856,1
2021-01-28,Bhutan,1,0,857,1
2021-01-29,Bhutan,1,0,858,1
2021-01-30,Bhutan,0,0,858,1
2021-01-31,Bhutan,1,0,859,1
2021-02-01,Bhutan,0,0,859,1
2021-02-02,Bhutan,0,0,859,1
2021-02-03,Bhutan,0,0,859,1
2021-02-04,Bhutan,0,0,859,1
2021-02-05,Bhutan,2,0,861,1
2021-02-06,Bhutan,0,0,861,1
2021-02-07,Bhutan,0,0,861,1
2021-02-08,Bhutan,0,0,861,1
2021-02-09,Bhutan,0,0,861,1
2021-02-10,Bhutan,0,0,861,1
2021-02-11,Bhutan,0,0,861,1
2021-02-12,Bhutan,2,0,863,1
2021-02-13,Bhutan,0,0,863,1
2021-02-14,Bhutan,1,0,864,1
2021-02-15,Bhutan,2,0,866,1
2021-02-16,Bhutan,0,0,866,1
2021-02-17,Bhutan,0,0,866,1
2021-02-18,Bhutan,0,0,866,1
2021-02-19,Bhutan,0,0,866,1
2021-02-20,Bhutan,0,0,866,1
2021-02-21,Bhutan,0,0,866,1
2021-02-22,Bhutan,0,0,866,1
2021-02-23,Bhutan,1,0,867,1
2021-02-24,Bhutan,0,0,867,1
2021-02-25,Bhutan,0,0,867,1
2021-02-26,Bhutan,0,0,867,1
2021-02-27,Bhutan,0,0,867,1
2021-02-28,Bhutan,0,0,867,1
2021-03-01,Bhutan,0,0,867,1
2021-03-02,Bhutan,0,0,867,1
2021-03-03,Bhutan,0,0,867,1
2021-03-04,Bhutan,0,0,867,1
2021-03-05,Bhutan,0,0,867,1
2021-03-06,Bhutan,1,0,868,1
2021-03-07,Bhutan,0,0,868,1
2021-03-08,Bhutan,0,0,868,1
2021-03-09,Bhutan,0,0,868,1
2021-03-10,Bhutan,0,0,868,1
2021-03-11,Bhutan,0,0,868,1
2021-03-12,Bhutan,0,0,868,1
2021-03-13,Bhutan,0,0,868,1
2021-03-14,Bhutan,0,0,868,1
2021-03-15,Bhutan,0,0,868,1
2021-03-16,Bhutan,0,0,868,1
2021-03-17,Bhutan,0,0,868,1
2021-03-18,Bhutan,0,0,868,1
2021-03-19,Bhutan,0,0,868,1
2021-03-20,Bhutan,1,0,869,1
2021-03-21,Bhutan,0,0,869,1
2021-03-22,Bhutan,0,0,869,1
2021-03-23,Bhutan,0,0,869,1
2021-03-24,Bhutan,1,0,870,1
2021-03-25,Bhutan,0,0,870,1
2021-03-26,Bhutan,0,0,870,1
2021-03-27,Bhutan,1,0,871,1
2021-03-28,Bhutan,1,0,872,1
2021-03-29,Bhutan,0,0,872,1
2021-03-30,Bhutan,0,0,872,1
2021-03-31,Bhutan,1,0,873,1
2021-04-01,Bhutan,13,0,886,1
2021-04-02,Bhutan,3,0,889,1
2021-04-03,Bhutan,2,0,891,1
2021-04-04,Bhutan,0,0,891,1
2021-04-05,Bhutan,0,0,891,1
2021-04-06,Bhutan,5,0,896,1
2021-04-07,Bhutan,4,0,900,1
2021-04-08,Bhutan,0,0,900,1
2020-03-11,Bolivia,2,0,2,0
2020-03-12,Bolivia,0,0,2,0
2020-03-13,Bolivia,1,0,3,0
2020-03-14,Bolivia,7,0,10,0
2020-03-15,Bolivia,0,0,10,0
2020-03-16,Bolivia,1,0,11,0
2020-03-17,Bolivia,0,0,11,0
2020-03-18,Bolivia,1,0,12,0
2020-03-19,Bolivia,0,0,12,0
2020-03-20,Bolivia,3,0,15,0
2020-03-21,Bolivia,4,0,19,0
2020-03-22,Bolivia,5,0,24,0
2020-03-23,Bolivia,3,0,27,0
2020-03-24,Bolivia,2,0,29,0
2020-03-25,Bolivia,3,0,32,0
2020-03-26,Bolivia,11,0,43,0
2020-03-27,Bolivia,18,0,61,0
2020-03-28,Bolivia,13,0,74,0
2020-03-29,Bolivia,7,1,81,1
2020-03-30,Bolivia,16,3,97,4
2020-03-31,Bolivia,10,2,107,6
2020-04-01,Bolivia,8,1,115,7
2020-04-02,Bolivia,8,1,123,8
2020-04-03,Bolivia,9,1,132,9
2020-04-04,Bolivia,7,1,139,10
2020-04-05,Bolivia,18,0,157,10
2020-04-06,Bolivia,26,1,183,11
2020-04-07,Bolivia,11,3,194,14
2020-04-08,Bolivia,16,1,210,15
2020-04-09,Bolivia,54,3,264,18
2020-04-10,Bolivia,4,1,268,19
2020-04-11,Bolivia,7,1,275,20
2020-04-12,Bolivia,25,4,300,24
2020-04-13,Bolivia,30,3,330,27
2020-04-14,Bolivia,24,1,354,28
2020-04-15,Bolivia,43,0,397,28
2020-04-16,Bolivia,44,1,441,29
2020-04-17,Bolivia,24,2,465,31
2020-04-18,Bolivia,28,0,493,31
2020-04-19,Bolivia,27,1,520,32
2020-04-20,Bolivia,44,1,564,33
2020-04-21,Bolivia,34,1,598,34
2020-04-22,Bolivia,11,3,609,37
2020-04-23,Bolivia,94,6,703,43
2020-04-24,Bolivia,104,1,807,44
2020-04-25,Bolivia,59,2,866,46
2020-04-26,Bolivia,84,4,950,50
2020-04-27,Bolivia,64,3,1014,53
2020-04-28,Bolivia,39,2,1053,55
2020-04-29,Bolivia,57,4,1110,59
2020-04-30,Bolivia,57,3,1167,62
2020-05-01,Bolivia,62,4,1229,66
2020-05-02,Bolivia,241,5,1470,71
2020-05-03,Bolivia,124,5,1594,76
2020-05-04,Bolivia,87,6,1681,82
2020-05-05,Bolivia,121,4,1802,86
2020-05-06,Bolivia,84,5,1886,91
2020-05-07,Bolivia,195,11,2081,102
2020-05-08,Bolivia,185,4,2266,106
2020-05-09,Bolivia,171,8,2437,114
2020-05-10,Bolivia,119,4,2556,118
2020-05-11,Bolivia,275,4,2831,122
2020-05-12,Bolivia,133,6,2964,128
2020-05-13,Bolivia,184,14,3148,142
2020-05-14,Bolivia,224,10,3372,152
2020-05-15,Bolivia,205,12,3577,164
2020-05-16,Bolivia,249,1,3826,165
2020-05-17,Bolivia,262,4,4088,169
2020-05-18,Bolivia,175,5,4263,174
2020-05-19,Bolivia,218,15,4481,189
2020-05-20,Bolivia,438,10,4919,199
2020-05-21,Bolivia,268,16,5187,215
2020-05-22,Bolivia,392,15,5579,230
2020-05-23,Bolivia,336,10,5915,240
2020-05-24,Bolivia,348,10,6263,250
2020-05-25,Bolivia,397,11,6660,261
2020-05-26,Bolivia,476,13,7136,274
2020-05-27,Bolivia,632,6,7768,280
2020-05-28,Bolivia,619,13,8387,293
2020-05-29,Bolivia,344,7,8731,300
2020-05-30,Bolivia,861,10,9592,310
2020-05-31,Bolivia,390,3,9982,313
2020-06-01,Bolivia,549,30,10531,343
2020-06-02,Bolivia,460,33,10991,376
2020-06-03,Bolivia,647,24,11638,400
2020-06-04,Bolivia,607,15,12245,415
2020-06-05,Bolivia,483,12,12728,427
2020-06-06,Bolivia,630,27,13358,454
2020-06-07,Bolivia,285,11,13643,465
2020-06-08,Bolivia,306,10,13949,475
2020-06-09,Bolivia,695,12,14644,487
2020-06-10,Bolivia,637,25,15281,512
2020-06-11,Bolivia,884,21,16165,533
2020-06-12,Bolivia,764,26,16929,559
2020-06-13,Bolivia,913,26,17842,585
2020-06-14,Bolivia,617,26,18459,611
2020-06-15,Bolivia,614,21,19073,632
2020-06-16,Bolivia,810,27,19883,659
2020-06-17,Bolivia,802,20,20685,679
2020-06-18,Bolivia,814,18,21499,697
2020-06-19,Bolivia,977,18,22476,715
2020-06-20,Bolivia,1036,25,23512,740
2020-06-21,Bolivia,876,33,24388,773
2020-06-22,Bolivia,1105,47,25493,820
2020-06-23,Bolivia,896,26,26389,846
2020-06-24,Bolivia,1098,30,27487,876
2020-06-25,Bolivia,1016,37,28503,913
2020-06-26,Bolivia,920,21,29423,934
2020-06-27,Bolivia,1253,36,30676,970
2020-06-28,Bolivia,848,44,31524,1014
2020-06-29,Bolivia,601,57,32125,1071
2020-06-30,Bolivia,1094,52,33219,1123
2020-07-01,Bolivia,1008,78,34227,1201
2020-07-02,Bolivia,1301,70,35528,1271
2020-07-03,Bolivia,1290,49,36818,1320
2020-07-04,Bolivia,1253,58,38071,1378
2020-07-05,Bolivia,1226,56,39297,1434
2020-07-06,Bolivia,1212,42,40509,1476
2020-07-07,Bolivia,1036,54,41545,1530
2020-07-08,Bolivia,1439,47,42984,1577
2020-07-09,Bolivia,1129,61,44113,1638
2020-07-10,Bolivia,1452,64,45565,1702
2020-07-11,Bolivia,1635,52,47200,1754
2020-07-12,Bolivia,987,53,48187,1807
2020-07-13,Bolivia,1063,59,49250,1866
2020-07-14,Bolivia,1617,32,50867,1898
2020-07-15,Bolivia,1351,44,52218,1942
2020-07-16,Bolivia,1938,42,54156,1984
2020-07-17,Bolivia,1946,65,56102,2049
2020-07-18,Bolivia,2036,57,58138,2106
2020-07-19,Bolivia,1444,45,59582,2151
2020-07-20,Bolivia,1409,67,60991,2218
2020-07-21,Bolivia,1366,55,62357,2273
2020-07-22,Bolivia,1778,55,64135,2328
2020-07-23,Bolivia,1117,79,65252,2407
2020-07-24,Bolivia,1204,66,66456,2473
2020-07-25,Bolivia,1825,62,68281,2535
2020-07-26,Bolivia,1148,48,69429,2583
2020-07-27,Bolivia,1752,64,71181,2647
2020-07-28,Bolivia,1146,73,72327,2720
2020-07-29,Bolivia,1207,88,73534,2808
2020-07-30,Bolivia,1700,86,75234,2894
2020-07-31,Bolivia,1555,83,76789,2977
2020-08-01,Bolivia,2004,87,78793,3064
2020-08-02,Bolivia,1360,89,80153,3153
2020-08-03,Bolivia,1693,75,81846,3228
2020-08-04,Bolivia,1515,92,83361,3320
2020-08-05,Bolivia,1780,65,85141,3385
2020-08-06,Bolivia,1282,80,86423,3465
2020-08-07,Bolivia,1468,59,87891,3524
2020-08-08,Bolivia,1164,63,89055,3587
2020-08-09,Bolivia,944,53,89999,3640
2020-08-10,Bolivia,1636,72,91635,3712
2020-08-11,Bolivia,1693,49,93328,3761
2020-08-12,Bolivia,1743,66,95071,3827
2020-08-13,Bolivia,1388,57,96459,3884
2020-08-14,Bolivia,1491,55,97950,3939
2020-08-15,Bolivia,1196,64,99146,4003
2020-08-16,Bolivia,1198,55,100344,4058
2020-08-17,Bolivia,879,65,101223,4123
2020-08-18,Bolivia,1796,49,103019,4172
2020-08-19,Bolivia,2031,61,105050,4233
2020-08-20,Bolivia,1015,72,106065,4305
2020-08-21,Bolivia,1370,61,107435,4366
2020-08-22,Bolivia,992,76,108427,4442
2020-08-23,Bolivia,722,67,109149,4509
2020-08-24,Bolivia,999,69,110148,4578
2020-08-25,Bolivia,851,86,110999,4664
2020-08-26,Bolivia,1095,62,112094,4726
2020-08-27,Bolivia,1035,65,113129,4791
2020-08-28,Bolivia,1280,55,114409,4846
2020-08-29,Bolivia,945,92,115354,4938
2020-08-30,Bolivia,614,28,115968,4966
2020-08-31,Bolivia,630,61,116598,5027
2020-09-01,Bolivia,669,74,117267,5101
2020-09-02,Bolivia,661,102,117928,5203
2020-09-03,Bolivia,853,85,118781,5288
2020-09-04,Bolivia,799,55,119580,5343
2020-09-05,Bolivia,661,55,120241,5398
2020-09-06,Bolivia,528,0,120769,5398
2020-09-07,Bolivia,835,1656,121604,7054
2020-09-08,Bolivia,704,43,122308,7097
2020-09-09,Bolivia,1037,49,123345,7146
2020-09-10,Bolivia,860,47,124205,7193
2020-09-11,Bolivia,967,57,125172,7250
2020-09-12,Bolivia,810,47,125982,7297
2020-09-13,Bolivia,809,47,126791,7344
2020-09-14,Bolivia,828,50,127619,7394
2020-09-15,Bolivia,667,53,128286,7447
2020-09-16,Bolivia,586,31,128872,7478
2020-09-17,Bolivia,547,33,129419,7511
2020-09-18,Bolivia,632,39,130051,7550
2020-09-19,Bolivia,419,36,130470,7586
2020-09-20,Bolivia,206,31,130676,7617
2020-09-21,Bolivia,310,37,130986,7654
2020-09-22,Bolivia,467,39,131453,7693
2020-09-23,Bolivia,537,38,131990,7731
2020-09-24,Bolivia,628,34,132618,7765
2020-09-25,Bolivia,604,35,133222,7800
2020-09-26,Bolivia,370,28,133592,7828
2020-09-27,Bolivia,309,30,133901,7858
2020-09-28,Bolivia,322,42,134223,7900
2020-09-29,Bolivia,418,31,134641,7931
2020-09-30,Bolivia,670,34,135311,7965
2020-10-01,Bolivia,405,36,135716,8001
2020-10-02,Bolivia,503,44,136219,8045
2020-10-03,Bolivia,350,28,136569,8073
2020-10-04,Bolivia,299,28,136868,8101
2020-10-05,Bolivia,239,28,137107,8129
2020-10-06,Bolivia,361,27,137468,8156
2020-10-07,Bolivia,238,36,137706,8192
2020-10-08,Bolivia,263,36,137969,8228
2020-10-09,Bolivia,257,34,138226,8262
2020-10-10,Bolivia,237,30,138463,8292
2020-10-11,Bolivia,111,16,138574,8308
2020-10-12,Bolivia,121,18,138695,8326
2020-10-13,Bolivia,227,25,138922,8351
2020-10-14,Bolivia,219,26,139141,8377
2020-10-15,Bolivia,178,30,139319,8407
2020-10-16,Bolivia,243,32,139562,8439
2020-10-17,Bolivia,148,24,139710,8463
2020-10-18,Bolivia,61,18,139771,8481
2020-10-19,Bolivia,119,21,139890,8502
2020-10-20,Bolivia,147,24,140037,8526
2020-10-21,Bolivia,191,32,140228,8558
2020-10-22,Bolivia,217,26,140445,8584
2020-10-23,Bolivia,167,24,140612,8608
2020-10-24,Bolivia,167,19,140779,8627
2020-10-25,Bolivia,74,18,140853,8645
2020-10-26,Bolivia,99,13,140952,8658
2020-10-27,Bolivia,172,14,141124,8672
2020-10-28,Bolivia,197,22,141321,8694
2020-10-29,Bolivia,163,11,141484,8705
2020-10-30,Bolivia,147,10,141631,8715
2020-10-31,Bolivia,126,10,141757,8725
2020-11-01,Bolivia,76,6,141833,8731
2020-11-02,Bolivia,34,10,141867,8741
2020-11-03,Bolivia,69,10,141936,8751
2020-11-04,Bolivia,126,7,142062,8758
2020-11-05,Bolivia,139,10,142201,8768
2020-11-06,Bolivia,142,13,142343,8781
2020-11-07,Bolivia,84,9,142427,8790
2020-11-08,Bolivia,48,5,142475,8795
2020-11-09,Bolivia,86,7,142561,8802
2020-11-10,Bolivia,103,6,142664,8808
2020-11-11,Bolivia,112,10,142776,8818
2020-11-12,Bolivia,113,7,142889,8825
2020-11-13,Bolivia,180,10,143069,8835
2020-11-14,Bolivia,112,6,143181,8841
2020-11-15,Bolivia,65,8,143246,8849
2020-11-16,Bolivia,125,10,143371,8859
2020-11-17,Bolivia,102,7,143473,8866
2020-11-18,Bolivia,96,9,143569,8875
2020-11-19,Bolivia,187,14,143756,8889
2020-11-20,Bolivia,98,11,143854,8900
2020-11-21,Bolivia,68,4,143922,8904
2020-11-22,Bolivia,56,3,143978,8907
2020-11-23,Bolivia,56,9,144034,8916
2020-11-24,Bolivia,113,12,144147,8928
2020-11-25,Bolivia,129,5,144276,8933
2020-11-26,Bolivia,114,6,144390,8939
2020-11-27,Bolivia,104,4,144494,8943
2020-11-28,Bolivia,98,6,144592,8949
2020-11-29,Bolivia,30,3,144622,8952
2020-11-30,Bolivia,86,5,144708,8957
2020-12-01,Bolivia,102,6,144810,8963
2020-12-02,Bolivia,184,9,144994,8972
2020-12-03,Bolivia,192,10,145186,8982
2020-12-04,Bolivia,139,5,145325,8987
2020-12-05,Bolivia,167,5,145492,8992
2020-12-06,Bolivia,68,3,145560,8995
2020-12-07,Bolivia,97,2,145657,8997
2020-12-08,Bolivia,189,5,145846,9002
2020-12-09,Bolivia,214,2,146060,9004
2020-12-10,Bolivia,325,4,146385,9008
2020-12-11,Bolivia,312,5,146697,9013
2020-12-12,Bolivia,333,1,147030,9014
2020-12-13,Bolivia,120,4,147150,9018
2020-12-14,Bolivia,195,6,147345,9024
2020-12-15,Bolivia,371,2,147716,9026
2020-12-16,Bolivia,498,3,148214,9029
2020-12-17,Bolivia,451,2,148665,9031
2020-12-18,Bolivia,484,2,149149,9033
2020-12-19,Bolivia,621,2,149770,9035
2020-12-20,Bolivia,253,1,150023,9036
2020-12-21,Bolivia,362,7,150385,9043
2020-12-22,Bolivia,674,9,151059,9052
2020-12-23,Bolivia,1005,13,152064,9065
2020-12-24,Bolivia,1057,11,153121,9076
2020-12-25,Bolivia,469,7,153590,9083
2020-12-26,Bolivia,759,10,154349,9093
2020-12-27,Bolivia,494,5,154843,9098
2020-12-28,Bolivia,751,8,155594,9106
2020-12-29,Bolivia,1293,29,156887,9135
2020-12-30,Bolivia,1485,14,158372,9149
2020-12-31,Bolivia,1752,16,160124,9165
2021-01-01,Bolivia,861,10,160985,9175
2021-01-02,Bolivia,1070,11,162055,9186
2021-01-03,Bolivia,606,15,162661,9201
2021-01-04,Bolivia,1010,18,163671,9219
2021-01-05,Bolivia,1597,22,165268,9241
2021-01-06,Bolivia,1713,46,166981,9287
2021-01-07,Bolivia,1910,17,168891,9304
2021-01-08,Bolivia,2263,24,171154,9328
2021-01-09,Bolivia,1644,23,172798,9351
2021-01-10,Bolivia,1098,25,173896,9376
2021-01-11,Bolivia,1392,39,175288,9415
2021-01-12,Bolivia,1473,39,176761,9454
2021-01-13,Bolivia,2057,39,178818,9493
2021-01-14,Bolivia,2198,37,181016,9530
2021-01-15,Bolivia,2573,41,183589,9571
2021-01-16,Bolivia,2091,25,185680,9596
2021-01-17,Bolivia,1503,40,187183,9636
2021-01-18,Bolivia,1550,44,188733,9680
2021-01-19,Bolivia,2357,42,191090,9722
2021-01-20,Bolivia,2655,42,193745,9764
2021-01-21,Bolivia,2648,54,196393,9818
2021-01-22,Bolivia,1864,53,198257,9871
2021-01-23,Bolivia,1732,56,199989,9927
2021-01-24,Bolivia,1048,58,201037,9985
2021-01-25,Bolivia,1781,66,202818,10051
2021-01-26,Bolivia,2390,54,205208,10105
2021-01-27,Bolivia,2866,62,208074,10167
2021-01-28,Bolivia,2652,59,210726,10226
2021-01-29,Bolivia,2666,53,213392,10279
2021-01-30,Bolivia,2005,51,215397,10330
2021-01-31,Bolivia,1438,49,216835,10379
2021-02-01,Bolivia,1464,60,218299,10439
2021-02-02,Bolivia,2127,74,220426,10513
2021-02-03,Bolivia,2021,58,222447,10571
2021-02-04,Bolivia,1787,62,224234,10633
2021-02-05,Bolivia,1676,54,225910,10687
2021-02-06,Bolivia,1218,66,227128,10753
2021-02-07,Bolivia,839,43,227967,10796
2021-02-08,Bolivia,1220,68,229187,10864
2021-02-09,Bolivia,1544,65,230731,10929
2021-02-10,Bolivia,1771,67,232502,10996
2021-02-11,Bolivia,1352,48,233854,11044
2021-02-12,Bolivia,1244,63,235098,11107
2021-02-13,Bolivia,938,48,236036,11155
2021-02-14,Bolivia,696,47,236732,11202
2021-02-15,Bolivia,412,32,237144,11234
2021-02-16,Bolivia,562,40,237706,11274
2021-02-17,Bolivia,789,29,238495,11303
2021-02-18,Bolivia,1029,50,239524,11353
2021-02-19,Bolivia,1152,37,240676,11390
2021-02-20,Bolivia,1095,27,241771,11417
2021-02-21,Bolivia,521,24,242292,11441
2021-02-22,Bolivia,884,29,243176,11470
2021-02-23,Bolivia,1204,38,244380,11508
2021-02-24,Bolivia,1339,39,245719,11547
2021-02-25,Bolivia,1103,30,246822,11577
2021-02-26,Bolivia,1069,32,247891,11609
2021-02-27,Bolivia,656,19,248547,11628
2021-02-28,Bolivia,463,21,249010,11649
2021-03-01,Bolivia,757,17,249767,11666
2021-03-02,Bolivia,790,37,250557,11703
2021-03-03,Bolivia,834,31,251391,11734
2021-03-04,Bolivia,969,27,252360,11761
2021-03-05,Bolivia,937,28,253297,11789
2021-03-06,Bolivia,653,18,253950,11807
2021-03-07,Bolivia,323,16,254273,11823
2021-03-08,Bolivia,463,22,254736,11845
2021-03-09,Bolivia,885,13,255621,11858
2021-03-10,Bolivia,841,26,256462,11884
2021-03-11,Bolivia,778,19,257240,11903
2021-03-12,Bolivia,1084,27,258324,11930
2021-03-13,Bolivia,680,14,259004,11944
2021-03-14,Bolivia,385,14,259389,11958
2021-03-15,Bolivia,670,16,260059,11974
2021-03-16,Bolivia,929,23,260988,11997
2021-03-17,Bolivia,1068,18,262056,12015
2021-03-18,Bolivia,885,13,262941,12028
2021-03-19,Bolivia,867,13,263808,12041
2021-03-20,Bolivia,603,10,264411,12051
2021-03-21,Bolivia,223,9,264634,12060
2021-03-22,Bolivia,573,14,265207,12074
2021-03-23,Bolivia,879,19,266086,12093
2021-03-24,Bolivia,973,14,267059,12107
2021-03-25,Bolivia,774,24,267833,12131
2021-03-26,Bolivia,878,12,268711,12143
2021-03-27,Bolivia,591,22,269302,12165
2021-03-28,Bolivia,326,21,269628,12186
2021-03-29,Bolivia,719,25,270347,12211
2021-03-30,Bolivia,1072,28,271419,12239
2021-03-31,Bolivia,992,18,272411,12257
2021-04-01,Bolivia,916,23,273327,12280
2021-04-02,Bolivia,620,25,273947,12305
2021-04-03,Bolivia,520,11,274467,12316
2021-04-04,Bolivia,467,8,274934,12324
2021-04-05,Bolivia,458,20,275392,12344
2021-04-06,Bolivia,1498,22,276890,12366
2021-04-07,Bolivia,1076,19,277966,12385
2021-04-08,Bolivia,1241,27,279207,12412
2020-03-05,Bosnia and Herzegovina,2,0,2,0
2020-03-06,Bosnia and Herzegovina,0,0,2,0
2020-03-07,Bosnia and Herzegovina,1,0,3,0
2020-03-08,Bosnia and Herzegovina,0,0,3,0
2020-03-09,Bosnia and Herzegovina,0,0,3,0
2020-03-10,Bosnia and Herzegovina,2,0,5,0
2020-03-11,Bosnia and Herzegovina,2,0,7,0
2020-03-12,Bosnia and Herzegovina,4,0,11,0
2020-03-13,Bosnia and Herzegovina,2,0,13,0
2020-03-14,Bosnia and Herzegovina,5,0,18,0
2020-03-15,Bosnia and Herzegovina,6,0,24,0
2020-03-16,Bosnia and Herzegovina,1,0,25,0
2020-03-17,Bosnia and Herzegovina,1,0,26,0
2020-03-18,Bosnia and Herzegovina,12,0,38,0
2020-03-19,Bosnia and Herzegovina,25,0,63,0
2020-03-20,Bosnia and Herzegovina,26,0,89,0
2020-03-21,Bosnia and Herzegovina,4,1,93,1
2020-03-22,Bosnia and Herzegovina,33,0,126,1
2020-03-23,Bosnia and Herzegovina,10,0,136,1
2020-03-24,Bosnia and Herzegovina,30,2,166,3
2020-03-25,Bosnia and Herzegovina,10,0,176,3
2020-03-26,Bosnia and Herzegovina,15,0,191,3
2020-03-27,Bosnia and Herzegovina,46,1,237,4
2020-03-28,Bosnia and Herzegovina,21,1,258,5
2020-03-29,Bosnia and Herzegovina,65,1,323,6
2020-03-30,Bosnia and Herzegovina,45,4,368,10
2020-03-31,Bosnia and Herzegovina,52,3,420,13
2020-04-01,Bosnia and Herzegovina,39,0,459,13
2020-04-02,Bosnia and Herzegovina,74,3,533,16
2020-04-03,Bosnia and Herzegovina,46,1,579,17
2020-04-04,Bosnia and Herzegovina,45,4,624,21
2020-04-05,Bosnia and Herzegovina,30,2,654,23
2020-04-06,Bosnia and Herzegovina,20,6,674,29
2020-04-07,Bosnia and Herzegovina,90,4,764,33
2020-04-08,Bosnia and Herzegovina,40,1,804,34
2020-04-09,Bosnia and Herzegovina,54,1,858,35
2020-04-10,Bosnia and Herzegovina,43,1,901,36
2020-04-11,Bosnia and Herzegovina,45,1,946,37
2020-04-12,Bosnia and Herzegovina,63,2,1009,39
2020-04-13,Bosnia and Herzegovina,28,0,1037,39
2020-04-14,Bosnia and Herzegovina,46,1,1083,40
2020-04-15,Bosnia and Herzegovina,27,1,1110,41
2020-04-16,Bosnia and Herzegovina,57,2,1167,43
2020-04-17,Bosnia and Herzegovina,47,3,1214,46
2020-04-18,Bosnia and Herzegovina,54,1,1268,47
2020-04-19,Bosnia and Herzegovina,17,1,1285,48
2020-04-20,Bosnia and Herzegovina,24,1,1309,49
2020-04-21,Bosnia and Herzegovina,33,2,1342,51
2020-04-22,Bosnia and Herzegovina,26,2,1368,53
2020-04-23,Bosnia and Herzegovina,45,1,1413,54
2020-04-24,Bosnia and Herzegovina,8,1,1421,55
2020-04-25,Bosnia and Herzegovina,65,2,1486,57
2020-04-26,Bosnia and Herzegovina,30,2,1516,59
2020-04-27,Bosnia and Herzegovina,49,1,1565,60
2020-04-28,Bosnia and Herzegovina,20,3,1585,63
2020-04-29,Bosnia and Herzegovina,92,2,1677,65
2020-04-30,Bosnia and Herzegovina,80,4,1757,69
2020-05-01,Bosnia and Herzegovina,24,1,1781,70
2020-05-02,Bosnia and Herzegovina,58,2,1839,72
2020-05-03,Bosnia and Herzegovina,18,5,1857,77
2020-05-04,Bosnia and Herzegovina,69,1,1926,78
2020-05-05,Bosnia and Herzegovina,20,1,1946,79
2020-05-06,Bosnia and Herzegovina,41,7,1987,86
2020-05-07,Bosnia and Herzegovina,40,4,2027,90
2020-05-08,Bosnia and Herzegovina,43,8,2070,98
2020-05-09,Bosnia and Herzegovina,20,4,2090,102
2020-05-10,Bosnia and Herzegovina,27,5,2117,107
2020-05-11,Bosnia and Herzegovina,24,6,2141,113
2020-05-12,Bosnia and Herzegovina,17,4,2158,117
2020-05-13,Bosnia and Herzegovina,23,3,2181,120
2020-05-14,Bosnia and Herzegovina,37,2,2218,122
2020-05-15,Bosnia and Herzegovina,18,6,2236,128
2020-05-16,Bosnia and Herzegovina,31,1,2267,129
2020-05-17,Bosnia and Herzegovina,23,4,2290,133
2020-05-18,Bosnia and Herzegovina,14,0,2304,133
2020-05-19,Bosnia and Herzegovina,17,1,2321,134
2020-05-20,Bosnia and Herzegovina,17,2,2338,136
2020-05-21,Bosnia and Herzegovina,12,4,2350,140
2020-05-22,Bosnia and Herzegovina,22,1,2372,141
2020-05-23,Bosnia and Herzegovina,19,0,2391,141
2020-05-24,Bosnia and Herzegovina,10,3,2401,144
2020-05-25,Bosnia and Herzegovina,5,2,2406,146
2020-05-26,Bosnia and Herzegovina,10,3,2416,149
2020-05-27,Bosnia and Herzegovina,19,2,2435,151
2020-05-28,Bosnia and Herzegovina,27,2,2462,153
2020-05-29,Bosnia and Herzegovina,23,0,2485,153
2020-05-30,Bosnia and Herzegovina,9,0,2494,153
2020-05-31,Bosnia and Herzegovina,16,0,2510,153
2020-06-01,Bosnia and Herzegovina,14,1,2524,154
2020-06-02,Bosnia and Herzegovina,11,3,2535,157
2020-06-03,Bosnia and Herzegovina,16,0,2551,157
2020-06-04,Bosnia and Herzegovina,43,2,2594,159
2020-06-05,Bosnia and Herzegovina,12,0,2606,159
2020-06-06,Bosnia and Herzegovina,0,0,2606,159
2020-06-07,Bosnia and Herzegovina,0,0,2606,159
2020-06-08,Bosnia and Herzegovina,98,1,2704,160
2020-06-09,Bosnia and Herzegovina,24,0,2728,160
2020-06-10,Bosnia and Herzegovina,47,1,2775,161
2020-06-11,Bosnia and Herzegovina,57,0,2832,161
2020-06-12,Bosnia and Herzegovina,61,2,2893,163
2020-06-13,Bosnia and Herzegovina,0,0,2893,163
2020-06-14,Bosnia and Herzegovina,0,0,2893,163
2020-06-15,Bosnia and Herzegovina,147,2,3040,165
2020-06-16,Bosnia and Herzegovina,45,3,3085,168
2020-06-17,Bosnia and Herzegovina,56,0,3141,168
2020-06-18,Bosnia and Herzegovina,33,0,3174,168
2020-06-19,Bosnia and Herzegovina,99,1,3273,169
2020-06-20,Bosnia and Herzegovina,0,0,3273,169
2020-06-21,Bosnia and Herzegovina,0,0,3273,169
2020-06-22,Bosnia and Herzegovina,252,2,3525,171
2020-06-23,Bosnia and Herzegovina,63,1,3588,172
2020-06-24,Bosnia and Herzegovina,88,1,3676,173
2020-06-25,Bosnia and Herzegovina,120,2,3796,175
2020-06-26,Bosnia and Herzegovina,139,3,3935,178
2020-06-27,Bosnia and Herzegovina,0,0,3935,178
2020-06-28,Bosnia and Herzegovina,0,0,3935,178
2020-06-29,Bosnia and Herzegovina,390,6,4325,184
2020-06-30,Bosnia and Herzegovina,128,2,4453,186
2020-07-01,Bosnia and Herzegovina,153,2,4606,188
2020-07-02,Bosnia and Herzegovina,182,1,4788,189
2020-07-03,Bosnia and Herzegovina,174,2,4962,191
2020-07-04,Bosnia and Herzegovina,0,0,4962,191
2020-07-05,Bosnia and Herzegovina,0,0,4962,191
2020-07-06,Bosnia and Herzegovina,496,8,5458,199
2020-07-07,Bosnia and Herzegovina,163,8,5621,207
2020-07-08,Bosnia and Herzegovina,248,2,5869,209
2020-07-09,Bosnia and Herzegovina,217,5,6086,214
2020-07-10,Bosnia and Herzegovina,316,2,6402,216
2020-07-11,Bosnia and Herzegovina,317,3,6719,219
2020-07-12,Bosnia and Herzegovina,158,2,6877,221
2020-07-13,Bosnia and Herzegovina,104,5,6981,226
2020-07-14,Bosnia and Herzegovina,0,0,6981,226
2020-07-15,Bosnia and Herzegovina,430,9,7411,235
2020-07-16,Bosnia and Herzegovina,270,5,7681,240
2020-07-17,Bosnia and Herzegovina,227,5,7908,245
2020-07-18,Bosnia and Herzegovina,253,1,8161,246
2020-07-19,Bosnia and Herzegovina,179,3,8340,249
2020-07-20,Bosnia and Herzegovina,139,6,8479,255
2020-07-21,Bosnia and Herzegovina,308,9,8787,264
2020-07-22,Bosnia and Herzegovina,328,4,9115,268
2020-07-23,Bosnia and Herzegovina,347,6,9462,274
2020-07-24,Bosnia and Herzegovina,305,6,9767,280
2020-07-25,Bosnia and Herzegovina,0,0,9767,280
2020-07-26,Bosnia and Herzegovina,0,0,9767,280
2020-07-27,Bosnia and Herzegovina,731,14,10498,294
2020-07-28,Bosnia and Herzegovina,268,3,10766,297
2020-07-29,Bosnia and Herzegovina,361,19,11127,316
2020-07-30,Bosnia and Herzegovina,317,12,11444,328
2020-07-31,Bosnia and Herzegovina,432,11,11876,339
2020-08-01,Bosnia and Herzegovina,0,0,11876,339
2020-08-02,Bosnia and Herzegovina,420,13,12296,352
2020-08-03,Bosnia and Herzegovina,166,10,12462,362
2020-08-04,Bosnia and Herzegovina,394,11,12856,373
2020-08-05,Bosnia and Herzegovina,282,6,13138,379
2020-08-06,Bosnia and Herzegovina,258,5,13396,384
2020-08-07,Bosnia and Herzegovina,291,10,13687,394
2020-08-08,Bosnia and Herzegovina,0,0,13687,394
2020-08-09,Bosnia and Herzegovina,0,0,13687,394
2020-08-10,Bosnia and Herzegovina,811,31,14498,425
2020-08-11,Bosnia and Herzegovina,210,22,14708,447
2020-08-12,Bosnia and Herzegovina,253,6,14961,453
2020-08-13,Bosnia and Herzegovina,223,5,15184,458
2020-08-14,Bosnia and Herzegovina,351,11,15535,469
2020-08-15,Bosnia and Herzegovina,266,2,15801,471
2020-08-16,Bosnia and Herzegovina,0,0,15801,471
2020-08-17,Bosnia and Herzegovina,310,15,16111,486
2020-08-18,Bosnia and Herzegovina,240,9,16351,495
2020-08-19,Bosnia and Herzegovina,340,12,16691,507
2020-08-20,Bosnia and Herzegovina,338,8,17029,515
2020-08-21,Bosnia and Herzegovina,367,11,17396,526
2020-08-22,Bosnia and Herzegovina,319,6,17715,532
2020-08-23,Bosnia and Herzegovina,0,0,17715,532
2020-08-24,Bosnia and Herzegovina,314,15,18029,547
2020-08-25,Bosnia and Herzegovina,297,13,18326,560
2020-08-26,Bosnia and Herzegovina,283,11,18609,571
2020-08-27,Bosnia and Herzegovina,311,11,18920,582
2020-08-28,Bosnia and Herzegovina,294,9,19214,591
2020-08-29,Bosnia and Herzegovina,336,3,19550,594
2020-08-30,Bosnia and Herzegovina,243,4,19793,598
2020-08-31,Bosnia and Herzegovina,171,11,19964,609
2020-09-01,Bosnia and Herzegovina,270,11,20234,620
2020-09-02,Bosnia and Herzegovina,283,7,20517,627
2020-09-03,Bosnia and Herzegovina,287,9,20804,636
2020-09-04,Bosnia and Herzegovina,338,3,21142,639
2020-09-05,Bosnia and Herzegovina,297,12,21439,651
2020-09-06,Bosnia and Herzegovina,121,4,21560,655
2020-09-07,Bosnia and Herzegovina,100,9,21660,664
2020-09-08,Bosnia and Herzegovina,301,5,21961,669
2020-09-09,Bosnia and Herzegovina,297,6,22258,675
2020-09-10,Bosnia and Herzegovina,286,5,22544,680
2020-09-11,Bosnia and Herzegovina,290,6,22834,686
2020-09-12,Bosnia and Herzegovina,304,4,23138,690
2020-09-13,Bosnia and Herzegovina,327,6,23465,696
2020-09-14,Bosnia and Herzegovina,170,9,23635,705
2020-09-15,Bosnia and Herzegovina,294,20,23929,725
2020-09-16,Bosnia and Herzegovina,282,11,24211,736
2020-09-17,Bosnia and Herzegovina,394,11,24605,747
2020-09-18,Bosnia and Herzegovina,292,5,24897,752
2020-09-19,Bosnia and Herzegovina,320,6,25217,758
2020-09-20,Bosnia and Herzegovina,211,5,25428,763
2020-09-21,Bosnia and Herzegovina,93,7,25521,770
2020-09-22,Bosnia and Herzegovina,216,8,25737,778
2020-09-23,Bosnia and Herzegovina,344,12,26081,790
2020-09-24,Bosnia and Herzegovina,235,12,26316,802
2020-09-25,Bosnia and Herzegovina,248,6,26564,808
2020-09-26,Bosnia and Herzegovina,233,12,26797,820
2020-09-27,Bosnia and Herzegovina,123,2,26920,822
2020-09-28,Bosnia and Herzegovina,81,7,27001,829
2020-09-29,Bosnia and Herzegovina,225,14,27226,843
2020-09-30,Bosnia and Herzegovina,243,13,27469,856
2020-10-01,Bosnia and Herzegovina,280,5,27749,861
2020-10-02,Bosnia and Herzegovina,226,10,27975,871
2020-10-03,Bosnia and Herzegovina,0,0,27975,871
2020-10-04,Bosnia and Herzegovina,379,8,28354,879
2020-10-05,Bosnia and Herzegovina,95,9,28449,888
2020-10-06,Bosnia and Herzegovina,261,15,28710,903
2020-10-07,Bosnia and Herzegovina,365,5,29075,908
2020-10-08,Bosnia and Herzegovina,453,5,29528,913
2020-10-09,Bosnia and Herzegovina,389,13,29917,926
2020-10-10,Bosnia and Herzegovina,428,1,30345,927
2020-10-11,Bosnia and Herzegovina,302,1,30647,928
2020-10-12,Bosnia and Herzegovina,190,8,30837,936
2020-10-13,Bosnia and Herzegovina,336,11,31173,947
2020-10-14,Bosnia and Herzegovina,482,11,31655,958
2020-10-15,Bosnia and Herzegovina,569,14,32224,972
2020-10-16,Bosnia and Herzegovina,621,8,32845,980
2020-10-17,Bosnia and Herzegovina,716,1,33561,981
2020-10-18,Bosnia and Herzegovina,551,3,34112,984
2020-10-19,Bosnia and Herzegovina,549,13,34661,997
2020-10-20,Bosnia and Herzegovina,728,20,35389,1017
2020-10-21,Bosnia and Herzegovina,926,14,36315,1031
2020-10-22,Bosnia and Herzegovina,999,20,37314,1051
2020-10-23,Bosnia and Herzegovina,1179,14,38493,1065
2020-10-24,Bosnia and Herzegovina,1265,10,39758,1075
2020-10-25,Bosnia and Herzegovina,1135,11,40893,1086
2020-10-26,Bosnia and Herzegovina,703,18,41596,1104
2020-10-27,Bosnia and Herzegovina,1555,21,43151,1125
2020-10-28,Bosnia and Herzegovina,1586,36,44737,1161
2020-10-29,Bosnia and Herzegovina,1902,21,46639,1182
2020-10-30,Bosnia and Herzegovina,1498,30,48137,1212
2020-10-31,Bosnia and Herzegovina,1953,22,50090,1234
2020-11-01,Bosnia and Herzegovina,1415,14,51505,1248
2020-11-02,Bosnia and Herzegovina,764,32,52269,1280
2020-11-03,Bosnia and Herzegovina,1553,37,53822,1317
2020-11-04,Bosnia and Herzegovina,1776,41,55598,1358
2020-11-05,Bosnia and Herzegovina,1908,44,57506,1402
2020-11-06,Bosnia and Herzegovina,1921,55,59427,1457
2020-11-07,Bosnia and Herzegovina,1785,33,61212,1490
2020-11-08,Bosnia and Herzegovina,1211,20,62423,1510
2020-11-09,Bosnia and Herzegovina,996,73,63419,1583
2020-11-10,Bosnia and Herzegovina,1605,46,65024,1629
2020-11-11,Bosnia and Herzegovina,1541,72,66565,1701
2020-11-12,Bosnia and Herzegovina,1728,49,68293,1750
2020-11-13,Bosnia and Herzegovina,1332,58,69625,1808
2020-11-14,Bosnia and Herzegovina,1275,49,70900,1857
2020-11-15,Bosnia and Herzegovina,1056,32,71956,1889
2020-11-16,Bosnia and Herzegovina,733,84,72689,1973
2020-11-17,Bosnia and Herzegovina,1255,69,73944,2042
2020-11-18,Bosnia and Herzegovina,1633,47,75577,2089
2020-11-19,Bosnia and Herzegovina,1180,64,76757,2153
2020-11-20,Bosnia and Herzegovina,1237,56,77994,2209
2020-11-21,Bosnia and Herzegovina,1315,37,79309,2246
2020-11-22,Bosnia and Herzegovina,697,30,80006,2276
2020-11-23,Bosnia and Herzegovina,547,66,80553,2342
2020-11-24,Bosnia and Herzegovina,1186,52,81739,2394
2020-11-25,Bosnia and Herzegovina,1589,35,83328,2429
2020-11-26,Bosnia and Herzegovina,924,51,84252,2480
2020-11-27,Bosnia and Herzegovina,1179,62,85431,2542
2020-11-28,Bosnia and Herzegovina,1279,34,86710,2576
2020-11-29,Bosnia and Herzegovina,664,44,87374,2620
2020-11-30,Bosnia and Herzegovina,527,61,87901,2681
2020-12-01,Bosnia and Herzegovina,1184,46,89085,2727
2020-12-02,Bosnia and Herzegovina,1293,46,90378,2773
2020-12-03,Bosnia and Herzegovina,1161,39,91539,2812
2020-12-04,Bosnia and Herzegovina,1254,53,92793,2865
2020-12-05,Bosnia and Herzegovina,975,57,93768,2922
2020-12-06,Bosnia and Herzegovina,739,30,94507,2952
2020-12-07,Bosnia and Herzegovina,437,60,94944,3012
2020-12-08,Bosnia and Herzegovina,1077,69,96021,3081
2020-12-09,Bosnia and Herzegovina,1296,70,97317,3151
2020-12-10,Bosnia and Herzegovina,1286,48,98603,3199
2020-12-11,Bosnia and Herzegovina,940,51,99543,3250
2020-12-12,Bosnia and Herzegovina,763,48,100306,3298
2020-12-13,Bosnia and Herzegovina,811,38,101117,3336
2020-12-14,Bosnia and Herzegovina,344,55,101461,3391
2020-12-15,Bosnia and Herzegovina,869,66,102330,3457
2020-12-16,Bosnia and Herzegovina,902,54,103232,3511
2020-12-17,Bosnia and Herzegovina,855,38,104087,3549
2020-12-18,Bosnia and Herzegovina,794,34,104881,3583
2020-12-19,Bosnia and Herzegovina,643,42,105524,3625
2020-12-20,Bosnia and Herzegovina,0,0,105524,3625
2020-12-21,Bosnia and Herzegovina,698,81,106222,3706
2020-12-22,Bosnia and Herzegovina,764,86,106986,3792
2020-12-23,Bosnia and Herzegovina,584,46,107570,3838
2020-12-24,Bosnia and Herzegovina,728,40,108298,3878
2020-12-25,Bosnia and Herzegovina,593,23,108891,3901
2020-12-26,Bosnia and Herzegovina,439,22,109330,3923
2020-12-27,Bosnia and Herzegovina,361,30,109691,3953
2020-12-28,Bosnia and Herzegovina,220,-11,109911,3942
2020-12-29,Bosnia and Herzegovina,543,82,110454,4024
2020-12-30,Bosnia and Herzegovina,531,26,110985,4050
2020-12-31,Bosnia and Herzegovina,0,0,110985,4050
2021-01-01,Bosnia and Herzegovina,1158,36,112143,4086
2021-01-02,Bosnia and Herzegovina,0,0,112143,4086
2021-01-03,Bosnia and Herzegovina,502,45,112645,4131
2021-01-04,Bosnia and Herzegovina,0,0,112645,4131
2021-01-05,Bosnia and Herzegovina,747,80,113392,4211
2021-01-06,Bosnia and Herzegovina,0,0,113392,4211
2021-01-07,Bosnia and Herzegovina,0,0,113392,4211
2021-01-08,Bosnia and Herzegovina,1528,74,114920,4285
2021-01-09,Bosnia and Herzegovina,459,20,115379,4305
2021-01-10,Bosnia and Herzegovina,254,25,115633,4330
2021-01-11,Bosnia and Herzegovina,0,0,115633,4330
2021-01-12,Bosnia and Herzegovina,567,43,116200,4373
2021-01-13,Bosnia and Herzegovina,468,26,116668,4399
2021-01-14,Bosnia and Herzegovina,343,12,117011,4411
2021-01-15,Bosnia and Herzegovina,0,0,117011,4411
2021-01-16,Bosnia and Herzegovina,0,0,117011,4411
2021-01-17,Bosnia and Herzegovina,0,0,117011,4411
2021-01-18,Bosnia and Herzegovina,1072,75,118083,4486
2021-01-19,Bosnia and Herzegovina,300,23,118383,4509
2021-01-20,Bosnia and Herzegovina,334,12,118717,4521
2021-01-21,Bosnia and Herzegovina,489,15,119206,4536
2021-01-22,Bosnia and Herzegovina,214,19,119420,4555
2021-01-23,Bosnia and Herzegovina,0,0,119420,4555
2021-01-24,Bosnia and Herzegovina,0,0,119420,4555
2021-01-25,Bosnia and Herzegovina,723,38,120143,4593
2021-01-26,Bosnia and Herzegovina,389,28,120532,4621
2021-01-27,Bosnia and Herzegovina,332,22,120864,4643
2021-01-28,Bosnia and Herzegovina,330,16,121194,4659
2021-01-29,Bosnia and Herzegovina,303,20,121497,4679
2021-01-30,Bosnia and Herzegovina,0,0,121497,4679
2021-01-31,Bosnia and Herzegovina,0,0,121497,4679
2021-02-01,Bosnia and Herzegovina,702,45,122199,4724
2021-02-02,Bosnia and Herzegovina,262,13,122461,4737
2021-02-03,Bosnia and Herzegovina,367,8,122828,4745
2021-02-04,Bosnia and Herzegovina,0,0,122828,4745
2021-02-05,Bosnia and Herzegovina,606,30,123434,4775
2021-02-06,Bosnia and Herzegovina,0,0,123434,4775
2021-02-07,Bosnia and Herzegovina,0,0,123434,4775
2021-02-08,Bosnia and Herzegovina,667,38,124101,4813
2021-02-09,Bosnia and Herzegovina,342,21,124443,4834
2021-02-10,Bosnia and Herzegovina,253,19,124696,4853
2021-02-11,Bosnia and Herzegovina,427,15,125123,4868
2021-02-12,Bosnia and Herzegovina,279,13,125402,4881
2021-02-13,Bosnia and Herzegovina,0,0,125402,4881
2021-02-14,Bosnia and Herzegovina,0,0,125402,4881
2021-02-15,Bosnia and Herzegovina,737,35,126139,4916
2021-02-16,Bosnia and Herzegovina,274,19,126413,4935
2021-02-17,Bosnia and Herzegovina,368,14,126781,4949
2021-02-18,Bosnia and Herzegovina,354,13,127135,4962
2021-02-19,Bosnia and Herzegovina,402,17,127537,4979
2021-02-20,Bosnia and Herzegovina,0,0,127537,4979
2021-02-21,Bosnia and Herzegovina,0,0,127537,4979
2021-02-22,Bosnia and Herzegovina,1124,37,128661,5016
2021-02-23,Bosnia and Herzegovina,515,18,129176,5034
2021-02-24,Bosnia and Herzegovina,577,17,129753,5051
2021-02-25,Bosnia and Herzegovina,757,11,130510,5062
2021-02-26,Bosnia and Herzegovina,469,9,130979,5071
2021-02-27,Bosnia and Herzegovina,0,0,130979,5071
2021-02-28,Bosnia and Herzegovina,0,0,130979,5071
2021-03-01,Bosnia and Herzegovina,0,0,130979,5071
2021-03-02,Bosnia and Herzegovina,2109,74,133088,5145
2021-03-03,Bosnia and Herzegovina,894,29,133982,5174
2021-03-04,Bosnia and Herzegovina,910,26,134892,5200
2021-03-05,Bosnia and Herzegovina,621,28,135513,5228
2021-03-06,Bosnia and Herzegovina,0,0,135513,5228
2021-03-07,Bosnia and Herzegovina,0,0,135513,5228
2021-03-08,Bosnia and Herzegovina,1778,69,137291,5297
2021-03-09,Bosnia and Herzegovina,1251,48,138542,5345
2021-03-10,Bosnia and Herzegovina,1110,37,139652,5382
2021-03-11,Bosnia and Herzegovina,1338,28,140990,5410
2021-03-12,Bosnia and Herzegovina,1170,36,142160,5446
2021-03-13,Bosnia and Herzegovina,0,0,142160,5446
2021-03-14,Bosnia and Herzegovina,0,0,142160,5446
2021-03-15,Bosnia and Herzegovina,2671,138,144831,5584
2021-03-16,Bosnia and Herzegovina,1606,53,146437,5637
2021-03-17,Bosnia and Herzegovina,1726,35,148163,5672
2021-03-18,Bosnia and Herzegovina,1728,57,149891,5729
2021-03-19,Bosnia and Herzegovina,1446,44,151337,5773
2021-03-20,Bosnia and Herzegovina,0,0,151337,5773
2021-03-21,Bosnia and Herzegovina,0,0,151337,5773
2021-03-22,Bosnia and Herzegovina,3290,165,154627,5938
2021-03-23,Bosnia and Herzegovina,1719,67,156346,6005
2021-03-24,Bosnia and Herzegovina,1852,62,158198,6067
2021-03-25,Bosnia and Herzegovina,1965,77,160163,6144
2021-03-26,Bosnia and Herzegovina,1869,76,162032,6220
2021-03-27,Bosnia and Herzegovina,0,0,162032,6220
2021-03-28,Bosnia and Herzegovina,0,0,162032,6220
2021-03-29,Bosnia and Herzegovina,3755,207,165787,6427
2021-03-30,Bosnia and Herzegovina,1867,92,167654,6519
2021-03-31,Bosnia and Herzegovina,1972,80,169626,6599
2021-04-01,Bosnia and Herzegovina,1698,76,171324,6675
2021-04-02,Bosnia and Herzegovina,2154,88,173478,6763
2021-04-03,Bosnia and Herzegovina,0,0,173478,6763
2021-04-04,Bosnia and Herzegovina,0,0,173478,6763
2021-04-05,Bosnia and Herzegovina,2935,190,176413,6953
2021-04-06,Bosnia and Herzegovina,1093,99,177506,7052
2021-04-07,Bosnia and Herzegovina,1742,80,179248,7132
2021-04-08,Bosnia and Herzegovina,1583,84,180831,7216
2020-03-30,Botswana,3,0,3,0
2020-03-31,Botswana,1,1,4,1
2020-04-01,Botswana,0,0,4,1
2020-04-02,Botswana,0,0,4,1
2020-04-03,Botswana,0,0,4,1
2020-04-04,Botswana,0,0,4,1
2020-04-05,Botswana,2,0,6,1
2020-04-06,Botswana,0,0,6,1
2020-04-07,Botswana,0,0,6,1
2020-04-08,Botswana,0,0,6,1
2020-04-09,Botswana,7,0,13,1
2020-04-10,Botswana,0,0,13,1
2020-04-11,Botswana,0,0,13,1
2020-04-12,Botswana,0,0,13,1
2020-04-13,Botswana,0,0,13,1
2020-04-14,Botswana,0,0,13,1
2020-04-15,Botswana,0,0,13,1
2020-04-16,Botswana,2,0,15,1
2020-04-17,Botswana,0,0,15,1
2020-04-18,Botswana,0,0,15,1
2020-04-19,Botswana,5,0,20,1
2020-04-20,Botswana,0,0,20,1
2020-04-21,Botswana,0,0,20,1
2020-04-22,Botswana,2,0,22,1
2020-04-23,Botswana,0,0,22,1
2020-04-24,Botswana,0,0,22,1
2020-04-25,Botswana,0,0,22,1
2020-04-26,Botswana,0,0,22,1
2020-04-27,Botswana,0,0,22,1
2020-04-28,Botswana,1,0,23,1
2020-04-29,Botswana,0,0,23,1
2020-04-30,Botswana,0,0,23,1
2020-05-01,Botswana,0,0,23,1
2020-05-02,Botswana,0,0,23,1
2020-05-03,Botswana,0,0,23,1
2020-05-04,Botswana,0,0,23,1
2020-05-05,Botswana,0,0,23,1
2020-05-06,Botswana,0,0,23,1
2020-05-07,Botswana,0,0,23,1
2020-05-08,Botswana,0,0,23,1
2020-05-09,Botswana,0,0,23,1
2020-05-10,Botswana,0,0,23,1
2020-05-11,Botswana,1,0,24,1
2020-05-12,Botswana,0,0,24,1
2020-05-13,Botswana,0,0,24,1
2020-05-14,Botswana,0,0,24,1
2020-05-15,Botswana,0,0,24,1
2020-05-16,Botswana,0,0,24,1
2020-05-17,Botswana,1,0,25,1
2020-05-18,Botswana,0,0,25,1
2020-05-19,Botswana,0,0,25,1
2020-05-20,Botswana,0,0,25,1
2020-05-21,Botswana,4,0,29,1
2020-05-22,Botswana,1,0,30,1
2020-05-23,Botswana,0,0,30,1
2020-05-24,Botswana,5,0,35,1
2020-05-25,Botswana,0,0,35,1
2020-05-26,Botswana,0,0,35,1
2020-05-27,Botswana,0,0,35,1
2020-05-28,Botswana,0,0,35,1
2020-05-29,Botswana,0,0,35,1
2020-05-30,Botswana,0,0,35,1
2020-05-31,Botswana,0,0,35,1
2020-06-01,Botswana,3,0,38,1
2020-06-02,Botswana,2,0,40,1
2020-06-03,Botswana,0,0,40,1
2020-06-04,Botswana,0,0,40,1
2020-06-05,Botswana,0,0,40,1
2020-06-06,Botswana,0,0,40,1
2020-06-07,Botswana,0,0,40,1
2020-06-08,Botswana,2,0,42,1
2020-06-09,Botswana,0,0,42,1
2020-06-10,Botswana,6,0,48,1
2020-06-11,Botswana,0,0,48,1
2020-06-12,Botswana,0,0,48,1
2020-06-13,Botswana,12,0,60,1
2020-06-14,Botswana,0,0,60,1
2020-06-15,Botswana,0,0,60,1
2020-06-16,Botswana,0,0,60,1
2020-06-17,Botswana,19,0,79,1
2020-06-18,Botswana,0,0,79,1
2020-06-19,Botswana,10,0,89,1
2020-06-20,Botswana,0,0,89,1
2020-06-21,Botswana,0,0,89,1
2020-06-22,Botswana,0,0,89,1
2020-06-23,Botswana,0,0,89,1
2020-06-24,Botswana,3,0,92,1
2020-06-25,Botswana,0,0,92,1
2020-06-26,Botswana,0,0,92,1
2020-06-27,Botswana,0,0,92,1
2020-06-28,Botswana,0,0,92,1
2020-06-29,Botswana,83,0,175,1
2020-06-30,Botswana,52,0,227,1
2020-07-01,Botswana,0,0,227,1
2020-07-02,Botswana,0,0,227,1
2020-07-03,Botswana,50,0,277,1
2020-07-04,Botswana,0,0,277,1
2020-07-05,Botswana,0,0,277,1
2020-07-06,Botswana,37,0,314,1
2020-07-07,Botswana,0,0,314,1
2020-07-08,Botswana,0,0,314,1
2020-07-09,Botswana,0,0,314,1
2020-07-10,Botswana,0,0,314,1
2020-07-11,Botswana,0,0,314,1
2020-07-12,Botswana,85,0,399,1
2020-07-13,Botswana,0,0,399,1
2020-07-14,Botswana,0,0,399,1
2020-07-15,Botswana,0,0,399,1
2020-07-16,Botswana,123,0,522,1
2020-07-17,Botswana,0,0,522,1
2020-07-18,Botswana,0,0,522,1
2020-07-19,Botswana,0,0,522,1
2020-07-20,Botswana,0,0,522,1
2020-07-21,Botswana,0,0,522,1
2020-07-22,Botswana,0,0,522,1
2020-07-23,Botswana,70,0,592,1
2020-07-24,Botswana,94,0,686,1
2020-07-25,Botswana,0,0,686,1
2020-07-26,Botswana,0,0,686,1
2020-07-27,Botswana,53,1,739,2
2020-07-28,Botswana,0,0,739,2
2020-07-29,Botswana,65,0,804,2
2020-07-30,Botswana,0,0,804,2
2020-07-31,Botswana,0,0,804,2
2020-08-01,Botswana,0,0,804,2
2020-08-02,Botswana,0,0,804,2
2020-08-03,Botswana,0,0,804,2
2020-08-04,Botswana,0,0,804,2
2020-08-05,Botswana,0,0,804,2
2020-08-06,Botswana,0,0,804,2
2020-08-07,Botswana,0,0,804,2
2020-08-08,Botswana,0,0,804,2
2020-08-09,Botswana,0,0,804,2
2020-08-10,Botswana,262,0,1066,2
2020-08-11,Botswana,0,0,1066,2
2020-08-12,Botswana,0,0,1066,2
2020-08-13,Botswana,148,1,1214,3
2020-08-14,Botswana,0,0,1214,3
2020-08-15,Botswana,0,0,1214,3
2020-08-16,Botswana,0,0,1214,3
2020-08-17,Botswana,94,0,1308,3
2020-08-18,Botswana,0,0,1308,3
2020-08-19,Botswana,0,0,1308,3
2020-08-20,Botswana,0,0,1308,3
2020-08-21,Botswana,0,0,1308,3
2020-08-22,Botswana,0,0,1308,3
2020-08-23,Botswana,0,0,1308,3
2020-08-24,Botswana,254,0,1562,3
2020-08-25,Botswana,0,0,1562,3
2020-08-26,Botswana,0,0,1562,3
2020-08-27,Botswana,0,0,1562,3
2020-08-28,Botswana,0,0,1562,3
2020-08-29,Botswana,0,0,1562,3
2020-08-30,Botswana,71,3,1633,6
2020-08-31,Botswana,0,0,1633,6
2020-09-01,Botswana,91,0,1724,6
2020-09-02,Botswana,0,0,1724,6
2020-09-03,Botswana,0,0,1724,6
2020-09-04,Botswana,278,2,2002,8
2020-09-05,Botswana,0,0,2002,8
2020-09-06,Botswana,0,0,2002,8
2020-09-07,Botswana,124,1,2126,9
2020-09-08,Botswana,0,0,2126,9
2020-09-09,Botswana,0,0,2126,9
2020-09-10,Botswana,126,1,2252,10
2020-09-11,Botswana,0,0,2252,10
2020-09-12,Botswana,0,0,2252,10
2020-09-13,Botswana,0,0,2252,10
2020-09-14,Botswana,211,1,2463,11
2020-09-15,Botswana,0,0,2463,11
2020-09-16,Botswana,0,0,2463,11
2020-09-17,Botswana,104,2,2567,13
2020-09-18,Botswana,0,0,2567,13
2020-09-19,Botswana,0,0,2567,13
2020-09-20,Botswana,0,0,2567,13
2020-09-21,Botswana,0,0,2567,13
2020-09-22,Botswana,0,0,2567,13
2020-09-23,Botswana,0,0,2567,13
2020-09-24,Botswana,354,3,2921,16
2020-09-25,Botswana,0,0,2921,16
2020-09-26,Botswana,0,0,2921,16
2020-09-27,Botswana,0,0,2921,16
2020-09-28,Botswana,251,0,3172,16
2020-09-29,Botswana,0,0,3172,16
2020-09-30,Botswana,0,0,3172,16
2020-10-01,Botswana,0,0,3172,16
2020-10-02,Botswana,0,0,3172,16
2020-10-03,Botswana,0,0,3172,16
2020-10-04,Botswana,0,0,3172,16
2020-10-05,Botswana,0,0,3172,16
2020-10-06,Botswana,0,2,3172,18
2020-10-07,Botswana,0,0,3172,18
2020-10-08,Botswana,47,0,3219,18
2020-10-09,Botswana,0,0,3219,18
2020-10-10,Botswana,0,0,3219,18
2020-10-11,Botswana,0,0,3219,18
2020-10-12,Botswana,296,2,3515,20
2020-10-13,Botswana,0,0,3515,20
2020-10-14,Botswana,0,0,3515,20
2020-10-15,Botswana,399,0,3914,20
2020-10-16,Botswana,1328,0,5242,20
2020-10-17,Botswana,0,0,5242,20
2020-10-18,Botswana,0,0,5242,20
2020-10-19,Botswana,367,1,5609,21
2020-10-20,Botswana,0,0,5609,21
2020-10-21,Botswana,0,0,5609,21
2020-10-22,Botswana,314,0,5923,21
2020-10-23,Botswana,0,0,5923,21
2020-10-24,Botswana,0,0,5923,21
2020-10-25,Botswana,0,0,5923,21
2020-10-26,Botswana,360,0,6283,21
2020-10-27,Botswana,0,0,6283,21
2020-10-28,Botswana,0,0,6283,21
2020-10-29,Botswana,359,3,6642,24
2020-10-30,Botswana,0,0,6642,24
2020-10-31,Botswana,0,0,6642,24
2020-11-01,Botswana,0,0,6642,24
2020-11-02,Botswana,0,0,6642,24
2020-11-03,Botswana,0,0,6642,24
2020-11-04,Botswana,0,0,6642,24
2020-11-05,Botswana,1193,3,7835,27
2020-11-06,Botswana,0,0,7835,27
2020-11-07,Botswana,0,0,7835,27
2020-11-08,Botswana,0,0,7835,27
2020-11-09,Botswana,0,0,7835,27
2020-11-10,Botswana,0,0,7835,27
2020-11-11,Botswana,0,0,7835,27
2020-11-12,Botswana,390,0,8225,27
2020-11-13,Botswana,0,0,8225,27
2020-11-14,Botswana,0,0,8225,27
2020-11-15,Botswana,0,0,8225,27
2020-11-16,Botswana,878,3,9103,30
2020-11-17,Botswana,0,0,9103,30
2020-11-18,Botswana,0,0,9103,30
2020-11-19,Botswana,491,1,9594,31
2020-11-20,Botswana,0,0,9594,31
2020-11-21,Botswana,0,0,9594,31
2020-11-22,Botswana,0,0,9594,31
2020-11-23,Botswana,398,0,9992,31
2020-11-24,Botswana,0,0,9992,31
2020-11-25,Botswana,0,0,9992,31
2020-11-26,Botswana,266,0,10258,31
2020-11-27,Botswana,0,0,10258,31
2020-11-28,Botswana,0,0,10258,31
2020-11-29,Botswana,0,0,10258,31
2020-11-30,Botswana,484,3,10742,34
2020-12-01,Botswana,0,0,10742,34
2020-12-02,Botswana,0,0,10742,34
2020-12-03,Botswana,789,0,11531,34
2020-12-04,Botswana,0,0,11531,34
2020-12-05,Botswana,0,0,11531,34
2020-12-06,Botswana,0,0,11531,34
2020-12-07,Botswana,527,2,12058,36
2020-12-08,Botswana,0,0,12058,36
2020-12-09,Botswana,0,0,12058,36
2020-12-10,Botswana,443,1,12501,37
2020-12-11,Botswana,0,0,12501,37
2020-12-12,Botswana,0,0,12501,37
2020-12-13,Botswana,0,0,12501,37
2020-12-14,Botswana,372,1,12873,38
2020-12-15,Botswana,0,0,12873,38
2020-12-16,Botswana,0,0,12873,38
2020-12-17,Botswana,141,0,13014,38
2020-12-18,Botswana,0,0,13014,38
2020-12-19,Botswana,0,0,13014,38
2020-12-20,Botswana,0,0,13014,38
2020-12-21,Botswana,608,0,13622,38
2020-12-22,Botswana,0,0,13622,38
2020-12-23,Botswana,0,0,13622,38
2020-12-24,Botswana,403,2,14025,40
2020-12-25,Botswana,0,0,14025,40
2020-12-26,Botswana,0,0,14025,40
2020-12-27,Botswana,0,0,14025,40
2020-12-28,Botswana,0,0,14025,40
2020-12-29,Botswana,0,0,14025,40
2020-12-30,Botswana,675,0,14700,40
2020-12-31,Botswana,105,2,14805,42
2021-01-01,Botswana,0,0,14805,42
2021-01-02,Botswana,0,0,14805,42
2021-01-03,Botswana,0,0,14805,42
2021-01-04,Botswana,563,3,15368,45
2021-01-05,Botswana,72,0,15440,45
2021-01-06,Botswana,0,0,15440,45
2021-01-07,Botswana,610,3,16050,48
2021-01-08,Botswana,0,0,16050,48
2021-01-09,Botswana,0,0,16050,48
2021-01-10,Botswana,0,0,16050,48
2021-01-11,Botswana,718,11,16768,59
2021-01-12,Botswana,0,0,16768,59
2021-01-13,Botswana,0,0,16768,59
2021-01-14,Botswana,597,12,17365,71
2021-01-15,Botswana,0,0,17365,71
2021-01-16,Botswana,0,0,17365,71
2021-01-17,Botswana,0,0,17365,71
2021-01-18,Botswana,1265,17,18630,88
2021-01-19,Botswana,0,0,18630,88
2021-01-20,Botswana,0,0,18630,88
2021-01-21,Botswana,1024,17,19654,105
2021-01-22,Botswana,0,0,19654,105
2021-01-23,Botswana,0,0,19654,105
2021-01-24,Botswana,0,0,19654,105
2021-01-25,Botswana,1004,19,20658,124
2021-01-26,Botswana,0,0,20658,124
2021-01-27,Botswana,0,0,20658,124
2021-01-28,Botswana,635,10,21293,134
2021-01-29,Botswana,0,0,21293,134
2021-01-30,Botswana,0,0,21293,134
2021-01-31,Botswana,0,0,21293,134
2021-02-01,Botswana,1445,14,22738,148
2021-02-02,Botswana,0,0,22738,148
2021-02-03,Botswana,0,0,22738,148
2021-02-04,Botswana,765,15,23503,163
2021-02-05,Botswana,0,0,23503,163
2021-02-06,Botswana,0,0,23503,163
2021-02-07,Botswana,0,0,23503,163
2021-02-08,Botswana,932,16,24435,179
2021-02-09,Botswana,0,0,24435,179
2021-02-10,Botswana,0,0,24435,179
2021-02-11,Botswana,491,23,24926,202
2021-02-12,Botswana,0,0,24926,202
2021-02-13,Botswana,0,0,24926,202
2021-02-14,Botswana,0,0,24926,202
2021-02-15,Botswana,876,24,25802,226
2021-02-16,Botswana,0,0,25802,226
2021-02-17,Botswana,0,0,25802,226
2021-02-18,Botswana,722,28,26524,254
2021-02-19,Botswana,0,0,26524,254
2021-02-20,Botswana,0,0,26524,254
2021-02-21,Botswana,0,0,26524,254
2021-02-22,Botswana,1197,46,27721,300
2021-02-23,Botswana,0,0,27721,300
2021-02-24,Botswana,0,0,27721,300
2021-02-25,Botswana,650,10,28371,310
2021-02-26,Botswana,0,0,28371,310
2021-02-27,Botswana,0,0,28371,310
2021-02-28,Botswana,0,0,28371,310
2021-03-01,Botswana,2356,22,30727,332
2021-03-02,Botswana,0,0,30727,332
2021-03-03,Botswana,0,0,30727,332
2021-03-04,Botswana,1019,27,31746,359
2021-03-05,Botswana,0,0,31746,359
2021-03-06,Botswana,0,0,31746,359
2021-03-07,Botswana,0,0,31746,359
2021-03-08,Botswana,1166,54,32912,413
2021-03-09,Botswana,0,0,32912,413
2021-03-10,Botswana,0,0,32912,413
2021-03-11,Botswana,1186,11,34098,424
2021-03-12,Botswana,0,0,34098,424
2021-03-13,Botswana,0,0,34098,424
2021-03-14,Botswana,0,0,34098,424
2021-03-15,Botswana,901,23,34999,447
2021-03-16,Botswana,0,0,34999,447
2021-03-17,Botswana,0,0,34999,447
2021-03-18,Botswana,494,11,35493,458
2021-03-19,Botswana,0,0,35493,458
2021-03-20,Botswana,0,0,35493,458
2021-03-21,Botswana,0,0,35493,458
2021-03-22,Botswana,2066,27,37559,485
2021-03-23,Botswana,0,0,37559,485
2021-03-24,Botswana,0,0,37559,485
2021-03-25,Botswana,907,21,38466,506
2021-03-26,Botswana,0,0,38466,506
2021-03-27,Botswana,0,0,38466,506
2021-03-28,Botswana,0,0,38466,506
2021-03-29,Botswana,1382,62,39848,568
2021-03-30,Botswana,0,0,39848,568
2021-03-31,Botswana,0,0,39848,568
2021-04-01,Botswana,1030,23,40878,591
2021-04-02,Botswana,0,0,40878,591
2021-04-03,Botswana,0,0,40878,591
2021-04-04,Botswana,0,0,40878,591
2021-04-05,Botswana,832,25,41710,616
2021-04-06,Botswana,0,0,41710,616
2021-04-07,Botswana,0,0,41710,616
2021-04-08,Botswana,0,0,41710,616
2020-02-26,Brazil,1,0,1,0
2020-02-27,Brazil,0,0,1,0
2020-02-28,Brazil,0,0,1,0
2020-02-29,Brazil,1,0,2,0
2020-03-01,Brazil,0,0,2,0
2020-03-02,Brazil,0,0,2,0
2020-03-03,Brazil,0,0,2,0
2020-03-04,Brazil,2,0,4,0
2020-03-05,Brazil,0,0,4,0
2020-03-06,Brazil,9,0,13,0
2020-03-07,Brazil,0,0,13,0
2020-03-08,Brazil,7,0,20,0
2020-03-09,Brazil,5,0,25,0
2020-03-10,Brazil,6,0,31,0
2020-03-11,Brazil,7,0,38,0
2020-03-12,Brazil,14,0,52,0
2020-03-13,Brazil,99,0,151,0
2020-03-14,Brazil,0,0,151,0
2020-03-15,Brazil,11,0,162,0
2020-03-16,Brazil,38,0,200,0
2020-03-17,Brazil,121,1,321,1
2020-03-18,Brazil,51,2,372,3
2020-03-19,Brazil,249,3,621,6
2020-03-20,Brazil,172,5,793,11
2020-03-21,Brazil,228,4,1021,15
2020-03-22,Brazil,525,10,1546,25
2020-03-23,Brazil,378,9,1924,34
2020-03-24,Brazil,323,12,2247,46
2020-03-25,Brazil,307,13,2554,59
2020-03-26,Brazil,431,18,2985,77
2020-03-27,Brazil,432,15,3417,92
2020-03-28,Brazil,487,19,3904,111
2020-03-29,Brazil,352,25,4256,136
2020-03-30,Brazil,323,23,4579,159
2020-03-31,Brazil,1138,42,5717,201
2020-04-01,Brazil,1119,39,6836,240
2020-04-02,Brazil,1208,84,8044,324
2020-04-03,Brazil,1012,35,9056,359
2020-04-04,Brazil,1304,86,10360,445
2020-04-05,Brazil,770,41,11130,486
2020-04-06,Brazil,1031,78,12161,564
2020-04-07,Brazil,1873,122,14034,686
2020-04-08,Brazil,2136,133,16170,819
2020-04-09,Brazil,1922,131,18092,950
2020-04-10,Brazil,1546,107,19638,1057
2020-04-11,Brazil,1089,67,20727,1124
2020-04-12,Brazil,1465,99,22192,1223
2020-04-13,Brazil,1238,105,23430,1328
2020-04-14,Brazil,1832,204,25262,1532
2020-04-15,Brazil,3058,204,28320,1736
2020-04-16,Brazil,2105,188,30425,1924
2020-04-17,Brazil,3257,217,33682,2141
2020-04-18,Brazil,2976,213,36658,2354
2020-04-19,Brazil,1996,108,38654,2462
2020-04-20,Brazil,2089,125,40743,2587
2020-04-21,Brazil,2336,154,43079,2741
2020-04-22,Brazil,2678,165,45757,2906
2020-04-23,Brazil,4279,425,50036,3331
2020-04-24,Brazil,4007,373,54043,3704
2020-04-25,Brazil,5281,353,59324,4057
2020-04-26,Brazil,3776,229,63100,4286
2020-04-27,Brazil,4346,317,67446,4603
2020-04-28,Brazil,5789,480,73235,5083
2020-04-29,Brazil,6450,430,79685,5513
2020-04-30,Brazil,7502,493,87187,6006
2020-05-01,Brazil,5015,406,92202,6412
2020-05-02,Brazil,4898,349,97100,6761
2020-05-03,Brazil,4726,290,101826,7051
2020-05-04,Brazil,6794,316,108620,7367
2020-05-05,Brazil,6835,571,115455,7938
2020-05-06,Brazil,11156,650,126611,8588
2020-05-07,Brazil,9162,602,135773,9190
2020-05-08,Brazil,11121,827,146894,10017
2020-05-09,Brazil,9167,639,156061,10656
2020-05-10,Brazil,6638,467,162699,11123
2020-05-11,Brazil,6895,530,169594,11653
2020-05-12,Brazil,8620,808,178214,12461
2020-05-13,Brazil,11923,779,190137,13240
2020-05-14,Brazil,13028,759,203165,13999
2020-05-15,Brazil,17126,963,220291,14962
2020-05-16,Brazil,13220,700,233511,15662
2020-05-17,Brazil,7569,456,241080,16118
2020-05-18,Brazil,14288,735,255368,16853
2020-05-19,Brazil,16517,1130,271885,17983
2020-05-20,Brazil,19694,876,291579,18859
2020-05-21,Brazil,18508,1188,310087,20047
2020-05-22,Brazil,20803,1001,330890,21048
2020-05-23,Brazil,16508,965,347398,22013
2020-05-24,Brazil,15813,653,363211,22666
2020-05-25,Brazil,11687,807,374898,23473
2020-05-26,Brazil,16324,1039,391222,24512
2020-05-27,Brazil,20599,1086,411821,25598
2020-05-28,Brazil,26417,1156,438238,26754
2020-05-29,Brazil,26928,1124,465166,27878
2020-05-30,Brazil,33274,956,498440,28834
2020-05-31,Brazil,16409,480,514849,29314
2020-06-01,Brazil,11598,623,526447,29937
2020-06-02,Brazil,28936,1262,555383,31199
2020-06-03,Brazil,28633,1349,584016,32548
2020-06-04,Brazil,30925,1473,614941,34021
2020-06-05,Brazil,30830,1005,645771,35026
2020-06-06,Brazil,27075,904,672846,35930
2020-06-07,Brazil,18912,525,691758,36455
2020-06-08,Brazil,15654,679,707412,37134
2020-06-09,Brazil,32091,1272,739503,38406
2020-06-10,Brazil,32913,1274,772416,39680
2020-06-11,Brazil,30412,1239,802828,40919
2020-06-12,Brazil,25982,909,828810,41828
2020-06-13,Brazil,21704,892,850514,42720
2020-06-14,Brazil,17110,612,867624,43332
2020-06-15,Brazil,20647,627,888271,43959
2020-06-16,Brazil,34918,1282,923189,45241
2020-06-17,Brazil,32188,1269,955377,46510
2020-06-18,Brazil,22765,1238,978142,47748
2020-06-19,Brazil,54771,1206,1032913,48954
2020-06-20,Brazil,34666,1022,1067579,49976
2020-06-21,Brazil,15762,615,1083341,50591
2020-06-22,Brazil,23129,680,1106470,51271
2020-06-23,Brazil,39436,1374,1145906,52645
2020-06-24,Brazil,42725,1185,1188631,53830
2020-06-25,Brazil,39483,1141,1228114,54971
2020-06-26,Brazil,46860,990,1274974,55961
2020-06-27,Brazil,38693,1109,1313667,57070
2020-06-28,Brazil,30476,552,1344143,57622
2020-06-29,Brazil,24052,692,1368195,58314
2020-06-30,Brazil,33846,1280,1402041,59594
2020-07-01,Brazil,46712,1038,1448753,60632
2020-07-02,Brazil,48105,1252,1496858,61884
2020-07-03,Brazil,42223,1290,1539081,63174
2020-07-04,Brazil,37923,1091,1577004,64265
2020-07-05,Brazil,26051,602,1603055,64867
2020-07-06,Brazil,20229,620,1623284,65487
2020-07-07,Brazil,45305,1254,1668589,66741
2020-07-08,Brazil,44571,1223,1713160,67964
2020-07-09,Brazil,42619,1220,1755779,69184
2020-07-10,Brazil,45048,1214,1800827,70398
2020-07-11,Brazil,39023,1071,1839850,71469
2020-07-12,Brazil,24831,631,1864681,72100
2020-07-13,Brazil,20286,733,1884967,72833
2020-07-14,Brazil,41857,1300,1926824,74133
2020-07-15,Brazil,39924,1233,1966748,75366
2020-07-16,Brazil,45403,1322,2012151,76688
2020-07-17,Brazil,34177,1163,2046328,77851
2020-07-18,Brazil,28532,921,2074860,78772
2020-07-19,Brazil,23529,716,2098389,79488
2020-07-20,Brazil,20257,632,2118646,80120
2020-07-21,Brazil,41008,1367,2159654,81487
2020-07-22,Brazil,67860,1284,2227514,82771
2020-07-23,Brazil,59961,1311,2287475,84082
2020-07-24,Brazil,55891,1156,2343366,85238
2020-07-25,Brazil,51147,1211,2394513,86449
2020-07-26,Brazil,24578,555,2419091,87004
2020-07-27,Brazil,23284,614,2442375,87618
2020-07-28,Brazil,40816,921,2483191,88539
2020-07-29,Brazil,69074,1595,2552265,90134
2020-07-30,Brazil,57837,1129,2610102,91263
2020-07-31,Brazil,52383,1212,2662485,92475
2020-08-01,Brazil,45392,1088,2707877,93563
2020-08-02,Brazil,25800,541,2733677,94104
2020-08-03,Brazil,16641,561,2750318,94665
2020-08-04,Brazil,51603,1154,2801921,95819
2020-08-05,Brazil,57152,1437,2859073,97256
2020-08-06,Brazil,53139,1237,2912212,98493
2020-08-07,Brazil,50230,1079,2962442,99572
2020-08-08,Brazil,49970,905,3012412,100477
2020-08-09,Brazil,23010,572,3035422,101049
2020-08-10,Brazil,22048,703,3057470,101752
2020-08-11,Brazil,52160,1274,3109630,103026
2020-08-12,Brazil,55155,1175,3164785,104201
2020-08-13,Brazil,60091,1262,3224876,105463
2020-08-14,Brazil,50644,1060,3275520,106523
2020-08-15,Brazil,41576,709,3317096,107232
2020-08-16,Brazil,23101,620,3340197,107852
2020-08-17,Brazil,19373,684,3359570,108536
2020-08-18,Brazil,47784,1352,3407354,109888
2020-08-19,Brazil,49298,1212,3456652,111100
2020-08-20,Brazil,45323,1204,3501975,112304
2020-08-21,Brazil,30355,1054,3532330,113358
2020-08-22,Brazil,50032,892,3582362,114250
2020-08-23,Brazil,23421,494,3605783,114744
2020-08-24,Brazil,17078,565,3622861,115309
2020-08-25,Brazil,47134,1271,3669995,116580
2020-08-26,Brazil,47161,1085,3717156,117665
2020-08-27,Brazil,44235,984,3761391,118649
2020-08-28,Brazil,43412,855,3804803,119504
2020-08-29,Brazil,41350,758,3846153,120262
2020-08-30,Brazil,16158,566,3862311,120828
2020-08-31,Brazil,45961,553,3908272,121381
2020-09-01,Brazil,42659,1215,3950931,122596
2020-09-02,Brazil,46934,1184,3997865,123780
2020-09-03,Brazil,43773,834,4041638,124614
2020-09-04,Brazil,50163,888,4091801,125502
2020-09-05,Brazil,31199,701,4123000,126203
2020-09-06,Brazil,14521,447,4137521,126650
2020-09-07,Brazil,10273,310,4147794,126960
2020-09-08,Brazil,14279,504,4162073,127464
2020-09-09,Brazil,35816,1075,4197889,128539
2020-09-10,Brazil,40557,983,4238446,129522
2020-09-11,Brazil,43718,874,4282164,130396
2020-09-12,Brazil,33523,814,4315687,131210
2020-09-13,Brazil,14768,415,4330455,131625
2020-09-14,Brazil,15155,381,4345610,132006
2020-09-15,Brazil,36653,1113,4382263,133119
2020-09-16,Brazil,36820,987,4419083,134106
2020-09-17,Brazil,36303,829,4455386,134935
2020-09-18,Brazil,39797,858,4495183,135793
2020-09-19,Brazil,33057,739,4528240,136532
2020-09-20,Brazil,16389,363,4544629,136895
2020-09-21,Brazil,13411,377,4558040,137272
2020-09-22,Brazil,33324,833,4591364,138105
2020-09-23,Brazil,0,0,4591364,138105
2020-09-24,Brazil,66338,1703,4657702,139808
2020-09-25,Brazil,31911,729,4689613,140537
2020-09-26,Brazil,28378,869,4717991,141406
2020-09-27,Brazil,14318,335,4732309,141741
2020-09-28,Brazil,13155,317,4745464,142058
2020-09-29,Brazil,32058,863,4777522,142921
2020-09-30,Brazil,33413,1031,4810935,143952
2020-10-01,Brazil,36157,728,4847092,144680
2020-10-02,Brazil,0,0,4847092,144680
2020-10-03,Brazil,59741,1307,4906833,145987
2020-10-04,Brazil,8456,365,4915289,146352
2020-10-05,Brazil,11946,323,4927235,146675
2020-10-06,Brazil,41906,819,4969141,147494
2020-10-07,Brazil,31553,734,5000694,148228
2020-10-08,Brazil,27750,729,5028444,148957
2020-10-09,Brazil,27444,682,5055888,149639
2020-10-10,Brazil,26749,559,5082637,150198
2020-10-11,Brazil,12342,290,5094979,150488
2020-10-12,Brazil,8429,201,5103408,150689
2020-10-13,Brazil,10220,309,5113628,150998
2020-10-14,Brazil,27235,749,5140863,151747
2020-10-15,Brazil,28523,713,5169386,152460
2020-10-16,Brazil,30914,754,5200300,153214
2020-10-17,Brazil,24062,461,5224362,153675
2020-10-18,Brazil,0,0,5224362,153675
2020-10-19,Brazil,26365,501,5250727,154176
2020-10-20,Brazil,23227,661,5273954,154837
2020-10-21,Brazil,24818,566,5298772,155403
2020-10-22,Brazil,24858,497,5323630,155900
2020-10-23,Brazil,30026,571,5353656,156471
2020-10-24,Brazil,26979,432,5380635,156903
2020-10-25,Brazil,13493,231,5394128,157134
2020-10-26,Brazil,15726,263,5409854,157397
2020-10-27,Brazil,29787,549,5439641,157946
2020-10-28,Brazil,28629,510,5468270,158456
2020-10-29,Brazil,26106,513,5494376,158969
2020-10-30,Brazil,22282,508,5516658,159477
2020-10-31,Brazil,18947,407,5535605,159884
2020-11-01,Brazil,10100,190,5545705,160074
2020-11-02,Brazil,8501,179,5554206,160253
2020-11-03,Brazil,11843,243,5566049,160496
2020-11-04,Brazil,23976,610,5590025,161106
2020-11-05,Brazil,0,0,5590025,161106
2020-11-06,Brazil,41156,909,5631181,162015
2020-11-07,Brazil,22380,254,5653561,162269
2020-11-08,Brazil,10554,128,5664115,162397
2020-11-09,Brazil,10917,231,5675032,162628
2020-11-10,Brazil,23973,174,5699005,162802
2020-11-11,Brazil,48655,566,5747660,163368
2020-11-12,Brazil,33922,913,5781582,164281
2020-11-13,Brazil,29070,456,5810652,164737
2020-11-14,Brazil,38307,921,5848959,165658
2020-11-15,Brazil,14134,140,5863093,165798
2020-11-16,Brazil,13371,216,5876464,166014
2020-11-17,Brazil,35294,685,5911758,166699
2020-11-18,Brazil,34091,756,5945849,167455
2020-11-19,Brazil,35918,606,5981767,168061
2020-11-20,Brazil,38397,552,6020164,168613
2020-11-21,Brazil,32622,376,6052786,168989
2020-11-22,Brazil,18615,194,6071401,169183
2020-11-23,Brazil,16207,302,6087608,169485
2020-11-24,Brazil,31100,630,6118708,170115
2020-11-25,Brazil,47898,654,6166606,170769
2020-11-26,Brazil,37614,691,6204220,171460
2020-11-27,Brazil,34130,514,6238350,171974
2020-11-28,Brazil,51922,587,6290272,172561
2020-11-29,Brazil,24468,272,6314740,172833
2020-11-30,Brazil,21138,287,6335878,173120
2020-12-01,Brazil,50909,697,6386787,173817
2020-12-02,Brazil,49863,698,6436650,174515
2020-12-03,Brazil,50434,755,6487084,175270
2020-12-04,Brazil,46884,694,6533968,175964
2020-12-05,Brazil,43209,664,6577177,176628
2020-12-06,Brazil,26363,313,6603540,176941
2020-12-07,Brazil,20371,376,6623911,177317
2020-12-08,Brazil,51088,842,6674999,178159
2020-12-09,Brazil,53453,836,6728452,178995
2020-12-10,Brazil,53347,770,6781799,179765
2020-12-11,Brazil,54428,672,6836227,180437
2020-12-12,Brazil,43900,686,6880127,181123
2020-12-13,Brazil,21825,279,6901952,181402
2020-12-14,Brazil,25193,433,6927145,181835
2020-12-15,Brazil,42889,964,6970034,182799
2020-12-16,Brazil,70574,936,7040608,183735
2020-12-17,Brazil,69826,1092,7110434,184827
2020-12-18,Brazil,52544,823,7162978,185650
2020-12-19,Brazil,50177,706,7213155,186356
2020-12-20,Brazil,25445,408,7238600,186764
2020-12-21,Brazil,25019,527,7263619,187291
2020-12-22,Brazil,55202,968,7318821,188259
2020-12-23,Brazil,46696,961,7365517,189220
2020-12-24,Brazil,58428,762,7423945,189982
2020-12-25,Brazil,24615,506,7448560,190488
2020-12-26,Brazil,17246,307,7465806,190795
2020-12-27,Brazil,18479,344,7484285,191139
2020-12-28,Brazil,20548,431,7504833,191570
2020-12-29,Brazil,58718,1111,7563551,192681
2020-12-30,Brazil,55649,1194,7619200,193875
2020-12-31,Brazil,56773,1074,7675973,194949
2021-01-01,Brazil,24605,462,7700578,195411
2021-01-02,Brazil,15827,314,7716405,195725
2021-01-03,Brazil,17341,293,7733746,196018
2021-01-04,Brazil,20006,543,7753752,196561
2021-01-05,Brazil,56648,1171,7810400,197732
2021-01-06,Brazil,63430,1242,7873830,198974
2021-01-07,Brazil,87843,1524,7961673,200498
2021-01-08,Brazil,52035,962,8013708,201460
2021-01-09,Brazil,62290,1171,8075998,202631
2021-01-10,Brazil,29792,469,8105790,203100
2021-01-11,Brazil,25822,480,8131612,203580
2021-01-12,Brazil,64025,1110,8195637,204690
2021-01-13,Brazil,60899,1274,8256536,205964
2021-01-14,Brazil,67758,1131,8324294,207095
2021-01-15,Brazil,69198,1151,8393492,208246
2021-01-16,Brazil,61567,1050,8455059,209296
2021-01-17,Brazil,33040,551,8488099,209847
2021-01-18,Brazil,23671,452,8511770,210299
2021-01-19,Brazil,62094,1192,8573864,211491
2021-01-20,Brazil,64385,1340,8638249,212831
2021-01-21,Brazil,59119,1316,8697368,214147
2021-01-22,Brazil,56552,1096,8753920,215243
2021-01-23,Brazil,62334,1202,8816254,216445
2021-01-24,Brazil,28323,592,8844577,217037
2021-01-25,Brazil,26816,627,8871393,217664
2021-01-26,Brazil,61963,1214,8933356,218878
2021-01-27,Brazil,63520,1283,8996876,220161
2021-01-28,Brazil,61811,1386,9058687,221547
2021-01-29,Brazil,59826,1119,9118513,222666
2021-01-30,Brazil,58462,1279,9176975,223945
2021-01-31,Brazil,27756,559,9204731,224504
2021-02-01,Brazil,24591,595,9229322,225099
2021-02-02,Brazil,54096,1210,9283418,226309
2021-02-03,Brazil,56002,1254,9339420,227563
2021-02-04,Brazil,56873,1232,9396293,228795
2021-02-05,Brazil,50872,1239,9447165,230034
2021-02-06,Brazil,0,0,9447165,230034
2021-02-07,Brazil,77475,1500,9524640,231534
2021-02-08,Brazil,0,0,9524640,231534
2021-02-09,Brazil,74925,1986,9599565,233520
2021-02-10,Brazil,59602,1330,9659167,234850
2021-02-11,Brazil,54742,1351,9713909,236201
2021-02-12,Brazil,51546,1288,9765455,237489
2021-02-13,Brazil,44299,1043,9809754,238532
2021-02-14,Brazil,24759,713,9834513,239245
2021-02-15,Brazil,32197,528,9866710,239773
2021-02-16,Brazil,55271,1167,9921981,240940
2021-02-17,Brazil,56766,1150,9978747,242090
2021-02-18,Brazil,51879,1367,10030626,243457
2021-02-19,Brazil,53582,1280,10084208,244737
2021-02-20,Brazil,54940,1240,10139148,245977
2021-02-21,Brazil,29026,527,10168174,246504
2021-02-22,Brazil,26986,639,10195160,247143
2021-02-23,Brazil,62715,1386,10257875,248529
2021-02-24,Brazil,66588,1428,10324463,249957
2021-02-25,Brazil,65998,1541,10390461,251498
2021-02-26,Brazil,65169,1337,10455630,252835
2021-02-27,Brazil,61602,1386,10517232,254221
2021-02-28,Brazil,34027,721,10551259,254942
2021-03-01,Brazil,35742,778,10587001,255720
2021-03-02,Brazil,59925,1641,10646926,257361
2021-03-03,Brazil,71704,1910,10718630,259271
2021-03-04,Brazil,75102,1699,10793732,260970
2021-03-05,Brazil,75495,1800,10869227,262770
2021-03-06,Brazil,69609,1555,10938836,264325
2021-03-07,Brazil,80508,1086,11019344,265411
2021-03-08,Brazil,32321,987,11051665,266398
2021-03-09,Brazil,70764,1972,11122429,268370
2021-03-10,Brazil,79876,2286,11202305,270656
2021-03-11,Brazil,75412,2233,11277717,272889
2021-03-12,Brazil,85663,2216,11363380,275105
2021-03-13,Brazil,76178,1997,11439558,277102
2021-03-14,Brazil,43812,1127,11483370,278229
2021-03-15,Brazil,36239,1057,11519609,279286
2021-03-16,Brazil,83926,2841,11603535,282127
2021-03-17,Brazil,90303,2648,11693838,284775
2021-03-18,Brazil,86982,2724,11780820,287499
2021-03-19,Brazil,90570,2815,11871390,290314
2021-03-20,Brazil,79069,2438,11950459,292752
2021-03-21,Brazil,47774,1290,11998233,294042
2021-03-22,Brazil,49293,1383,12047526,295425
2021-03-23,Brazil,82493,3251,12130019,298676
2021-03-24,Brazil,89992,2009,12220011,300685
2021-03-25,Brazil,100158,2777,12320169,303462
2021-03-26,Brazil,84245,3650,12404414,307112
2021-03-27,Brazil,85948,3438,12490362,310550
2021-03-28,Brazil,44326,1656,12534688,312206
2021-03-29,Brazil,38927,1660,12573615,313866
2021-03-30,Brazil,84494,3780,12658109,317646
2021-03-31,Brazil,90638,3869,12748747,321515
2021-04-01,Brazil,91097,3769,12839844,325284
2021-04-02,Brazil,70238,2922,12910082,328206
2021-04-03,Brazil,43515,1987,12953597,330193
2021-04-04,Brazil,31359,1240,12984956,331433
2021-04-05,Brazil,28645,1319,13013601,332752
2021-04-06,Brazil,86979,4195,13100580,336947
2021-04-07,Brazil,92625,3829,13193205,340776
2021-04-08,Brazil,86652,4249,13279857,345025
2020-03-09,Brunei,1,0,1,0
2020-03-10,Brunei,0,0,1,0
2020-03-11,Brunei,10,0,11,0
2020-03-12,Brunei,0,0,11,0
2020-03-13,Brunei,26,0,37,0
2020-03-14,Brunei,3,0,40,0
2020-03-15,Brunei,10,0,50,0
2020-03-16,Brunei,4,0,54,0
2020-03-17,Brunei,2,0,56,0
2020-03-18,Brunei,12,0,68,0
2020-03-19,Brunei,7,0,75,0
2020-03-20,Brunei,3,0,78,0
2020-03-21,Brunei,5,0,83,0
2020-03-22,Brunei,5,0,88,0
2020-03-23,Brunei,3,0,91,0
2020-03-24,Brunei,13,0,104,0
2020-03-25,Brunei,5,0,109,0
2020-03-26,Brunei,5,0,114,0
2020-03-27,Brunei,1,0,115,0
2020-03-28,Brunei,5,1,120,1
2020-03-29,Brunei,6,0,126,1
2020-03-30,Brunei,1,0,127,1
2020-03-31,Brunei,2,0,129,1
2020-04-01,Brunei,2,0,131,1
2020-04-02,Brunei,2,0,133,1
2020-04-03,Brunei,1,0,134,1
2020-04-04,Brunei,1,0,135,1
2020-04-05,Brunei,0,0,135,1
2020-04-06,Brunei,0,0,135,1
2020-04-07,Brunei,0,0,135,1
2020-04-08,Brunei,0,0,135,1
2020-04-09,Brunei,0,0,135,1
2020-04-10,Brunei,1,0,136,1
2020-04-11,Brunei,0,0,136,1
2020-04-12,Brunei,0,0,136,1
2020-04-13,Brunei,0,0,136,1
2020-04-14,Brunei,0,0,136,1
2020-04-15,Brunei,0,0,136,1
2020-04-16,Brunei,0,0,136,1
2020-04-17,Brunei,0,0,136,1
2020-04-18,Brunei,1,0,137,1
2020-04-19,Brunei,1,0,138,1
2020-04-20,Brunei,0,0,138,1
2020-04-21,Brunei,0,0,138,1
2020-04-22,Brunei,0,0,138,1
2020-04-23,Brunei,0,0,138,1
2020-04-24,Brunei,0,0,138,1
2020-04-25,Brunei,0,0,138,1
2020-04-26,Brunei,0,0,138,1
2020-04-27,Brunei,0,0,138,1
2020-04-28,Brunei,0,0,138,1
2020-04-29,Brunei,0,0,138,1
2020-04-30,Brunei,0,0,138,1
2020-05-01,Brunei,0,0,138,1
2020-05-02,Brunei,0,0,138,1
2020-05-03,Brunei,0,0,138,1
2020-05-04,Brunei,0,0,138,1
2020-05-05,Brunei,0,0,138,1
2020-05-06,Brunei,1,0,139,1
2020-05-07,Brunei,2,0,141,1
2020-05-08,Brunei,0,0,141,1
2020-05-09,Brunei,0,0,141,1
2020-05-10,Brunei,0,0,141,1
2020-05-11,Brunei,0,0,141,1
2020-05-12,Brunei,0,0,141,1
2020-05-13,Brunei,0,0,141,1
2020-05-14,Brunei,0,0,141,1
2020-05-15,Brunei,0,0,141,1
2020-05-16,Brunei,0,0,141,1
2020-05-17,Brunei,0,0,141,1
2020-05-18,Brunei,0,0,141,1
2020-05-19,Brunei,0,0,141,1
2020-05-20,Brunei,0,0,141,1
2020-05-21,Brunei,0,0,141,1
2020-05-22,Brunei,0,0,141,1
2020-05-23,Brunei,0,0,141,1
2020-05-24,Brunei,0,0,141,1
2020-05-25,Brunei,0,0,141,1
2020-05-26,Brunei,0,0,141,1
2020-05-27,Brunei,0,1,141,2
2020-05-28,Brunei,0,0,141,2
2020-05-29,Brunei,0,0,141,2
2020-05-30,Brunei,0,0,141,2
2020-05-31,Brunei,0,0,141,2
2020-06-01,Brunei,0,0,141,2
2020-06-02,Brunei,0,0,141,2
2020-06-03,Brunei,0,0,141,2
2020-06-04,Brunei,0,0,141,2
2020-06-05,Brunei,0,0,141,2
2020-06-06,Brunei,0,0,141,2
2020-06-07,Brunei,0,0,141,2
2020-06-08,Brunei,0,0,141,2
2020-06-09,Brunei,0,0,141,2
2020-06-10,Brunei,0,0,141,2
2020-06-11,Brunei,0,0,141,2
2020-06-12,Brunei,0,0,141,2
2020-06-13,Brunei,0,0,141,2
2020-06-14,Brunei,0,0,141,2
2020-06-15,Brunei,0,0,141,2
2020-06-16,Brunei,0,1,141,3
2020-06-17,Brunei,0,0,141,3
2020-06-18,Brunei,0,0,141,3
2020-06-19,Brunei,0,0,141,3
2020-06-20,Brunei,0,0,141,3
2020-06-21,Brunei,0,0,141,3
2020-06-22,Brunei,0,0,141,3
2020-06-23,Brunei,0,0,141,3
2020-06-24,Brunei,0,0,141,3
2020-06-25,Brunei,0,0,141,3
2020-06-26,Brunei,0,0,141,3
2020-06-27,Brunei,0,0,141,3
2020-06-28,Brunei,0,0,141,3
2020-06-29,Brunei,0,0,141,3
2020-06-30,Brunei,0,0,141,3
2020-07-01,Brunei,0,0,141,3
2020-07-02,Brunei,0,0,141,3
2020-07-03,Brunei,0,0,141,3
2020-07-04,Brunei,0,0,141,3
2020-07-05,Brunei,0,0,141,3
2020-07-06,Brunei,0,0,141,3
2020-07-07,Brunei,0,0,141,3
2020-07-08,Brunei,0,0,141,3
2020-07-09,Brunei,0,0,141,3
2020-07-10,Brunei,0,0,141,3
2020-07-11,Brunei,0,0,141,3
2020-07-12,Brunei,0,0,141,3
2020-07-13,Brunei,0,0,141,3
2020-07-14,Brunei,0,0,141,3
2020-07-15,Brunei,0,0,141,3
2020-07-16,Brunei,0,0,141,3
2020-07-17,Brunei,0,0,141,3
2020-07-18,Brunei,0,0,141,3
2020-07-19,Brunei,0,0,141,3
2020-07-20,Brunei,0,0,141,3
2020-07-21,Brunei,0,0,141,3
2020-07-22,Brunei,0,0,141,3
2020-07-23,Brunei,0,0,141,3
2020-07-24,Brunei,0,0,141,3
2020-07-25,Brunei,0,0,141,3
2020-07-26,Brunei,0,0,141,3
2020-07-27,Brunei,0,0,141,3
2020-07-28,Brunei,0,0,141,3
2020-07-29,Brunei,0,0,141,3
2020-07-30,Brunei,0,0,141,3
2020-07-31,Brunei,0,0,141,3
2020-08-01,Brunei,0,0,141,3
2020-08-02,Brunei,0,0,141,3
2020-08-03,Brunei,0,0,141,3
2020-08-04,Brunei,0,0,141,3
2020-08-05,Brunei,0,0,141,3
2020-08-06,Brunei,0,0,141,3
2020-08-07,Brunei,1,0,142,3
2020-08-08,Brunei,0,0,142,3
2020-08-09,Brunei,0,0,142,3
2020-08-10,Brunei,0,0,142,3
2020-08-11,Brunei,0,0,142,3
2020-08-12,Brunei,0,0,142,3
2020-08-13,Brunei,0,0,142,3
2020-08-14,Brunei,0,0,142,3
2020-08-15,Brunei,0,0,142,3
2020-08-16,Brunei,0,0,142,3
2020-08-17,Brunei,0,0,142,3
2020-08-18,Brunei,0,0,142,3
2020-08-19,Brunei,1,0,143,3
2020-08-20,Brunei,0,0,143,3
2020-08-21,Brunei,0,0,143,3
2020-08-22,Brunei,0,0,143,3
2020-08-23,Brunei,0,0,143,3
2020-08-24,Brunei,0,0,143,3
2020-08-25,Brunei,1,0,144,3
2020-08-26,Brunei,0,0,144,3
2020-08-27,Brunei,0,0,144,3
2020-08-28,Brunei,0,0,144,3
2020-08-29,Brunei,0,0,144,3
2020-08-30,Brunei,0,0,144,3
2020-08-31,Brunei,0,0,144,3
2020-09-01,Brunei,0,0,144,3
2020-09-02,Brunei,0,0,144,3
2020-09-03,Brunei,1,0,145,3
2020-09-04,Brunei,0,0,145,3
2020-09-05,Brunei,0,0,145,3
2020-09-06,Brunei,0,0,145,3
2020-09-07,Brunei,0,0,145,3
2020-09-08,Brunei,0,0,145,3
2020-09-09,Brunei,0,0,145,3
2020-09-10,Brunei,0,0,145,3
2020-09-11,Brunei,0,0,145,3
2020-09-12,Brunei,0,0,145,3
2020-09-13,Brunei,0,0,145,3
2020-09-14,Brunei,0,0,145,3
2020-09-15,Brunei,0,0,145,3
2020-09-16,Brunei,0,0,145,3
2020-09-17,Brunei,0,0,145,3
2020-09-18,Brunei,0,0,145,3
2020-09-19,Brunei,0,0,145,3
2020-09-20,Brunei,0,0,145,3
2020-09-21,Brunei,0,0,145,3
2020-09-22,Brunei,0,0,145,3
2020-09-23,Brunei,0,0,145,3
2020-09-24,Brunei,1,0,146,3
2020-09-25,Brunei,0,0,146,3
2020-09-26,Brunei,0,0,146,3
2020-09-27,Brunei,0,0,146,3
2020-09-28,Brunei,0,0,146,3
2020-09-29,Brunei,0,0,146,3
2020-09-30,Brunei,0,0,146,3
2020-10-01,Brunei,0,0,146,3
2020-10-02,Brunei,0,0,146,3
2020-10-03,Brunei,0,0,146,3
2020-10-04,Brunei,0,0,146,3
2020-10-05,Brunei,0,0,146,3
2020-10-06,Brunei,0,0,146,3
2020-10-07,Brunei,0,0,146,3
2020-10-08,Brunei,0,0,146,3
2020-10-09,Brunei,0,0,146,3
2020-10-10,Brunei,0,0,146,3
2020-10-11,Brunei,0,0,146,3
2020-10-12,Brunei,0,0,146,3
2020-10-13,Brunei,0,0,146,3
2020-10-14,Brunei,1,0,147,3
2020-10-15,Brunei,0,0,147,3
2020-10-16,Brunei,0,0,147,3
2020-10-17,Brunei,0,0,147,3
2020-10-18,Brunei,0,0,147,3
2020-10-19,Brunei,0,0,147,3
2020-10-20,Brunei,0,0,147,3
2020-10-21,Brunei,0,0,147,3
2020-10-22,Brunei,1,0,148,3
2020-10-23,Brunei,0,0,148,3
2020-10-24,Brunei,0,0,148,3
2020-10-25,Brunei,0,0,148,3
2020-10-26,Brunei,0,0,148,3
2020-10-27,Brunei,0,0,148,3
2020-10-28,Brunei,0,0,148,3
2020-10-29,Brunei,0,0,148,3
2020-10-30,Brunei,0,0,148,3
2020-10-31,Brunei,0,0,148,3
2020-11-01,Brunei,0,0,148,3
2020-11-02,Brunei,0,0,148,3
2020-11-03,Brunei,0,0,148,3
2020-11-04,Brunei,0,0,148,3
2020-11-05,Brunei,0,0,148,3
2020-11-06,Brunei,0,0,148,3
2020-11-07,Brunei,0,0,148,3
2020-11-08,Brunei,0,0,148,3
2020-11-09,Brunei,0,0,148,3
2020-11-10,Brunei,0,0,148,3
2020-11-11,Brunei,0,0,148,3
2020-11-12,Brunei,0,0,148,3
2020-11-13,Brunei,0,0,148,3
2020-11-14,Brunei,0,0,148,3
2020-11-15,Brunei,0,0,148,3
2020-11-16,Brunei,0,0,148,3
2020-11-17,Brunei,0,0,148,3
2020-11-18,Brunei,0,0,148,3
2020-11-19,Brunei,0,0,148,3
2020-11-20,Brunei,0,0,148,3
2020-11-21,Brunei,0,0,148,3
2020-11-22,Brunei,0,0,148,3
2020-11-23,Brunei,1,0,149,3
2020-11-24,Brunei,1,0,150,3
2020-11-25,Brunei,0,0,150,3
2020-11-26,Brunei,0,0,150,3
2020-11-27,Brunei,0,0,150,3
2020-11-28,Brunei,0,0,150,3
2020-11-29,Brunei,0,0,150,3
2020-11-30,Brunei,0,0,150,3
2020-12-01,Brunei,1,0,151,3
2020-12-02,Brunei,0,0,151,3
2020-12-03,Brunei,0,0,151,3
2020-12-04,Brunei,0,0,151,3
2020-12-05,Brunei,0,0,151,3
2020-12-06,Brunei,0,0,151,3
2020-12-07,Brunei,0,0,151,3
2020-12-08,Brunei,1,0,152,3
2020-12-09,Brunei,0,0,152,3
2020-12-10,Brunei,0,0,152,3
2020-12-11,Brunei,0,0,152,3
2020-12-12,Brunei,0,0,152,3
2020-12-13,Brunei,0,0,152,3
2020-12-14,Brunei,0,0,152,3
2020-12-15,Brunei,0,0,152,3
2020-12-16,Brunei,0,0,152,3
2020-12-17,Brunei,0,0,152,3
2020-12-18,Brunei,0,0,152,3
2020-12-19,Brunei,0,0,152,3
2020-12-20,Brunei,0,0,152,3
2020-12-21,Brunei,0,0,152,3
2020-12-22,Brunei,0,0,152,3
2020-12-23,Brunei,0,0,152,3
2020-12-24,Brunei,0,0,152,3
2020-12-25,Brunei,0,0,152,3
2020-12-26,Brunei,0,0,152,3
2020-12-27,Brunei,0,0,152,3
2020-12-28,Brunei,0,0,152,3
2020-12-29,Brunei,0,0,152,3
2020-12-30,Brunei,5,0,157,3
2020-12-31,Brunei,0,0,157,3
2021-01-01,Brunei,0,0,157,3
2021-01-02,Brunei,0,0,157,3
2021-01-03,Brunei,15,0,172,3
2021-01-04,Brunei,0,0,172,3
2021-01-05,Brunei,0,0,172,3
2021-01-06,Brunei,0,0,172,3
2021-01-07,Brunei,1,0,173,3
2021-01-08,Brunei,0,0,173,3
2021-01-09,Brunei,0,0,173,3
2021-01-10,Brunei,0,0,173,3
2021-01-11,Brunei,0,0,173,3
2021-01-12,Brunei,1,0,174,3
2021-01-13,Brunei,0,0,174,3
2021-01-14,Brunei,0,0,174,3
2021-01-15,Brunei,0,0,174,3
2021-01-16,Brunei,0,0,174,3
2021-01-17,Brunei,0,0,174,3
2021-01-18,Brunei,0,0,174,3
2021-01-19,Brunei,0,0,174,3
2021-01-20,Brunei,0,0,174,3
2021-01-21,Brunei,0,0,174,3
2021-01-22,Brunei,1,0,175,3
2021-01-23,Brunei,0,0,175,3
2021-01-24,Brunei,0,0,175,3
2021-01-25,Brunei,0,0,175,3
2021-01-26,Brunei,1,0,176,3
2021-01-27,Brunei,0,0,176,3
2021-01-28,Brunei,4,0,180,3
2021-01-29,Brunei,0,0,180,3
2021-01-30,Brunei,0,0,180,3
2021-01-31,Brunei,0,0,180,3
2021-02-01,Brunei,0,0,180,3
2021-02-02,Brunei,0,0,180,3
2021-02-03,Brunei,0,0,180,3
2021-02-04,Brunei,0,0,180,3
2021-02-05,Brunei,0,0,180,3
2021-02-06,Brunei,1,0,181,3
2021-02-07,Brunei,0,0,181,3
2021-02-08,Brunei,1,0,182,3
2021-02-09,Brunei,0,0,182,3
2021-02-10,Brunei,0,0,182,3
2021-02-11,Brunei,1,0,183,3
2021-02-12,Brunei,1,0,184,3
2021-02-13,Brunei,0,0,184,3
2021-02-14,Brunei,0,0,184,3
2021-02-15,Brunei,0,0,184,3
2021-02-16,Brunei,0,0,184,3
2021-02-17,Brunei,1,0,185,3
2021-02-18,Brunei,0,0,185,3
2021-02-19,Brunei,0,0,185,3
2021-02-20,Brunei,0,0,185,3
2021-02-21,Brunei,0,0,185,3
2021-02-22,Brunei,0,0,185,3
2021-02-23,Brunei,0,0,185,3
2021-02-24,Brunei,0,0,185,3
2021-02-25,Brunei,0,0,185,3
2021-02-26,Brunei,0,0,185,3
2021-02-27,Brunei,1,0,186,3
2021-02-28,Brunei,0,0,186,3
2021-03-01,Brunei,0,0,186,3
2021-03-02,Brunei,1,0,187,3
2021-03-03,Brunei,0,0,187,3
2021-03-04,Brunei,1,0,188,3
2021-03-05,Brunei,0,0,188,3
2021-03-06,Brunei,1,0,189,3
2021-03-07,Brunei,0,0,189,3
2021-03-08,Brunei,1,0,190,3
2021-03-09,Brunei,1,0,191,3
2021-03-10,Brunei,1,0,192,3
2021-03-11,Brunei,0,0,192,3
2021-03-12,Brunei,0,0,192,3
2021-03-13,Brunei,0,0,192,3
2021-03-14,Brunei,7,0,199,3
2021-03-15,Brunei,0,0,199,3
2021-03-16,Brunei,3,0,202,3
2021-03-17,Brunei,1,0,203,3
2021-03-18,Brunei,0,0,203,3
2021-03-19,Brunei,0,0,203,3
2021-03-20,Brunei,2,0,205,3
2021-03-21,Brunei,1,0,206,3
2021-03-22,Brunei,0,0,206,3
2021-03-23,Brunei,0,0,206,3
2021-03-24,Brunei,0,0,206,3
2021-03-25,Brunei,0,0,206,3
2021-03-26,Brunei,0,0,206,3
2021-03-27,Brunei,0,0,206,3
2021-03-28,Brunei,1,0,207,3
2021-03-29,Brunei,0,0,207,3
2021-03-30,Brunei,3,0,210,3
2021-03-31,Brunei,2,0,212,3
2021-04-01,Brunei,1,0,213,3
2021-04-02,Brunei,0,0,213,3
2021-04-03,Brunei,1,0,214,3
2021-04-04,Brunei,0,0,214,3
2021-04-05,Brunei,0,0,214,3
2021-04-06,Brunei,0,0,214,3
2021-04-07,Brunei,1,0,215,3
2021-04-08,Brunei,1,0,216,3
2020-03-08,Bulgaria,4,0,4,0
2020-03-09,Bulgaria,0,0,4,0
2020-03-10,Bulgaria,0,0,4,0
2020-03-11,Bulgaria,3,1,7,1
2020-03-12,Bulgaria,0,0,7,1
2020-03-13,Bulgaria,16,0,23,1
2020-03-14,Bulgaria,18,1,41,2
2020-03-15,Bulgaria,10,0,51,2
2020-03-16,Bulgaria,1,0,52,2
2020-03-17,Bulgaria,15,0,67,2
2020-03-18,Bulgaria,25,0,92,2
2020-03-19,Bulgaria,2,1,94,3
2020-03-20,Bulgaria,33,0,127,3
2020-03-21,Bulgaria,36,0,163,3
2020-03-22,Bulgaria,24,0,187,3
2020-03-23,Bulgaria,14,0,201,3
2020-03-24,Bulgaria,17,0,218,3
2020-03-25,Bulgaria,24,0,242,3
2020-03-26,Bulgaria,22,0,264,3
2020-03-27,Bulgaria,29,0,293,3
2020-03-28,Bulgaria,38,4,331,7
2020-03-29,Bulgaria,15,1,346,8
2020-03-30,Bulgaria,13,0,359,8
2020-03-31,Bulgaria,40,0,399,8
2020-04-01,Bulgaria,23,2,422,10
2020-04-02,Bulgaria,35,0,457,10
2020-04-03,Bulgaria,28,4,485,14
2020-04-04,Bulgaria,18,3,503,17
2020-04-05,Bulgaria,28,3,531,20
2020-04-06,Bulgaria,18,2,549,22
2020-04-07,Bulgaria,28,1,577,23
2020-04-08,Bulgaria,16,1,593,24
2020-04-09,Bulgaria,25,0,618,24
2020-04-10,Bulgaria,17,1,635,25
2020-04-11,Bulgaria,26,3,661,28
2020-04-12,Bulgaria,14,1,675,29
2020-04-13,Bulgaria,10,3,685,32
2020-04-14,Bulgaria,28,3,713,35
2020-04-15,Bulgaria,34,1,747,36
2020-04-16,Bulgaria,53,2,800,38
2020-04-17,Bulgaria,46,3,846,41
2020-04-18,Bulgaria,32,0,878,41
2020-04-19,Bulgaria,16,1,894,42
2020-04-20,Bulgaria,35,1,929,43
2020-04-21,Bulgaria,46,2,975,45
2020-04-22,Bulgaria,49,4,1024,49
2020-04-23,Bulgaria,73,3,1097,52
2020-04-24,Bulgaria,137,2,1234,54
2020-04-25,Bulgaria,13,1,1247,55
2020-04-26,Bulgaria,53,1,1300,56
2020-04-27,Bulgaria,63,2,1363,58
2020-04-28,Bulgaria,36,0,1399,58
2020-04-29,Bulgaria,48,6,1447,64
2020-04-30,Bulgaria,59,2,1506,66
2020-05-01,Bulgaria,49,2,1555,68
2020-05-02,Bulgaria,39,4,1594,72
2020-05-03,Bulgaria,24,1,1618,73
2020-05-04,Bulgaria,34,5,1652,78
2020-05-05,Bulgaria,52,2,1704,80
2020-05-06,Bulgaria,74,4,1778,84
2020-05-07,Bulgaria,51,0,1829,84
2020-05-08,Bulgaria,43,2,1872,86
2020-05-09,Bulgaria,49,4,1921,90
2020-05-10,Bulgaria,44,1,1965,91
2020-05-11,Bulgaria,25,2,1990,93
2020-05-12,Bulgaria,33,2,2023,95
2020-05-13,Bulgaria,46,1,2069,96
2020-05-14,Bulgaria,31,3,2100,99
2020-05-15,Bulgaria,38,3,2138,102
2020-05-16,Bulgaria,37,3,2175,105
2020-05-17,Bulgaria,36,3,2211,108
2020-05-18,Bulgaria,24,2,2235,110
2020-05-19,Bulgaria,24,2,2259,112
2020-05-20,Bulgaria,33,4,2292,116
2020-05-21,Bulgaria,39,4,2331,120
2020-05-22,Bulgaria,41,5,2372,125
2020-05-23,Bulgaria,36,1,2408,126
2020-05-24,Bulgaria,19,4,2427,130
2020-05-25,Bulgaria,6,0,2433,130
2020-05-26,Bulgaria,10,0,2443,130
2020-05-27,Bulgaria,17,3,2460,133
2020-05-28,Bulgaria,17,1,2477,134
2020-05-29,Bulgaria,8,2,2485,136
2020-05-30,Bulgaria,14,3,2499,139
2020-05-31,Bulgaria,14,1,2513,140
2020-06-01,Bulgaria,6,0,2519,140
2020-06-02,Bulgaria,19,4,2538,144
2020-06-03,Bulgaria,22,2,2560,146
2020-06-04,Bulgaria,25,1,2585,147
2020-06-05,Bulgaria,42,12,2627,159
2020-06-06,Bulgaria,84,1,2711,160
2020-06-07,Bulgaria,16,0,2727,160
2020-06-08,Bulgaria,83,4,2810,164
2020-06-09,Bulgaria,79,3,2889,167
2020-06-10,Bulgaria,104,0,2993,167
2020-06-11,Bulgaria,93,1,3086,168
2020-06-12,Bulgaria,105,4,3191,172
2020-06-13,Bulgaria,75,0,3266,172
2020-06-14,Bulgaria,24,2,3290,174
2020-06-15,Bulgaria,51,2,3341,176
2020-06-16,Bulgaria,112,5,3453,181
2020-06-17,Bulgaria,89,3,3542,184
2020-06-18,Bulgaria,132,6,3674,190
2020-06-19,Bulgaria,81,3,3755,193
2020-06-20,Bulgaria,117,6,3872,199
2020-06-21,Bulgaria,33,0,3905,199
2020-06-22,Bulgaria,79,8,3984,207
2020-06-23,Bulgaria,130,1,4114,208
2020-06-24,Bulgaria,128,1,4242,209
2020-06-25,Bulgaria,166,2,4408,211
2020-06-26,Bulgaria,105,4,4513,215
2020-06-27,Bulgaria,112,1,4625,216
2020-06-28,Bulgaria,66,3,4691,219
2020-06-29,Bulgaria,140,4,4831,223
2020-06-30,Bulgaria,158,7,4989,230
2020-07-01,Bulgaria,165,2,5154,232
2020-07-02,Bulgaria,161,0,5315,232
2020-07-03,Bulgaria,182,7,5497,239
2020-07-04,Bulgaria,180,2,5677,241
2020-07-05,Bulgaria,63,5,5740,246
2020-07-06,Bulgaria,174,4,5914,250
2020-07-07,Bulgaria,188,4,6102,254
2020-07-08,Bulgaria,240,5,6342,259
2020-07-09,Bulgaria,330,3,6672,262
2020-07-10,Bulgaria,292,5,6964,267
2020-07-11,Bulgaria,211,0,7175,267
2020-07-12,Bulgaria,77,1,7252,268
2020-07-13,Bulgaria,159,8,7411,276
2020-07-14,Bulgaria,234,7,7645,283
2020-07-15,Bulgaria,232,6,7877,289
2020-07-16,Bulgaria,267,4,8144,293
2020-07-17,Bulgaria,298,4,8442,297
2020-07-18,Bulgaria,196,2,8638,299
2020-07-19,Bulgaria,95,1,8733,300
2020-07-20,Bulgaria,196,8,8929,308
2020-07-21,Bulgaria,325,5,9254,313
2020-07-22,Bulgaria,330,8,9584,321
2020-07-23,Bulgaria,269,8,9853,329
2020-07-24,Bulgaria,270,8,10123,337
2020-07-25,Bulgaria,189,1,10312,338
2020-07-26,Bulgaria,115,2,10427,340
2020-07-27,Bulgaria,194,7,10621,347
2020-07-28,Bulgaria,250,8,10871,355
2020-07-29,Bulgaria,284,13,11155,368
2020-07-30,Bulgaria,265,6,11420,374
2020-07-31,Bulgaria,270,9,11690,383
2020-08-01,Bulgaria,146,2,11836,385
2020-08-02,Bulgaria,119,3,11955,388
2020-08-03,Bulgaria,204,16,12159,404
2020-08-04,Bulgaria,255,11,12414,415
2020-08-05,Bulgaria,303,9,12717,424
2020-08-06,Bulgaria,297,11,13014,435
2020-08-07,Bulgaria,195,7,13209,442
2020-08-08,Bulgaria,134,3,13343,445
2020-08-09,Bulgaria,53,2,13396,447
2020-08-10,Bulgaria,116,12,13512,459
2020-08-11,Bulgaria,210,12,13722,471
2020-08-12,Bulgaria,171,11,13893,482
2020-08-13,Bulgaria,0,0,13893,482
2020-08-14,Bulgaria,350,10,14243,492
2020-08-15,Bulgaria,90,3,14333,495
2020-08-16,Bulgaria,32,3,14365,498
2020-08-17,Bulgaria,135,14,14500,512
2020-08-18,Bulgaria,169,7,14669,519
2020-08-19,Bulgaria,151,8,14820,527
2020-08-20,Bulgaria,142,5,14962,532
2020-08-21,Bulgaria,169,7,15131,539
2020-08-22,Bulgaria,0,0,15131,539
2020-08-23,Bulgaria,156,6,15287,545
2020-08-24,Bulgaria,99,18,15386,563
2020-08-25,Bulgaria,203,9,15589,572
2020-08-26,Bulgaria,162,14,15751,586
2020-08-27,Bulgaria,157,8,15908,594
2020-08-28,Bulgaria,157,9,16065,603
2020-08-29,Bulgaria,99,2,16164,605
2020-08-30,Bulgaria,26,8,16190,613
2020-08-31,Bulgaria,76,16,16266,629
2020-09-01,Bulgaria,188,13,16454,642
2020-09-02,Bulgaria,163,6,16617,648
2020-09-03,Bulgaria,158,10,16775,658
2020-09-04,Bulgaria,179,7,16954,665
2020-09-05,Bulgaria,96,6,17050,671
2020-09-06,Bulgaria,39,5,17089,676
2020-09-07,Bulgaria,57,1,17146,677
2020-09-08,Bulgaria,167,15,17313,692
2020-09-09,Bulgaria,122,10,17435,702
2020-09-10,Bulgaria,163,4,17598,706
2020-09-11,Bulgaria,201,7,17799,713
2020-09-12,Bulgaria,92,4,17891,717
2020-09-13,Bulgaria,27,3,17918,720
2020-09-14,Bulgaria,143,9,18061,729
2020-09-15,Bulgaria,155,7,18216,736
2020-09-16,Bulgaria,174,3,18390,739
2020-09-17,Bulgaria,154,10,18544,749
2020-09-18,Bulgaria,189,4,18733,753
2020-09-19,Bulgaria,86,2,18819,755
2020-09-20,Bulgaria,44,6,18863,761
2020-09-21,Bulgaria,151,4,19014,765
2020-09-22,Bulgaria,109,2,19123,767
2020-09-23,Bulgaria,160,12,19283,779
2020-09-24,Bulgaria,290,6,19573,785
2020-09-25,Bulgaria,255,4,19828,789
2020-09-26,Bulgaria,169,0,19997,789
2020-09-27,Bulgaria,58,7,20055,796
2020-09-28,Bulgaria,216,11,20271,807
2020-09-29,Bulgaria,276,6,20547,813
2020-09-30,Bulgaria,286,12,20833,825
2020-10-01,Bulgaria,0,0,20833,825
2020-10-02,Bulgaria,503,13,21336,838
2020-10-03,Bulgaria,182,3,21518,841
2020-10-04,Bulgaria,69,3,21587,844
2020-10-05,Bulgaria,283,10,21870,854
2020-10-06,Bulgaria,436,8,22306,862
2020-10-07,Bulgaria,437,11,22743,873
2020-10-08,Bulgaria,516,7,23259,880
2020-10-09,Bulgaria,612,7,23871,887
2020-10-10,Bulgaria,448,4,24319,891
2020-10-11,Bulgaria,83,1,24402,892
2020-10-12,Bulgaria,587,23,24989,915
2020-10-13,Bulgaria,785,8,25774,923
2020-10-14,Bulgaria,819,6,26593,929
2020-10-15,Bulgaria,914,15,27507,944
2020-10-16,Bulgaria,998,14,28505,958
2020-10-17,Bulgaria,603,10,29108,968
2020-10-18,Bulgaria,395,18,29503,986
2020-10-19,Bulgaria,1024,22,30527,1008
2020-10-20,Bulgaria,1336,11,31863,1019
2020-10-21,Bulgaria,1472,29,33335,1048
2020-10-22,Bulgaria,1595,16,34930,1064
2020-10-23,Bulgaria,1589,13,36519,1077
2020-10-24,Bulgaria,1043,7,37562,1084
2020-10-25,Bulgaria,327,10,37889,1094
2020-10-26,Bulgaria,2243,42,40132,1136
2020-10-27,Bulgaria,2569,25,42701,1161
2020-10-28,Bulgaria,2760,36,45461,1197
2020-10-29,Bulgaria,2689,28,48150,1225
2020-10-30,Bulgaria,2891,29,51041,1254
2020-10-31,Bulgaria,1803,25,52844,1279
2020-11-01,Bulgaria,1225,19,54069,1298
2020-11-02,Bulgaria,2427,51,56496,1349
2020-11-03,Bulgaria,4041,63,60537,1412
2020-11-04,Bulgaria,4054,54,64591,1466
2020-11-05,Bulgaria,3754,52,68345,1518
2020-11-06,Bulgaria,3839,58,72184,1576
2020-11-07,Bulgaria,2301,56,74485,1632
2020-11-08,Bulgaria,675,33,75160,1665
2020-11-09,Bulgaria,3816,106,78976,1771
2020-11-10,Bulgaria,4390,80,83366,1851
2020-11-11,Bulgaria,3945,47,87311,1898
2020-11-12,Bulgaria,3414,72,90725,1970
2020-11-13,Bulgaria,4212,85,94937,2055
2020-11-14,Bulgaria,2498,36,97435,2091
2020-11-15,Bulgaria,816,39,98251,2130
2020-11-16,Bulgaria,3519,152,101770,2282
2020-11-17,Bulgaria,4828,131,106598,2413
2020-11-18,Bulgaria,3938,117,110536,2530
2020-11-19,Bulgaria,3899,119,114435,2649
2020-11-20,Bulgaria,3983,129,118418,2778
2020-11-21,Bulgaria,2279,42,120697,2820
2020-11-22,Bulgaria,1123,60,121820,2880
2020-11-23,Bulgaria,3146,189,124966,3069
2020-11-24,Bulgaria,4382,157,129348,3226
2020-11-25,Bulgaria,3712,141,133060,3367
2020-11-26,Bulgaria,3568,162,136628,3529
2020-11-27,Bulgaria,3327,151,139955,3680
2020-11-28,Bulgaria,1792,69,141747,3749
2020-11-29,Bulgaria,739,65,142486,3814
2020-11-30,Bulgaria,2814,221,145300,4035
2020-12-01,Bulgaria,3475,153,148775,4188
2020-12-02,Bulgaria,3138,159,151913,4347
2020-12-03,Bulgaria,3280,156,155193,4503
2020-12-04,Bulgaria,3614,147,158807,4650
2020-12-05,Bulgaria,2037,79,160844,4729
2020-12-06,Bulgaria,577,68,161421,4797
2020-12-07,Bulgaria,2764,213,164185,5010
2020-12-08,Bulgaria,3980,146,168165,5156
2020-12-09,Bulgaria,3328,127,171493,5283
2020-12-10,Bulgaria,3075,122,174568,5405
2020-12-11,Bulgaria,3097,157,177665,5562
2020-12-12,Bulgaria,1287,64,178952,5626
2020-12-13,Bulgaria,497,62,179449,5688
2020-12-14,Bulgaria,2095,150,181544,5838
2020-12-15,Bulgaria,2743,167,184287,6005
2020-12-16,Bulgaria,1959,191,186246,6196
2020-12-17,Bulgaria,2042,143,188288,6339
2020-12-18,Bulgaria,1739,157,190027,6496
2020-12-19,Bulgaria,1002,55,191029,6551
2020-12-20,Bulgaria,166,58,191195,6609
2020-12-21,Bulgaria,1277,156,192472,6765
2020-12-22,Bulgaria,1799,114,194271,6879
2020-12-23,Bulgaria,1615,99,195886,6978
2020-12-24,Bulgaria,772,45,196658,7023
2020-12-25,Bulgaria,257,50,196915,7073
2020-12-26,Bulgaria,469,50,197384,7123
2020-12-27,Bulgaria,332,41,197716,7164
2020-12-28,Bulgaria,337,87,198053,7251
2020-12-29,Bulgaria,1438,154,199491,7405
2020-12-30,Bulgaria,1729,110,201220,7515
2020-12-31,Bulgaria,1046,61,202266,7576
2021-01-01,Bulgaria,274,28,202540,7604
2021-01-02,Bulgaria,340,40,202880,7644
2021-01-03,Bulgaria,171,34,203051,7678
2021-01-04,Bulgaria,1029,157,204080,7835
2021-01-05,Bulgaria,1310,67,205390,7902
2021-01-06,Bulgaria,1002,59,206392,7961
2021-01-07,Bulgaria,867,56,207259,8017
2021-01-08,Bulgaria,753,61,208012,8078
2021-01-09,Bulgaria,394,19,208406,8097
2021-01-10,Bulgaria,105,29,208511,8126
2021-01-11,Bulgaria,620,106,209131,8232
2021-01-12,Bulgaria,750,47,209881,8279
2021-01-13,Bulgaria,535,70,210416,8349
2021-01-14,Bulgaria,535,47,210951,8396
2021-01-15,Bulgaria,552,61,211503,8457
2021-01-16,Bulgaria,233,17,211736,8474
2021-01-17,Bulgaria,77,9,211813,8483
2021-01-18,Bulgaria,570,82,212383,8565
2021-01-19,Bulgaria,544,49,212927,8614
2021-01-20,Bulgaria,482,37,213409,8651
2021-01-21,Bulgaria,455,90,213864,8741
2021-01-22,Bulgaria,566,58,214430,8799
2021-01-23,Bulgaria,266,12,214696,8811
2021-01-24,Bulgaria,121,9,214817,8820
2021-01-25,Bulgaria,772,60,215589,8880
2021-01-26,Bulgaria,827,36,216416,8916
2021-01-27,Bulgaria,598,28,217014,8944
2021-01-28,Bulgaria,560,29,217574,8973
2021-01-29,Bulgaria,695,35,218269,9008
2021-01-30,Bulgaria,349,20,218618,9028
2021-01-31,Bulgaria,130,17,218748,9045
2021-02-01,Bulgaria,832,97,219580,9142
2021-02-02,Bulgaria,967,36,220547,9178
2021-02-03,Bulgaria,719,40,221266,9218
2021-02-04,Bulgaria,883,54,222149,9272
2021-02-05,Bulgaria,910,30,223059,9302
2021-02-06,Bulgaria,493,9,223552,9311
2021-02-07,Bulgaria,182,20,223734,9331
2021-02-08,Bulgaria,1115,89,224849,9420
2021-02-09,Bulgaria,1212,62,226061,9482
2021-02-10,Bulgaria,913,45,226974,9527
2021-02-11,Bulgaria,1070,34,228044,9561
2021-02-12,Bulgaria,966,33,229010,9594
2021-02-13,Bulgaria,506,14,229516,9608
2021-02-14,Bulgaria,163,16,229679,9624
2021-02-15,Bulgaria,1068,47,230747,9671
2021-02-16,Bulgaria,1349,32,232096,9703
2021-02-17,Bulgaria,1246,41,233342,9744
2021-02-18,Bulgaria,1086,42,234428,9786
2021-02-19,Bulgaria,1463,35,235891,9821
2021-02-20,Bulgaria,548,18,236439,9839
2021-02-21,Bulgaria,227,15,236666,9854
2021-02-22,Bulgaria,1925,79,238591,9933
2021-02-23,Bulgaria,1800,45,240391,9978
2021-02-24,Bulgaria,1733,48,242124,10026
2021-02-25,Bulgaria,1822,53,243946,10079
2021-02-26,Bulgaria,1681,49,245627,10128
2021-02-27,Bulgaria,1079,39,246706,10167
2021-02-28,Bulgaria,332,24,247038,10191
2021-03-01,Bulgaria,2588,117,249626,10308
2021-03-02,Bulgaria,2403,83,252029,10391
2021-03-03,Bulgaria,1154,22,253183,10413
2021-03-04,Bulgaria,2198,93,255381,10506
2021-03-05,Bulgaria,3004,65,258385,10571
2021-03-06,Bulgaria,1426,22,259811,10593
2021-03-07,Bulgaria,497,21,260308,10614
2021-03-08,Bulgaria,2995,150,263303,10764
2021-03-09,Bulgaria,3502,138,266805,10902
2021-03-10,Bulgaria,2774,97,269579,10999
2021-03-11,Bulgaria,3121,95,272700,11094
2021-03-12,Bulgaria,3159,102,275859,11196
2021-03-13,Bulgaria,2019,38,277878,11234
2021-03-14,Bulgaria,679,51,278557,11285
2021-03-15,Bulgaria,4637,187,283194,11472
2021-03-16,Bulgaria,4374,107,287568,11579
2021-03-17,Bulgaria,4201,136,291769,11715
2021-03-18,Bulgaria,4008,102,295777,11817
2021-03-19,Bulgaria,4162,115,299939,11932
2021-03-20,Bulgaria,2541,34,302480,11966
2021-03-21,Bulgaria,943,53,303423,12019
2021-03-22,Bulgaria,4467,169,307890,12188
2021-03-23,Bulgaria,4851,119,312741,12307
2021-03-24,Bulgaria,4375,106,317116,12413
2021-03-25,Bulgaria,3988,99,321104,12512
2021-03-26,Bulgaria,4129,89,325233,12601
2021-03-27,Bulgaria,2537,49,327770,12650
2021-03-28,Bulgaria,983,60,328753,12710
2021-03-29,Bulgaria,4497,203,333250,12913
2021-03-30,Bulgaria,5176,155,338426,13068
2021-03-31,Bulgaria,4207,129,342633,13197
2021-04-01,Bulgaria,3694,116,346327,13313
2021-04-02,Bulgaria,4013,125,350340,13438
2021-04-03,Bulgaria,1919,69,352259,13507
2021-04-04,Bulgaria,740,82,352999,13589
2021-04-05,Bulgaria,3860,197,356859,13786
2021-04-06,Bulgaria,0,0,356859,13786
2021-04-07,Bulgaria,7560,248,364419,14034
2021-04-08,Bulgaria,2957,136,367376,14170
2020-03-10,Burkina Faso,1,0,1,0
2020-03-11,Burkina Faso,1,0,2,0
2020-03-12,Burkina Faso,0,0,2,0
2020-03-13,Burkina Faso,0,0,2,0
2020-03-14,Burkina Faso,0,0,2,0
2020-03-15,Burkina Faso,1,0,3,0
2020-03-16,Burkina Faso,12,0,15,0
2020-03-17,Burkina Faso,0,0,15,0
2020-03-18,Burkina Faso,5,1,20,1
2020-03-19,Burkina Faso,13,0,33,1
2020-03-20,Burkina Faso,7,0,40,1
2020-03-21,Burkina Faso,24,1,64,2
2020-03-22,Burkina Faso,11,2,75,4
2020-03-23,Burkina Faso,24,0,99,4
2020-03-24,Burkina Faso,15,0,114,4
2020-03-25,Burkina Faso,32,0,146,4
2020-03-26,Burkina Faso,6,3,152,7
2020-03-27,Burkina Faso,28,2,180,9
2020-03-28,Burkina Faso,27,2,207,11
2020-03-29,Burkina Faso,15,1,222,12
2020-03-30,Burkina Faso,24,0,246,12
2020-03-31,Burkina Faso,15,2,261,14
2020-04-01,Burkina Faso,21,2,282,16
2020-04-02,Burkina Faso,6,0,288,16
2020-04-03,Burkina Faso,14,0,302,16
2020-04-04,Burkina Faso,16,0,318,16
2020-04-05,Burkina Faso,27,1,345,17
2020-04-06,Burkina Faso,19,1,364,18
2020-04-07,Burkina Faso,20,1,384,19
2020-04-08,Burkina Faso,30,4,414,23
2020-04-09,Burkina Faso,29,1,443,24
2020-04-10,Burkina Faso,0,0,443,24
2020-04-11,Burkina Faso,41,3,484,27
2020-04-12,Burkina Faso,13,0,497,27
2020-04-13,Burkina Faso,0,0,497,27
2020-04-14,Burkina Faso,31,3,528,30
2020-04-15,Burkina Faso,14,2,542,32
2020-04-16,Burkina Faso,4,0,546,32
2020-04-17,Burkina Faso,11,3,557,35
2020-04-18,Burkina Faso,8,1,565,36
2020-04-19,Burkina Faso,11,0,576,36
2020-04-20,Burkina Faso,5,2,581,38
2020-04-21,Burkina Faso,19,0,600,38
2020-04-22,Burkina Faso,9,1,609,39
2020-04-23,Burkina Faso,7,2,616,41
2020-04-24,Burkina Faso,13,0,629,41
2020-04-25,Burkina Faso,0,0,629,41
2020-04-26,Burkina Faso,3,1,632,42
2020-04-27,Burkina Faso,3,0,635,42
2020-04-28,Burkina Faso,3,0,638,42
2020-04-29,Burkina Faso,3,1,641,43
2020-04-30,Burkina Faso,4,0,645,43
2020-05-01,Burkina Faso,4,1,649,44
2020-05-02,Burkina Faso,3,0,652,44
2020-05-03,Burkina Faso,10,1,662,45
2020-05-04,Burkina Faso,10,1,672,46
2020-05-05,Burkina Faso,16,2,688,48
2020-05-06,Burkina Faso,41,0,729,48
2020-05-07,Burkina Faso,7,0,736,48
2020-05-08,Burkina Faso,8,0,744,48
2020-05-09,Burkina Faso,4,0,748,48
2020-05-10,Burkina Faso,3,1,751,49
2020-05-11,Burkina Faso,9,1,760,50
2020-05-12,Burkina Faso,6,1,766,51
2020-05-13,Burkina Faso,7,0,773,51
2020-05-14,Burkina Faso,0,0,773,51
2020-05-15,Burkina Faso,7,0,780,51
2020-05-16,Burkina Faso,2,0,782,51
2020-05-17,Burkina Faso,14,0,796,51
2020-05-18,Burkina Faso,0,0,796,51
2020-05-19,Burkina Faso,0,0,796,51
2020-05-20,Burkina Faso,13,1,809,52
2020-05-21,Burkina Faso,3,0,812,52
2020-05-22,Burkina Faso,2,0,814,52
2020-05-23,Burkina Faso,0,0,814,52
2020-05-24,Burkina Faso,0,0,814,52
2020-05-25,Burkina Faso,18,0,832,52
2020-05-26,Burkina Faso,0,0,832,52
2020-05-27,Burkina Faso,13,1,845,53
2020-05-28,Burkina Faso,2,0,847,53
2020-05-29,Burkina Faso,0,0,847,53
2020-05-30,Burkina Faso,0,0,847,53
2020-05-31,Burkina Faso,0,0,847,53
2020-06-01,Burkina Faso,0,0,847,53
2020-06-02,Burkina Faso,34,0,881,53
2020-06-03,Burkina Faso,3,0,884,53
2020-06-04,Burkina Faso,1,0,885,53
2020-06-05,Burkina Faso,3,0,888,53
2020-06-06,Burkina Faso,0,0,888,53
2020-06-07,Burkina Faso,1,0,889,53
2020-06-08,Burkina Faso,1,0,890,53
2020-06-09,Burkina Faso,1,0,891,53
2020-06-10,Burkina Faso,0,0,891,53
2020-06-11,Burkina Faso,1,0,892,53
2020-06-12,Burkina Faso,0,0,892,53
2020-06-13,Burkina Faso,0,0,892,53
2020-06-14,Burkina Faso,2,0,894,53
2020-06-15,Burkina Faso,0,0,894,53
2020-06-16,Burkina Faso,1,0,895,53
2020-06-17,Burkina Faso,4,0,899,53
2020-06-18,Burkina Faso,0,0,899,53
2020-06-19,Burkina Faso,1,0,900,53
2020-06-20,Burkina Faso,1,0,901,53
2020-06-21,Burkina Faso,2,0,903,53
2020-06-22,Burkina Faso,0,0,903,53
2020-06-23,Burkina Faso,4,0,907,53
2020-06-24,Burkina Faso,12,0,919,53
2020-06-25,Burkina Faso,15,0,934,53
2020-06-26,Burkina Faso,7,0,941,53
2020-06-27,Burkina Faso,0,0,941,53
2020-06-28,Burkina Faso,18,0,959,53
2020-06-29,Burkina Faso,0,0,959,53
2020-06-30,Burkina Faso,3,0,962,53
2020-07-01,Burkina Faso,0,0,962,53
2020-07-02,Burkina Faso,5,0,967,53
2020-07-03,Burkina Faso,13,0,980,53
2020-07-04,Burkina Faso,7,0,987,53
2020-07-05,Burkina Faso,0,0,987,53
2020-07-06,Burkina Faso,13,0,1000,53
2020-07-07,Burkina Faso,3,0,1003,53
2020-07-08,Burkina Faso,0,0,1003,53
2020-07-09,Burkina Faso,2,0,1005,53
2020-07-10,Burkina Faso,15,0,1020,53
2020-07-11,Burkina Faso,13,0,1033,53
2020-07-12,Burkina Faso,3,0,1036,53
2020-07-13,Burkina Faso,0,0,1036,53
2020-07-14,Burkina Faso,1,0,1037,53
2020-07-15,Burkina Faso,1,0,1038,53
2020-07-16,Burkina Faso,0,0,1038,53
2020-07-17,Burkina Faso,7,0,1045,53
2020-07-18,Burkina Faso,2,0,1047,53
2020-07-19,Burkina Faso,5,0,1052,53
2020-07-20,Burkina Faso,13,0,1065,53
2020-07-21,Burkina Faso,0,0,1065,53
2020-07-22,Burkina Faso,1,0,1066,53
2020-07-23,Burkina Faso,4,0,1070,53
2020-07-24,Burkina Faso,5,0,1075,53
2020-07-25,Burkina Faso,11,0,1086,53
2020-07-26,Burkina Faso,0,0,1086,53
2020-07-27,Burkina Faso,14,0,1100,53
2020-07-28,Burkina Faso,5,0,1105,53
2020-07-29,Burkina Faso,0,0,1105,53
2020-07-30,Burkina Faso,1,0,1106,53
2020-07-31,Burkina Faso,0,0,1106,53
2020-08-01,Burkina Faso,37,0,1143,53
2020-08-02,Burkina Faso,0,0,1143,53
2020-08-03,Burkina Faso,7,0,1150,53
2020-08-04,Burkina Faso,3,1,1153,54
2020-08-05,Burkina Faso,0,0,1153,54
2020-08-06,Burkina Faso,5,0,1158,54
2020-08-07,Burkina Faso,0,0,1158,54
2020-08-08,Burkina Faso,17,0,1175,54
2020-08-09,Burkina Faso,0,0,1175,54
2020-08-10,Burkina Faso,29,0,1204,54
2020-08-11,Burkina Faso,7,0,1211,54
2020-08-12,Burkina Faso,2,0,1213,54
2020-08-13,Burkina Faso,15,0,1228,54
2020-08-14,Burkina Faso,10,0,1238,54
2020-08-15,Burkina Faso,2,0,1240,54
2020-08-16,Burkina Faso,27,1,1267,55
2020-08-17,Burkina Faso,13,0,1280,55
2020-08-18,Burkina Faso,0,0,1280,55
2020-08-19,Burkina Faso,5,0,1285,55
2020-08-20,Burkina Faso,12,0,1297,55
2020-08-21,Burkina Faso,0,0,1297,55
2020-08-22,Burkina Faso,0,0,1297,55
2020-08-23,Burkina Faso,23,0,1320,55
2020-08-24,Burkina Faso,18,0,1338,55
2020-08-25,Burkina Faso,0,0,1338,55
2020-08-26,Burkina Faso,14,0,1352,55
2020-08-27,Burkina Faso,0,0,1352,55
2020-08-28,Burkina Faso,0,0,1352,55
2020-08-29,Burkina Faso,0,0,1352,55
2020-08-30,Burkina Faso,5,0,1357,55
2020-08-31,Burkina Faso,11,0,1368,55
2020-09-01,Burkina Faso,2,0,1370,55
2020-09-02,Burkina Faso,0,0,1370,55
2020-09-03,Burkina Faso,5,0,1375,55
2020-09-04,Burkina Faso,33,0,1408,55
2020-09-05,Burkina Faso,0,0,1408,55
2020-09-06,Burkina Faso,44,0,1452,55
2020-09-07,Burkina Faso,11,1,1463,56
2020-09-08,Burkina Faso,3,0,1466,56
2020-09-09,Burkina Faso,10,0,1476,56
2020-09-10,Burkina Faso,10,0,1486,56
2020-09-11,Burkina Faso,13,0,1499,56
2020-09-12,Burkina Faso,15,0,1514,56
2020-09-13,Burkina Faso,193,0,1707,56
2020-09-14,Burkina Faso,10,0,1717,56
2020-09-15,Burkina Faso,16,0,1733,56
2020-09-16,Burkina Faso,15,0,1748,56
2020-09-17,Burkina Faso,19,0,1767,56
2020-09-18,Burkina Faso,30,0,1797,56
2020-09-19,Burkina Faso,19,0,1816,56
2020-09-20,Burkina Faso,30,0,1846,56
2020-09-21,Burkina Faso,50,0,1896,56
2020-09-22,Burkina Faso,11,0,1907,56
2020-09-23,Burkina Faso,22,0,1929,56
2020-09-24,Burkina Faso,21,0,1950,56
2020-09-25,Burkina Faso,12,0,1962,56
2020-09-26,Burkina Faso,11,0,1973,56
2020-09-27,Burkina Faso,35,0,2008,56
2020-09-28,Burkina Faso,20,1,2028,57
2020-09-29,Burkina Faso,4,1,2032,58
2020-09-30,Burkina Faso,24,0,2056,58
2020-10-01,Burkina Faso,32,0,2088,58
2020-10-02,Burkina Faso,35,1,2123,59
2020-10-03,Burkina Faso,31,0,2154,59
2020-10-04,Burkina Faso,13,0,2167,59
2020-10-05,Burkina Faso,17,0,2184,59
2020-10-06,Burkina Faso,13,0,2197,59
2020-10-07,Burkina Faso,25,0,2222,59
2020-10-08,Burkina Faso,19,1,2241,60
2020-10-09,Burkina Faso,13,0,2254,60
2020-10-10,Burkina Faso,17,1,2271,61
2020-10-11,Burkina Faso,0,0,2271,61
2020-10-12,Burkina Faso,23,2,2294,63
2020-10-13,Burkina Faso,11,0,2305,63
2020-10-14,Burkina Faso,0,0,2305,63
2020-10-15,Burkina Faso,30,2,2335,65
2020-10-16,Burkina Faso,8,0,2343,65
2020-10-17,Burkina Faso,0,0,2343,65
2020-10-18,Burkina Faso,38,0,2381,65
2020-10-19,Burkina Faso,6,0,2387,65
2020-10-20,Burkina Faso,19,0,2406,65
2020-10-21,Burkina Faso,0,0,2406,65
2020-10-22,Burkina Faso,8,0,2414,65
2020-10-23,Burkina Faso,19,0,2433,65
2020-10-24,Burkina Faso,11,0,2444,65
2020-10-25,Burkina Faso,7,0,2451,65
2020-10-26,Burkina Faso,8,2,2459,67
2020-10-27,Burkina Faso,7,0,2466,67
2020-10-28,Burkina Faso,0,0,2466,67
2020-10-29,Burkina Faso,5,0,2471,67
2020-10-30,Burkina Faso,6,0,2477,67
2020-10-31,Burkina Faso,23,0,2500,67
2020-11-01,Burkina Faso,0,0,2500,67
2020-11-02,Burkina Faso,17,0,2517,67
2020-11-03,Burkina Faso,13,0,2530,67
2020-11-04,Burkina Faso,9,0,2539,67
2020-11-05,Burkina Faso,11,0,2550,67
2020-11-06,Burkina Faso,12,0,2562,67
2020-11-07,Burkina Faso,3,0,2565,67
2020-11-08,Burkina Faso,4,0,2569,67
2020-11-09,Burkina Faso,12,0,2581,67
2020-11-10,Burkina Faso,1,0,2582,67
2020-11-11,Burkina Faso,4,0,2586,67
2020-11-12,Burkina Faso,0,0,2586,67
2020-11-13,Burkina Faso,23,1,2609,68
2020-11-14,Burkina Faso,26,0,2635,68
2020-11-15,Burkina Faso,6,0,2641,68
2020-11-16,Burkina Faso,11,0,2652,68
2020-11-17,Burkina Faso,0,0,2652,68
2020-11-18,Burkina Faso,18,0,2670,68
2020-11-19,Burkina Faso,16,0,2686,68
2020-11-20,Burkina Faso,0,0,2686,68
2020-11-21,Burkina Faso,17,0,2703,68
2020-11-22,Burkina Faso,32,0,2735,68
2020-11-23,Burkina Faso,19,0,2754,68
2020-11-24,Burkina Faso,3,0,2757,68
2020-11-25,Burkina Faso,20,0,2777,68
2020-11-26,Burkina Faso,0,0,2777,68
2020-11-27,Burkina Faso,39,0,2816,68
2020-11-28,Burkina Faso,0,0,2816,68
2020-11-29,Burkina Faso,40,0,2856,68
2020-11-30,Burkina Faso,30,0,2886,68
2020-12-01,Burkina Faso,45,0,2931,68
2020-12-02,Burkina Faso,79,0,3010,68
2020-12-03,Burkina Faso,52,0,3062,68
2020-12-04,Burkina Faso,29,0,3091,68
2020-12-05,Burkina Faso,65,0,3156,68
2020-12-06,Burkina Faso,56,0,3212,68
2020-12-07,Burkina Faso,103,0,3315,68
2020-12-08,Burkina Faso,154,1,3469,69
2020-12-09,Burkina Faso,0,0,3469,69
2020-12-10,Burkina Faso,110,0,3579,69
2020-12-11,Burkina Faso,0,0,3579,69
2020-12-12,Burkina Faso,315,2,3894,71
2020-12-13,Burkina Faso,136,0,4030,71
2020-12-14,Burkina Faso,179,0,4209,71
2020-12-15,Burkina Faso,91,2,4300,73
2020-12-16,Burkina Faso,149,0,4449,73
2020-12-17,Burkina Faso,162,0,4611,73
2020-12-18,Burkina Faso,221,1,4832,74
2020-12-19,Burkina Faso,122,0,4954,74
2020-12-20,Burkina Faso,206,2,5160,76
2020-12-21,Burkina Faso,141,0,5301,76
2020-12-22,Burkina Faso,160,1,5461,77
2020-12-23,Burkina Faso,188,0,5649,77
2020-12-24,Burkina Faso,292,0,5941,77
2020-12-25,Burkina Faso,193,0,6134,77
2020-12-26,Burkina Faso,121,0,6255,77
2020-12-27,Burkina Faso,89,1,6344,78
2020-12-28,Burkina Faso,0,0,6344,78
2020-12-29,Burkina Faso,193,4,6537,82
2020-12-30,Burkina Faso,94,2,6631,84
2020-12-31,Burkina Faso,76,1,6707,85
2021-01-01,Burkina Faso,121,0,6828,85
2021-01-02,Burkina Faso,112,1,6940,86
2021-01-03,Burkina Faso,111,0,7051,86
2021-01-04,Burkina Faso,75,0,7126,86
2021-01-05,Burkina Faso,216,0,7342,86
2021-01-06,Burkina Faso,221,3,7563,89
2021-01-07,Burkina Faso,150,0,7713,89
2021-01-08,Burkina Faso,153,0,7866,89
2021-01-09,Burkina Faso,0,0,7866,89
2021-01-10,Burkina Faso,216,0,8082,89
2021-01-11,Burkina Faso,197,0,8279,89
2021-01-12,Burkina Faso,184,3,8463,92
2021-01-13,Burkina Faso,83,1,8546,93
2021-01-14,Burkina Faso,263,4,8809,97
2021-01-15,Burkina Faso,73,0,8882,97
2021-01-16,Burkina Faso,118,4,9000,101
2021-01-17,Burkina Faso,188,1,9188,102
2021-01-18,Burkina Faso,164,3,9352,105
2021-01-19,Burkina Faso,0,0,9352,105
2021-01-20,Burkina Faso,201,1,9553,106
2021-01-21,Burkina Faso,166,0,9719,106
2021-01-22,Burkina Faso,138,1,9857,107
2021-01-23,Burkina Faso,110,2,9967,109
2021-01-24,Burkina Faso,71,3,10038,112
2021-01-25,Burkina Faso,65,5,10103,117
2021-01-26,Burkina Faso,54,1,10157,118
2021-01-27,Burkina Faso,60,2,10217,120
2021-01-28,Burkina Faso,160,0,10377,120
2021-01-29,Burkina Faso,46,0,10423,120
2021-01-30,Burkina Faso,157,0,10580,120
2021-01-31,Burkina Faso,102,0,10682,120
2021-02-01,Burkina Faso,86,1,10768,121
2021-02-02,Burkina Faso,136,5,10904,126
2021-02-03,Burkina Faso,54,1,10958,127
2021-02-04,Burkina Faso,95,5,11053,132
2021-02-05,Burkina Faso,90,0,11143,132
2021-02-06,Burkina Faso,84,2,11227,134
2021-02-07,Burkina Faso,58,0,11285,134
2021-02-08,Burkina Faso,24,0,11309,134
2021-02-09,Burkina Faso,58,0,11367,134
2021-02-10,Burkina Faso,59,0,11426,134
2021-02-11,Burkina Faso,0,0,11426,134
2021-02-12,Burkina Faso,112,3,11538,137
2021-02-13,Burkina Faso,50,1,11588,138
2021-02-14,Burkina Faso,0,0,11588,138
2021-02-15,Burkina Faso,42,0,11630,138
2021-02-16,Burkina Faso,0,0,11630,138
2021-02-17,Burkina Faso,42,0,11672,138
2021-02-18,Burkina Faso,31,1,11703,139
2021-02-19,Burkina Faso,60,0,11763,139
2021-02-20,Burkina Faso,20,0,11783,139
2021-02-21,Burkina Faso,14,0,11797,139
2021-02-22,Burkina Faso,50,0,11847,139
2021-02-23,Burkina Faso,21,2,11868,141
2021-02-24,Burkina Faso,19,1,11887,142
2021-02-25,Burkina Faso,27,0,11914,142
2021-02-26,Burkina Faso,25,0,11939,142
2021-02-27,Burkina Faso,43,0,11982,142
2021-02-28,Burkina Faso,0,0,11982,142
2021-03-01,Burkina Faso,48,1,12030,143
2021-03-02,Burkina Faso,17,0,12047,143
2021-03-03,Burkina Faso,24,0,12071,143
2021-03-04,Burkina Faso,32,0,12103,143
2021-03-05,Burkina Faso,20,0,12123,143
2021-03-06,Burkina Faso,30,0,12153,143
2021-03-07,Burkina Faso,28,0,12181,143
2021-03-08,Burkina Faso,0,0,12181,143
2021-03-09,Burkina Faso,6,0,12187,143
2021-03-10,Burkina Faso,43,0,12230,143
2021-03-11,Burkina Faso,45,0,12275,143
2021-03-12,Burkina Faso,30,1,12305,144
2021-03-13,Burkina Faso,45,0,12350,144
2021-03-14,Burkina Faso,22,0,12372,144
2021-03-15,Burkina Faso,6,0,12378,144
2021-03-16,Burkina Faso,0,0,12378,144
2021-03-17,Burkina Faso,21,0,12399,144
2021-03-18,Burkina Faso,51,1,12450,145
2021-03-19,Burkina Faso,0,0,12450,145
2021-03-20,Burkina Faso,66,0,12516,145
2021-03-21,Burkina Faso,19,0,12535,145
2021-03-22,Burkina Faso,24,0,12559,145
2021-03-23,Burkina Faso,13,0,12572,145
2021-03-24,Burkina Faso,24,0,12596,145
2021-03-25,Burkina Faso,23,0,12619,145
2021-03-26,Burkina Faso,31,0,12650,145
2021-03-27,Burkina Faso,23,0,12673,145
2021-03-28,Burkina Faso,19,0,12692,145
2021-03-29,Burkina Faso,10,0,12702,145
2021-03-30,Burkina Faso,15,1,12717,146
2021-03-31,Burkina Faso,0,0,12717,146
2021-04-01,Burkina Faso,57,3,12774,149
2021-04-02,Burkina Faso,17,1,12791,150
2021-04-03,Burkina Faso,12,0,12803,150
2021-04-04,Burkina Faso,14,0,12817,150
2021-04-05,Burkina Faso,8,0,12825,150
2021-04-06,Burkina Faso,20,0,12845,150
2021-04-07,Burkina Faso,28,0,12873,150
2021-04-08,Burkina Faso,31,2,12904,152
2020-03-31,Burundi,2,0,2,0
2020-04-01,Burundi,0,0,2,0
2020-04-02,Burundi,1,0,3,0
2020-04-03,Burundi,0,0,3,0
2020-04-04,Burundi,0,0,3,0
2020-04-05,Burundi,0,0,3,0
2020-04-06,Burundi,0,0,3,0
2020-04-07,Burundi,0,0,3,0
2020-04-08,Burundi,0,0,3,0
2020-04-09,Burundi,0,0,3,0
2020-04-10,Burundi,0,0,3,0
2020-04-11,Burundi,2,0,5,0
2020-04-12,Burundi,0,0,5,0
2020-04-13,Burundi,0,1,5,1
2020-04-14,Burundi,0,0,5,1
2020-04-15,Burundi,0,0,5,1
2020-04-16,Burundi,0,0,5,1
2020-04-17,Burundi,0,0,5,1
2020-04-18,Burundi,0,0,5,1
2020-04-19,Burundi,0,0,5,1
2020-04-20,Burundi,0,0,5,1
2020-04-21,Burundi,0,0,5,1
2020-04-22,Burundi,6,0,11,1
2020-04-23,Burundi,0,0,11,1
2020-04-24,Burundi,0,0,11,1
2020-04-25,Burundi,0,0,11,1
2020-04-26,Burundi,0,0,11,1
2020-04-27,Burundi,0,0,11,1
2020-04-28,Burundi,0,0,11,1
2020-04-29,Burundi,0,0,11,1
2020-04-30,Burundi,0,0,11,1
2020-05-01,Burundi,0,0,11,1
2020-05-02,Burundi,4,0,15,1
2020-05-03,Burundi,0,0,15,1
2020-05-04,Burundi,0,0,15,1
2020-05-05,Burundi,0,0,15,1
2020-05-06,Burundi,0,0,15,1
2020-05-07,Burundi,0,0,15,1
2020-05-08,Burundi,0,0,15,1
2020-05-09,Burundi,0,0,15,1
2020-05-10,Burundi,0,0,15,1
2020-05-11,Burundi,0,0,15,1
2020-05-12,Burundi,0,0,15,1
2020-05-13,Burundi,0,0,15,1
2020-05-14,Burundi,0,0,15,1
2020-05-15,Burundi,0,0,15,1
2020-05-16,Burundi,0,0,15,1
2020-05-17,Burundi,8,0,23,1
2020-05-18,Burundi,19,0,42,1
2020-05-19,Burundi,0,0,42,1
2020-05-20,Burundi,0,0,42,1
2020-05-21,Burundi,0,0,42,1
2020-05-22,Burundi,0,0,42,1
2020-05-23,Burundi,0,0,42,1
2020-05-24,Burundi,0,0,42,1
2020-05-25,Burundi,0,0,42,1
2020-05-26,Burundi,0,0,42,1
2020-05-27,Burundi,0,0,42,1
2020-05-28,Burundi,0,0,42,1
2020-05-29,Burundi,0,0,42,1
2020-05-30,Burundi,21,0,63,1
2020-05-31,Burundi,0,0,63,1
2020-06-01,Burundi,0,0,63,1
2020-06-02,Burundi,0,0,63,1
2020-06-03,Burundi,0,0,63,1
2020-06-04,Burundi,0,0,63,1
2020-06-05,Burundi,0,0,63,1
2020-06-06,Burundi,20,0,83,1
2020-06-07,Burundi,0,0,83,1
2020-06-08,Burundi,0,0,83,1
2020-06-09,Burundi,0,0,83,1
2020-06-10,Burundi,0,0,83,1
2020-06-11,Burundi,2,0,85,1
2020-06-12,Burundi,0,0,85,1
2020-06-13,Burundi,0,0,85,1
2020-06-14,Burundi,0,0,85,1
2020-06-15,Burundi,0,0,85,1
2020-06-16,Burundi,19,0,104,1
2020-06-17,Burundi,0,0,104,1
2020-06-18,Burundi,0,0,104,1
2020-06-19,Burundi,0,0,104,1
2020-06-20,Burundi,0,0,104,1
2020-06-21,Burundi,40,0,144,1
2020-06-22,Burundi,0,0,144,1
2020-06-23,Burundi,0,0,144,1
2020-06-24,Burundi,0,0,144,1
2020-06-25,Burundi,0,0,144,1
2020-06-26,Burundi,0,0,144,1
2020-06-27,Burundi,26,0,170,1
2020-06-28,Burundi,0,0,170,1
2020-06-29,Burundi,0,0,170,1
2020-06-30,Burundi,0,0,170,1
2020-07-01,Burundi,0,0,170,1
2020-07-02,Burundi,0,0,170,1
2020-07-03,Burundi,21,0,191,1
2020-07-04,Burundi,0,0,191,1
2020-07-05,Burundi,0,0,191,1
2020-07-06,Burundi,0,0,191,1
2020-07-07,Burundi,0,0,191,1
2020-07-08,Burundi,0,0,191,1
2020-07-09,Burundi,0,0,191,1
2020-07-10,Burundi,0,0,191,1
2020-07-11,Burundi,0,0,191,1
2020-07-12,Burundi,0,0,191,1
2020-07-13,Burundi,78,0,269,1
2020-07-14,Burundi,0,0,269,1
2020-07-15,Burundi,0,0,269,1
2020-07-16,Burundi,34,0,303,1
2020-07-17,Burundi,7,0,310,1
2020-07-18,Burundi,0,0,310,1
2020-07-19,Burundi,0,0,310,1
2020-07-20,Burundi,12,0,322,1
2020-07-21,Burundi,6,0,328,1
2020-07-22,Burundi,0,0,328,1
2020-07-23,Burundi,17,0,345,1
2020-07-24,Burundi,0,0,345,1
2020-07-25,Burundi,16,0,361,1
2020-07-26,Burundi,0,0,361,1
2020-07-27,Burundi,17,0,378,1
2020-07-28,Burundi,0,0,378,1
2020-07-29,Burundi,9,0,387,1
2020-07-30,Burundi,0,0,387,1
2020-07-31,Burundi,0,0,387,1
2020-08-01,Burundi,8,0,395,1
2020-08-02,Burundi,0,0,395,1
2020-08-03,Burundi,0,0,395,1
2020-08-04,Burundi,0,0,395,1
2020-08-05,Burundi,0,0,395,1
2020-08-06,Burundi,5,0,400,1
2020-08-07,Burundi,0,0,400,1
2020-08-08,Burundi,5,0,405,1
2020-08-09,Burundi,3,0,408,1
2020-08-10,Burundi,0,0,408,1
2020-08-11,Burundi,0,0,408,1
2020-08-12,Burundi,1,0,409,1
2020-08-13,Burundi,1,0,410,1
2020-08-14,Burundi,2,0,412,1
2020-08-15,Burundi,0,0,412,1
2020-08-16,Burundi,1,0,413,1
2020-08-17,Burundi,0,0,413,1
2020-08-18,Burundi,3,0,416,1
2020-08-19,Burundi,6,0,422,1
2020-08-20,Burundi,0,0,422,1
2020-08-21,Burundi,4,0,426,1
2020-08-22,Burundi,3,0,429,1
2020-08-23,Burundi,1,0,430,1
2020-08-24,Burundi,0,0,430,1
2020-08-25,Burundi,0,0,430,1
2020-08-26,Burundi,0,0,430,1
2020-08-27,Burundi,1,0,431,1
2020-08-28,Burundi,2,0,433,1
2020-08-29,Burundi,12,0,445,1
2020-08-30,Burundi,0,0,445,1
2020-08-31,Burundi,0,0,445,1
2020-09-01,Burundi,0,0,445,1
2020-09-02,Burundi,3,0,448,1
2020-09-03,Burundi,0,0,448,1
2020-09-04,Burundi,3,0,451,1
2020-09-05,Burundi,9,0,460,1
2020-09-06,Burundi,2,0,462,1
2020-09-07,Burundi,4,0,466,1
2020-09-08,Burundi,0,0,466,1
2020-09-09,Burundi,0,0,466,1
2020-09-10,Burundi,3,0,469,1
2020-09-11,Burundi,0,0,469,1
2020-09-12,Burundi,2,0,471,1
2020-09-13,Burundi,1,0,472,1
2020-09-14,Burundi,0,0,472,1
2020-09-15,Burundi,0,0,472,1
2020-09-16,Burundi,0,0,472,1
2020-09-17,Burundi,1,0,473,1
2020-09-18,Burundi,0,0,473,1
2020-09-19,Burundi,0,0,473,1
2020-09-20,Burundi,0,0,473,1
2020-09-21,Burundi,1,0,474,1
2020-09-22,Burundi,0,0,474,1
2020-09-23,Burundi,2,0,476,1
2020-09-24,Burundi,1,0,477,1
2020-09-25,Burundi,6,0,483,1
2020-09-26,Burundi,2,0,485,1
2020-09-27,Burundi,0,0,485,1
2020-09-28,Burundi,17,0,502,1
2020-09-29,Burundi,4,0,506,1
2020-09-30,Burundi,2,0,508,1
2020-10-01,Burundi,2,0,510,1
2020-10-02,Burundi,3,0,513,1
2020-10-03,Burundi,0,0,513,1
2020-10-04,Burundi,0,0,513,1
2020-10-05,Burundi,1,0,514,1
2020-10-06,Burundi,0,0,514,1
2020-10-07,Burundi,1,0,515,1
2020-10-08,Burundi,0,0,515,1
2020-10-09,Burundi,0,0,515,1
2020-10-10,Burundi,2,0,517,1
2020-10-11,Burundi,7,0,524,1
2020-10-12,Burundi,1,0,525,1
2020-10-13,Burundi,4,0,529,1
2020-10-14,Burundi,0,0,529,1
2020-10-15,Burundi,0,0,529,1
2020-10-16,Burundi,2,0,531,1
2020-10-17,Burundi,5,0,536,1
2020-10-18,Burundi,6,0,542,1
2020-10-19,Burundi,7,0,549,1
2020-10-20,Burundi,1,0,550,1
2020-10-21,Burundi,0,0,550,1
2020-10-22,Burundi,1,0,551,1
2020-10-23,Burundi,2,0,553,1
2020-10-24,Burundi,2,0,555,1
2020-10-25,Burundi,2,0,557,1
2020-10-26,Burundi,0,0,557,1
2020-10-27,Burundi,1,0,558,1
2020-10-28,Burundi,1,0,559,1
2020-10-29,Burundi,1,0,560,1
2020-10-30,Burundi,22,0,582,1
2020-10-31,Burundi,3,0,585,1
2020-11-01,Burundi,4,0,589,1
2020-11-02,Burundi,0,0,589,1
2020-11-03,Burundi,8,0,597,1
2020-11-04,Burundi,9,0,606,1
2020-11-05,Burundi,0,0,606,1
2020-11-06,Burundi,0,0,606,1
2020-11-07,Burundi,6,0,612,1
2020-11-08,Burundi,0,0,612,1
2020-11-09,Burundi,2,0,614,1
2020-11-10,Burundi,1,0,615,1
2020-11-11,Burundi,5,0,620,1
2020-11-12,Burundi,3,0,623,1
2020-11-13,Burundi,1,0,624,1
2020-11-14,Burundi,3,0,627,1
2020-11-15,Burundi,1,0,628,1
2020-11-16,Burundi,2,0,630,1
2020-11-17,Burundi,1,0,631,1
2020-11-18,Burundi,10,0,641,1
2020-11-19,Burundi,0,0,641,1
2020-11-20,Burundi,8,0,649,1
2020-11-21,Burundi,7,0,656,1
2020-11-22,Burundi,6,0,662,1
2020-11-23,Burundi,2,0,664,1
2020-11-24,Burundi,9,0,673,1
2020-11-25,Burundi,0,0,673,1
2020-11-26,Burundi,4,0,677,1
2020-11-27,Burundi,4,0,681,1
2020-11-28,Burundi,0,0,681,1
2020-11-29,Burundi,0,0,681,1
2020-11-30,Burundi,7,0,688,1
2020-12-01,Burundi,1,0,689,1
2020-12-02,Burundi,0,0,689,1
2020-12-03,Burundi,3,0,692,1
2020-12-04,Burundi,0,0,692,1
2020-12-05,Burundi,2,0,694,1
2020-12-06,Burundi,0,0,694,1
2020-12-07,Burundi,4,0,698,1
2020-12-08,Burundi,18,0,716,1
2020-12-09,Burundi,4,0,720,1
2020-12-10,Burundi,0,0,720,1
2020-12-11,Burundi,3,0,723,1
2020-12-12,Burundi,5,0,728,1
2020-12-13,Burundi,1,0,729,1
2020-12-14,Burundi,0,0,729,1
2020-12-15,Burundi,6,0,735,1
2020-12-16,Burundi,6,0,741,1
2020-12-17,Burundi,10,0,751,1
2020-12-18,Burundi,0,0,751,1
2020-12-19,Burundi,10,1,761,2
2020-12-20,Burundi,0,0,761,2
2020-12-21,Burundi,1,0,762,2
2020-12-22,Burundi,0,0,762,2
2020-12-23,Burundi,11,0,773,2
2020-12-24,Burundi,0,0,773,2
2020-12-25,Burundi,13,0,786,2
2020-12-26,Burundi,0,0,786,2
2020-12-27,Burundi,18,0,804,2
2020-12-28,Burundi,0,0,804,2
2020-12-29,Burundi,5,0,809,2
2020-12-30,Burundi,0,0,809,2
2020-12-31,Burundi,9,0,818,2
2021-01-01,Burundi,4,0,822,2
2021-01-02,Burundi,0,0,822,2
2021-01-03,Burundi,11,0,833,2
2021-01-04,Burundi,9,0,842,2
2021-01-05,Burundi,0,0,842,2
2021-01-06,Burundi,42,0,884,2
2021-01-07,Burundi,1,0,885,2
2021-01-08,Burundi,0,0,885,2
2021-01-09,Burundi,0,0,885,2
2021-01-10,Burundi,101,0,986,2
2021-01-11,Burundi,33,0,1019,2
2021-01-12,Burundi,0,0,1019,2
2021-01-13,Burundi,43,0,1062,2
2021-01-14,Burundi,41,0,1103,2
2021-01-15,Burundi,47,0,1150,2
2021-01-16,Burundi,35,0,1185,2
2021-01-17,Burundi,51,0,1236,2
2021-01-18,Burundi,9,0,1245,2
2021-01-19,Burundi,8,0,1253,2
2021-01-20,Burundi,69,0,1322,2
2021-01-21,Burundi,36,0,1358,2
2021-01-22,Burundi,22,0,1380,2
2021-01-23,Burundi,58,0,1438,2
2021-01-24,Burundi,34,0,1472,2
2021-01-25,Burundi,7,0,1479,2
2021-01-26,Burundi,2,0,1481,2
2021-01-27,Burundi,61,0,1542,2
2021-01-28,Burundi,42,0,1584,2
2021-01-29,Burundi,20,0,1604,2
2021-01-30,Burundi,9,0,1613,2
2021-01-31,Burundi,19,0,1632,2
2021-02-01,Burundi,3,0,1635,2
2021-02-02,Burundi,6,0,1641,2
2021-02-03,Burundi,23,0,1664,2
2021-02-04,Burundi,22,0,1686,2
2021-02-05,Burundi,12,1,1698,3
2021-02-06,Burundi,19,0,1717,3
2021-02-07,Burundi,6,0,1723,3
2021-02-08,Burundi,5,0,1728,3
2021-02-09,Burundi,2,0,1730,3
2021-02-10,Burundi,21,0,1751,3
2021-02-11,Burundi,20,0,1771,3
2021-02-12,Burundi,26,0,1797,3
2021-02-13,Burundi,27,0,1824,3
2021-02-14,Burundi,0,0,1824,3
2021-02-15,Burundi,25,0,1849,3
2021-02-16,Burundi,6,0,1855,3
2021-02-17,Burundi,40,0,1895,3
2021-02-18,Burundi,33,0,1928,3
2021-02-19,Burundi,27,0,1955,3
2021-02-20,Burundi,28,0,1983,3
2021-02-21,Burundi,48,0,2031,3
2021-02-22,Burundi,3,0,2034,3
2021-02-23,Burundi,7,0,2041,3
2021-02-24,Burundi,28,0,2069,3
2021-02-25,Burundi,37,0,2106,3
2021-02-26,Burundi,37,0,2143,3
2021-02-27,Burundi,38,0,2181,3
2021-02-28,Burundi,28,0,2209,3
2021-03-01,Burundi,8,0,2217,3
2021-03-02,Burundi,7,0,2224,3
2021-03-03,Burundi,16,0,2240,3
2021-03-04,Burundi,28,0,2268,3
2021-03-05,Burundi,15,0,2283,3
2021-03-06,Burundi,16,0,2299,3
2021-03-07,Burundi,20,0,2319,3
2021-03-08,Burundi,15,0,2334,3
2021-03-09,Burundi,5,0,2339,3
2021-03-10,Burundi,30,0,2369,3
2021-03-11,Burundi,27,0,2396,3
2021-03-12,Burundi,24,0,2420,3
2021-03-13,Burundi,21,0,2441,3
2021-03-14,Burundi,20,0,2461,3
2021-03-15,Burundi,0,0,2461,3
2021-03-16,Burundi,0,0,2461,3
2021-03-17,Burundi,0,0,2461,3
2021-03-18,Burundi,81,0,2542,3
2021-03-19,Burundi,21,0,2563,3
2021-03-20,Burundi,0,0,2563,3
2021-03-21,Burundi,50,3,2613,6
2021-03-22,Burundi,5,0,2618,6
2021-03-23,Burundi,10,0,2628,6
2021-03-24,Burundi,29,0,2657,6
2021-03-25,Burundi,0,0,2657,6
2021-03-26,Burundi,0,0,2657,6
2021-03-27,Burundi,0,0,2657,6
2021-03-28,Burundi,100,0,2757,6
2021-03-29,Burundi,0,0,2757,6
2021-03-30,Burundi,0,0,2757,6
2021-03-31,Burundi,53,0,2810,6
2021-04-01,Burundi,32,0,2842,6
2021-04-02,Burundi,0,0,2842,6
2021-04-03,Burundi,69,0,2911,6
2021-04-04,Burundi,0,0,2911,6
2021-04-05,Burundi,53,0,2964,6
2021-04-06,Burundi,6,0,2970,6
2021-04-07,Burundi,47,0,3017,6
2021-04-08,Burundi,10,0,3027,6
2020-01-27,Cambodia,1,0,1,0
2020-01-28,Cambodia,0,0,1,0
2020-01-29,Cambodia,0,0,1,0
2020-01-30,Cambodia,0,0,1,0
2020-01-31,Cambodia,0,0,1,0
2020-02-01,Cambodia,0,0,1,0
2020-02-02,Cambodia,0,0,1,0
2020-02-03,Cambodia,0,0,1,0
2020-02-04,Cambodia,0,0,1,0
2020-02-05,Cambodia,0,0,1,0
2020-02-06,Cambodia,0,0,1,0
2020-02-07,Cambodia,0,0,1,0
2020-02-08,Cambodia,0,0,1,0
2020-02-09,Cambodia,0,0,1,0
2020-02-10,Cambodia,0,0,1,0
2020-02-11,Cambodia,0,0,1,0
2020-02-12,Cambodia,0,0,1,0
2020-02-13,Cambodia,0,0,1,0
2020-02-14,Cambodia,0,0,1,0
2020-02-15,Cambodia,0,0,1,0
2020-02-16,Cambodia,0,0,1,0
2020-02-17,Cambodia,0,0,1,0
2020-02-18,Cambodia,0,0,1,0
2020-02-19,Cambodia,0,0,1,0
2020-02-20,Cambodia,0,0,1,0
2020-02-21,Cambodia,0,0,1,0
2020-02-22,Cambodia,0,0,1,0
2020-02-23,Cambodia,0,0,1,0
2020-02-24,Cambodia,0,0,1,0
2020-02-25,Cambodia,0,0,1,0
2020-02-26,Cambodia,0,0,1,0
2020-02-27,Cambodia,0,0,1,0
2020-02-28,Cambodia,0,0,1,0
2020-02-29,Cambodia,0,0,1,0
2020-03-01,Cambodia,0,0,1,0
2020-03-02,Cambodia,0,0,1,0
2020-03-03,Cambodia,0,0,1,0
2020-03-04,Cambodia,0,0,1,0
2020-03-05,Cambodia,0,0,1,0
2020-03-06,Cambodia,0,0,1,0
2020-03-07,Cambodia,0,0,1,0
2020-03-08,Cambodia,1,0,2,0
2020-03-09,Cambodia,0,0,2,0
2020-03-10,Cambodia,0,0,2,0
2020-03-11,Cambodia,1,0,3,0
2020-03-12,Cambodia,0,0,3,0
2020-03-13,Cambodia,2,0,5,0
2020-03-14,Cambodia,2,0,7,0
2020-03-15,Cambodia,0,0,7,0
2020-03-16,Cambodia,0,0,7,0
2020-03-17,Cambodia,26,0,33,0
2020-03-18,Cambodia,2,0,35,0
2020-03-19,Cambodia,2,0,37,0
2020-03-20,Cambodia,14,0,51,0
2020-03-21,Cambodia,2,0,53,0
2020-03-22,Cambodia,31,0,84,0
2020-03-23,Cambodia,3,0,87,0
2020-03-24,Cambodia,4,0,91,0
2020-03-25,Cambodia,5,0,96,0
2020-03-26,Cambodia,0,0,96,0
2020-03-27,Cambodia,3,0,99,0
2020-03-28,Cambodia,0,0,99,0
2020-03-29,Cambodia,4,0,103,0
2020-03-30,Cambodia,4,0,107,0
2020-03-31,Cambodia,2,0,109,0
2020-04-01,Cambodia,0,0,109,0
2020-04-02,Cambodia,1,0,110,0
2020-04-03,Cambodia,4,0,114,0
2020-04-04,Cambodia,0,0,114,0
2020-04-05,Cambodia,0,0,114,0
2020-04-06,Cambodia,0,0,114,0
2020-04-07,Cambodia,1,0,115,0
2020-04-08,Cambodia,2,0,117,0
2020-04-09,Cambodia,2,0,119,0
2020-04-10,Cambodia,0,0,119,0
2020-04-11,Cambodia,1,0,120,0
2020-04-12,Cambodia,2,0,122,0
2020-04-13,Cambodia,0,0,122,0
2020-04-14,Cambodia,0,0,122,0
2020-04-15,Cambodia,0,0,122,0
2020-04-16,Cambodia,0,0,122,0
2020-04-17,Cambodia,0,0,122,0
2020-04-18,Cambodia,0,0,122,0
2020-04-19,Cambodia,0,0,122,0
2020-04-20,Cambodia,0,0,122,0
2020-04-21,Cambodia,0,0,122,0
2020-04-22,Cambodia,0,0,122,0
2020-04-23,Cambodia,0,0,122,0
2020-04-24,Cambodia,0,0,122,0
2020-04-25,Cambodia,0,0,122,0
2020-04-26,Cambodia,0,0,122,0
2020-04-27,Cambodia,0,0,122,0
2020-04-28,Cambodia,0,0,122,0
2020-04-29,Cambodia,0,0,122,0
2020-04-30,Cambodia,0,0,122,0
2020-05-01,Cambodia,0,0,122,0
2020-05-02,Cambodia,0,0,122,0
2020-05-03,Cambodia,0,0,122,0
2020-05-04,Cambodia,0,0,122,0
2020-05-05,Cambodia,0,0,122,0
2020-05-06,Cambodia,0,0,122,0
2020-05-07,Cambodia,0,0,122,0
2020-05-08,Cambodia,0,0,122,0
2020-05-09,Cambodia,0,0,122,0
2020-05-10,Cambodia,0,0,122,0
2020-05-11,Cambodia,0,0,122,0
2020-05-12,Cambodia,0,0,122,0
2020-05-13,Cambodia,0,0,122,0
2020-05-14,Cambodia,0,0,122,0
2020-05-15,Cambodia,0,0,122,0
2020-05-16,Cambodia,0,0,122,0
2020-05-17,Cambodia,0,0,122,0
2020-05-18,Cambodia,0,0,122,0
2020-05-19,Cambodia,0,0,122,0
2020-05-20,Cambodia,0,0,122,0
2020-05-21,Cambodia,1,0,123,0
2020-05-22,Cambodia,0,0,123,0
2020-05-23,Cambodia,1,0,124,0
2020-05-24,Cambodia,0,0,124,0
2020-05-25,Cambodia,0,0,124,0
2020-05-26,Cambodia,0,0,124,0
2020-05-27,Cambodia,0,0,124,0
2020-05-28,Cambodia,0,0,124,0
2020-05-29,Cambodia,0,0,124,0
2020-05-30,Cambodia,1,0,125,0
2020-05-31,Cambodia,0,0,125,0
2020-06-01,Cambodia,0,0,125,0
2020-06-02,Cambodia,0,0,125,0
2020-06-03,Cambodia,0,0,125,0
2020-06-04,Cambodia,0,0,125,0
2020-06-05,Cambodia,0,0,125,0
2020-06-06,Cambodia,0,0,125,0
2020-06-07,Cambodia,1,0,126,0
2020-06-08,Cambodia,0,0,126,0
2020-06-09,Cambodia,0,0,126,0
2020-06-10,Cambodia,0,0,126,0
2020-06-11,Cambodia,0,0,126,0
2020-06-12,Cambodia,0,0,126,0
2020-06-13,Cambodia,2,0,128,0
2020-06-14,Cambodia,0,0,128,0
2020-06-15,Cambodia,0,0,128,0
2020-06-16,Cambodia,0,0,128,0
2020-06-17,Cambodia,0,0,128,0
2020-06-18,Cambodia,1,0,129,0
2020-06-19,Cambodia,0,0,129,0
2020-06-20,Cambodia,0,0,129,0
2020-06-21,Cambodia,0,0,129,0
2020-06-22,Cambodia,1,0,130,0
2020-06-23,Cambodia,0,0,130,0
2020-06-24,Cambodia,0,0,130,0
2020-06-25,Cambodia,0,0,130,0
2020-06-26,Cambodia,9,0,139,0
2020-06-27,Cambodia,2,0,141,0
2020-06-28,Cambodia,0,0,141,0
2020-06-29,Cambodia,0,0,141,0
2020-06-30,Cambodia,0,0,141,0
2020-07-01,Cambodia,0,0,141,0
2020-07-02,Cambodia,0,0,141,0
2020-07-03,Cambodia,0,0,141,0
2020-07-04,Cambodia,0,0,141,0
2020-07-05,Cambodia,0,0,141,0
2020-07-06,Cambodia,0,0,141,0
2020-07-07,Cambodia,0,0,141,0
2020-07-08,Cambodia,0,0,141,0
2020-07-09,Cambodia,0,0,141,0
2020-07-10,Cambodia,0,0,141,0
2020-07-11,Cambodia,15,0,156,0
2020-07-12,Cambodia,0,0,156,0
2020-07-13,Cambodia,9,0,165,0
2020-07-14,Cambodia,0,0,165,0
2020-07-15,Cambodia,1,0,166,0
2020-07-16,Cambodia,5,0,171,0
2020-07-17,Cambodia,0,0,171,0
2020-07-18,Cambodia,0,0,171,0
2020-07-19,Cambodia,0,0,171,0
2020-07-20,Cambodia,0,0,171,0
2020-07-21,Cambodia,26,0,197,0
2020-07-22,Cambodia,1,0,198,0
2020-07-23,Cambodia,4,0,202,0
2020-07-24,Cambodia,0,0,202,0
2020-07-25,Cambodia,23,0,225,0
2020-07-26,Cambodia,0,0,225,0
2020-07-27,Cambodia,1,0,226,0
2020-07-28,Cambodia,0,0,226,0
2020-07-29,Cambodia,0,0,226,0
2020-07-30,Cambodia,8,0,234,0
2020-07-31,Cambodia,5,0,239,0
2020-08-01,Cambodia,1,0,240,0
2020-08-02,Cambodia,0,0,240,0
2020-08-03,Cambodia,0,0,240,0
2020-08-04,Cambodia,3,0,243,0
2020-08-05,Cambodia,0,0,243,0
2020-08-06,Cambodia,0,0,243,0
2020-08-07,Cambodia,3,0,246,0
2020-08-08,Cambodia,2,0,248,0
2020-08-09,Cambodia,3,0,251,0
2020-08-10,Cambodia,0,0,251,0
2020-08-11,Cambodia,17,0,268,0
2020-08-12,Cambodia,4,0,272,0
2020-08-13,Cambodia,1,0,273,0
2020-08-14,Cambodia,0,0,273,0
2020-08-15,Cambodia,0,0,273,0
2020-08-16,Cambodia,0,0,273,0
2020-08-17,Cambodia,0,0,273,0
2020-08-18,Cambodia,0,0,273,0
2020-08-19,Cambodia,0,0,273,0
2020-08-20,Cambodia,0,0,273,0
2020-08-21,Cambodia,0,0,273,0
2020-08-22,Cambodia,0,0,273,0
2020-08-23,Cambodia,0,0,273,0
2020-08-24,Cambodia,0,0,273,0
2020-08-25,Cambodia,0,0,273,0
2020-08-26,Cambodia,0,0,273,0
2020-08-27,Cambodia,0,0,273,0
2020-08-28,Cambodia,0,0,273,0
2020-08-29,Cambodia,0,0,273,0
2020-08-30,Cambodia,0,0,273,0
2020-08-31,Cambodia,1,0,274,0
2020-09-01,Cambodia,0,0,274,0
2020-09-02,Cambodia,0,0,274,0
2020-09-03,Cambodia,0,0,274,0
2020-09-04,Cambodia,0,0,274,0
2020-09-05,Cambodia,0,0,274,0
2020-09-06,Cambodia,0,0,274,0
2020-09-07,Cambodia,0,0,274,0
2020-09-08,Cambodia,0,0,274,0
2020-09-09,Cambodia,0,0,274,0
2020-09-10,Cambodia,0,0,274,0
2020-09-11,Cambodia,0,0,274,0
2020-09-12,Cambodia,1,0,275,0
2020-09-13,Cambodia,0,0,275,0
2020-09-14,Cambodia,0,0,275,0
2020-09-15,Cambodia,0,0,275,0
2020-09-16,Cambodia,0,0,275,0
2020-09-17,Cambodia,0,0,275,0
2020-09-18,Cambodia,0,0,275,0
2020-09-19,Cambodia,0,0,275,0
2020-09-20,Cambodia,0,0,275,0
2020-09-21,Cambodia,0,0,275,0
2020-09-22,Cambodia,0,0,275,0
2020-09-23,Cambodia,0,0,275,0
2020-09-24,Cambodia,0,0,275,0
2020-09-25,Cambodia,0,0,275,0
2020-09-26,Cambodia,1,0,276,0
2020-09-27,Cambodia,0,0,276,0
2020-09-28,Cambodia,1,0,277,0
2020-09-29,Cambodia,0,0,277,0
2020-09-30,Cambodia,0,0,277,0
2020-10-01,Cambodia,1,0,278,0
2020-10-02,Cambodia,0,0,278,0
2020-10-03,Cambodia,0,0,278,0
2020-10-04,Cambodia,0,0,278,0
2020-10-05,Cambodia,2,0,280,0
2020-10-06,Cambodia,0,0,280,0
2020-10-07,Cambodia,1,0,281,0
2020-10-08,Cambodia,0,0,281,0
2020-10-09,Cambodia,2,0,283,0
2020-10-10,Cambodia,0,0,283,0
2020-10-11,Cambodia,0,0,283,0
2020-10-12,Cambodia,0,0,283,0
2020-10-13,Cambodia,0,0,283,0
2020-10-14,Cambodia,0,0,283,0
2020-10-15,Cambodia,0,0,283,0
2020-10-16,Cambodia,0,0,283,0
2020-10-17,Cambodia,0,0,283,0
2020-10-18,Cambodia,0,0,283,0
2020-10-19,Cambodia,2,0,285,0
2020-10-20,Cambodia,1,0,286,0
2020-10-21,Cambodia,0,0,286,0
2020-10-22,Cambodia,0,0,286,0
2020-10-23,Cambodia,1,0,287,0
2020-10-24,Cambodia,0,0,287,0
2020-10-25,Cambodia,0,0,287,0
2020-10-26,Cambodia,1,0,288,0
2020-10-27,Cambodia,2,0,290,0
2020-10-28,Cambodia,0,0,290,0
2020-10-29,Cambodia,1,0,291,0
2020-10-30,Cambodia,0,0,291,0
2020-10-31,Cambodia,0,0,291,0
2020-11-01,Cambodia,1,0,292,0
2020-11-02,Cambodia,0,0,292,0
2020-11-03,Cambodia,0,0,292,0
2020-11-04,Cambodia,0,0,292,0
2020-11-05,Cambodia,0,0,292,0
2020-11-06,Cambodia,2,0,294,0
2020-11-07,Cambodia,1,0,295,0
2020-11-08,Cambodia,2,0,297,0
2020-11-09,Cambodia,3,0,300,0
2020-11-10,Cambodia,0,0,300,0
2020-11-11,Cambodia,1,0,301,0
2020-11-12,Cambodia,0,0,301,0
2020-11-13,Cambodia,1,0,302,0
2020-11-14,Cambodia,0,0,302,0
2020-11-15,Cambodia,0,0,302,0
2020-11-16,Cambodia,1,0,303,0
2020-11-17,Cambodia,1,0,304,0
2020-11-18,Cambodia,0,0,304,0
2020-11-19,Cambodia,0,0,304,0
2020-11-20,Cambodia,1,0,305,0
2020-11-21,Cambodia,1,0,306,0
2020-11-22,Cambodia,0,0,306,0
2020-11-23,Cambodia,0,0,306,0
2020-11-24,Cambodia,1,0,307,0
2020-11-25,Cambodia,0,0,307,0
2020-11-26,Cambodia,0,0,307,0
2020-11-27,Cambodia,1,0,308,0
2020-11-28,Cambodia,7,0,315,0
2020-11-29,Cambodia,8,0,323,0
2020-11-30,Cambodia,3,0,326,0
2020-12-01,Cambodia,3,0,329,0
2020-12-02,Cambodia,2,0,331,0
2020-12-03,Cambodia,4,0,335,0
2020-12-04,Cambodia,10,0,345,0
2020-12-05,Cambodia,1,0,346,0
2020-12-06,Cambodia,2,0,348,0
2020-12-07,Cambodia,2,0,350,0
2020-12-08,Cambodia,4,0,354,0
2020-12-09,Cambodia,2,0,356,0
2020-12-10,Cambodia,1,0,357,0
2020-12-11,Cambodia,0,0,357,0
2020-12-12,Cambodia,2,0,359,0
2020-12-13,Cambodia,0,0,359,0
2020-12-14,Cambodia,3,0,362,0
2020-12-15,Cambodia,0,0,362,0
2020-12-16,Cambodia,0,0,362,0
2020-12-17,Cambodia,0,0,362,0
2020-12-18,Cambodia,0,0,362,0
2020-12-19,Cambodia,0,0,362,0
2020-12-20,Cambodia,1,0,363,0
2020-12-21,Cambodia,0,0,363,0
2020-12-22,Cambodia,0,0,363,0
2020-12-23,Cambodia,0,0,363,0
2020-12-24,Cambodia,0,0,363,0
2020-12-25,Cambodia,0,0,363,0
2020-12-26,Cambodia,1,0,364,0
2020-12-27,Cambodia,0,0,364,0
2020-12-28,Cambodia,0,0,364,0
2020-12-29,Cambodia,0,0,364,0
2020-12-30,Cambodia,2,0,366,0
2020-12-31,Cambodia,12,0,378,0
2021-01-01,Cambodia,1,0,379,0
2021-01-02,Cambodia,2,0,381,0
2021-01-03,Cambodia,1,0,382,0
2021-01-04,Cambodia,0,0,382,0
2021-01-05,Cambodia,1,0,383,0
2021-01-06,Cambodia,2,0,385,0
2021-01-07,Cambodia,1,0,386,0
2021-01-08,Cambodia,1,0,387,0
2021-01-09,Cambodia,4,0,391,0
2021-01-10,Cambodia,0,0,391,0
2021-01-11,Cambodia,1,0,392,0
2021-01-12,Cambodia,6,0,398,0
2021-01-13,Cambodia,13,0,411,0
2021-01-14,Cambodia,15,0,426,0
2021-01-15,Cambodia,10,0,436,0
2021-01-16,Cambodia,3,0,439,0
2021-01-17,Cambodia,0,0,439,0
2021-01-18,Cambodia,2,0,441,0
2021-01-19,Cambodia,7,0,448,0
2021-01-20,Cambodia,5,0,453,0
2021-01-21,Cambodia,3,0,456,0
2021-01-22,Cambodia,0,0,456,0
2021-01-23,Cambodia,2,0,458,0
2021-01-24,Cambodia,0,0,458,0
2021-01-25,Cambodia,2,0,460,0
2021-01-26,Cambodia,0,0,460,0
2021-01-27,Cambodia,0,0,460,0
2021-01-28,Cambodia,3,0,463,0
2021-01-29,Cambodia,0,0,463,0
2021-01-30,Cambodia,2,0,465,0
2021-01-31,Cambodia,1,0,466,0
2021-02-01,Cambodia,0,0,466,0
2021-02-02,Cambodia,0,0,466,0
2021-02-03,Cambodia,1,0,467,0
2021-02-04,Cambodia,3,0,470,0
2021-02-05,Cambodia,2,0,472,0
2021-02-06,Cambodia,2,0,474,0
2021-02-07,Cambodia,0,0,474,0
2021-02-08,Cambodia,2,0,476,0
2021-02-09,Cambodia,0,0,476,0
2021-02-10,Cambodia,2,0,478,0
2021-02-11,Cambodia,1,0,479,0
2021-02-12,Cambodia,0,0,479,0
2021-02-13,Cambodia,0,0,479,0
2021-02-14,Cambodia,0,0,479,0
2021-02-15,Cambodia,0,0,479,0
2021-02-16,Cambodia,0,0,479,0
2021-02-17,Cambodia,4,0,483,0
2021-02-18,Cambodia,1,0,484,0
2021-02-19,Cambodia,0,0,484,0
2021-02-20,Cambodia,49,0,533,0
2021-02-21,Cambodia,35,0,568,0
2021-02-22,Cambodia,25,0,593,0
2021-02-23,Cambodia,40,0,633,0
2021-02-24,Cambodia,64,0,697,0
2021-02-25,Cambodia,44,0,741,0
2021-02-26,Cambodia,26,0,767,0
2021-02-27,Cambodia,38,0,805,0
2021-02-28,Cambodia,15,0,820,0
2021-03-01,Cambodia,24,0,844,0
2021-03-02,Cambodia,34,0,878,0
2021-03-03,Cambodia,31,0,909,0
2021-03-04,Cambodia,23,0,932,0
2021-03-05,Cambodia,21,0,953,0
2021-03-06,Cambodia,34,0,987,0
2021-03-07,Cambodia,24,0,1011,0
2021-03-08,Cambodia,0,0,1011,0
2021-03-09,Cambodia,113,0,1124,0
2021-03-10,Cambodia,39,0,1163,0
2021-03-11,Cambodia,62,1,1225,1
2021-03-12,Cambodia,39,0,1264,1
2021-03-13,Cambodia,41,0,1305,1
2021-03-14,Cambodia,20,0,1325,1
2021-03-15,Cambodia,0,0,1325,1
2021-03-16,Cambodia,180,0,1505,1
2021-03-17,Cambodia,36,0,1541,1
2021-03-18,Cambodia,37,0,1578,1
2021-03-19,Cambodia,0,1,1578,2
2021-03-20,Cambodia,0,0,1578,2
2021-03-21,Cambodia,175,1,1753,3
2021-03-22,Cambodia,35,1,1788,4
2021-03-23,Cambodia,29,1,1817,5
2021-03-24,Cambodia,55,0,1872,5
2021-03-25,Cambodia,0,0,1872,5
2021-03-26,Cambodia,96,3,1968,8
2021-03-27,Cambodia,179,0,2147,8
2021-03-28,Cambodia,86,2,2233,10
2021-03-29,Cambodia,145,1,2378,11
2021-03-30,Cambodia,62,0,2440,11
2021-03-31,Cambodia,0,0,2440,11
2021-04-01,Cambodia,37,3,2477,14
2021-04-02,Cambodia,69,2,2546,16
2021-04-03,Cambodia,143,3,2689,19
2021-04-04,Cambodia,0,0,2689,19
2021-04-05,Cambodia,63,2,2752,21
2021-04-06,Cambodia,163,1,2915,22
2021-04-07,Cambodia,0,0,2915,22
2021-04-08,Cambodia,113,2,3028,24
2020-03-06,Cameroon,1,0,1,0
2020-03-07,Cameroon,0,0,1,0
2020-03-08,Cameroon,1,0,2,0
2020-03-09,Cameroon,0,0,2,0
2020-03-10,Cameroon,0,0,2,0
2020-03-11,Cameroon,0,0,2,0
2020-03-12,Cameroon,0,0,2,0
2020-03-13,Cameroon,0,0,2,0
2020-03-14,Cameroon,0,0,2,0
2020-03-15,Cameroon,0,0,2,0
2020-03-16,Cameroon,2,0,4,0
2020-03-17,Cameroon,6,0,10,0
2020-03-18,Cameroon,0,0,10,0
2020-03-19,Cameroon,3,0,13,0
2020-03-20,Cameroon,7,0,20,0
2020-03-21,Cameroon,7,0,27,0
2020-03-22,Cameroon,13,0,40,0
2020-03-23,Cameroon,16,0,56,0
2020-03-24,Cameroon,10,0,66,0
2020-03-25,Cameroon,9,1,75,1
2020-03-26,Cameroon,0,0,75,1
2020-03-27,Cameroon,16,1,91,2
2020-03-28,Cameroon,0,0,91,2
2020-03-29,Cameroon,48,4,139,6
2020-03-30,Cameroon,0,0,139,6
2020-03-31,Cameroon,54,0,193,6
2020-04-01,Cameroon,40,0,233,6
2020-04-02,Cameroon,73,1,306,7
2020-04-03,Cameroon,203,1,509,8
2020-04-04,Cameroon,46,1,555,9
2020-04-05,Cameroon,95,0,650,9
2020-04-06,Cameroon,8,0,658,9
2020-04-07,Cameroon,0,0,658,9
2020-04-08,Cameroon,72,1,730,10
2020-04-09,Cameroon,0,0,730,10
2020-04-10,Cameroon,90,2,820,12
2020-04-11,Cameroon,0,0,820,12
2020-04-12,Cameroon,0,0,820,12
2020-04-13,Cameroon,0,0,820,12
2020-04-14,Cameroon,28,2,848,14
2020-04-15,Cameroon,0,3,848,17
2020-04-16,Cameroon,148,5,996,22
2020-04-17,Cameroon,0,0,996,22
2020-04-18,Cameroon,21,0,1017,22
2020-04-19,Cameroon,0,20,1017,42
2020-04-20,Cameroon,146,0,1163,42
2020-04-21,Cameroon,0,1,1163,43
2020-04-22,Cameroon,0,0,1163,43
2020-04-23,Cameroon,171,0,1334,43
2020-04-24,Cameroon,96,0,1430,43
2020-04-25,Cameroon,88,10,1518,53
2020-04-26,Cameroon,103,3,1621,56
2020-04-27,Cameroon,84,2,1705,58
2020-04-28,Cameroon,0,0,1705,58
2020-04-29,Cameroon,127,3,1832,61
2020-04-30,Cameroon,0,0,1832,61
2020-05-01,Cameroon,0,0,1832,61
2020-05-02,Cameroon,245,3,2077,64
2020-05-03,Cameroon,0,0,2077,64
2020-05-04,Cameroon,27,0,2104,64
2020-05-05,Cameroon,0,0,2104,64
2020-05-06,Cameroon,161,44,2265,108
2020-05-07,Cameroon,2,0,2267,108
2020-05-08,Cameroon,0,0,2267,108
2020-05-09,Cameroon,7,0,2274,108
2020-05-10,Cameroon,305,6,2579,114
2020-05-11,Cameroon,110,11,2689,125
2020-05-12,Cameroon,0,0,2689,125
2020-05-13,Cameroon,111,11,2800,136
2020-05-14,Cameroon,154,3,2954,139
2020-05-15,Cameroon,151,1,3105,140
2020-05-16,Cameroon,0,0,3105,140
2020-05-17,Cameroon,0,0,3105,140
2020-05-18,Cameroon,424,0,3529,140
2020-05-19,Cameroon,0,0,3529,140
2020-05-20,Cameroon,204,6,3733,146
2020-05-21,Cameroon,555,10,4288,156
2020-05-22,Cameroon,112,3,4400,159
2020-05-23,Cameroon,0,0,4400,159
2020-05-24,Cameroon,490,6,4890,165
2020-05-25,Cameroon,0,0,4890,165
2020-05-26,Cameroon,546,10,5436,175
2020-05-27,Cameroon,0,0,5436,175
2020-05-28,Cameroon,0,0,5436,175
2020-05-29,Cameroon,0,2,5436,177
2020-05-30,Cameroon,468,14,5904,191
2020-05-31,Cameroon,0,0,5904,191
2020-06-01,Cameroon,493,8,6397,199
2020-06-02,Cameroon,188,1,6585,200
2020-06-03,Cameroon,0,0,6585,200
2020-06-04,Cameroon,204,3,6789,203
2020-06-05,Cameroon,603,2,7392,205
2020-06-06,Cameroon,207,7,7599,212
2020-06-07,Cameroon,309,0,7908,212
2020-06-08,Cameroon,152,0,8060,212
2020-06-09,Cameroon,252,0,8312,212
2020-06-10,Cameroon,369,0,8681,212
2020-06-11,Cameroon,0,0,8681,212
2020-06-12,Cameroon,0,0,8681,212
2020-06-13,Cameroon,0,0,8681,212
2020-06-14,Cameroon,0,0,8681,212
2020-06-15,Cameroon,1183,64,9864,276
2020-06-16,Cameroon,0,0,9864,276
2020-06-17,Cameroon,0,0,9864,276
2020-06-18,Cameroon,0,0,9864,276
2020-06-19,Cameroon,774,6,10638,282
2020-06-20,Cameroon,972,19,11610,301
2020-06-21,Cameroon,282,2,11892,303
2020-06-22,Cameroon,149,5,12041,308
2020-06-23,Cameroon,229,5,12270,313
2020-06-24,Cameroon,322,0,12592,313
2020-06-25,Cameroon,0,0,12592,313
2020-06-26,Cameroon,0,0,12592,313
2020-06-27,Cameroon,0,0,12592,313
2020-06-28,Cameroon,0,0,12592,313
2020-06-29,Cameroon,0,0,12592,313
2020-06-30,Cameroon,0,0,12592,313
2020-07-01,Cameroon,0,0,12592,313
2020-07-02,Cameroon,0,0,12592,313
2020-07-03,Cameroon,0,0,12592,313
2020-07-04,Cameroon,0,0,12592,313
2020-07-05,Cameroon,0,0,12592,313
2020-07-06,Cameroon,0,0,12592,313
2020-07-07,Cameroon,2324,46,14916,359
2020-07-08,Cameroon,0,0,14916,359
2020-07-09,Cameroon,0,0,14916,359
2020-07-10,Cameroon,0,0,14916,359
2020-07-11,Cameroon,257,0,15173,359
2020-07-12,Cameroon,0,0,15173,359
2020-07-13,Cameroon,0,0,15173,359
2020-07-14,Cameroon,0,0,15173,359
2020-07-15,Cameroon,0,0,15173,359
2020-07-16,Cameroon,984,14,16157,373
2020-07-17,Cameroon,0,0,16157,373
2020-07-18,Cameroon,0,0,16157,373
2020-07-19,Cameroon,0,0,16157,373
2020-07-20,Cameroon,0,0,16157,373
2020-07-21,Cameroon,365,9,16522,382
2020-07-22,Cameroon,0,0,16522,382
2020-07-23,Cameroon,0,0,16522,382
2020-07-24,Cameroon,186,3,16708,385
2020-07-25,Cameroon,0,0,16708,385
2020-07-26,Cameroon,0,0,16708,385
2020-07-27,Cameroon,402,6,17110,391
2020-07-28,Cameroon,69,0,17179,391
2020-07-29,Cameroon,76,0,17255,391
2020-07-30,Cameroon,0,0,17255,391
2020-07-31,Cameroon,0,0,17255,391
2020-08-01,Cameroon,0,0,17255,391
2020-08-02,Cameroon,0,0,17255,391
2020-08-03,Cameroon,0,0,17255,391
2020-08-04,Cameroon,463,0,17718,391
2020-08-05,Cameroon,0,0,17718,391
2020-08-06,Cameroon,0,0,17718,391
2020-08-07,Cameroon,0,0,17718,391
2020-08-08,Cameroon,324,4,18042,395
2020-08-09,Cameroon,0,0,18042,395
2020-08-10,Cameroon,0,0,18042,395
2020-08-11,Cameroon,171,3,18213,398
2020-08-12,Cameroon,50,3,18263,401
2020-08-13,Cameroon,45,0,18308,401
2020-08-14,Cameroon,161,0,18469,401
2020-08-15,Cameroon,0,0,18469,401
2020-08-16,Cameroon,0,0,18469,401
2020-08-17,Cameroon,113,2,18582,403
2020-08-18,Cameroon,17,3,18599,406
2020-08-19,Cameroon,25,0,18624,406
2020-08-20,Cameroon,138,2,18762,408
2020-08-21,Cameroon,0,0,18762,408
2020-08-22,Cameroon,0,0,18762,408
2020-08-23,Cameroon,0,0,18762,408
2020-08-24,Cameroon,0,0,18762,408
2020-08-25,Cameroon,211,2,18973,410
2020-08-26,Cameroon,0,0,18973,410
2020-08-27,Cameroon,169,1,19142,411
2020-08-28,Cameroon,0,0,19142,411
2020-08-29,Cameroon,0,0,19142,411
2020-08-30,Cameroon,0,0,19142,411
2020-08-31,Cameroon,0,0,19142,411
2020-09-01,Cameroon,267,3,19409,414
2020-09-02,Cameroon,51,1,19460,415
2020-09-03,Cameroon,144,0,19604,415
2020-09-04,Cameroon,0,0,19604,415
2020-09-05,Cameroon,0,0,19604,415
2020-09-06,Cameroon,0,0,19604,415
2020-09-07,Cameroon,0,0,19604,415
2020-09-08,Cameroon,244,0,19848,415
2020-09-09,Cameroon,0,0,19848,415
2020-09-10,Cameroon,161,0,20009,415
2020-09-11,Cameroon,0,0,20009,415
2020-09-12,Cameroon,0,0,20009,415
2020-09-13,Cameroon,158,0,20167,415
2020-09-14,Cameroon,61,0,20228,415
2020-09-15,Cameroon,43,0,20271,415
2020-09-16,Cameroon,32,0,20303,415
2020-09-17,Cameroon,0,0,20303,415
2020-09-18,Cameroon,68,1,20371,416
2020-09-19,Cameroon,60,0,20431,416
2020-09-20,Cameroon,0,0,20431,416
2020-09-21,Cameroon,167,0,20598,416
2020-09-22,Cameroon,0,0,20598,416
2020-09-23,Cameroon,92,0,20690,416
2020-09-24,Cameroon,22,2,20712,418
2020-09-25,Cameroon,0,0,20712,418
2020-09-26,Cameroon,23,0,20735,418
2020-09-27,Cameroon,0,0,20735,418
2020-09-28,Cameroon,103,0,20838,418
2020-09-29,Cameroon,0,0,20838,418
2020-09-30,Cameroon,0,0,20838,418
2020-10-01,Cameroon,0,0,20838,418
2020-10-02,Cameroon,86,2,20924,420
2020-10-03,Cameroon,0,0,20924,420
2020-10-04,Cameroon,0,0,20924,420
2020-10-05,Cameroon,0,0,20924,420
2020-10-06,Cameroon,0,0,20924,420
2020-10-07,Cameroon,0,0,20924,420
2020-10-08,Cameroon,279,3,21203,423
2020-10-09,Cameroon,0,0,21203,423
2020-10-10,Cameroon,0,0,21203,423
2020-10-11,Cameroon,0,0,21203,423
2020-10-12,Cameroon,0,0,21203,423
2020-10-13,Cameroon,0,0,21203,423
2020-10-14,Cameroon,238,0,21441,423
2020-10-15,Cameroon,0,0,21441,423
2020-10-16,Cameroon,0,0,21441,423
2020-10-17,Cameroon,0,0,21441,423
2020-10-18,Cameroon,0,0,21441,423
2020-10-19,Cameroon,65,1,21506,424
2020-10-20,Cameroon,64,1,21570,425
2020-10-21,Cameroon,0,0,21570,425
2020-10-22,Cameroon,0,0,21570,425
2020-10-23,Cameroon,0,0,21570,425
2020-10-24,Cameroon,0,0,21570,425
2020-10-25,Cameroon,0,0,21570,425
2020-10-26,Cameroon,223,1,21793,426
2020-10-27,Cameroon,0,0,21793,426
2020-10-28,Cameroon,0,0,21793,426
2020-10-29,Cameroon,0,0,21793,426
2020-10-30,Cameroon,0,0,21793,426
2020-10-31,Cameroon,0,0,21793,426
2020-11-01,Cameroon,310,3,22103,429
2020-11-02,Cameroon,0,0,22103,429
2020-11-03,Cameroon,0,0,22103,429
2020-11-04,Cameroon,0,0,22103,429
2020-11-05,Cameroon,0,0,22103,429
2020-11-06,Cameroon,0,0,22103,429
2020-11-07,Cameroon,239,0,22342,429
2020-11-08,Cameroon,79,4,22421,433
2020-11-09,Cameroon,0,0,22421,433
2020-11-10,Cameroon,0,0,22421,433
2020-11-11,Cameroon,69,0,22490,433
2020-11-12,Cameroon,0,0,22490,433
2020-11-13,Cameroon,93,0,22583,433
2020-11-14,Cameroon,109,0,22692,433
2020-11-15,Cameroon,0,0,22692,433
2020-11-16,Cameroon,0,0,22692,433
2020-11-17,Cameroon,204,0,22896,433
2020-11-18,Cameroon,0,0,22896,433
2020-11-19,Cameroon,632,2,23528,435
2020-11-20,Cameroon,0,0,23528,435
2020-11-21,Cameroon,0,0,23528,435
2020-11-22,Cameroon,0,0,23528,435
2020-11-23,Cameroon,314,0,23842,435
2020-11-24,Cameroon,27,1,23869,436
2020-11-25,Cameroon,46,1,23915,437
2020-11-26,Cameroon,107,0,24022,437
2020-11-27,Cameroon,95,0,24117,437
2020-11-28,Cameroon,0,0,24117,437
2020-11-29,Cameroon,0,0,24117,437
2020-11-30,Cameroon,328,0,24445,437
2020-12-01,Cameroon,42,4,24487,441
2020-12-02,Cameroon,0,0,24487,441
2020-12-03,Cameroon,0,0,24487,441
2020-12-04,Cameroon,265,2,24752,443
2020-12-05,Cameroon,0,0,24752,443
2020-12-06,Cameroon,0,0,24752,443
2020-12-07,Cameroon,0,0,24752,443
2020-12-08,Cameroon,0,0,24752,443
2020-12-09,Cameroon,211,0,24963,443
2020-12-10,Cameroon,0,0,24963,443
2020-12-11,Cameroon,124,0,25087,443
2020-12-12,Cameroon,56,0,25143,443
2020-12-13,Cameroon,0,0,25143,443
2020-12-14,Cameroon,71,0,25214,443
2020-12-15,Cameroon,145,2,25359,445
2020-12-16,Cameroon,113,0,25472,445
2020-12-17,Cameroon,0,0,25472,445
2020-12-18,Cameroon,0,0,25472,445
2020-12-19,Cameroon,252,0,25724,445
2020-12-20,Cameroon,125,3,25849,448
2020-12-21,Cameroon,0,0,25849,448
2020-12-22,Cameroon,0,0,25849,448
2020-12-23,Cameroon,0,0,25849,448
2020-12-24,Cameroon,428,0,26277,448
2020-12-25,Cameroon,0,0,26277,448
2020-12-26,Cameroon,0,0,26277,448
2020-12-27,Cameroon,0,0,26277,448
2020-12-28,Cameroon,0,0,26277,448
2020-12-29,Cameroon,0,0,26277,448
2020-12-30,Cameroon,0,0,26277,448
2020-12-31,Cameroon,0,0,26277,448
2021-01-01,Cameroon,571,0,26848,448
2021-01-02,Cameroon,0,0,26848,448
2021-01-03,Cameroon,0,0,26848,448
2021-01-04,Cameroon,0,0,26848,448
2021-01-05,Cameroon,0,0,26848,448
2021-01-06,Cameroon,0,0,26848,448
2021-01-07,Cameroon,0,0,26848,448
2021-01-08,Cameroon,0,0,26848,448
2021-01-09,Cameroon,0,0,26848,448
2021-01-10,Cameroon,0,0,26848,448
2021-01-11,Cameroon,0,0,26848,448
2021-01-12,Cameroon,488,3,27336,451
2021-01-13,Cameroon,0,0,27336,451
2021-01-14,Cameroon,0,0,27336,451
2021-01-15,Cameroon,0,0,27336,451
2021-01-16,Cameroon,674,4,28010,455
2021-01-17,Cameroon,0,0,28010,455
2021-01-18,Cameroon,0,0,28010,455
2021-01-19,Cameroon,0,0,28010,455
2021-01-20,Cameroon,0,0,28010,455
2021-01-21,Cameroon,0,0,28010,455
2021-01-22,Cameroon,0,0,28010,455
2021-01-23,Cameroon,1607,7,29617,462
2021-01-24,Cameroon,0,0,29617,462
2021-01-25,Cameroon,0,0,29617,462
2021-01-26,Cameroon,0,0,29617,462
2021-01-27,Cameroon,0,0,29617,462
2021-01-28,Cameroon,0,0,29617,462
2021-01-29,Cameroon,0,0,29617,462
2021-01-30,Cameroon,0,0,29617,462
2021-01-31,Cameroon,0,0,29617,462
2021-02-01,Cameroon,0,0,29617,462
2021-02-02,Cameroon,696,12,30313,474
2021-02-03,Cameroon,0,0,30313,474
2021-02-04,Cameroon,0,0,30313,474
2021-02-05,Cameroon,0,0,30313,474
2021-02-06,Cameroon,1081,0,31394,474
2021-02-07,Cameroon,0,0,31394,474
2021-02-08,Cameroon,0,0,31394,474
2021-02-09,Cameroon,0,0,31394,474
2021-02-10,Cameroon,0,0,31394,474
2021-02-11,Cameroon,0,0,31394,474
2021-02-12,Cameroon,704,5,32098,479
2021-02-13,Cameroon,0,0,32098,479
2021-02-14,Cameroon,0,0,32098,479
2021-02-15,Cameroon,0,0,32098,479
2021-02-16,Cameroon,0,0,32098,479
2021-02-17,Cameroon,0,0,32098,479
2021-02-18,Cameroon,1651,44,33749,523
2021-02-19,Cameroon,0,0,33749,523
2021-02-20,Cameroon,0,0,33749,523
2021-02-21,Cameroon,0,0,33749,523
2021-02-22,Cameroon,0,0,33749,523
2021-02-23,Cameroon,0,0,33749,523
2021-02-24,Cameroon,0,0,33749,523
2021-02-25,Cameroon,1965,28,35714,551
2021-02-26,Cameroon,0,0,35714,551
2021-02-27,Cameroon,0,0,35714,551
2021-02-28,Cameroon,0,0,35714,551
2021-03-01,Cameroon,0,0,35714,551
2021-03-02,Cameroon,0,0,35714,551
2021-03-03,Cameroon,0,0,35714,551
2021-03-04,Cameroon,0,0,35714,551
2021-03-05,Cameroon,0,0,35714,551
2021-03-06,Cameroon,0,0,35714,551
2021-03-07,Cameroon,0,0,35714,551
2021-03-08,Cameroon,1080,15,36794,566
2021-03-09,Cameroon,0,0,36794,566
2021-03-10,Cameroon,0,0,36794,566
2021-03-11,Cameroon,3828,35,40622,601
2021-03-12,Cameroon,0,0,40622,601
2021-03-13,Cameroon,0,0,40622,601
2021-03-14,Cameroon,0,0,40622,601
2021-03-15,Cameroon,0,0,40622,601
2021-03-16,Cameroon,0,0,40622,601
2021-03-17,Cameroon,0,0,40622,601
2021-03-18,Cameroon,0,0,40622,601
2021-03-19,Cameroon,0,0,40622,601
2021-03-20,Cameroon,0,0,40622,601
2021-03-21,Cameroon,0,0,40622,601
2021-03-22,Cameroon,0,0,40622,601
2021-03-23,Cameroon,0,0,40622,601
2021-03-24,Cameroon,0,0,40622,601
2021-03-25,Cameroon,0,0,40622,601
2021-03-26,Cameroon,7047,120,47669,721
2021-03-27,Cameroon,0,0,47669,721
2021-03-28,Cameroon,0,0,47669,721
2021-03-29,Cameroon,0,0,47669,721
2021-03-30,Cameroon,0,0,47669,721
2021-03-31,Cameroon,0,0,47669,721
2021-04-01,Cameroon,9668,130,57337,851
2021-04-02,Cameroon,0,0,57337,851
2021-04-03,Cameroon,0,0,57337,851
2021-04-04,Cameroon,0,0,57337,851
2021-04-05,Cameroon,0,0,57337,851
2021-04-06,Cameroon,0,0,57337,851
2021-04-07,Cameroon,0,0,57337,851
2021-04-08,Cameroon,4394,68,61731,919
2020-01-26,Canada,1,0,1,0
2020-01-27,Canada,0,0,1,0
2020-01-28,Canada,1,0,2,0
2020-01-29,Canada,0,0,2,0
2020-01-30,Canada,0,0,2,0
2020-01-31,Canada,2,0,4,0
2020-02-01,Canada,0,0,4,0
2020-02-02,Canada,0,0,4,0
2020-02-03,Canada,0,0,4,0
2020-02-04,Canada,0,0,4,0
2020-02-05,Canada,1,0,5,0
2020-02-06,Canada,0,0,5,0
2020-02-07,Canada,2,0,7,0
2020-02-08,Canada,0,0,7,0
2020-02-09,Canada,0,0,7,0
2020-02-10,Canada,0,0,7,0
2020-02-11,Canada,0,0,7,0
2020-02-12,Canada,0,0,7,0
2020-02-13,Canada,0,0,7,0
2020-02-14,Canada,0,0,7,0
2020-02-15,Canada,0,0,7,0
2020-02-16,Canada,0,0,7,0
2020-02-17,Canada,1,0,8,0
2020-02-18,Canada,0,0,8,0
2020-02-19,Canada,0,0,8,0
2020-02-20,Canada,0,0,8,0
2020-02-21,Canada,1,0,9,0
2020-02-22,Canada,0,0,9,0
2020-02-23,Canada,0,0,9,0
2020-02-24,Canada,1,0,10,0
2020-02-25,Canada,1,0,11,0
2020-02-26,Canada,0,0,11,0
2020-02-27,Canada,2,0,13,0
2020-02-28,Canada,1,0,14,0
2020-02-29,Canada,6,0,20,0
2020-03-01,Canada,4,0,24,0
2020-03-02,Canada,3,0,27,0
2020-03-03,Canada,3,0,30,0
2020-03-04,Canada,3,0,33,0
2020-03-05,Canada,4,0,37,0
2020-03-06,Canada,12,0,49,0
2020-03-07,Canada,5,0,54,0
2020-03-08,Canada,10,0,64,0
2020-03-09,Canada,13,1,77,1
2020-03-10,Canada,2,0,79,1
2020-03-11,Canada,29,0,108,1
2020-03-12,Canada,9,0,117,1
2020-03-13,Canada,76,0,193,1
2020-03-14,Canada,5,0,198,1
2020-03-15,Canada,54,0,252,1
2020-03-16,Canada,163,3,415,4
2020-03-17,Canada,63,2,478,6
2020-03-18,Canada,179,5,657,11
2020-03-19,Canada,143,0,800,11
2020-03-20,Canada,143,4,943,15
2020-03-21,Canada,334,4,1277,19
2020-03-22,Canada,192,3,1469,22
2020-03-23,Canada,619,7,2088,29
2020-03-24,Canada,702,4,2790,33
2020-03-25,Canada,461,9,3251,42
2020-03-26,Canada,791,15,4042,57
2020-03-27,Canada,640,9,4682,66
2020-03-28,Canada,894,16,5576,82
2020-03-29,Canada,704,14,6280,96
2020-03-30,Canada,1118,29,7398,125
2020-03-31,Canada,1129,27,8527,152
2020-04-01,Canada,1033,23,9560,175
2020-04-02,Canada,1724,49,11284,224
2020-04-03,Canada,1153,53,12437,277
2020-04-04,Canada,541,83,12978,360
2020-04-05,Canada,2778,75,15756,435
2020-04-06,Canada,807,85,16563,520
2020-04-07,Canada,1309,61,17872,581
2020-04-08,Canada,1269,67,19141,648
2020-04-09,Canada,1513,123,20654,771
2020-04-10,Canada,1405,96,22059,867
2020-04-11,Canada,1257,119,23316,986
2020-04-12,Canada,983,109,24299,1095
2020-04-13,Canada,1381,130,25680,1225
2020-04-14,Canada,1355,136,27035,1361
2020-04-15,Canada,1174,154,28209,1515
2020-04-16,Canada,2600,203,30809,1718
2020-04-17,Canada,2005,126,32814,1844
2020-04-18,Canada,1542,143,34356,1987
2020-04-19,Canada,1277,158,35633,2145
2020-04-20,Canada,2025,146,37658,2291
2020-04-21,Canada,1744,193,39402,2484
2020-04-22,Canada,2261,195,41663,2679
2020-04-23,Canada,1636,171,43299,2850
2020-04-24,Canada,1620,180,44919,3030
2020-04-25,Canada,1452,187,46371,3217
2020-04-26,Canada,1662,157,48033,3374
2020-04-27,Canada,1583,185,49616,3559
2020-04-28,Canada,1534,197,51150,3756
2020-04-29,Canada,1715,244,52865,4000
2020-04-30,Canada,1592,179,54457,4179
2020-05-01,Canada,1886,202,56343,4381
2020-05-02,Canada,1583,148,57926,4529
2020-05-03,Canada,2578,140,60504,4669
2020-05-04,Canada,1453,242,61957,4911
2020-05-05,Canada,1258,170,63215,5081
2020-05-06,Canada,1479,159,64694,5240
2020-05-07,Canada,1507,147,66201,5387
2020-05-08,Canada,1473,153,67674,5540
2020-05-09,Canada,1244,164,68918,5704
2020-05-10,Canada,1173,118,70091,5822
2020-05-11,Canada,1173,134,71264,5956
2020-05-12,Canada,1155,151,72419,6107
2020-05-13,Canada,1149,103,73568,6210
2020-05-14,Canada,1213,121,74781,6331
2020-05-15,Canada,1178,121,75959,6452
2020-05-16,Canada,1247,119,77206,6571
2020-05-17,Canada,1126,90,78332,6661
2020-05-18,Canada,1079,92,79411,6753
2020-05-19,Canada,1082,75,80493,6828
2020-05-20,Canada,1082,122,81575,6950
2020-05-21,Canada,1167,96,82742,7046
2020-05-22,Canada,1205,98,83947,7144
2020-05-23,Canada,1204,94,85151,7238
2020-05-24,Canada,955,88,86106,7326
2020-05-25,Canada,1013,94,87119,7420
2020-05-26,Canada,971,92,88090,7512
2020-05-27,Canada,899,94,88989,7606
2020-05-28,Canada,987,111,89976,7717
2020-05-29,Canada,933,80,90909,7797
2020-05-30,Canada,772,60,91681,7857
2020-05-31,Canada,798,49,92479,7906
2020-06-01,Canada,809,46,93288,7952
2020-06-02,Canada,672,56,93960,8008
2020-06-03,Canada,681,54,94641,8062
2020-06-04,Canada,628,64,95269,8126
2020-06-05,Canada,678,40,95947,8166
2020-06-06,Canada,528,62,96475,8228
2020-06-07,Canada,703,41,97178,8269
2020-06-08,Canada,601,44,97779,8313
2020-06-09,Canada,462,34,98241,8347
2020-06-10,Canada,479,35,98720,8382
2020-06-11,Canada,439,31,99159,8413
2020-06-12,Canada,436,29,99595,8442
2020-06-13,Canada,448,28,100043,8470
2020-06-14,Canada,361,19,100404,8489
2020-06-15,Canada,359,8,100763,8497
2020-06-16,Canada,324,24,101087,8521
2020-06-17,Canada,404,21,101491,8542
2020-06-18,Canada,386,13,101877,8555
2020-06-19,Canada,437,25,102314,8580
2020-06-20,Canada,448,29,102762,8609
2020-06-21,Canada,316,17,103078,8626
2020-06-22,Canada,340,20,103418,8646
2020-06-23,Canada,349,24,103767,8670
2020-06-24,Canada,320,30,104087,8700
2020-06-25,Canada,376,23,104463,8723
2020-06-26,Canada,166,7,104629,8730
2020-06-27,Canada,249,9,104878,8739
2020-06-28,Canada,315,10,105193,8749
2020-06-29,Canada,637,19,105830,8768
2020-06-30,Canada,267,12,106097,8780
2020-07-01,Canada,191,10,106288,8790
2020-07-02,Canada,355,16,106643,8806
2020-07-03,Canada,319,7,106962,8813
2020-07-04,Canada,223,8,107185,8821
2020-07-05,Canada,209,2,107394,8823
2020-07-06,Canada,421,13,107815,8836
2020-07-07,Canada,208,7,108023,8843
2020-07-08,Canada,311,12,108334,8855
2020-07-09,Canada,322,10,108656,8865
2020-07-10,Canada,328,14,108984,8879
2020-07-11,Canada,166,3,109150,8882
2020-07-12,Canada,198,5,109348,8887
2020-07-13,Canada,636,8,109984,8895
2020-07-14,Canada,366,5,110350,8900
2020-07-15,Canada,343,14,110693,8914
2020-07-16,Canada,451,12,111144,8926
2020-07-17,Canada,415,10,111559,8936
2020-07-18,Canada,316,3,111875,8939
2020-07-19,Canada,293,4,112168,8943
2020-07-20,Canada,770,4,112938,8947
2020-07-21,Canada,535,7,113473,8954
2020-07-22,Canada,317,4,113790,8958
2020-07-23,Canada,608,8,114398,8966
2020-07-24,Canada,717,4,115115,8970
2020-07-25,Canada,355,4,115470,8974
2020-07-26,Canada,319,4,115789,8978
2020-07-27,Canada,682,13,116471,8991
2020-07-28,Canada,400,10,116871,9001
2020-07-29,Canada,486,5,117357,9006
2020-07-30,Canada,320,13,117677,9019
2020-07-31,Canada,604,6,118281,9025
2020-08-01,Canada,242,4,118523,9029
2020-08-02,Canada,245,3,118768,9032
2020-08-03,Canada,205,3,118973,9035
2020-08-04,Canada,686,8,119659,9043
2020-08-05,Canada,374,6,120033,9049
2020-08-06,Canada,354,6,120387,9055
2020-08-07,Canada,516,5,120903,9060
2020-08-08,Canada,245,4,121148,9064
2020-08-09,Canada,219,3,121367,9067
2020-08-10,Canada,686,7,122053,9074
2020-08-11,Canada,336,6,122389,9080
2020-08-12,Canada,314,5,122703,9085
2020-08-13,Canada,477,6,123180,9091
2020-08-14,Canada,425,4,123605,9095
2020-08-15,Canada,220,6,123825,9101
2020-08-16,Canada,179,5,124004,9106
2020-08-17,Canada,214,2,124218,9108
2020-08-18,Canada,866,10,125084,9118
2020-08-19,Canada,324,6,125408,9124
2020-08-20,Canada,217,3,125625,9127
2020-08-21,Canada,694,14,126319,9141
2020-08-22,Canada,241,1,126560,9142
2020-08-23,Canada,257,4,126817,9146
2020-08-24,Canada,777,8,127594,9154
2020-08-25,Canada,309,5,127903,9159
2020-08-26,Canada,477,5,128380,9164
2020-08-27,Canada,456,4,128836,9168
2020-08-28,Canada,506,13,129342,9181
2020-08-29,Canada,297,3,129639,9184
2020-08-30,Canada,249,1,129888,9185
2020-08-31,Canada,1030,8,130918,9193
2020-09-01,Canada,504,4,131422,9197
2020-09-02,Canada,519,2,131941,9199
2020-09-03,Canada,586,6,132527,9205
2020-09-04,Canada,614,1,133141,9206
2020-09-05,Canada,370,1,133511,9207
2020-09-06,Canada,379,2,133890,9209
2020-09-07,Canada,405,3,134295,9212
2020-09-08,Canada,1462,7,135757,9219
2020-09-09,Canada,378,4,136135,9223
2020-09-10,Canada,821,8,136956,9231
2020-09-11,Canada,720,0,137676,9231
2020-09-12,Canada,488,2,138164,9233
2020-09-13,Canada,476,3,138640,9236
2020-09-14,Canada,1458,13,140098,9249
2020-09-15,Canada,802,8,140900,9257
2020-09-16,Canada,952,5,141852,9262
2020-09-17,Canada,1027,5,142879,9267
2020-09-18,Canada,1174,12,144053,9279
2020-09-19,Canada,554,7,144607,9286
2020-09-20,Canada,1143,2,145750,9288
2020-09-21,Canada,1833,12,147583,9300
2020-09-22,Canada,1272,9,148855,9309
2020-09-23,Canada,1084,8,149939,9317
2020-09-24,Canada,1148,8,151087,9325
2020-09-25,Canada,1630,7,152717,9332
2020-09-26,Canada,1053,6,153770,9338
2020-09-27,Canada,1658,5,155428,9343
2020-09-28,Canada,1791,17,157219,9360
2020-09-29,Canada,1772,13,158991,9373
2020-09-30,Canada,2116,18,161107,9391
2020-10-01,Canada,1823,16,162930,9407
2020-10-02,Canada,2124,98,165054,9505
2020-10-03,Canada,1306,21,166360,9526
2020-10-04,Canada,2141,44,168501,9570
2020-10-05,Canada,2883,29,171384,9599
2020-10-06,Canada,2372,18,173756,9617
2020-10-07,Canada,1624,19,175380,9636
2020-10-08,Canada,2350,18,177730,9654
2020-10-09,Canada,2895,14,180625,9668
2020-10-10,Canada,2142,26,182767,9694
2020-10-11,Canada,1636,14,184403,9708
2020-10-12,Canada,975,12,185378,9720
2020-10-13,Canada,4111,32,189489,9752
2020-10-14,Canada,2575,25,192064,9777
2020-10-15,Canada,2298,19,194362,9796
2020-10-16,Canada,2566,32,196928,9828
2020-10-17,Canada,139,8,197067,9836
2020-10-18,Canada,3737,24,200804,9860
2020-10-19,Canada,3307,31,204111,9891
2020-10-20,Canada,2238,18,206349,9909
2020-10-21,Canada,2687,37,209036,9946
2020-10-22,Canada,2581,31,211617,9977
2020-10-23,Canada,2902,27,214519,10004
2020-10-24,Canada,1532,22,216051,10026
2020-10-25,Canada,2823,31,218874,10057
2020-10-26,Canada,4099,38,222973,10095
2020-10-27,Canada,2730,25,225703,10120
2020-10-28,Canada,2663,38,228366,10158
2020-10-29,Canada,3017,34,231383,10192
2020-10-30,Canada,3556,45,234939,10237
2020-10-31,Canada,2374,39,237313,10276
2020-11-01,Canada,2336,37,239649,10313
2020-11-02,Canada,3529,32,243178,10345
2020-11-03,Canada,4738,58,247916,10403
2020-11-04,Canada,2782,41,250698,10444
2020-11-05,Canada,2784,40,253482,10484
2020-11-06,Canada,5393,62,258875,10546
2020-11-07,Canada,4346,47,263221,10593
2020-11-08,Canada,3944,48,267165,10641
2020-11-09,Canada,4871,61,272036,10702
2020-11-10,Canada,4445,67,276481,10769
2020-11-11,Canada,3984,63,280465,10832
2020-11-12,Canada,5474,73,285939,10905
2020-11-13,Canada,4770,46,290709,10951
2020-11-14,Canada,4430,62,295139,11013
2020-11-15,Canada,4301,65,299440,11078
2020-11-16,Canada,6033,74,305473,11152
2020-11-17,Canada,4462,68,309935,11220
2020-11-18,Canada,4518,104,314453,11324
2020-11-19,Canada,4794,70,319247,11394
2020-11-20,Canada,4987,67,324234,11461
2020-11-21,Canada,4957,66,329191,11527
2020-11-22,Canada,4745,56,333936,11583
2020-11-23,Canada,6795,79,340731,11662
2020-11-24,Canada,5282,100,346013,11762
2020-11-25,Canada,4958,58,350971,11820
2020-11-26,Canada,5679,82,356650,11902
2020-11-27,Canada,5954,86,362604,11988
2020-11-28,Canada,5675,68,368279,12056
2020-11-29,Canada,5383,74,373662,12130
2020-11-30,Canada,7895,109,381557,12239
2020-12-01,Canada,5495,78,387052,12317
2020-12-02,Canada,6454,106,393506,12423
2020-12-03,Canada,6264,90,399770,12513
2020-12-04,Canada,6419,103,406189,12616
2020-12-05,Canada,6354,74,412543,12690
2020-12-06,Canada,6305,85,418848,12775
2020-12-07,Canada,7724,121,426572,12896
2020-12-08,Canada,6171,97,432743,12993
2020-12-09,Canada,6399,116,439142,13109
2020-12-10,Canada,6686,118,445828,13227
2020-12-11,Canada,6715,128,452543,13355
2020-12-12,Canada,5984,98,458527,13453
2020-12-13,Canada,5916,84,464443,13537
2020-12-14,Canada,8377,140,472820,13677
2020-12-15,Canada,6244,116,479064,13793
2020-12-16,Canada,6512,118,485576,13911
2020-12-17,Canada,7006,156,492582,14067
2020-12-18,Canada,6700,113,499282,14180
2020-12-19,Canada,6459,104,505741,14284
2020-12-20,Canada,6007,90,511748,14374
2020-12-21,Canada,7577,107,519325,14481
2020-12-22,Canada,6260,126,525585,14607
2020-12-23,Canada,6921,145,532506,14752
2020-12-24,Canada,6684,150,539190,14902
2020-12-25,Canada,1749,64,540939,14966
2020-12-26,Canada,3114,85,544053,15051
2020-12-27,Canada,10100,120,554153,15171
2020-12-28,Canada,6465,157,560618,15328
2020-12-29,Canada,8189,200,568807,15528
2020-12-30,Canada,8459,122,577266,15650
2020-12-31,Canada,7143,112,584409,15762
2021-01-01,Canada,991,44,585400,15806
2021-01-02,Canada,4535,108,589935,15914
2021-01-03,Canada,16141,92,606076,16006
2021-01-04,Canada,10058,241,616134,16247
2021-01-05,Canada,7250,142,623384,16389
2021-01-06,Canada,8082,150,631466,16539
2021-01-07,Canada,8227,165,639693,16704
2021-01-08,Canada,9237,142,648930,16846
2021-01-09,Canada,8393,138,657323,16984
2021-01-10,Canada,7283,90,664606,17074
2021-01-11,Canada,8325,125,672931,17199
2021-01-12,Canada,6141,160,679072,17359
2021-01-13,Canada,7139,180,686211,17539
2021-01-14,Canada,7447,147,693658,17686
2021-01-15,Canada,6880,170,700538,17856
2021-01-16,Canada,6359,122,706897,17978
2021-01-17,Canada,6284,128,713181,18106
2021-01-18,Canada,6420,125,719601,18231
2021-01-19,Canada,5028,151,724629,18382
2021-01-20,Canada,5701,185,730330,18567
2021-01-21,Canada,6111,139,736441,18706
2021-01-22,Canada,5827,181,742268,18887
2021-01-23,Canada,5094,105,747362,18992
2021-01-24,Canada,4679,127,752041,19119
2021-01-25,Canada,5617,126,757658,19245
2021-01-26,Canada,4041,147,761699,19392
2021-01-27,Canada,4320,93,766019,19485
2021-01-28,Canada,4806,191,770825,19676
2021-01-29,Canada,4827,149,775652,19825
2021-01-30,Canada,4110,133,779762,19958
2021-01-31,Canada,3933,83,783695,20041
2021-02-01,Canada,4502,104,788197,20145
2021-02-02,Canada,2948,97,791145,20242
2021-02-03,Canada,3267,119,794412,20361
2021-02-04,Canada,3982,125,798394,20486
2021-02-05,Canada,4136,121,802530,20607
2021-02-06,Canada,3264,93,805794,20700
2021-02-07,Canada,3207,60,809001,20760
2021-02-08,Canada,3803,70,812804,20830
2021-02-09,Canada,2683,84,815487,20914
2021-02-10,Canada,3268,93,818755,21007
2021-02-11,Canada,3177,82,821932,21089
2021-02-12,Canada,2679,79,824611,21168
2021-02-13,Canada,3797,70,828408,21238
2021-02-14,Canada,2204,23,830612,21261
2021-02-15,Canada,1763,37,832375,21298
2021-02-16,Canada,4219,97,836594,21395
2021-02-17,Canada,2561,44,839155,21439
2021-02-18,Canada,3435,70,842590,21509
2021-02-19,Canada,3083,72,845673,21581
2021-02-20,Canada,2657,50,848330,21631
2021-02-21,Canada,2407,44,850737,21675
2021-02-22,Canada,3453,45,854190,21720
2021-02-23,Canada,3213,41,857403,21761
2021-02-24,Canada,2945,49,860348,21810
2021-02-25,Canada,3147,58,863495,21868
2021-02-26,Canada,3172,47,866667,21915
2021-02-27,Canada,2680,46,869347,21961
2021-02-28,Canada,2347,29,871694,21990
2021-03-01,Canada,3694,24,875388,22014
2021-03-02,Canada,2663,29,878051,22043
2021-03-03,Canada,2784,62,880835,22105
2021-03-04,Canada,2980,47,883815,22152
2021-03-05,Canada,2967,31,886782,22183
2021-03-06,Canada,2769,29,889551,22212
2021-03-07,Canada,2648,22,892199,22234
2021-03-08,Canada,4048,37,896247,22271
2021-03-09,Canada,2928,31,899175,22302
2021-03-10,Canada,3059,28,902234,22330
2021-03-11,Canada,3105,37,905339,22367
2021-03-12,Canada,3515,30,908854,22397
2021-03-13,Canada,3030,29,911884,22426
2021-03-14,Canada,2711,29,914595,22455
2021-03-15,Canada,3811,29,918406,22484
2021-03-16,Canada,2857,25,921263,22509
2021-03-17,Canada,3407,34,924670,22543
2021-03-18,Canada,3613,34,928283,22577
2021-03-19,Canada,4232,28,932515,22605
2021-03-20,Canada,3417,30,935932,22635
2021-03-21,Canada,3125,21,939057,22656
2021-03-22,Canada,4863,39,943920,22695
2021-03-23,Canada,3569,20,947489,22715
2021-03-24,Canada,3949,24,951438,22739
2021-03-25,Canada,5104,32,956542,22771
2021-03-26,Canada,5025,38,961567,22809
2021-03-27,Canada,4315,21,965882,22830
2021-03-28,Canada,4183,25,970065,22855
2021-03-29,Canada,6262,16,976327,22871
2021-03-30,Canada,3753,21,980080,22892
2021-03-31,Canada,8728,68,988808,22960
2021-04-01,Canada,5741,38,994549,22998
2021-04-02,Canada,3659,13,998208,23011
2021-04-03,Canada,7088,27,1005296,23038
2021-04-04,Canada,3512,22,1008808,23060
2021-04-05,Canada,8322,23,1017130,23083
2021-04-06,Canada,10724,49,1027854,23132
2021-04-07,Canada,7388,28,1035242,23160
2021-04-08,Canada,8236,36,1043478,23196
2020-03-20,Cape Verde,1,0,1,0
2020-03-21,Cape Verde,2,0,3,0
2020-03-22,Cape Verde,0,0,3,0
2020-03-23,Cape Verde,0,0,3,0
2020-03-24,Cape Verde,0,1,3,1
2020-03-25,Cape Verde,1,0,4,1
2020-03-26,Cape Verde,0,0,4,1
2020-03-27,Cape Verde,1,0,5,1
2020-03-28,Cape Verde,0,0,5,1
2020-03-29,Cape Verde,1,0,6,1
2020-03-30,Cape Verde,0,0,6,1
2020-03-31,Cape Verde,0,0,6,1
2020-04-01,Cape Verde,0,0,6,1
2020-04-02,Cape Verde,0,0,6,1
2020-04-03,Cape Verde,0,0,6,1
2020-04-04,Cape Verde,1,0,7,1
2020-04-05,Cape Verde,0,0,7,1
2020-04-06,Cape Verde,0,0,7,1
2020-04-07,Cape Verde,0,0,7,1
2020-04-08,Cape Verde,0,0,7,1
2020-04-09,Cape Verde,0,0,7,1
2020-04-10,Cape Verde,0,0,7,1
2020-04-11,Cape Verde,1,0,8,1
2020-04-12,Cape Verde,0,0,8,1
2020-04-13,Cape Verde,2,0,10,1
2020-04-14,Cape Verde,1,0,11,1
2020-04-15,Cape Verde,45,0,56,1
2020-04-16,Cape Verde,0,0,56,1
2020-04-17,Cape Verde,0,0,56,1
2020-04-18,Cape Verde,2,0,58,1
2020-04-19,Cape Verde,3,0,61,1
2020-04-20,Cape Verde,6,0,67,1
2020-04-21,Cape Verde,1,0,68,1
2020-04-22,Cape Verde,5,0,73,1
2020-04-23,Cape Verde,9,0,82,1
2020-04-24,Cape Verde,6,0,88,1
2020-04-25,Cape Verde,2,0,90,1
2020-04-26,Cape Verde,16,0,106,1
2020-04-27,Cape Verde,3,0,109,1
2020-04-28,Cape Verde,5,0,114,1
2020-04-29,Cape Verde,0,0,114,1
2020-04-30,Cape Verde,7,0,121,1
2020-05-01,Cape Verde,1,0,122,1
2020-05-02,Cape Verde,30,1,152,2
2020-05-03,Cape Verde,13,0,165,2
2020-05-04,Cape Verde,10,0,175,2
2020-05-05,Cape Verde,11,0,186,2
2020-05-06,Cape Verde,5,0,191,2
2020-05-07,Cape Verde,27,0,218,2
2020-05-08,Cape Verde,12,0,230,2
2020-05-09,Cape Verde,6,0,236,2
2020-05-10,Cape Verde,10,0,246,2
2020-05-11,Cape Verde,14,0,260,2
2020-05-12,Cape Verde,7,0,267,2
2020-05-13,Cape Verde,22,0,289,2
2020-05-14,Cape Verde,26,0,315,2
2020-05-15,Cape Verde,11,0,326,2
2020-05-16,Cape Verde,2,1,328,3
2020-05-17,Cape Verde,0,0,328,3
2020-05-18,Cape Verde,0,0,328,3
2020-05-19,Cape Verde,7,0,335,3
2020-05-20,Cape Verde,14,0,349,3
2020-05-21,Cape Verde,7,0,356,3
2020-05-22,Cape Verde,6,0,362,3
2020-05-23,Cape Verde,9,0,371,3
2020-05-24,Cape Verde,9,0,380,3
2020-05-25,Cape Verde,10,0,390,3
2020-05-26,Cape Verde,0,1,390,4
2020-05-27,Cape Verde,0,0,390,4
2020-05-28,Cape Verde,0,0,390,4
2020-05-29,Cape Verde,15,0,405,4
2020-05-30,Cape Verde,16,0,421,4
2020-05-31,Cape Verde,14,0,435,4
2020-06-01,Cape Verde,23,0,458,4
2020-06-02,Cape Verde,8,1,466,5
2020-06-03,Cape Verde,11,0,477,5
2020-06-04,Cape Verde,25,0,502,5
2020-06-05,Cape Verde,34,0,536,5
2020-06-06,Cape Verde,6,0,542,5
2020-06-07,Cape Verde,12,0,554,5
2020-06-08,Cape Verde,13,0,567,5
2020-06-09,Cape Verde,18,0,585,5
2020-06-10,Cape Verde,30,0,615,5
2020-06-11,Cape Verde,42,1,657,6
2020-06-12,Cape Verde,40,0,697,6
2020-06-13,Cape Verde,29,0,726,6
2020-06-14,Cape Verde,24,0,750,6
2020-06-15,Cape Verde,10,1,760,7
2020-06-16,Cape Verde,21,0,781,7
2020-06-17,Cape Verde,11,0,792,7
2020-06-18,Cape Verde,31,0,823,7
2020-06-19,Cape Verde,25,1,848,8
2020-06-20,Cape Verde,15,0,863,8
2020-06-21,Cape Verde,27,0,890,8
2020-06-22,Cape Verde,54,0,944,8
2020-06-23,Cape Verde,38,0,982,8
2020-06-24,Cape Verde,17,0,999,8
2020-06-25,Cape Verde,4,0,1003,8
2020-06-26,Cape Verde,24,2,1027,10
2020-06-27,Cape Verde,64,2,1091,12
2020-06-28,Cape Verde,64,0,1155,12
2020-06-29,Cape Verde,10,0,1165,12
2020-06-30,Cape Verde,62,3,1227,15
2020-07-01,Cape Verde,40,0,1267,15
2020-07-02,Cape Verde,34,0,1301,15
2020-07-03,Cape Verde,81,0,1382,15
2020-07-04,Cape Verde,39,1,1421,16
2020-07-05,Cape Verde,30,1,1451,17
2020-07-06,Cape Verde,12,0,1463,17
2020-07-07,Cape Verde,36,1,1499,18
2020-07-08,Cape Verde,43,0,1542,18
2020-07-09,Cape Verde,10,0,1552,18
2020-07-10,Cape Verde,39,1,1591,19
2020-07-11,Cape Verde,32,0,1623,19
2020-07-12,Cape Verde,0,0,1623,19
2020-07-13,Cape Verde,75,0,1698,19
2020-07-14,Cape Verde,24,0,1722,19
2020-07-15,Cape Verde,58,0,1780,19
2020-07-16,Cape Verde,114,0,1894,19
2020-07-17,Cape Verde,45,0,1939,19
2020-07-18,Cape Verde,75,2,2014,21
2020-07-19,Cape Verde,31,0,2045,21
2020-07-20,Cape Verde,26,0,2071,21
2020-07-21,Cape Verde,36,0,2107,21
2020-07-22,Cape Verde,47,0,2154,21
2020-07-23,Cape Verde,36,0,2190,21
2020-07-24,Cape Verde,30,1,2220,22
2020-07-25,Cape Verde,38,0,2258,22
2020-07-26,Cape Verde,49,0,2307,22
2020-07-27,Cape Verde,21,0,2328,22
2020-07-28,Cape Verde,26,0,2354,22
2020-07-29,Cape Verde,19,1,2373,23
2020-07-30,Cape Verde,45,0,2418,23
2020-07-31,Cape Verde,33,0,2451,23
2020-08-01,Cape Verde,29,1,2480,24
2020-08-02,Cape Verde,67,0,2547,24
2020-08-03,Cape Verde,36,1,2583,25
2020-08-04,Cape Verde,48,1,2631,26
2020-08-05,Cape Verde,58,1,2689,27
2020-08-06,Cape Verde,45,0,2734,27
2020-08-07,Cape Verde,46,2,2780,29
2020-08-08,Cape Verde,55,3,2835,32
2020-08-09,Cape Verde,23,0,2858,32
2020-08-10,Cape Verde,25,0,2883,32
2020-08-11,Cape Verde,37,1,2920,33
2020-08-12,Cape Verde,80,0,3000,33
2020-08-13,Cape Verde,73,0,3073,33
2020-08-14,Cape Verde,63,0,3136,33
2020-08-15,Cape Verde,27,1,3163,34
2020-08-16,Cape Verde,16,1,3179,35
2020-08-17,Cape Verde,24,1,3203,36
2020-08-18,Cape Verde,50,0,3253,36
2020-08-19,Cape Verde,68,0,3321,36
2020-08-20,Cape Verde,47,1,3368,37
2020-08-21,Cape Verde,44,0,3412,37
2020-08-22,Cape Verde,43,0,3455,37
2020-08-23,Cape Verde,54,0,3509,37
2020-08-24,Cape Verde,23,0,3532,37
2020-08-25,Cape Verde,36,0,3568,37
2020-08-26,Cape Verde,62,1,3630,38
2020-08-27,Cape Verde,69,0,3699,38
2020-08-28,Cape Verde,46,0,3745,38
2020-08-29,Cape Verde,33,1,3778,39
2020-08-30,Cape Verde,74,1,3852,40
2020-08-31,Cape Verde,32,0,3884,40
2020-09-01,Cape Verde,86,0,3970,40
2020-09-02,Cape Verde,78,1,4048,41
2020-09-03,Cape Verde,77,0,4125,41
2020-09-04,Cape Verde,75,0,4200,41
2020-09-05,Cape Verde,75,1,4275,42
2020-09-06,Cape Verde,55,0,4330,42
2020-09-07,Cape Verde,28,0,4358,42
2020-09-08,Cape Verde,42,0,4400,42
2020-09-09,Cape Verde,73,1,4473,43
2020-09-10,Cape Verde,84,0,4557,43
2020-09-11,Cape Verde,94,1,4651,44
2020-09-12,Cape Verde,60,0,4711,44
2020-09-13,Cape Verde,102,0,4813,44
2020-09-14,Cape Verde,26,1,4839,45
2020-09-15,Cape Verde,65,1,4904,46
2020-09-16,Cape Verde,74,1,4978,47
2020-09-17,Cape Verde,85,2,5063,49
2020-09-18,Cape Verde,78,1,5141,50
2020-09-19,Cape Verde,45,0,5186,50
2020-09-20,Cape Verde,71,1,5257,51
2020-09-21,Cape Verde,24,1,5281,52
2020-09-22,Cape Verde,56,0,5337,52
2020-09-23,Cape Verde,75,2,5412,54
2020-09-24,Cape Verde,67,1,5479,55
2020-09-25,Cape Verde,149,0,5628,55
2020-09-26,Cape Verde,73,1,5701,56
2020-09-27,Cape Verde,70,1,5771,57
2020-09-28,Cape Verde,46,2,5817,59
2020-09-29,Cape Verde,83,0,5900,59
2020-09-30,Cape Verde,124,1,6024,60
2020-10-01,Cape Verde,102,1,6126,61
2020-10-02,Cape Verde,79,1,6205,62
2020-10-03,Cape Verde,91,0,6296,62
2020-10-04,Cape Verde,64,3,6360,65
2020-10-05,Cape Verde,73,3,6433,68
2020-10-06,Cape Verde,85,1,6518,69
2020-10-07,Cape Verde,106,2,6624,71
2020-10-08,Cape Verde,93,0,6717,71
2020-10-09,Cape Verde,92,2,6809,73
2020-10-10,Cape Verde,104,1,6913,74
2020-10-11,Cape Verde,159,1,7072,75
2020-10-12,Cape Verde,83,0,7155,75
2020-10-13,Cape Verde,99,2,7254,77
2020-10-14,Cape Verde,117,2,7371,79
2020-10-15,Cape Verde,73,0,7444,79
2020-10-16,Cape Verde,82,3,7526,82
2020-10-17,Cape Verde,112,3,7638,85
2020-10-18,Cape Verde,114,1,7752,86
2020-10-19,Cape Verde,48,1,7800,87
2020-10-20,Cape Verde,101,0,7901,87
2020-10-21,Cape Verde,132,3,8033,90
2020-10-22,Cape Verde,89,1,8122,91
2020-10-23,Cape Verde,76,3,8198,94
2020-10-24,Cape Verde,124,0,8322,94
2020-10-25,Cape Verde,74,0,8396,94
2020-10-26,Cape Verde,27,0,8423,94
2020-10-27,Cape Verde,49,0,8472,94
2020-10-28,Cape Verde,76,0,8548,94
2020-10-29,Cape Verde,55,1,8603,95
2020-10-30,Cape Verde,91,0,8694,95
2020-10-31,Cape Verde,99,0,8793,95
2020-11-01,Cape Verde,55,0,8848,95
2020-11-02,Cape Verde,34,0,8882,95
2020-11-03,Cape Verde,62,0,8944,95
2020-11-04,Cape Verde,109,0,9053,95
2020-11-05,Cape Verde,96,2,9149,97
2020-11-06,Cape Verde,75,3,9224,100
2020-11-07,Cape Verde,67,0,9291,100
2020-11-08,Cape Verde,78,0,9369,100
2020-11-09,Cape Verde,50,0,9419,100
2020-11-10,Cape Verde,80,1,9499,101
2020-11-11,Cape Verde,61,1,9560,102
2020-11-12,Cape Verde,134,0,9694,102
2020-11-13,Cape Verde,47,0,9741,102
2020-11-14,Cape Verde,39,0,9780,102
2020-11-15,Cape Verde,42,1,9822,103
2020-11-16,Cape Verde,18,0,9840,103
2020-11-17,Cape Verde,120,0,9960,103
2020-11-18,Cape Verde,40,1,10000,104
2020-11-19,Cape Verde,82,0,10082,104
2020-11-20,Cape Verde,70,0,10152,104
2020-11-21,Cape Verde,82,0,10234,104
2020-11-22,Cape Verde,42,0,10276,104
2020-11-23,Cape Verde,26,0,10302,104
2020-11-24,Cape Verde,98,0,10400,104
2020-11-25,Cape Verde,126,0,10526,104
2020-11-26,Cape Verde,44,1,10570,105
2020-11-27,Cape Verde,56,0,10626,105
2020-11-28,Cape Verde,74,0,10700,105
2020-11-29,Cape Verde,47,0,10747,105
2020-11-30,Cape Verde,14,0,10761,105
2020-12-01,Cape Verde,55,1,10816,106
2020-12-02,Cape Verde,51,0,10867,106
2020-12-03,Cape Verde,71,1,10938,107
2020-12-04,Cape Verde,58,1,10996,108
2020-12-05,Cape Verde,40,1,11036,109
2020-12-06,Cape Verde,27,0,11063,109
2020-12-07,Cape Verde,35,0,11098,109
2020-12-08,Cape Verde,20,0,11118,109
2020-12-09,Cape Verde,74,0,11192,109
2020-12-10,Cape Verde,11,0,11203,109
2020-12-11,Cape Verde,59,1,11262,110
2020-12-12,Cape Verde,40,0,11302,110
2020-12-13,Cape Verde,55,0,11357,110
2020-12-14,Cape Verde,4,0,11361,110
2020-12-15,Cape Verde,34,0,11395,110
2020-12-16,Cape Verde,63,0,11458,110
2020-12-17,Cape Verde,44,0,11502,110
2020-12-18,Cape Verde,24,0,11526,110
2020-12-19,Cape Verde,41,1,11567,111
2020-12-20,Cape Verde,12,0,11579,111
2020-12-21,Cape Verde,21,0,11600,111
2020-12-22,Cape Verde,36,1,11636,112
2020-12-23,Cape Verde,32,0,11668,112
2020-12-24,Cape Verde,20,0,11688,112
2020-12-25,Cape Verde,8,0,11696,112
2020-12-26,Cape Verde,2,0,11698,112
2020-12-27,Cape Verde,16,0,11714,112
2020-12-28,Cape Verde,9,0,11723,112
2020-12-29,Cape Verde,29,0,11752,112
2020-12-30,Cape Verde,41,0,11793,112
2020-12-31,Cape Verde,47,1,11840,113
2021-01-01,Cape Verde,32,0,11872,113
2021-01-02,Cape Verde,11,0,11883,113
2021-01-03,Cape Verde,37,0,11920,113
2021-01-04,Cape Verde,29,0,11949,113
2021-01-05,Cape Verde,34,0,11983,113
2021-01-06,Cape Verde,69,0,12052,113
2021-01-07,Cape Verde,94,0,12146,113
2021-01-08,Cape Verde,91,1,12237,114
2021-01-09,Cape Verde,79,0,12316,114
2021-01-10,Cape Verde,76,0,12392,114
2021-01-11,Cape Verde,41,1,12433,115
2021-01-12,Cape Verde,73,0,12506,115
2021-01-13,Cape Verde,86,0,12592,115
2021-01-14,Cape Verde,72,0,12664,115
2021-01-15,Cape Verde,112,3,12776,118
2021-01-16,Cape Verde,125,1,12901,119
2021-01-17,Cape Verde,92,0,12993,119
2021-01-18,Cape Verde,53,1,13046,120
2021-01-19,Cape Verde,93,0,13139,120
2021-01-20,Cape Verde,85,1,13224,121
2021-01-21,Cape Verde,83,1,13307,122
2021-01-22,Cape Verde,74,0,13381,122
2021-01-23,Cape Verde,33,2,13414,124
2021-01-24,Cape Verde,75,3,13489,127
2021-01-25,Cape Verde,68,0,13557,127
2021-01-26,Cape Verde,62,2,13619,129
2021-01-27,Cape Verde,103,0,13722,129
2021-01-28,Cape Verde,62,2,13784,131
2021-01-29,Cape Verde,113,0,13897,131
2021-01-30,Cape Verde,84,2,13981,133
2021-01-31,Cape Verde,89,1,14070,134
2021-02-01,Cape Verde,28,0,14098,134
2021-02-02,Cape Verde,54,0,14152,134
2021-02-03,Cape Verde,62,1,14214,135
2021-02-04,Cape Verde,76,0,14290,135
2021-02-05,Cape Verde,16,0,14306,135
2021-02-06,Cape Verde,74,0,14380,135
2021-02-07,Cape Verde,43,0,14423,135
2021-02-08,Cape Verde,28,1,14451,136
2021-02-09,Cape Verde,28,1,14479,137
2021-02-10,Cape Verde,64,1,14543,138
2021-02-11,Cape Verde,58,0,14601,138
2021-02-12,Cape Verde,46,1,14647,139
2021-02-13,Cape Verde,53,0,14700,139
2021-02-14,Cape Verde,41,0,14741,139
2021-02-15,Cape Verde,20,0,14761,139
2021-02-16,Cape Verde,24,1,14785,140
2021-02-17,Cape Verde,63,1,14848,141
2021-02-18,Cape Verde,37,1,14885,142
2021-02-19,Cape Verde,63,0,14948,142
2021-02-20,Cape Verde,51,1,14999,143
2021-02-21,Cape Verde,49,1,15048,144
2021-02-22,Cape Verde,24,0,15072,144
2021-02-23,Cape Verde,17,0,15089,144
2021-02-24,Cape Verde,72,1,15161,145
2021-02-25,Cape Verde,40,0,15201,145
2021-02-26,Cape Verde,52,1,15253,146
2021-02-27,Cape Verde,71,1,15324,147
2021-02-28,Cape Verde,76,0,15400,147
2021-03-01,Cape Verde,32,0,15432,147
2021-03-02,Cape Verde,51,1,15483,148
2021-03-03,Cape Verde,75,2,15558,150
2021-03-04,Cape Verde,63,2,15621,152
2021-03-05,Cape Verde,62,0,15683,152
2021-03-06,Cape Verde,41,0,15724,152
2021-03-07,Cape Verde,58,2,15782,154
2021-03-08,Cape Verde,24,0,15806,154
2021-03-09,Cape Verde,20,0,15826,154
2021-03-10,Cape Verde,66,1,15892,155
2021-03-11,Cape Verde,40,0,15932,155
2021-03-12,Cape Verde,54,0,15986,155
2021-03-13,Cape Verde,49,1,16035,156
2021-03-14,Cape Verde,66,0,16101,156
2021-03-15,Cape Verde,19,0,16120,156
2021-03-16,Cape Verde,34,1,16154,157
2021-03-17,Cape Verde,96,1,16250,158
2021-03-18,Cape Verde,48,0,16298,158
2021-03-19,Cape Verde,76,1,16374,159
2021-03-20,Cape Verde,66,0,16440,159
2021-03-21,Cape Verde,51,0,16491,159
2021-03-22,Cape Verde,26,1,16517,160
2021-03-23,Cape Verde,38,3,16555,163
2021-03-24,Cape Verde,106,0,16661,163
2021-03-25,Cape Verde,126,1,16787,164
2021-03-26,Cape Verde,124,1,16911,165
2021-03-27,Cape Verde,107,0,17018,165
2021-03-28,Cape Verde,107,0,17125,165
2021-03-29,Cape Verde,65,0,17190,165
2021-03-30,Cape Verde,89,3,17279,168
2021-03-31,Cape Verde,191,0,17470,168
2021-04-01,Cape Verde,117,1,17587,169
2021-04-02,Cape Verde,130,2,17717,171
2021-04-03,Cape Verde,104,0,17821,171
2021-04-04,Cape Verde,50,2,17871,173
2021-04-05,Cape Verde,68,0,17939,173
2021-04-06,Cape Verde,84,0,18023,173
2021-04-07,Cape Verde,191,2,18214,175
2021-04-08,Cape Verde,208,1,18422,176
2020-03-15,Central African Republic,1,0,1,0
2020-03-16,Central African Republic,0,0,1,0
2020-03-17,Central African Republic,0,0,1,0
2020-03-18,Central African Republic,0,0,1,0
2020-03-19,Central African Republic,0,0,1,0
2020-03-20,Central African Republic,2,0,3,0
2020-03-21,Central African Republic,0,0,3,0
2020-03-22,Central African Republic,0,0,3,0
2020-03-23,Central African Republic,0,0,3,0
2020-03-24,Central African Republic,0,0,3,0
2020-03-25,Central African Republic,0,0,3,0
2020-03-26,Central African Republic,0,0,3,0
2020-03-27,Central African Republic,0,0,3,0
2020-03-28,Central African Republic,0,0,3,0
2020-03-29,Central African Republic,0,0,3,0
2020-03-30,Central African Republic,0,0,3,0
2020-03-31,Central African Republic,0,0,3,0
2020-04-01,Central African Republic,0,0,3,0
2020-04-02,Central African Republic,0,0,3,0
2020-04-03,Central African Republic,5,0,8,0
2020-04-04,Central African Republic,0,0,8,0
2020-04-05,Central African Republic,0,0,8,0
2020-04-06,Central African Republic,0,0,8,0
2020-04-07,Central African Republic,0,0,8,0
2020-04-08,Central African Republic,0,0,8,0
2020-04-09,Central African Republic,0,0,8,0
2020-04-10,Central African Republic,0,0,8,0
2020-04-11,Central African Republic,0,0,8,0
2020-04-12,Central African Republic,0,0,8,0
2020-04-13,Central African Republic,3,0,11,0
2020-04-14,Central African Republic,0,0,11,0
2020-04-15,Central African Republic,1,0,12,0
2020-04-16,Central African Republic,0,0,12,0
2020-04-17,Central African Republic,0,0,12,0
2020-04-18,Central African Republic,0,0,12,0
2020-04-19,Central African Republic,0,0,12,0
2020-04-20,Central African Republic,0,0,12,0
2020-04-21,Central African Republic,2,0,14,0
2020-04-22,Central African Republic,0,0,14,0
2020-04-23,Central African Republic,2,0,16,0
2020-04-24,Central African Republic,0,0,16,0
2020-04-25,Central African Republic,0,0,16,0
2020-04-26,Central African Republic,3,0,19,0
2020-04-27,Central African Republic,0,0,19,0
2020-04-28,Central African Republic,31,0,50,0
2020-04-29,Central African Republic,0,0,50,0
2020-04-30,Central African Republic,0,0,50,0
2020-05-01,Central African Republic,22,0,72,0
2020-05-02,Central African Republic,0,0,72,0
2020-05-03,Central African Republic,0,0,72,0
2020-05-04,Central African Republic,13,0,85,0
2020-05-05,Central African Republic,0,0,85,0
2020-05-06,Central African Republic,9,0,94,0
2020-05-07,Central African Republic,0,0,94,0
2020-05-08,Central African Republic,49,0,143,0
2020-05-09,Central African Republic,0,0,143,0
2020-05-10,Central African Republic,0,0,143,0
2020-05-11,Central African Republic,0,0,143,0
2020-05-12,Central African Republic,0,0,143,0
2020-05-13,Central African Republic,0,0,143,0
2020-05-14,Central African Republic,0,0,143,0
2020-05-15,Central African Republic,158,0,301,0
2020-05-16,Central African Republic,26,0,327,0
2020-05-17,Central African Republic,0,0,327,0
2020-05-18,Central African Republic,0,0,327,0
2020-05-19,Central African Republic,39,0,366,0
2020-05-20,Central African Republic,52,0,418,0
2020-05-21,Central African Republic,18,0,436,0
2020-05-22,Central African Republic,43,0,479,0
2020-05-23,Central African Republic,73,1,552,1
2020-05-24,Central African Republic,52,0,604,1
2020-05-25,Central African Republic,48,0,652,1
2020-05-26,Central African Republic,19,0,671,1
2020-05-27,Central African Republic,31,0,702,1
2020-05-28,Central African Republic,53,0,755,1
2020-05-29,Central African Republic,119,0,874,1
2020-05-30,Central African Republic,88,0,962,1
2020-05-31,Central African Republic,49,1,1011,2
2020-06-01,Central African Republic,58,2,1069,4
2020-06-02,Central African Republic,0,0,1069,4
2020-06-03,Central African Republic,104,0,1173,4
2020-06-04,Central African Republic,115,0,1288,4
2020-06-05,Central African Republic,163,0,1451,4
2020-06-06,Central African Republic,119,1,1570,5
2020-06-07,Central African Republic,64,0,1634,5
2020-06-08,Central African Republic,216,0,1850,5
2020-06-09,Central African Republic,0,0,1850,5
2020-06-10,Central African Republic,38,0,1888,5
2020-06-11,Central African Republic,64,0,1952,5
2020-06-12,Central African Republic,92,2,2044,7
2020-06-13,Central African Republic,13,0,2057,7
2020-06-14,Central African Republic,0,0,2057,7
2020-06-15,Central African Republic,165,0,2222,7
2020-06-16,Central African Republic,188,7,2410,14
2020-06-17,Central African Republic,154,4,2564,18
2020-06-18,Central African Republic,41,1,2605,19
2020-06-19,Central African Republic,0,0,2605,19
2020-06-20,Central African Republic,81,0,2686,19
2020-06-21,Central African Republic,122,4,2808,23
2020-06-22,Central African Republic,155,7,2963,30
2020-06-23,Central African Republic,88,7,3051,37
2020-06-24,Central African Republic,48,1,3099,38
2020-06-25,Central African Republic,145,2,3244,40
2020-06-26,Central African Republic,96,0,3340,40
2020-06-27,Central African Republic,89,5,3429,45
2020-06-28,Central African Republic,0,0,3429,45
2020-06-29,Central African Republic,184,2,3613,47
2020-06-30,Central African Republic,132,0,3745,47
2020-07-01,Central African Republic,0,0,3745,47
2020-07-02,Central African Republic,43,0,3788,47
2020-07-03,Central African Republic,130,1,3918,48
2020-07-04,Central African Republic,51,0,3969,48
2020-07-05,Central African Republic,0,0,3969,48
2020-07-06,Central African Republic,64,4,4033,52
2020-07-07,Central African Republic,38,0,4071,52
2020-07-08,Central African Republic,38,0,4109,52
2020-07-09,Central African Republic,91,0,4200,52
2020-07-10,Central African Republic,59,1,4259,53
2020-07-11,Central African Republic,29,0,4288,53
2020-07-12,Central African Republic,0,0,4288,53
2020-07-13,Central African Republic,33,0,4321,53
2020-07-14,Central African Republic,35,0,4356,53
2020-07-15,Central African Republic,6,0,4362,53
2020-07-16,Central African Republic,11,0,4373,53
2020-07-17,Central African Republic,16,0,4389,53
2020-07-18,Central African Republic,96,2,4485,55
2020-07-19,Central African Republic,0,0,4485,55
2020-07-20,Central African Republic,63,0,4548,55
2020-07-21,Central African Republic,13,0,4561,55
2020-07-22,Central African Republic,13,2,4574,57
2020-07-23,Central African Republic,16,1,4590,58
2020-07-24,Central African Republic,3,1,4593,59
2020-07-25,Central African Republic,5,0,4598,59
2020-07-26,Central African Republic,1,0,4599,59
2020-07-27,Central African Republic,0,0,4599,59
2020-07-28,Central African Republic,0,0,4599,59
2020-07-29,Central African Republic,6,0,4605,59
2020-07-30,Central African Republic,0,0,4605,59
2020-07-31,Central African Republic,3,0,4608,59
2020-08-01,Central African Republic,6,0,4614,59
2020-08-02,Central African Republic,0,0,4614,59
2020-08-03,Central African Republic,0,0,4614,59
2020-08-04,Central African Republic,4,0,4618,59
2020-08-05,Central African Republic,0,0,4618,59
2020-08-06,Central African Republic,2,0,4620,59
2020-08-07,Central African Republic,21,0,4641,59
2020-08-08,Central African Republic,0,0,4641,59
2020-08-09,Central African Republic,0,1,4641,60
2020-08-10,Central African Republic,0,0,4641,60
2020-08-11,Central African Republic,4,1,4645,61
2020-08-12,Central African Republic,7,0,4652,61
2020-08-13,Central African Republic,0,0,4652,61
2020-08-14,Central African Republic,0,0,4652,61
2020-08-15,Central African Republic,0,0,4652,61
2020-08-16,Central African Republic,0,0,4652,61
2020-08-17,Central African Republic,15,0,4667,61
2020-08-18,Central African Republic,12,0,4679,61
2020-08-19,Central African Republic,0,0,4679,61
2020-08-20,Central African Republic,0,0,4679,61
2020-08-21,Central African Republic,0,0,4679,61
2020-08-22,Central African Republic,0,0,4679,61
2020-08-23,Central African Republic,0,0,4679,61
2020-08-24,Central African Republic,0,0,4679,61
2020-08-25,Central African Republic,12,0,4691,61
2020-08-26,Central African Republic,7,0,4698,61
2020-08-27,Central African Republic,0,0,4698,61
2020-08-28,Central African Republic,2,0,4700,61
2020-08-29,Central African Republic,0,0,4700,61
2020-08-30,Central African Republic,0,0,4700,61
2020-08-31,Central African Republic,11,1,4711,62
2020-09-01,Central African Republic,0,0,4711,62
2020-09-02,Central African Republic,1,0,4712,62
2020-09-03,Central African Republic,17,0,4729,62
2020-09-04,Central African Republic,0,0,4729,62
2020-09-05,Central African Republic,0,0,4729,62
2020-09-06,Central African Republic,0,0,4729,62
2020-09-07,Central African Republic,0,0,4729,62
2020-09-08,Central African Republic,6,0,4735,62
2020-09-09,Central African Republic,1,0,4736,62
2020-09-10,Central African Republic,11,0,4747,62
2020-09-11,Central African Republic,2,0,4749,62
2020-09-12,Central African Republic,0,0,4749,62
2020-09-13,Central African Republic,0,0,4749,62
2020-09-14,Central African Republic,23,0,4772,62
2020-09-15,Central African Republic,0,0,4772,62
2020-09-16,Central African Republic,10,0,4782,62
2020-09-17,Central African Republic,0,0,4782,62
2020-09-18,Central African Republic,4,0,4786,62
2020-09-19,Central African Republic,0,0,4786,62
2020-09-20,Central African Republic,0,0,4786,62
2020-09-21,Central African Republic,0,0,4786,62
2020-09-22,Central African Republic,16,0,4802,62
2020-09-23,Central African Republic,0,0,4802,62
2020-09-24,Central African Republic,2,0,4804,62
2020-09-25,Central African Republic,2,0,4806,62
2020-09-26,Central African Republic,0,0,4806,62
2020-09-27,Central African Republic,0,0,4806,62
2020-09-28,Central African Republic,0,0,4806,62
2020-09-29,Central African Republic,0,0,4806,62
2020-09-30,Central African Republic,23,0,4829,62
2020-10-01,Central African Republic,0,0,4829,62
2020-10-02,Central African Republic,0,0,4829,62
2020-10-03,Central African Republic,16,0,4845,62
2020-10-04,Central African Republic,0,0,4845,62
2020-10-05,Central African Republic,0,0,4845,62
2020-10-06,Central African Republic,7,0,4852,62
2020-10-07,Central African Republic,0,0,4852,62
2020-10-08,Central African Republic,1,0,4853,62
2020-10-09,Central African Republic,0,0,4853,62
2020-10-10,Central African Republic,1,0,4854,62
2020-10-11,Central African Republic,0,0,4854,62
2020-10-12,Central African Republic,0,0,4854,62
2020-10-13,Central African Republic,0,0,4854,62
2020-10-14,Central African Republic,1,0,4855,62
2020-10-15,Central African Republic,0,0,4855,62
2020-10-16,Central African Republic,0,0,4855,62
2020-10-17,Central African Republic,0,0,4855,62
2020-10-18,Central African Republic,0,0,4855,62
2020-10-19,Central African Republic,1,0,4856,62
2020-10-20,Central African Republic,2,0,4858,62
2020-10-21,Central African Republic,0,0,4858,62
2020-10-22,Central African Republic,4,0,4862,62
2020-10-23,Central African Republic,0,0,4862,62
2020-10-24,Central African Republic,0,0,4862,62
2020-10-25,Central African Republic,0,0,4862,62
2020-10-26,Central African Republic,1,0,4863,62
2020-10-27,Central African Republic,0,0,4863,62
2020-10-28,Central African Republic,0,0,4863,62
2020-10-29,Central African Republic,0,0,4863,62
2020-10-30,Central African Republic,3,0,4866,62
2020-10-31,Central African Republic,0,0,4866,62
2020-11-01,Central African Republic,0,0,4866,62
2020-11-02,Central African Republic,0,0,4866,62
2020-11-03,Central African Republic,0,0,4866,62
2020-11-04,Central African Republic,0,0,4866,62
2020-11-05,Central African Republic,0,0,4866,62
2020-11-06,Central African Republic,0,0,4866,62
2020-11-07,Central African Republic,13,0,4879,62
2020-11-08,Central African Republic,0,0,4879,62
2020-11-09,Central African Republic,1,0,4880,62
2020-11-10,Central African Republic,4,0,4884,62
2020-11-11,Central African Republic,0,0,4884,62
2020-11-12,Central African Republic,4,0,4888,62
2020-11-13,Central African Republic,0,0,4888,62
2020-11-14,Central African Republic,8,1,4896,63
2020-11-15,Central African Republic,4,0,4900,63
2020-11-16,Central African Republic,0,0,4900,63
2020-11-17,Central African Republic,0,0,4900,63
2020-11-18,Central African Republic,0,0,4900,63
2020-11-19,Central African Republic,7,0,4907,63
2020-11-20,Central African Republic,4,0,4911,63
2020-11-21,Central African Republic,0,0,4911,63
2020-11-22,Central African Republic,0,0,4911,63
2020-11-23,Central African Republic,0,0,4911,63
2020-11-24,Central African Republic,0,0,4911,63
2020-11-25,Central African Republic,0,0,4911,63
2020-11-26,Central African Republic,2,0,4913,63
2020-11-27,Central African Republic,0,0,4913,63
2020-11-28,Central African Republic,0,0,4913,63
2020-11-29,Central African Republic,0,0,4913,63
2020-11-30,Central African Republic,0,0,4913,63
2020-12-01,Central African Republic,5,0,4918,63
2020-12-02,Central African Republic,0,0,4918,63
2020-12-03,Central African Republic,0,0,4918,63
2020-12-04,Central African Republic,0,0,4918,63
2020-12-05,Central African Republic,4,0,4922,63
2020-12-06,Central African Republic,0,0,4922,63
2020-12-07,Central African Republic,0,0,4922,63
2020-12-08,Central African Republic,5,0,4927,63
2020-12-09,Central African Republic,0,0,4927,63
2020-12-10,Central African Republic,0,0,4927,63
2020-12-11,Central African Republic,9,0,4936,63
2020-12-12,Central African Republic,0,0,4936,63
2020-12-13,Central African Republic,0,0,4936,63
2020-12-14,Central African Republic,0,0,4936,63
2020-12-15,Central African Republic,0,0,4936,63
2020-12-16,Central African Republic,0,0,4936,63
2020-12-17,Central African Republic,0,0,4936,63
2020-12-18,Central African Republic,0,0,4936,63
2020-12-19,Central African Republic,0,0,4936,63
2020-12-20,Central African Republic,0,0,4936,63
2020-12-21,Central African Republic,0,0,4936,63
2020-12-22,Central African Republic,0,0,4936,63
2020-12-23,Central African Republic,12,0,4948,63
2020-12-24,Central African Republic,0,0,4948,63
2020-12-25,Central African Republic,0,0,4948,63
2020-12-26,Central African Republic,0,0,4948,63
2020-12-27,Central African Republic,0,0,4948,63
2020-12-28,Central African Republic,0,0,4948,63
2020-12-29,Central African Republic,13,0,4961,63
2020-12-30,Central African Republic,2,0,4963,63
2020-12-31,Central African Republic,0,0,4963,63
2021-01-01,Central African Republic,0,0,4963,63
2021-01-02,Central African Republic,0,0,4963,63
2021-01-03,Central African Republic,0,0,4963,63
2021-01-04,Central African Republic,0,0,4963,63
2021-01-05,Central African Republic,0,0,4963,63
2021-01-06,Central African Republic,0,0,4963,63
2021-01-07,Central African Republic,6,0,4969,63
2021-01-08,Central African Republic,0,0,4969,63
2021-01-09,Central African Republic,0,0,4969,63
2021-01-10,Central African Republic,4,0,4973,63
2021-01-11,Central African Republic,0,0,4973,63
2021-01-12,Central African Republic,0,0,4973,63
2021-01-13,Central African Republic,0,0,4973,63
2021-01-14,Central African Republic,0,0,4973,63
2021-01-15,Central African Republic,0,0,4973,63
2021-01-16,Central African Republic,0,0,4973,63
2021-01-17,Central African Republic,0,0,4973,63
2021-01-18,Central African Republic,0,0,4973,63
2021-01-19,Central African Republic,0,0,4973,63
2021-01-20,Central African Republic,1,0,4974,63
2021-01-21,Central African Republic,0,0,4974,63
2021-01-22,Central African Republic,0,0,4974,63
2021-01-23,Central African Republic,0,0,4974,63
2021-01-24,Central African Republic,6,0,4980,63
2021-01-25,Central African Republic,0,0,4980,63
2021-01-26,Central African Republic,0,0,4980,63
2021-01-27,Central African Republic,0,0,4980,63
2021-01-28,Central African Republic,1,0,4981,63
2021-01-29,Central African Republic,0,0,4981,63
2021-01-30,Central African Republic,0,0,4981,63
2021-01-31,Central African Republic,0,0,4981,63
2021-02-01,Central African Republic,8,0,4989,63
2021-02-02,Central African Republic,0,0,4989,63
2021-02-03,Central African Republic,0,0,4989,63
2021-02-04,Central African Republic,0,0,4989,63
2021-02-05,Central African Republic,0,0,4989,63
2021-02-06,Central African Republic,0,0,4989,63
2021-02-07,Central African Republic,0,0,4989,63
2021-02-08,Central African Republic,0,0,4989,63
2021-02-09,Central African Republic,0,0,4989,63
2021-02-10,Central African Republic,0,0,4989,63
2021-02-11,Central African Republic,7,0,4996,63
2021-02-12,Central African Republic,0,0,4996,63
2021-02-13,Central African Republic,0,0,4996,63
2021-02-14,Central African Republic,0,0,4996,63
2021-02-15,Central African Republic,0,0,4996,63
2021-02-16,Central African Republic,0,0,4996,63
2021-02-17,Central African Republic,1,0,4997,63
2021-02-18,Central African Republic,0,0,4997,63
2021-02-19,Central African Republic,4,0,5001,63
2021-02-20,Central African Republic,0,0,5001,63
2021-02-21,Central African Republic,0,0,5001,63
2021-02-22,Central African Republic,0,0,5001,63
2021-02-23,Central African Republic,0,0,5001,63
2021-02-24,Central African Republic,3,0,5004,63
2021-02-25,Central African Republic,0,0,5004,63
2021-02-26,Central African Republic,0,0,5004,63
2021-02-27,Central African Republic,0,0,5004,63
2021-02-28,Central African Republic,0,0,5004,63
2021-03-01,Central African Republic,0,0,5004,63
2021-03-02,Central African Republic,0,0,5004,63
2021-03-03,Central African Republic,0,0,5004,63
2021-03-04,Central African Republic,14,0,5018,63
2021-03-05,Central African Republic,0,0,5018,63
2021-03-06,Central African Republic,0,0,5018,63
2021-03-07,Central African Republic,3,0,5021,63
2021-03-08,Central African Republic,0,0,5021,63
2021-03-09,Central African Republic,2,0,5023,63
2021-03-10,Central African Republic,0,0,5023,63
2021-03-11,Central African Republic,0,0,5023,63
2021-03-12,Central African Republic,0,0,5023,63
2021-03-13,Central African Republic,0,0,5023,63
2021-03-14,Central African Republic,0,0,5023,63
2021-03-15,Central African Republic,0,0,5023,63
2021-03-16,Central African Republic,2,0,5025,63
2021-03-17,Central African Republic,39,0,5064,63
2021-03-18,Central African Republic,11,1,5075,64
2021-03-19,Central African Republic,0,0,5075,64
2021-03-20,Central African Republic,0,0,5075,64
2021-03-21,Central African Republic,12,0,5087,64
2021-03-22,Central African Republic,0,0,5087,64
2021-03-23,Central African Republic,0,0,5087,64
2021-03-24,Central African Republic,1,0,5088,64
2021-03-25,Central African Republic,0,0,5088,64
2021-03-26,Central African Republic,0,0,5088,64
2021-03-27,Central African Republic,0,0,5088,64
2021-03-28,Central African Republic,0,0,5088,64
2021-03-29,Central African Republic,0,0,5088,64
2021-03-30,Central African Republic,73,3,5161,67
2021-03-31,Central African Republic,0,0,5161,67
2021-04-01,Central African Republic,61,5,5222,72
2021-04-02,Central African Republic,23,0,5245,72
2021-04-03,Central African Republic,0,0,5245,72
2021-04-04,Central African Republic,0,0,5245,72
2021-04-05,Central African Republic,68,1,5313,73
2021-04-06,Central African Republic,0,0,5313,73
2021-04-07,Central African Republic,40,0,5353,73
2021-04-08,Central African Republic,49,1,5402,74
2020-03-19,Chad,1,0,1,0
2020-03-20,Chad,0,0,1,0
2020-03-21,Chad,0,0,1,0
2020-03-22,Chad,0,0,1,0
2020-03-23,Chad,0,0,1,0
2020-03-24,Chad,2,0,3,0
2020-03-25,Chad,0,0,3,0
2020-03-26,Chad,0,0,3,0
2020-03-27,Chad,0,0,3,0
2020-03-28,Chad,0,0,3,0
2020-03-29,Chad,0,0,3,0
2020-03-30,Chad,2,0,5,0
2020-03-31,Chad,2,0,7,0
2020-04-01,Chad,0,0,7,0
2020-04-02,Chad,1,0,8,0
2020-04-03,Chad,0,0,8,0
2020-04-04,Chad,1,0,9,0
2020-04-05,Chad,0,0,9,0
2020-04-06,Chad,0,0,9,0
2020-04-07,Chad,1,0,10,0
2020-04-08,Chad,0,0,10,0
2020-04-09,Chad,1,0,11,0
2020-04-10,Chad,0,0,11,0
2020-04-11,Chad,0,0,11,0
2020-04-12,Chad,7,0,18,0
2020-04-13,Chad,5,0,23,0
2020-04-14,Chad,0,0,23,0
2020-04-15,Chad,0,0,23,0
2020-04-16,Chad,4,0,27,0
2020-04-17,Chad,0,0,27,0
2020-04-18,Chad,6,0,33,0
2020-04-19,Chad,0,0,33,0
2020-04-20,Chad,0,0,33,0
2020-04-21,Chad,0,0,33,0
2020-04-22,Chad,0,0,33,0
2020-04-23,Chad,0,0,33,0
2020-04-24,Chad,7,0,40,0
2020-04-25,Chad,6,0,46,0
2020-04-26,Chad,0,0,46,0
2020-04-27,Chad,0,0,46,0
2020-04-28,Chad,6,2,52,2
2020-04-29,Chad,0,0,52,2
2020-04-30,Chad,21,3,73,5
2020-05-01,Chad,0,0,73,5
2020-05-02,Chad,44,5,117,10
2020-05-03,Chad,0,0,117,10
2020-05-04,Chad,0,0,117,10
2020-05-05,Chad,53,7,170,17
2020-05-06,Chad,0,0,170,17
2020-05-07,Chad,83,10,253,27
2020-05-08,Chad,7,1,260,28
2020-05-09,Chad,62,3,322,31
2020-05-10,Chad,0,0,322,31
2020-05-11,Chad,0,0,322,31
2020-05-12,Chad,35,9,357,40
2020-05-13,Chad,15,2,372,42
2020-05-14,Chad,27,4,399,46
2020-05-15,Chad,29,2,428,48
2020-05-16,Chad,46,2,474,50
2020-05-17,Chad,29,3,503,53
2020-05-18,Chad,16,0,519,53
2020-05-19,Chad,26,3,545,56
2020-05-20,Chad,20,1,565,57
2020-05-21,Chad,23,1,588,58
2020-05-22,Chad,23,0,611,58
2020-05-23,Chad,37,2,648,60
2020-05-24,Chad,27,0,675,60
2020-05-25,Chad,12,1,687,61
2020-05-26,Chad,13,1,700,62
2020-05-27,Chad,15,2,715,64
2020-05-28,Chad,11,1,726,65
2020-05-29,Chad,33,0,759,65
2020-05-30,Chad,0,0,759,65
2020-05-31,Chad,19,0,778,65
2020-06-01,Chad,12,1,790,66
2020-06-02,Chad,13,0,803,66
2020-06-03,Chad,17,0,820,66
2020-06-04,Chad,8,0,828,66
2020-06-05,Chad,8,2,836,68
2020-06-06,Chad,0,1,836,69
2020-06-07,Chad,1,0,837,69
2020-06-08,Chad,2,1,839,70
2020-06-09,Chad,5,1,844,71
2020-06-10,Chad,2,1,846,72
2020-06-11,Chad,2,0,848,72
2020-06-12,Chad,0,0,848,72
2020-06-13,Chad,0,0,848,72
2020-06-14,Chad,2,1,850,73
2020-06-15,Chad,0,0,850,73
2020-06-16,Chad,3,1,853,74
2020-06-17,Chad,1,0,854,74
2020-06-18,Chad,0,0,854,74
2020-06-19,Chad,4,0,858,74
2020-06-20,Chad,0,0,858,74
2020-06-21,Chad,0,0,858,74
2020-06-22,Chad,0,0,858,74
2020-06-23,Chad,2,0,860,74
2020-06-24,Chad,0,0,860,74
2020-06-25,Chad,3,0,863,74
2020-06-26,Chad,2,0,865,74
2020-06-27,Chad,0,0,865,74
2020-06-28,Chad,1,0,866,74
2020-06-29,Chad,0,0,866,74
2020-06-30,Chad,0,0,866,74
2020-07-01,Chad,0,0,866,74
2020-07-02,Chad,2,0,868,74
2020-07-03,Chad,3,0,871,74
2020-07-04,Chad,0,0,871,74
2020-07-05,Chad,1,0,872,74
2020-07-06,Chad,0,0,872,74
2020-07-07,Chad,1,0,873,74
2020-07-08,Chad,0,0,873,74
2020-07-09,Chad,0,0,873,74
2020-07-10,Chad,1,0,874,74
2020-07-11,Chad,0,0,874,74
2020-07-12,Chad,6,1,880,75
2020-07-13,Chad,0,0,880,75
2020-07-14,Chad,4,0,884,75
2020-07-15,Chad,1,0,885,75
2020-07-16,Chad,1,0,886,75
2020-07-17,Chad,1,0,887,75
2020-07-18,Chad,2,0,889,75
2020-07-19,Chad,0,0,889,75
2020-07-20,Chad,0,0,889,75
2020-07-21,Chad,0,0,889,75
2020-07-22,Chad,0,0,889,75
2020-07-23,Chad,26,0,915,75
2020-07-24,Chad,0,0,915,75
2020-07-25,Chad,0,0,915,75
2020-07-26,Chad,0,0,915,75
2020-07-27,Chad,7,0,922,75
2020-07-28,Chad,4,0,926,75
2020-07-29,Chad,0,0,926,75
2020-07-30,Chad,9,0,935,75
2020-07-31,Chad,1,0,936,75
2020-08-01,Chad,0,0,936,75
2020-08-02,Chad,0,0,936,75
2020-08-03,Chad,0,0,936,75
2020-08-04,Chad,2,0,938,75
2020-08-05,Chad,1,0,939,75
2020-08-06,Chad,3,1,942,76
2020-08-07,Chad,0,0,942,76
2020-08-08,Chad,0,0,942,76
2020-08-09,Chad,2,0,944,76
2020-08-10,Chad,1,0,945,76
2020-08-11,Chad,1,0,946,76
2020-08-12,Chad,3,0,949,76
2020-08-13,Chad,0,0,949,76
2020-08-14,Chad,2,0,951,76
2020-08-15,Chad,1,0,952,76
2020-08-16,Chad,4,0,956,76
2020-08-17,Chad,3,0,959,76
2020-08-18,Chad,11,0,970,76
2020-08-19,Chad,1,0,971,76
2020-08-20,Chad,1,0,972,76
2020-08-21,Chad,9,0,981,76
2020-08-22,Chad,1,0,982,76
2020-08-23,Chad,4,0,986,76
2020-08-24,Chad,1,0,987,76
2020-08-25,Chad,8,1,995,77
2020-08-26,Chad,3,0,998,77
2020-08-27,Chad,6,0,1004,77
2020-08-28,Chad,4,0,1008,77
2020-08-29,Chad,0,0,1008,77
2020-08-30,Chad,4,0,1012,77
2020-08-31,Chad,1,0,1013,77
2020-09-01,Chad,4,0,1017,77
2020-09-02,Chad,0,0,1017,77
2020-09-03,Chad,1,0,1018,77
2020-09-04,Chad,5,0,1023,77
2020-09-05,Chad,11,0,1034,77
2020-09-06,Chad,5,2,1039,79
2020-09-07,Chad,1,0,1040,79
2020-09-08,Chad,5,0,1045,79
2020-09-09,Chad,3,0,1048,79
2020-09-10,Chad,3,0,1051,79
2020-09-11,Chad,30,0,1081,79
2020-09-12,Chad,2,1,1083,80
2020-09-13,Chad,1,0,1084,80
2020-09-14,Chad,1,1,1085,81
2020-09-15,Chad,2,0,1087,81
2020-09-16,Chad,3,0,1090,81
2020-09-17,Chad,25,0,1115,81
2020-09-18,Chad,32,0,1147,81
2020-09-19,Chad,2,0,1149,81
2020-09-20,Chad,2,0,1151,81
2020-09-21,Chad,2,0,1153,81
2020-09-22,Chad,2,0,1155,81
2020-09-23,Chad,9,1,1164,82
2020-09-24,Chad,7,0,1171,82
2020-09-25,Chad,4,1,1175,83
2020-09-26,Chad,2,0,1177,83
2020-09-27,Chad,1,1,1178,84
2020-09-28,Chad,7,1,1185,85
2020-09-29,Chad,8,0,1193,85
2020-09-30,Chad,7,0,1200,85
2020-10-01,Chad,3,0,1203,85
2020-10-02,Chad,8,0,1211,85
2020-10-03,Chad,3,0,1214,85
2020-10-04,Chad,3,1,1217,86
2020-10-05,Chad,6,0,1223,86
2020-10-06,Chad,15,2,1238,88
2020-10-07,Chad,13,1,1251,89
2020-10-08,Chad,11,0,1262,89
2020-10-09,Chad,12,1,1274,90
2020-10-10,Chad,17,2,1291,92
2020-10-11,Chad,13,0,1304,92
2020-10-12,Chad,4,0,1308,92
2020-10-13,Chad,13,0,1321,92
2020-10-14,Chad,8,0,1329,92
2020-10-15,Chad,21,0,1350,92
2020-10-16,Chad,11,1,1361,93
2020-10-17,Chad,4,0,1365,93
2020-10-18,Chad,14,0,1379,93
2020-10-19,Chad,11,0,1390,93
2020-10-20,Chad,9,0,1399,93
2020-10-21,Chad,5,3,1404,96
2020-10-22,Chad,6,0,1410,96
2020-10-23,Chad,13,0,1423,96
2020-10-24,Chad,11,0,1434,96
2020-10-25,Chad,3,0,1437,96
2020-10-26,Chad,4,0,1441,96
2020-10-27,Chad,19,0,1460,96
2020-10-28,Chad,8,1,1468,97
2020-10-29,Chad,5,0,1473,97
2020-10-30,Chad,10,1,1483,98
2020-10-31,Chad,0,0,1483,98
2020-11-01,Chad,15,0,1498,98
2020-11-02,Chad,1,0,1499,98
2020-11-03,Chad,14,0,1513,98
2020-11-04,Chad,4,1,1517,99
2020-11-05,Chad,12,0,1529,99
2020-11-06,Chad,9,0,1538,99
2020-11-07,Chad,5,0,1543,99
2020-11-08,Chad,4,0,1547,99
2020-11-09,Chad,4,0,1551,99
2020-11-10,Chad,10,0,1561,99
2020-11-11,Chad,4,0,1565,99
2020-11-12,Chad,13,1,1578,100
2020-11-13,Chad,11,0,1589,100
2020-11-14,Chad,2,0,1591,100
2020-11-15,Chad,6,1,1597,101
2020-11-16,Chad,6,0,1603,101
2020-11-17,Chad,5,0,1608,101
2020-11-18,Chad,8,0,1616,101
2020-11-19,Chad,4,0,1620,101
2020-11-20,Chad,6,0,1626,101
2020-11-21,Chad,7,0,1633,101
2020-11-22,Chad,9,0,1642,101
2020-11-23,Chad,6,0,1648,101
2020-11-24,Chad,1,0,1649,101
2020-11-25,Chad,6,0,1655,101
2020-11-26,Chad,6,0,1661,101
2020-11-27,Chad,2,0,1663,101
2020-11-28,Chad,0,0,1663,101
2020-11-29,Chad,19,0,1682,101
2020-11-30,Chad,6,0,1688,101
2020-12-01,Chad,12,1,1700,102
2020-12-02,Chad,5,0,1705,102
2020-12-03,Chad,3,0,1708,102
2020-12-04,Chad,11,0,1719,102
2020-12-05,Chad,3,0,1722,102
2020-12-06,Chad,3,0,1725,102
2020-12-07,Chad,3,0,1728,102
2020-12-08,Chad,1,0,1729,102
2020-12-09,Chad,3,0,1732,102
2020-12-10,Chad,7,0,1739,102
2020-12-11,Chad,6,0,1745,102
2020-12-12,Chad,6,0,1751,102
2020-12-13,Chad,19,0,1770,102
2020-12-14,Chad,1,0,1771,102
2020-12-15,Chad,13,0,1784,102
2020-12-16,Chad,16,0,1800,102
2020-12-17,Chad,18,0,1818,102
2020-12-18,Chad,21,0,1839,102
2020-12-19,Chad,28,0,1867,102
2020-12-20,Chad,23,0,1890,102
2020-12-21,Chad,12,0,1902,102
2020-12-22,Chad,14,0,1916,102
2020-12-23,Chad,22,0,1938,102
2020-12-24,Chad,20,0,1958,102
2020-12-25,Chad,13,0,1971,102
2020-12-26,Chad,15,1,1986,103
2020-12-27,Chad,19,1,2005,104
2020-12-28,Chad,10,0,2015,104
2020-12-29,Chad,33,0,2048,104
2020-12-30,Chad,29,0,2077,104
2020-12-31,Chad,36,0,2113,104
2021-01-01,Chad,28,0,2141,104
2021-01-02,Chad,28,0,2169,104
2021-01-03,Chad,44,0,2213,104
2021-01-04,Chad,16,0,2229,104
2021-01-05,Chad,60,1,2289,105
2021-01-06,Chad,39,0,2328,105
2021-01-07,Chad,30,0,2358,105
2021-01-08,Chad,61,1,2419,106
2021-01-09,Chad,91,1,2510,107
2021-01-10,Chad,27,0,2537,107
2021-01-11,Chad,52,0,2589,107
2021-01-12,Chad,79,1,2668,108
2021-01-13,Chad,41,1,2709,109
2021-01-14,Chad,64,1,2773,110
2021-01-15,Chad,34,1,2807,111
2021-01-16,Chad,48,0,2855,111
2021-01-17,Chad,40,0,2895,111
2021-01-18,Chad,24,2,2919,113
2021-01-19,Chad,58,1,2977,114
2021-01-20,Chad,35,0,3012,114
2021-01-21,Chad,53,0,3065,114
2021-01-22,Chad,39,1,3104,115
2021-01-23,Chad,33,0,3137,115
2021-01-24,Chad,24,1,3161,116
2021-01-25,Chad,21,0,3182,116
2021-01-26,Chad,43,0,3225,116
2021-01-27,Chad,44,1,3269,117
2021-01-28,Chad,27,1,3296,118
2021-01-29,Chad,25,0,3321,118
2021-01-30,Chad,26,0,3347,118
2021-01-31,Chad,29,0,3376,118
2021-02-01,Chad,9,3,3385,121
2021-02-02,Chad,19,0,3404,121
2021-02-03,Chad,15,0,3419,121
2021-02-04,Chad,14,0,3433,121
2021-02-05,Chad,17,3,3450,124
2021-02-06,Chad,23,1,3473,125
2021-02-07,Chad,24,0,3497,125
2021-02-08,Chad,11,0,3508,125
2021-02-09,Chad,31,0,3539,125
2021-02-10,Chad,29,1,3568,126
2021-02-11,Chad,13,0,3581,126
2021-02-12,Chad,16,2,3597,128
2021-02-13,Chad,25,0,3622,128
2021-02-14,Chad,23,1,3645,129
2021-02-15,Chad,19,2,3664,131
2021-02-16,Chad,25,0,3689,131
2021-02-17,Chad,35,1,3724,132
2021-02-18,Chad,27,0,3751,132
2021-02-19,Chad,25,0,3776,132
2021-02-20,Chad,18,1,3794,133
2021-02-21,Chad,55,1,3849,134
2021-02-22,Chad,19,1,3868,135
2021-02-23,Chad,14,1,3882,136
2021-02-24,Chad,22,0,3904,136
2021-02-25,Chad,30,1,3934,137
2021-02-26,Chad,23,1,3957,138
2021-02-27,Chad,16,2,3973,140
2021-02-28,Chad,0,0,3973,140
2021-03-01,Chad,13,0,3986,140
2021-03-02,Chad,13,0,3999,140
2021-03-03,Chad,57,0,4056,140
2021-03-04,Chad,33,0,4089,140
2021-03-05,Chad,0,0,4089,140
2021-03-06,Chad,72,0,4161,140
2021-03-07,Chad,16,0,4177,140
2021-03-08,Chad,16,6,4193,146
2021-03-09,Chad,21,2,4214,148
2021-03-10,Chad,17,1,4231,149
2021-03-11,Chad,15,2,4246,151
2021-03-12,Chad,28,1,4274,152
2021-03-13,Chad,14,1,4288,153
2021-03-14,Chad,21,1,4309,154
2021-03-15,Chad,19,1,4328,155
2021-03-16,Chad,16,0,4344,155
2021-03-17,Chad,13,1,4357,156
2021-03-18,Chad,23,1,4380,157
2021-03-19,Chad,15,0,4395,157
2021-03-20,Chad,15,0,4410,157
2021-03-21,Chad,10,0,4420,157
2021-03-22,Chad,7,0,4427,157
2021-03-23,Chad,13,1,4440,158
2021-03-24,Chad,13,0,4453,158
2021-03-25,Chad,12,0,4465,158
2021-03-26,Chad,15,0,4480,158
2021-03-27,Chad,21,2,4501,160
2021-03-28,Chad,5,2,4506,162
2021-03-29,Chad,4,2,4510,164
2021-03-30,Chad,13,0,4523,164
2021-03-31,Chad,10,0,4533,164
2021-04-01,Chad,19,0,4552,164
2021-04-02,Chad,21,0,4573,164
2021-04-03,Chad,16,0,4589,164
2021-04-04,Chad,6,1,4595,165
2021-04-05,Chad,0,1,4595,166
2021-04-06,Chad,8,0,4603,166
2021-04-07,Chad,3,0,4606,166
2021-04-08,Chad,10,1,4616,167
2020-02-23,Chile,2,0,2,0
2020-02-24,Chile,0,0,2,0
2020-02-25,Chile,0,0,2,0
2020-02-26,Chile,0,0,2,0
2020-02-27,Chile,0,0,2,0
2020-02-28,Chile,0,0,2,0
2020-02-29,Chile,0,0,2,0
2020-03-01,Chile,7,0,9,0
2020-03-02,Chile,0,0,9,0
2020-03-03,Chile,1,0,10,0
2020-03-04,Chile,0,0,10,0
2020-03-05,Chile,3,0,13,0
2020-03-06,Chile,0,0,13,0
2020-03-07,Chile,0,0,13,0
2020-03-08,Chile,7,0,20,0
2020-03-09,Chile,0,0,20,0
2020-03-10,Chile,5,0,25,0
2020-03-11,Chile,10,0,35,0
2020-03-12,Chile,0,0,35,0
2020-03-13,Chile,20,0,55,0
2020-03-14,Chile,33,0,88,0
2020-03-15,Chile,13,0,101,0
2020-03-16,Chile,81,0,182,0
2020-03-17,Chile,46,0,228,0
2020-03-18,Chile,37,0,265,0
2020-03-19,Chile,0,0,265,0
2020-03-20,Chile,196,0,461,0
2020-03-21,Chile,131,0,592,0
2020-03-22,Chile,95,1,687,1
2020-03-23,Chile,114,1,801,2
2020-03-24,Chile,176,0,977,2
2020-03-25,Chile,220,1,1197,3
2020-03-26,Chile,164,1,1361,4
2020-03-27,Chile,304,1,1665,5
2020-03-28,Chile,350,1,2015,6
2020-03-29,Chile,230,1,2245,7
2020-03-30,Chile,310,1,2555,8
2020-03-31,Chile,289,4,2844,12
2020-04-01,Chile,293,4,3137,16
2020-04-02,Chile,373,2,3510,18
2020-04-03,Chile,333,4,3843,22
2020-04-04,Chile,512,5,4355,27
2020-04-05,Chile,310,7,4665,34
2020-04-06,Chile,344,3,5009,37
2020-04-07,Chile,301,6,5310,43
2020-04-08,Chile,430,5,5740,48
2020-04-09,Chile,426,9,6166,57
2020-04-10,Chile,529,8,6695,65
2020-04-11,Chile,671,8,7366,73
2020-04-12,Chile,286,7,7652,80
2020-04-13,Chile,312,2,7964,82
2020-04-14,Chile,392,10,8356,92
2020-04-15,Chile,356,2,8712,94
2020-04-16,Chile,534,11,9246,105
2020-04-17,Chile,445,11,9691,116
2020-04-18,Chile,907,10,10598,126
2020-04-19,Chile,358,7,10956,133
2020-04-20,Chile,419,6,11375,139
2020-04-21,Chile,325,8,11700,147
2020-04-22,Chile,464,13,12164,160
2020-04-23,Chile,516,8,12680,168
2020-04-24,Chile,494,6,13174,174
2020-04-25,Chile,1363,7,14537,181
2020-04-26,Chile,473,8,15010,189
2020-04-27,Chile,482,9,15492,198
2020-04-28,Chile,552,9,16044,207
2020-04-29,Chile,520,9,16564,216
2020-04-30,Chile,1138,11,17702,227
2020-05-01,Chile,985,7,18687,234
2020-05-02,Chile,2526,13,21213,247
2020-05-03,Chile,1228,13,22441,260
2020-05-04,Chile,980,10,23421,270
2020-05-05,Chile,1373,5,24794,275
2020-05-06,Chile,1032,6,25826,281
2020-05-07,Chile,1533,4,27359,285
2020-05-08,Chile,1391,9,28750,294
2020-05-09,Chile,3458,10,32208,304
2020-05-10,Chile,1647,8,33855,312
2020-05-11,Chile,1197,11,35052,323
2020-05-12,Chile,1658,12,36710,335
2020-05-13,Chile,2660,11,39370,346
2020-05-14,Chile,2659,22,42029,368
2020-05-15,Chile,2502,26,44531,394
2020-05-16,Chile,5485,27,50016,421
2020-05-17,Chile,2353,29,52369,450
2020-05-18,Chile,2278,28,54647,478
2020-05-19,Chile,3520,31,58167,509
2020-05-20,Chile,4038,35,62205,544
2020-05-21,Chile,3964,45,66169,589
2020-05-22,Chile,4276,41,70445,630
2020-05-23,Chile,9842,43,80287,673
2020-05-24,Chile,3709,45,83996,718
2020-05-25,Chile,4895,43,88891,761
2020-05-26,Chile,3964,45,92855,806
2020-05-27,Chile,4328,35,97183,841
2020-05-28,Chile,4654,49,101837,890
2020-05-29,Chile,3695,54,105532,944
2020-05-30,Chile,13188,53,118720,997
2020-05-31,Chile,4830,57,123550,1054
2020-06-01,Chile,5470,59,129020,1113
2020-06-02,Chile,3528,75,132548,1188
2020-06-03,Chile,4942,87,137490,1275
2020-06-04,Chile,4664,81,142154,1356
2020-06-05,Chile,4207,92,146361,1448
2020-06-06,Chile,13990,93,160351,1541
2020-06-07,Chile,6405,96,166756,1637
2020-06-08,Chile,4696,627,171452,2264
2020-06-09,Chile,3913,19,175365,2283
2020-06-10,Chile,5697,192,181062,2475
2020-06-11,Chile,5636,173,186698,2648
2020-06-12,Chile,6754,222,193452,2870
2020-06-13,Chile,8182,231,201634,3101
2020-06-14,Chile,6938,222,208572,3323
2020-06-15,Chile,5143,39,213715,3362
2020-06-16,Chile,5013,21,218728,3383
2020-06-17,Chile,1900,232,220628,3615
2020-06-18,Chile,4475,226,225103,3841
2020-06-19,Chile,6290,252,231393,4093
2020-06-20,Chile,5355,202,236748,4295
2020-06-21,Chile,5607,184,242355,4479
2020-06-22,Chile,4608,23,246963,4502
2020-06-23,Chile,3804,3,250767,4505
2020-06-24,Chile,3649,226,254416,4731
2020-06-25,Chile,4648,172,259064,4903
2020-06-26,Chile,4296,165,263360,5068
2020-06-27,Chile,4406,279,267766,5347
2020-06-28,Chile,4216,162,271982,5509
2020-06-29,Chile,4017,66,275999,5575
2020-06-30,Chile,3394,113,279393,5688
2020-07-01,Chile,2650,65,282043,5753
2020-07-02,Chile,2498,167,284541,5920
2020-07-03,Chile,3548,131,288089,6051
2020-07-04,Chile,3758,141,291847,6192
2020-07-05,Chile,3685,116,295532,6308
2020-07-06,Chile,3025,76,298557,6384
2020-07-07,Chile,2462,50,301019,6434
2020-07-08,Chile,2064,139,303083,6573
2020-07-09,Chile,3133,109,306216,6682
2020-07-10,Chile,3058,99,309274,6781
2020-07-11,Chile,2755,100,312029,6881
2020-07-12,Chile,3012,98,315041,6979
2020-07-13,Chile,2616,45,317657,7024
2020-07-14,Chile,1836,45,319493,7069
2020-07-15,Chile,1712,117,321205,7186
2020-07-16,Chile,2493,104,323698,7290
2020-07-17,Chile,2741,1057,326439,8347
2020-07-18,Chile,2407,98,328846,8445
2020-07-19,Chile,2084,58,330930,8503
2020-07-20,Chile,2099,130,333029,8633
2020-07-21,Chile,1654,44,334683,8677
2020-07-22,Chile,1719,45,336402,8722
2020-07-23,Chile,2357,116,338759,8838
2020-07-24,Chile,2545,76,341304,8914
2020-07-25,Chile,2288,106,343592,9020
2020-07-26,Chile,2198,92,345790,9112
2020-07-27,Chile,2133,75,347923,9187
2020-07-28,Chile,1877,53,349800,9240
2020-07-29,Chile,1775,38,351575,9278
2020-07-30,Chile,1961,99,353536,9377
2020-07-31,Chile,2131,80,355667,9457
2020-08-01,Chile,1991,76,357658,9533
2020-08-02,Chile,2073,75,359731,9608
2020-08-03,Chile,1762,99,361493,9707
2020-08-04,Chile,1469,38,362962,9745
2020-08-05,Chile,1761,47,364723,9792
2020-08-06,Chile,1948,97,366671,9889
2020-08-07,Chile,2154,69,368825,9958
2020-08-08,Chile,2198,53,371023,10011
2020-08-09,Chile,2033,66,373056,10077
2020-08-10,Chile,1988,62,375044,10139
2020-08-11,Chile,1572,39,376616,10178
2020-08-12,Chile,1552,27,378168,10205
2020-08-13,Chile,1866,94,380034,10299
2020-08-14,Chile,2077,41,382111,10340
2020-08-15,Chile,1791,55,383902,10395
2020-08-16,Chile,2044,57,385946,10452
2020-08-17,Chile,1556,61,387502,10513
2020-08-18,Chile,1353,33,388855,10546
2020-08-19,Chile,1182,32,390037,10578
2020-08-20,Chile,1812,93,391849,10671
2020-08-21,Chile,1920,52,393769,10723
2020-08-22,Chile,1939,69,395708,10792
2020-08-23,Chile,1957,60,397665,10852
2020-08-24,Chile,1903,64,399568,10916
2020-08-25,Chile,1417,42,400985,10958
2020-08-26,Chile,1380,32,402365,10990
2020-08-27,Chile,1737,82,404102,11072
2020-08-28,Chile,1870,60,405972,11132
2020-08-29,Chile,2037,49,408009,11181
2020-08-30,Chile,1965,63,409974,11244
2020-08-31,Chile,1752,45,411726,11289
2020-09-01,Chile,1419,32,413145,11321
2020-09-02,Chile,1594,23,414739,11344
2020-09-03,Chile,1762,78,416501,11422
2020-09-04,Chile,1968,72,418469,11494
2020-09-05,Chile,1965,57,420434,11551
2020-09-06,Chile,2076,41,422510,11592
2020-09-07,Chile,1764,60,424274,11652
2020-09-08,Chile,1267,30,425541,11682
2020-09-09,Chile,1486,20,427027,11702
2020-09-10,Chile,1642,79,428669,11781
2020-09-11,Chile,1866,69,430535,11850
2020-09-12,Chile,2131,45,432666,11895
2020-09-13,Chile,2082,54,434748,11949
2020-09-14,Chile,1685,64,436433,12013
2020-09-15,Chile,1550,27,437983,12040
2020-09-16,Chile,1304,18,439287,12058
2020-09-17,Chile,1863,84,441150,12142
2020-09-18,Chile,1677,57,442827,12199
2020-09-19,Chile,1847,55,444674,12254
2020-09-20,Chile,1600,32,446274,12286
2020-09-21,Chile,1194,12,447468,12298
2020-09-22,Chile,1055,23,448523,12321
2020-09-23,Chile,1380,24,449903,12345
2020-09-24,Chile,1731,124,451634,12469
2020-09-25,Chile,2234,58,453868,12527
2020-09-26,Chile,2111,64,455979,12591
2020-09-27,Chile,1922,50,457901,12641
2020-09-28,Chile,1770,57,459671,12698
2020-09-29,Chile,1629,27,461300,12725
2020-09-30,Chile,1691,16,462991,12741
2020-10-01,Chile,1759,81,464750,12822
2020-10-02,Chile,1840,45,466590,12867
2020-10-03,Chile,1881,52,468471,12919
2020-10-04,Chile,1708,60,470179,12979
2020-10-05,Chile,1567,58,471746,13037
2020-10-06,Chile,1560,33,473306,13070
2020-10-07,Chile,1134,20,474440,13090
2020-10-08,Chile,1576,77,476016,13167
2020-10-09,Chile,1753,53,477769,13220
2020-10-10,Chile,1826,52,479595,13272
2020-10-11,Chile,1776,46,481371,13318
2020-10-12,Chile,1461,58,482832,13376
2020-10-13,Chile,1448,20,484280,13396
2020-10-14,Chile,1092,19,485372,13415
2020-10-15,Chile,1124,19,486496,13434
2020-10-16,Chile,1694,95,488190,13529
2020-10-17,Chile,1813,59,490003,13588
2020-10-18,Chile,1757,47,491760,13635
2020-10-19,Chile,1545,41,493305,13676
2020-10-20,Chile,1173,26,494478,13702
2020-10-21,Chile,1159,17,495637,13719
2020-10-22,Chile,1494,73,497131,13792
2020-10-23,Chile,1775,52,498906,13844
2020-10-24,Chile,1636,48,500542,13892
2020-10-25,Chile,1521,52,502063,13944
2020-10-26,Chile,1535,59,503598,14003
2020-10-27,Chile,927,23,504525,14026
2020-10-28,Chile,1005,6,505530,14032
2020-10-29,Chile,1520,86,507050,14118
2020-10-30,Chile,1521,40,508571,14158
2020-10-31,Chile,1685,49,510256,14207
2020-11-01,Chile,1608,40,511864,14247
2020-11-02,Chile,1276,55,513140,14302
2020-11-03,Chile,1062,17,514202,14319
2020-11-04,Chile,840,21,515042,14340
2020-11-05,Chile,1540,64,516582,14404
2020-11-06,Chile,1808,46,518390,14450
2020-11-07,Chile,1587,49,519977,14499
2020-11-08,Chile,1581,44,521558,14543
2020-11-09,Chile,1321,45,522879,14588
2020-11-10,Chile,1028,23,523907,14611
2020-11-11,Chile,897,22,524804,14633
2020-11-12,Chile,1634,66,526438,14699
2020-11-13,Chile,1592,39,528030,14738
2020-11-14,Chile,1646,39,529676,14777
2020-11-15,Chile,1597,42,531273,14819
2020-11-16,Chile,1331,44,532604,14863
2020-11-17,Chile,1006,20,533610,14883
2020-11-18,Chile,948,14,534558,14897
2020-11-19,Chile,1454,58,536012,14955
2020-11-20,Chile,1573,48,537585,15003
2020-11-21,Chile,1558,27,539143,15030
2020-11-22,Chile,1497,39,540640,15069
2020-11-23,Chile,1440,37,542080,15106
2020-11-24,Chile,1007,25,543087,15131
2020-11-25,Chile,1005,7,544092,15138
2020-11-26,Chile,1570,97,545662,15235
2020-11-27,Chile,1581,43,547243,15278
2020-11-28,Chile,1698,44,548941,15322
2020-11-29,Chile,1489,34,550430,15356
2020-11-30,Chile,1313,54,551743,15410
2020-12-01,Chile,1121,20,552864,15430
2020-12-02,Chile,1034,8,553898,15438
2020-12-03,Chile,1508,81,555406,15519
2020-12-04,Chile,1729,39,557135,15558
2020-12-05,Chile,1533,34,558668,15592
2020-12-06,Chile,1714,36,560382,15628
2020-12-07,Chile,1760,35,562142,15663
2020-12-08,Chile,1392,17,563534,15680
2020-12-09,Chile,1244,10,564778,15690
2020-12-10,Chile,1662,84,566440,15774
2020-12-11,Chile,1534,8,567974,15782
2020-12-12,Chile,1807,64,569781,15846
2020-12-13,Chile,2138,40,571919,15886
2020-12-14,Chile,1911,45,573830,15931
2020-12-15,Chile,1499,18,575329,15949
2020-12-16,Chile,1402,10,576731,15959
2020-12-17,Chile,2001,48,578732,16007
2020-12-18,Chile,2403,44,581135,16051
2020-12-19,Chile,2220,50,583355,16101
2020-12-20,Chile,2191,53,585546,16154
2020-12-21,Chile,2447,43,587993,16197
2020-12-22,Chile,1196,20,589189,16217
2020-12-23,Chile,1725,11,590914,16228
2020-12-24,Chile,3238,75,594152,16303
2020-12-25,Chile,1679,55,595831,16358
2020-12-26,Chile,2563,46,598394,16404
2020-12-27,Chile,1711,39,600105,16443
2020-12-28,Chile,1923,0,602028,16443
2020-12-29,Chile,1958,45,603986,16488
2020-12-30,Chile,2964,11,606950,16499
2020-12-31,Chile,2023,109,608973,16608
2021-01-01,Chile,3591,52,612564,16660
2021-01-02,Chile,3338,64,615902,16724
2021-01-03,Chile,2289,43,618191,16767
2021-01-04,Chile,2450,0,620641,16767
2021-01-05,Chile,2460,21,623101,16788
2021-01-06,Chile,2382,28,625483,16816
2021-01-07,Chile,3693,97,629176,16913
2021-01-08,Chile,4205,61,633381,16974
2021-01-09,Chile,4361,63,637742,17037
2021-01-10,Chile,4181,59,641923,17096
2021-01-11,Chile,3969,66,645892,17162
2021-01-12,Chile,3243,20,649135,17182
2021-01-13,Chile,3390,22,652525,17204
2021-01-14,Chile,4187,90,656712,17294
2021-01-15,Chile,4468,75,661180,17369
2021-01-16,Chile,4313,66,665493,17435
2021-01-17,Chile,4339,42,669832,17477
2021-01-18,Chile,3918,70,673750,17547
2021-01-19,Chile,3401,26,677151,17573
2021-01-20,Chile,3589,21,680740,17594
2021-01-21,Chile,4367,108,685107,17702
2021-01-22,Chile,4959,84,690066,17786
2021-01-23,Chile,4581,68,694647,17854
2021-01-24,Chile,4463,79,699110,17933
2021-01-25,Chile,4068,66,703178,17999
2021-01-26,Chile,3322,24,706500,18023
2021-01-27,Chile,3388,17,709888,18040
2021-01-28,Chile,4255,134,714143,18174
2021-01-29,Chile,4606,83,718749,18257
2021-01-30,Chile,4151,82,722900,18339
2021-01-31,Chile,4209,113,727109,18452
2021-02-01,Chile,3779,85,730888,18537
2021-02-02,Chile,3147,22,734035,18559
2021-02-03,Chile,2610,17,736645,18576
2021-02-04,Chile,3592,155,740237,18731
2021-02-05,Chile,3782,77,744019,18808
2021-02-06,Chile,4063,87,748082,18895
2021-02-07,Chile,3804,79,751886,18974
2021-02-08,Chile,3464,82,755350,19056
2021-02-09,Chile,2839,28,758189,19084
2021-02-10,Chile,2387,21,760576,19105
2021-02-11,Chile,3731,157,764307,19262
2021-02-12,Chile,4164,83,768471,19345
2021-02-13,Chile,3925,98,772396,19443
2021-02-14,Chile,3813,98,776209,19541
2021-02-15,Chile,3332,83,779541,19624
2021-02-16,Chile,2498,20,782039,19644
2021-02-17,Chile,2275,15,784314,19659
2021-02-18,Chile,3828,139,788142,19798
2021-02-19,Chile,3797,99,791939,19897
2021-02-20,Chile,3906,77,795845,19974
2021-02-21,Chile,3615,68,799460,20042
2021-02-22,Chile,3549,84,803009,20126
2021-02-23,Chile,2308,25,805317,20151
2021-02-24,Chile,2555,22,807872,20173
2021-02-25,Chile,4472,137,812344,20310
2021-02-26,Chile,4585,90,816929,20400
2021-02-27,Chile,4489,76,821418,20476
2021-02-28,Chile,3207,96,824625,20572
2021-03-01,Chile,5145,88,829770,20660
2021-03-02,Chile,2742,24,832512,20684
2021-03-03,Chile,3040,20,835552,20704
2021-03-04,Chile,4567,134,840119,20838
2021-03-05,Chile,5331,90,845450,20928
2021-03-06,Chile,5033,80,850483,21008
2021-03-07,Chile,5302,69,855785,21077
2021-03-08,Chile,4748,86,860533,21163
2021-03-09,Chile,3531,19,864064,21182
2021-03-10,Chile,3885,24,867949,21206
2021-03-11,Chile,5563,156,873512,21362
2021-03-12,Chile,5973,89,879485,21451
2021-03-13,Chile,5894,123,885379,21574
2021-03-14,Chile,5731,100,891110,21674
2021-03-15,Chile,5121,98,896231,21772
2021-03-16,Chile,4551,17,900782,21789
2021-03-17,Chile,3430,27,904212,21816
2021-03-18,Chile,7257,172,911469,21988
2021-03-19,Chile,6584,99,918053,22087
2021-03-20,Chile,7036,93,925089,22180
2021-03-21,Chile,6850,99,931939,22279
2021-03-22,Chile,6155,80,938094,22359
2021-03-23,Chile,4864,25,942958,22384
2021-03-24,Chile,4825,18,947783,22402
2021-03-25,Chile,7060,122,954843,22524
2021-03-26,Chile,7478,63,962321,22587
2021-03-27,Chile,7592,66,969913,22653
2021-03-28,Chile,7330,101,977243,22754
2021-03-29,Chile,7241,316,984484,23070
2021-03-30,Chile,5008,37,989492,23107
2021-03-31,Chile,6046,28,995538,23135
2021-04-01,Chile,7868,193,1003406,23328
2021-04-02,Chile,8079,93,1011485,23421
2021-04-03,Chile,7993,103,1019478,23524
2021-04-04,Chile,7307,120,1026785,23644
2021-04-05,Chile,5827,33,1032612,23677
2021-04-06,Chile,5168,57,1037780,23734
2021-04-07,Chile,5242,62,1043022,23796
2021-04-08,Chile,8248,183,1051270,23979
2020-01-22,China,0,0,548,17
2020-01-23,China,95,1,643,18
2020-01-24,China,277,8,920,26
2020-01-25,China,486,16,1406,42
2020-01-26,China,669,14,2075,56
2020-01-27,China,802,26,2877,82
2020-01-28,China,2632,49,5509,131
2020-01-29,China,578,2,6087,133
2020-01-30,China,2054,38,8141,171
2020-01-31,China,1661,42,9802,213
2020-02-01,China,2089,46,11891,259
2020-02-02,China,4739,102,16630,361
2020-02-03,China,3086,64,19716,425
2020-02-04,China,3991,66,23707,491
2020-02-05,China,3733,72,27440,563
2020-02-06,China,3147,70,30587,633
2020-02-07,China,3523,85,34110,718
2020-02-08,China,2704,87,36814,805
2020-02-09,China,3015,100,39829,905
2020-02-10,China,2525,107,42354,1012
2020-02-11,China,2032,100,44386,1112
2020-02-12,China,373,5,44759,1117
2020-02-13,China,15136,252,59895,1369
2020-02-14,China,6463,152,66358,1521
2020-02-15,China,2055,142,68413,1663
2020-02-16,China,2100,103,70513,1766
2020-02-17,China,1921,98,72434,1864
2020-02-18,China,1777,139,74211,2003
2020-02-19,China,408,113,74619,2116
2020-02-20,China,458,122,75077,2238
2020-02-21,China,473,0,75550,2238
2020-02-22,China,1451,205,77001,2443
2020-02-23,China,21,2,77022,2445
2020-02-24,China,219,150,77241,2595
2020-02-25,China,513,70,77754,2665
2020-02-26,China,412,52,78166,2717
2020-02-27,China,434,29,78600,2746
2020-02-28,China,328,44,78928,2790
2020-02-29,China,428,47,79356,2837
2020-03-01,China,576,35,79932,2872
2020-03-02,China,204,42,80136,2914
2020-03-03,China,125,33,80261,2947
2020-03-04,China,125,36,80386,2983
2020-03-05,China,151,32,80537,3015
2020-03-06,China,153,29,80690,3044
2020-03-07,China,80,28,80770,3072
2020-03-08,China,53,28,80823,3100
2020-03-09,China,37,23,80860,3123
2020-03-10,China,27,16,80887,3139
2020-03-11,China,34,22,80921,3161
2020-03-12,China,11,11,80932,3172
2020-03-13,China,13,8,80945,3180
2020-03-14,China,32,13,80977,3193
2020-03-15,China,26,10,81003,3203
2020-03-16,China,30,14,81033,3217
2020-03-17,China,25,13,81058,3230
2020-03-18,China,44,11,81102,3241
2020-03-19,China,54,8,81156,3249
2020-03-20,China,94,4,81250,3253
2020-03-21,China,55,6,81305,3259
2020-03-22,China,130,15,81435,3274
2020-03-23,China,63,0,81498,3274
2020-03-24,China,93,7,81591,3281
2020-03-25,China,70,4,81661,3285
2020-03-26,China,121,6,81782,3291
2020-03-27,China,115,5,81897,3296
2020-03-28,China,102,3,81999,3299
2020-03-29,China,123,5,82122,3304
2020-03-30,China,76,4,82198,3308
2020-03-31,China,81,1,82279,3309
2020-04-01,China,82,7,82361,3316
2020-04-02,China,71,6,82432,3322
2020-04-03,China,79,4,82511,3326
2020-04-04,China,32,4,82543,3330
2020-04-05,China,59,3,82602,3333
2020-04-06,China,63,2,82665,3335
2020-04-07,China,53,0,82718,3335
2020-04-08,China,91,2,82809,3337
2020-04-09,China,74,2,82883,3339
2020-04-10,China,58,1,82941,3340
2020-04-11,China,73,3,83014,3343
2020-04-12,China,120,0,83134,3343
2020-04-13,China,79,2,83213,3345
2020-04-14,China,93,0,83306,3345
2020-04-15,China,50,1,83356,3346
2020-04-16,China,47,0,83403,3346
2020-04-17,China,357,1290,83760,4636
2020-04-18,China,27,0,83787,4636
2020-04-19,China,18,0,83805,4636
2020-04-20,China,12,0,83817,4636
2020-04-21,China,36,0,83853,4636
2020-04-22,China,15,0,83868,4636
2020-04-23,China,16,0,83884,4636
2020-04-24,China,15,0,83899,4636
2020-04-25,China,10,0,83909,4636
2020-04-26,China,3,1,83912,4637
2020-04-27,China,6,0,83918,4637
2020-04-28,China,22,0,83940,4637
2020-04-29,China,4,0,83944,4637
2020-04-30,China,12,0,83956,4637
2020-05-01,China,3,0,83959,4637
2020-05-02,China,0,0,83959,4637
2020-05-03,China,5,0,83964,4637
2020-05-04,China,2,0,83966,4637
2020-05-05,China,2,0,83968,4637
2020-05-06,China,2,0,83970,4637
2020-05-07,China,5,0,83975,4637
2020-05-08,China,1,0,83976,4637
2020-05-09,China,14,0,83990,4637
2020-05-10,China,20,0,84010,4637
2020-05-11,China,1,0,84011,4637
2020-05-12,China,7,0,84018,4637
2020-05-13,China,6,0,84024,4637
2020-05-14,China,5,0,84029,4637
2020-05-15,China,9,0,84038,4637
2020-05-16,China,6,1,84044,4638
2020-05-17,China,10,0,84054,4638
2020-05-18,China,9,0,84063,4638
2020-05-19,China,0,0,84063,4638
2020-05-20,China,0,0,84063,4638
2020-05-21,China,0,0,84063,4638
2020-05-22,China,18,0,84081,4638
2020-05-23,China,3,0,84084,4638
2020-05-24,China,11,0,84095,4638
2020-05-25,China,7,0,84102,4638
2020-05-26,China,1,0,84103,4638
2020-05-27,China,3,0,84106,4638
2020-05-28,China,0,0,84106,4638
2020-05-29,China,17,0,84123,4638
2020-05-30,China,5,0,84128,4638
2020-05-31,China,18,0,84146,4638
2020-06-01,China,8,0,84154,4638
2020-06-02,China,7,0,84161,4638
2020-06-03,China,-1,0,84160,4638
2020-06-04,China,11,0,84171,4638
2020-06-05,China,6,0,84177,4638
2020-06-06,China,9,0,84186,4638
2020-06-07,China,5,0,84191,4638
2020-06-08,China,4,0,84195,4638
2020-06-09,China,3,0,84198,4638
2020-06-10,China,11,0,84209,4638
2020-06-11,China,7,0,84216,4638
2020-06-12,China,12,0,84228,4638
2020-06-13,China,58,0,84286,4638
2020-06-14,China,49,0,84335,4638
2020-06-15,China,43,0,84378,4638
2020-06-16,China,44,0,84422,4638
2020-06-17,China,36,0,84458,4638
2020-06-18,China,36,0,84494,4638
2020-06-19,China,0,0,84494,4638
2020-06-20,China,59,1,84553,4639
2020-06-21,China,19,0,84572,4639
2020-06-22,China,52,0,84624,4639
2020-06-23,China,29,1,84653,4640
2020-06-24,China,20,0,84673,4640
2020-06-25,China,28,1,84701,4641
2020-06-26,China,24,0,84725,4641
2020-06-27,China,18,0,84743,4641
2020-06-28,China,14,0,84757,4641
2020-06-29,China,23,0,84780,4641
2020-06-30,China,5,0,84785,4641
2020-07-01,China,31,0,84816,4641
2020-07-02,China,14,0,84830,4641
2020-07-03,China,8,0,84838,4641
2020-07-04,China,19,0,84857,4641
2020-07-05,China,14,0,84871,4641
2020-07-06,China,18,0,84889,4641
2020-07-07,China,28,0,84917,4641
2020-07-08,China,33,0,84950,4641
2020-07-09,China,42,0,84992,4641
2020-07-10,China,0,0,84992,4641
2020-07-11,China,79,0,85071,4641
2020-07-12,China,46,0,85117,4641
2020-07-13,China,0,0,85117,4641
2020-07-14,China,109,1,85226,4642
2020-07-15,China,20,2,85246,4644
2020-07-16,China,81,0,85327,4644
2020-07-17,China,75,1,85402,4645
2020-07-18,China,16,1,85418,4646
2020-07-19,China,85,0,85503,4646
2020-07-20,China,119,0,85622,4646
2020-07-21,China,86,2,85708,4648
2020-07-22,China,198,0,85906,4648
2020-07-23,China,139,1,86045,4649
2020-07-24,China,157,1,86202,4650
2020-07-25,China,179,2,86381,4652
2020-07-26,China,189,0,86570,4652
2020-07-27,China,213,4,86783,4656
2020-07-28,China,207,1,86990,4657
2020-07-29,China,223,1,87213,4658
2020-07-30,China,276,1,87489,4659
2020-07-31,China,166,2,87655,4661
2020-08-01,China,172,6,87827,4667
2020-08-02,China,158,2,87985,4669
2020-08-03,China,114,3,88099,4672
2020-08-04,China,107,4,88206,4676
2020-08-05,China,122,1,88328,4677
2020-08-06,China,132,3,88460,4680
2020-08-07,China,120,1,88580,4681
2020-08-08,China,92,0,88672,4681
2020-08-09,China,121,5,88793,4686
2020-08-10,China,113,3,88906,4689
2020-08-11,China,52,4,88958,4693
2020-08-12,China,87,4,89045,4697
2020-08-13,China,99,3,89144,4700
2020-08-14,China,70,1,89214,4701
2020-08-15,China,65,2,89279,4703
2020-08-16,China,96,0,89375,4703
2020-08-17,China,66,0,89441,4703
2020-08-18,China,53,2,89494,4705
2020-08-19,China,33,1,89527,4706
2020-08-20,China,40,3,89567,4709
2020-08-21,China,49,0,89616,4709
2020-08-22,China,38,2,89654,4711
2020-08-23,China,41,0,89695,4711
2020-08-24,China,23,0,89718,4711
2020-08-25,China,34,1,89752,4712
2020-08-26,China,32,1,89784,4713
2020-08-27,China,30,2,89814,4715
2020-08-28,China,22,3,89836,4718
2020-08-29,China,27,3,89863,4721
2020-08-30,China,32,1,89895,4722
2020-08-31,China,19,1,89914,4723
2020-09-01,China,19,1,89933,4724
2020-09-02,China,20,3,89953,4727
2020-09-03,China,33,1,89986,4728
2020-09-04,China,22,0,90008,4728
2020-09-05,China,17,0,90025,4728
2020-09-06,China,33,2,90058,4730
2020-09-07,China,20,2,90078,4732
2020-09-08,China,9,1,90087,4733
2020-09-09,China,13,0,90100,4733
2020-09-10,China,27,0,90127,4733
2020-09-11,China,18,0,90145,4733
2020-09-12,China,23,1,90168,4734
2020-09-13,China,29,0,90197,4734
2020-09-14,China,22,1,90219,4735
2020-09-15,China,16,1,90235,4736
2020-09-16,China,18,0,90253,4736
2020-09-17,China,41,0,90294,4736
2020-09-18,China,17,1,90311,4737
2020-09-19,China,23,0,90334,4737
2020-09-20,China,35,0,90369,4737
2020-09-21,China,12,0,90381,4737
2020-09-22,China,18,0,90399,4737
2020-09-23,China,10,1,90409,4738
2020-09-24,China,15,0,90424,4738
2020-09-25,China,17,1,90441,4739
2020-09-26,China,15,0,90456,4739
2020-09-27,China,27,0,90483,4739
2020-09-28,China,22,0,90505,4739
2020-09-29,China,23,0,90528,4739
2020-09-30,China,17,0,90545,4739
2020-10-01,China,22,0,90567,4739
2020-10-02,China,17,0,90584,4739
2020-10-03,China,20,0,90604,4739
2020-10-04,China,25,0,90629,4739
2020-10-05,China,23,0,90652,4739
2020-10-06,China,15,0,90667,4739
2020-10-07,China,20,0,90687,4739
2020-10-08,China,41,0,90728,4739
2020-10-09,China,23,0,90751,4739
2020-10-10,China,27,0,90778,4739
2020-10-11,China,34,0,90812,4739
2020-10-12,China,18,0,90830,4739
2020-10-13,China,28,0,90858,4739
2020-10-14,China,11,0,90869,4739
2020-10-15,China,36,0,90905,4739
2020-10-16,China,20,0,90925,4739
2020-10-17,China,30,0,90955,4739
2020-10-18,China,17,0,90972,4739
2020-10-19,China,34,0,91006,4739
2020-10-20,China,16,0,91022,4739
2020-10-21,China,22,0,91044,4739
2020-10-22,China,29,0,91073,4739
2020-10-23,China,35,0,91108,4739
2020-10-24,China,20,0,91128,4739
2020-10-25,China,23,0,91151,4739
2020-10-26,China,24,0,91175,4739
2020-10-27,China,47,0,91222,4739
2020-10-28,China,49,0,91271,4739
2020-10-29,China,28,0,91299,4739
2020-10-30,China,40,0,91339,4739
2020-10-31,China,27,0,91366,4739
2020-11-01,China,31,0,91397,4739
2020-11-02,China,55,0,91452,4739
2020-11-03,China,26,0,91478,4739
2020-11-04,China,31,1,91509,4740
2020-11-05,China,43,1,91552,4741
2020-11-06,China,39,0,91591,4741
2020-11-07,China,31,0,91622,4741
2020-11-08,China,43,0,91665,4741
2020-11-09,China,28,0,91693,4741
2020-11-10,China,26,1,91719,4742
2020-11-11,China,33,0,91752,4742
2020-11-12,China,31,0,91783,4742
2020-11-13,China,24,0,91807,4742
2020-11-14,China,21,0,91828,4742
2020-11-15,China,22,0,91850,4742
2020-11-16,China,22,0,91872,4742
2020-11-17,China,13,0,91885,4742
2020-11-18,China,21,0,91906,4742
2020-11-19,China,29,0,91935,4742
2020-11-20,China,42,0,91977,4742
2020-11-21,China,60,0,92037,4742
2020-11-22,China,79,0,92116,4742
2020-11-23,China,95,0,92211,4742
2020-11-24,China,85,0,92296,4742
2020-11-25,China,106,0,92402,4742
2020-11-26,China,86,0,92488,4742
2020-11-27,China,98,0,92586,4742
2020-11-28,China,95,1,92681,4743
2020-11-29,China,133,0,92814,4743
2020-11-30,China,88,0,92902,4743
2020-12-01,China,91,0,92993,4743
2020-12-02,China,120,1,93113,4744
2020-12-03,China,108,1,93221,4745
2020-12-04,China,127,1,93348,4746
2020-12-05,China,119,0,93467,4746
2020-12-06,China,110,0,93577,4746
2020-12-07,China,93,0,93670,4746
2020-12-08,China,112,0,93782,4746
2020-12-09,China,116,2,93898,4748
2020-12-10,China,127,0,94025,4748
2020-12-11,China,99,0,94124,4748
2020-12-12,China,93,1,94217,4749
2020-12-13,China,111,2,94328,4751
2020-12-14,China,99,3,94427,4754
2020-12-15,China,110,3,94537,4757
2020-12-16,China,89,0,94626,4757
2020-12-17,China,108,2,94734,4759
2020-12-18,China,87,4,94821,4763
2020-12-19,China,132,0,94953,4763
2020-12-20,China,97,1,95050,4764
2020-12-21,China,100,1,95150,4765
2020-12-22,China,78,1,95228,4766
2020-12-23,China,70,1,95298,4767
2020-12-24,China,85,2,95383,4769
2020-12-25,China,77,1,95460,4770
2020-12-26,China,81,0,95541,4770
2020-12-27,China,91,1,95632,4771
2020-12-28,China,88,4,95720,4775
2020-12-29,China,77,2,95797,4777
2020-12-30,China,79,4,95876,4781
2020-12-31,China,87,1,95963,4782
2021-01-01,China,60,0,96023,4782
2021-01-02,China,63,2,96086,4784
2021-01-03,China,74,0,96160,4784
2021-01-04,China,86,3,96246,4787
2021-01-05,China,64,0,96310,4787
2021-01-06,China,88,1,96398,4788
2021-01-07,China,86,0,96484,4788
2021-01-08,China,78,1,96562,4789
2021-01-09,China,128,2,96690,4791
2021-01-10,China,134,1,96824,4792
2021-01-11,China,96,1,96920,4793
2021-01-12,China,175,1,97095,4794
2021-01-13,China,180,2,97275,4796
2021-01-14,China,173,0,97448,4796
2021-01-15,China,168,0,97616,4796
2021-01-16,China,159,1,97775,4797
2021-01-17,China,164,0,97939,4797
2021-01-18,China,225,1,98164,4798
2021-01-19,China,159,2,98323,4800
2021-01-20,China,221,1,98544,4801
2021-01-21,China,242,2,98786,4803
2021-01-22,China,100,0,98886,4803
2021-01-23,China,161,0,99047,4803
2021-01-24,China,200,1,99247,4804
2021-01-25,China,155,3,99402,4807
2021-01-26,China,139,2,99541,4809
2021-01-27,China,114,2,99655,4811
2021-01-28,China,91,2,99746,4813
2021-01-29,China,102,1,99848,4814
2021-01-30,China,120,1,99968,4815
2021-01-31,China,95,2,100063,4817
2021-02-01,China,64,1,100127,4818
2021-02-02,China,50,2,100177,4820
2021-02-03,China,49,1,100226,4821
2021-02-04,China,42,1,100268,4822
2021-02-05,China,50,0,100318,4822
2021-02-06,China,30,0,100348,4822
2021-02-07,China,41,0,100389,4822
2021-02-08,China,46,0,100435,4822
2021-02-09,China,40,2,100475,4824
2021-02-10,China,19,1,100494,4825
2021-02-11,China,33,2,100527,4827
2021-02-12,China,32,1,100559,4828
2021-02-13,China,19,1,100578,4829
2021-02-14,China,21,0,100599,4829
2021-02-15,China,25,0,100624,4829
2021-02-16,China,15,2,100639,4831
2021-02-17,China,27,2,100666,4833
2021-02-18,China,18,0,100684,4833
2021-02-19,China,21,0,100705,4833
2021-02-20,China,22,0,100727,4833
2021-02-21,China,31,0,100758,4833
2021-02-22,China,26,0,100784,4833
2021-02-23,China,23,0,100807,4833
2021-02-24,China,25,1,100832,4834
2021-02-25,China,19,0,100851,4834
2021-02-26,China,34,0,100885,4834
2021-02-27,China,39,0,100924,4834
2021-02-28,China,41,1,100965,4835
2021-03-01,China,25,1,100990,4836
2021-03-02,China,23,0,101013,4836
2021-03-03,China,24,0,101037,4836
2021-03-04,China,18,1,101055,4837
2021-03-05,China,19,0,101074,4837
2021-03-06,China,23,1,101097,4838
2021-03-07,China,35,0,101132,4838
2021-03-08,China,17,0,101149,4838
2021-03-09,China,26,0,101175,4838
2021-03-10,China,19,1,101194,4839
2021-03-11,China,31,0,101225,4839
2021-03-12,China,67,0,101292,4839
2021-03-13,China,57,0,101349,4839
2021-03-14,China,29,0,101378,4839
2021-03-15,China,43,0,101421,4839
2021-03-16,China,22,0,101443,4839
2021-03-17,China,17,0,101460,4839
2021-03-18,China,21,0,101481,4839
2021-03-19,China,17,0,101498,4839
2021-03-20,China,20,0,101518,4839
2021-03-21,China,15,0,101533,4839
2021-03-22,China,27,0,101560,4839
2021-03-23,China,22,1,101582,4840
2021-03-24,China,21,0,101603,4840
2021-03-25,China,20,0,101623,4840
2021-03-26,China,23,1,101646,4841
2021-03-27,China,17,0,101663,4841
2021-03-28,China,12,0,101675,4841
2021-03-29,China,17,0,101692,4841
2021-03-30,China,18,0,101710,4841
2021-03-31,China,22,0,101732,4841
2021-04-01,China,21,0,101753,4841
2021-04-02,China,46,0,101799,4841
2021-04-03,China,22,0,101821,4841
2021-04-04,China,40,0,101861,4841
2021-04-05,China,40,0,101901,4841
2021-04-06,China,19,0,101920,4841
2021-04-07,China,33,0,101953,4841
2021-04-08,China,31,0,101984,4841
2020-03-06,Colombia,1,0,1,0
2020-03-07,Colombia,0,0,1,0
2020-03-08,Colombia,0,0,1,0
2020-03-09,Colombia,0,0,1,0
2020-03-10,Colombia,2,0,3,0
2020-03-11,Colombia,6,0,9,0
2020-03-12,Colombia,0,0,9,0
2020-03-13,Colombia,4,0,13,0
2020-03-14,Colombia,9,0,22,0
2020-03-15,Colombia,12,0,34,0
2020-03-16,Colombia,23,0,57,0
2020-03-17,Colombia,18,0,75,0
2020-03-18,Colombia,27,0,102,0
2020-03-19,Colombia,6,0,108,0
2020-03-20,Colombia,50,0,158,0
2020-03-21,Colombia,38,0,196,0
2020-03-22,Colombia,35,2,231,2
2020-03-23,Colombia,46,1,277,3
2020-03-24,Colombia,101,0,378,3
2020-03-25,Colombia,92,1,470,4
2020-03-26,Colombia,21,2,491,6
2020-03-27,Colombia,48,0,539,6
2020-03-28,Colombia,69,0,608,6
2020-03-29,Colombia,94,4,702,10
2020-03-30,Colombia,96,2,798,12
2020-03-31,Colombia,108,4,906,16
2020-04-01,Colombia,159,1,1065,17
2020-04-02,Colombia,96,2,1161,19
2020-04-03,Colombia,106,6,1267,25
2020-04-04,Colombia,139,7,1406,32
2020-04-05,Colombia,79,3,1485,35
2020-04-06,Colombia,94,11,1579,46
2020-04-07,Colombia,201,4,1780,50
2020-04-08,Colombia,274,4,2054,54
2020-04-09,Colombia,169,15,2223,69
2020-04-10,Colombia,250,11,2473,80
2020-04-11,Colombia,236,20,2709,100
2020-04-12,Colombia,67,9,2776,109
2020-04-13,Colombia,76,3,2852,112
2020-04-14,Colombia,127,15,2979,127
2020-04-15,Colombia,126,4,3105,131
2020-04-16,Colombia,128,13,3233,144
2020-04-17,Colombia,206,9,3439,153
2020-04-18,Colombia,182,13,3621,166
2020-04-19,Colombia,171,13,3792,179
2020-04-20,Colombia,185,10,3977,189
2020-04-21,Colombia,172,7,4149,196
2020-04-22,Colombia,207,10,4356,206
2020-04-23,Colombia,205,9,4561,215
2020-04-24,Colombia,320,10,4881,225
2020-04-25,Colombia,261,8,5142,233
2020-04-26,Colombia,237,11,5379,244
2020-04-27,Colombia,218,9,5597,253
2020-04-28,Colombia,352,16,5949,269
2020-04-29,Colombia,258,9,6207,278
2020-04-30,Colombia,300,15,6507,293
2020-05-01,Colombia,499,21,7006,314
2020-05-02,Colombia,279,10,7285,324
2020-05-03,Colombia,383,16,7668,340
2020-05-04,Colombia,305,18,7973,358
2020-05-05,Colombia,640,20,8613,378
2020-05-06,Colombia,346,19,8959,397
2020-05-07,Colombia,497,10,9456,407
2020-05-08,Colombia,595,21,10051,428
2020-05-09,Colombia,444,17,10495,445
2020-05-10,Colombia,568,18,11063,463
2020-05-11,Colombia,550,16,11613,479
2020-05-12,Colombia,659,14,12272,493
2020-05-13,Colombia,658,16,12930,509
2020-05-14,Colombia,680,16,13610,525
2020-05-15,Colombia,606,21,14216,546
2020-05-16,Colombia,723,16,14939,562
2020-05-17,Colombia,635,12,15574,574
2020-05-18,Colombia,721,18,16295,592
2020-05-19,Colombia,640,21,16935,613
2020-05-20,Colombia,752,17,17687,630
2020-05-21,Colombia,643,22,18330,652
2020-05-22,Colombia,801,30,19131,682
2020-05-23,Colombia,1046,23,20177,705
2020-05-24,Colombia,998,22,21175,727
2020-05-25,Colombia,806,23,21981,750
2020-05-26,Colombia,1022,26,23003,776
2020-05-27,Colombia,1101,27,24104,803
2020-05-28,Colombia,1262,19,25366,822
2020-05-29,Colombia,1322,31,26688,853
2020-05-30,Colombia,1548,37,28236,890
2020-05-31,Colombia,1147,49,29383,939
2020-06-01,Colombia,1110,30,30493,969
2020-06-02,Colombia,1340,40,31833,1009
2020-06-03,Colombia,1521,36,33354,1045
2020-06-04,Colombia,1766,42,35120,1087
2020-06-05,Colombia,1515,58,36635,1145
2020-06-06,Colombia,1392,60,38027,1205
2020-06-07,Colombia,1209,54,39236,1259
2020-06-08,Colombia,1483,49,40719,1308
2020-06-09,Colombia,1359,64,42078,1372
2020-06-10,Colombia,1604,61,43682,1433
2020-06-11,Colombia,1530,55,45212,1488
2020-06-12,Colombia,1646,57,46858,1545
2020-06-13,Colombia,1888,47,48746,1592
2020-06-14,Colombia,2193,75,50939,1667
2020-06-15,Colombia,2124,59,53063,1726
2020-06-16,Colombia,1868,75,54931,1801
2020-06-17,Colombia,2115,63,57046,1864
2020-06-18,Colombia,3171,86,60217,1950
2020-06-19,Colombia,3059,95,63276,2045
2020-06-20,Colombia,2357,81,65633,2126
2020-06-21,Colombia,3019,111,68652,2237
2020-06-22,Colombia,2531,73,71183,2310
2020-06-23,Colombia,2389,94,73572,2404
2020-06-24,Colombia,3541,87,77113,2491
2020-06-25,Colombia,3486,163,80599,2654
2020-06-26,Colombia,3843,157,84442,2811
2020-06-27,Colombia,4149,128,88591,2939
2020-06-28,Colombia,3178,239,91769,3178
2020-06-29,Colombia,3274,96,95043,3274
2020-06-30,Colombia,2803,60,97846,3334
2020-07-01,Colombia,4163,136,102009,3470
2020-07-02,Colombia,4101,171,106110,3641
2020-07-03,Colombia,3395,136,109505,3777
2020-07-04,Colombia,3884,165,113389,3942
2020-07-05,Colombia,3721,122,117110,4064
2020-07-06,Colombia,3171,146,120281,4210
2020-07-07,Colombia,4213,149,124494,4359
2020-07-08,Colombia,4144,168,128638,4527
2020-07-09,Colombia,5335,187,133973,4714
2020-07-10,Colombia,6803,211,140776,4925
2020-07-11,Colombia,4856,194,145632,5119
2020-07-12,Colombia,4813,188,150445,5307
2020-07-13,Colombia,3832,148,154277,5455
2020-07-14,Colombia,5621,170,159898,5625
2020-07-15,Colombia,5271,189,165169,5814
2020-07-16,Colombia,8037,215,173206,6029
2020-07-17,Colombia,8934,259,182140,6288
2020-07-18,Colombia,8560,228,190700,6516
2020-07-19,Colombia,6578,220,197278,6736
2020-07-20,Colombia,6727,193,204005,6929
2020-07-21,Colombia,7033,237,211038,7166
2020-07-22,Colombia,7390,207,218428,7373
2020-07-23,Colombia,7945,315,226373,7688
2020-07-24,Colombia,7168,287,233541,7975
2020-07-25,Colombia,7254,294,240795,8269
2020-07-26,Colombia,8181,256,248976,8525
2020-07-27,Colombia,8125,252,257101,8777
2020-07-28,Colombia,10284,297,267385,9074
2020-07-29,Colombia,8670,380,276055,9454
2020-07-30,Colombia,9965,356,286020,9810
2020-07-31,Colombia,9488,295,295508,10105
2020-08-01,Colombia,10673,225,306181,10330
2020-08-02,Colombia,11470,320,317651,10650
2020-08-03,Colombia,10199,367,327850,11017
2020-08-04,Colombia,7129,298,334979,11315
2020-08-05,Colombia,10735,309,345714,11624
2020-08-06,Colombia,11996,315,357710,11939
2020-08-07,Colombia,9494,311,367204,12250
2020-08-08,Colombia,9666,290,376870,12540
2020-08-09,Colombia,10611,302,387481,12842
2020-08-10,Colombia,10142,312,397623,13154
2020-08-11,Colombia,12830,321,410453,13475
2020-08-12,Colombia,12066,362,422519,13837
2020-08-13,Colombia,11286,308,433805,14145
2020-08-14,Colombia,11306,347,445111,14492
2020-08-15,Colombia,11578,318,456689,14810
2020-08-16,Colombia,11643,287,468332,15097
2020-08-17,Colombia,8328,275,476660,15372
2020-08-18,Colombia,12462,247,489122,15619
2020-08-19,Colombia,13056,360,502178,15979
2020-08-20,Colombia,11541,204,513719,16183
2020-08-21,Colombia,8419,385,522138,16568
2020-08-22,Colombia,10965,400,533103,16968
2020-08-23,Colombia,8036,348,541139,17316
2020-08-24,Colombia,10549,296,551688,17612
2020-08-25,Colombia,10425,277,562113,17889
2020-08-26,Colombia,10130,295,572243,18184
2020-08-27,Colombia,9752,283,581995,18467
2020-08-28,Colombia,8497,299,590492,18766
2020-08-29,Colombia,9392,297,599884,19063
2020-08-30,Colombia,8020,300,607904,19363
2020-08-31,Colombia,7190,299,615094,19662
2020-09-01,Colombia,8932,388,624026,20050
2020-09-02,Colombia,9295,295,633321,20345
2020-09-03,Colombia,8253,273,641574,20618
2020-09-04,Colombia,8489,270,650063,20888
2020-09-05,Colombia,8393,268,658456,21156
2020-09-06,Colombia,8065,256,666521,21412
2020-09-07,Colombia,5327,203,671848,21615
2020-09-08,Colombia,7665,202,679513,21817
2020-09-09,Colombia,7338,236,686851,22053
2020-09-10,Colombia,7813,222,694664,22275
2020-09-11,Colombia,7424,243,702088,22518
2020-09-12,Colombia,6876,216,708964,22734
2020-09-13,Colombia,7355,190,716319,22924
2020-09-14,Colombia,5573,199,721892,23123
2020-09-15,Colombia,6698,165,728590,23288
2020-09-16,Colombia,7787,190,736377,23478
2020-09-17,Colombia,7568,187,743945,23665
2020-09-18,Colombia,6526,0,750471,23665
2020-09-19,Colombia,7927,374,758398,24039
2020-09-20,Colombia,6678,169,765076,24208
2020-09-21,Colombia,5359,189,770435,24397
2020-09-22,Colombia,7102,0,777537,24397
2020-09-23,Colombia,6731,349,784268,24746
2020-09-24,Colombia,6555,0,790823,24746
2020-09-25,Colombia,7494,357,798317,25103
2020-09-26,Colombia,7721,193,806038,25296
2020-09-27,Colombia,7018,192,813056,25488
2020-09-28,Colombia,5147,153,818203,25641
2020-09-29,Colombia,5839,187,824042,25828
2020-09-30,Colombia,5637,170,829679,25998
2020-10-01,Colombia,5660,198,835339,26196
2020-10-02,Colombia,6193,201,841532,26397
2020-10-03,Colombia,6615,159,848147,26556
2020-10-04,Colombia,6905,156,855052,26712
2020-10-05,Colombia,7106,132,862158,26844
2020-10-06,Colombia,7650,173,869808,27017
2020-10-07,Colombia,7876,163,877684,27180
2020-10-08,Colombia,8495,0,886179,27180
2020-10-09,Colombia,8121,315,894300,27495
2020-10-10,Colombia,8447,165,902747,27660
2020-10-11,Colombia,8569,174,911316,27834
2020-10-12,Colombia,7768,151,919084,27985
2020-10-13,Colombia,5014,156,924098,28141
2020-10-14,Colombia,6061,165,930159,28306
2020-10-15,Colombia,6823,151,936982,28457
2020-10-16,Colombia,8372,159,945354,28616
2020-10-17,Colombia,7017,187,952371,28803
2020-10-18,Colombia,7201,167,959572,28970
2020-10-19,Colombia,6311,132,965883,29102
2020-10-20,Colombia,8256,170,974139,29272
2020-10-21,Colombia,7561,192,981700,29464
2020-10-22,Colombia,8673,173,990373,29637
2020-10-23,Colombia,8569,165,998942,29802
2020-10-24,Colombia,8769,198,1007711,30000
2020-10-25,Colombia,8174,154,1015885,30154
2020-10-26,Colombia,9167,194,1025052,30348
2020-10-27,Colombia,8166,217,1033218,30565
2020-10-28,Colombia,8717,188,1041935,30753
2020-10-29,Colombia,11187,173,1053122,30926
2020-10-30,Colombia,10029,209,1063151,31135
2020-10-31,Colombia,11033,179,1074184,31314
2020-11-01,Colombia,9137,201,1083321,31515
2020-11-02,Colombia,9935,138,1093256,31653
2020-11-03,Colombia,6136,194,1099392,31847
2020-11-04,Colombia,8694,166,1108086,32013
2020-11-05,Colombia,9891,196,1117977,32209
2020-11-06,Colombia,9756,196,1127733,32405
2020-11-07,Colombia,8714,190,1136447,32595
2020-11-08,Colombia,7440,196,1143887,32791
2020-11-09,Colombia,5177,183,1149064,32974
2020-11-10,Colombia,6292,154,1155356,33128
2020-11-11,Colombia,9970,184,1165326,33312
2020-11-12,Colombia,8686,179,1174012,33491
2020-11-13,Colombia,8685,178,1182697,33669
2020-11-14,Colombia,8937,160,1191634,33829
2020-11-15,Colombia,7112,202,1198746,34031
2020-11-16,Colombia,6471,192,1205217,34223
2020-11-17,Colombia,5911,158,1211128,34381
2020-11-18,Colombia,6875,182,1218003,34563
2020-11-19,Colombia,7487,198,1225490,34761
2020-11-20,Colombia,7954,168,1233444,34929
2020-11-21,Colombia,7049,175,1240493,35104
2020-11-22,Colombia,7924,183,1248417,35287
2020-11-23,Colombia,6562,192,1254979,35479
2020-11-24,Colombia,7515,198,1262494,35677
2020-11-25,Colombia,8497,183,1270991,35860
2020-11-26,Colombia,9496,159,1280487,36019
2020-11-27,Colombia,10023,195,1290510,36214
2020-11-28,Colombia,9103,187,1299613,36401
2020-11-29,Colombia,8763,183,1308376,36584
2020-11-30,Colombia,8430,182,1316806,36766
2020-12-01,Colombia,7986,168,1324792,36934
2020-12-02,Colombia,9297,183,1334089,37117
2020-12-03,Colombia,9233,188,1343322,37305
2020-12-04,Colombia,9285,162,1352607,37467
2020-12-05,Colombia,9642,166,1362249,37633
2020-12-06,Colombia,8854,175,1371103,37808
2020-12-07,Colombia,5997,187,1377100,37995
2020-12-08,Colombia,7510,163,1384610,38158
2020-12-09,Colombia,7523,150,1392133,38308
2020-12-10,Colombia,7778,176,1399911,38484
2020-12-11,Colombia,8998,185,1408909,38669
2020-12-12,Colombia,8163,197,1417072,38866
2020-12-13,Colombia,8702,187,1425774,39053
2020-12-14,Colombia,8742,142,1434516,39195
2020-12-15,Colombia,10130,161,1444646,39356
2020-12-16,Colombia,11953,204,1456599,39560
2020-12-17,Colombia,12196,227,1468795,39787
2020-12-18,Colombia,13277,232,1482072,40019
2020-12-19,Colombia,13990,249,1496062,40268
2020-12-20,Colombia,11160,207,1507222,40475
2020-12-21,Colombia,10845,205,1518067,40680
2020-12-22,Colombia,12526,251,1530593,40931
2020-12-23,Colombia,14233,243,1544826,41174
2020-12-24,Colombia,14940,280,1559766,41454
2020-12-25,Colombia,14941,236,1574707,41690
2020-12-26,Colombia,10196,253,1584903,41943
2020-12-27,Colombia,9594,228,1594497,42171
2020-12-28,Colombia,9310,203,1603807,42374
2020-12-29,Colombia,11015,246,1614822,42620
2020-12-30,Colombia,11639,289,1626461,42909
2020-12-31,Colombia,16314,304,1642775,43213
2021-01-01,Colombia,12105,282,1654880,43495
2021-01-02,Colombia,11528,270,1666408,43765
2021-01-03,Colombia,9412,200,1675820,43965
2021-01-04,Colombia,10311,222,1686131,44187
2021-01-05,Colombia,16835,241,1702966,44428
2021-01-06,Colombia,16805,295,1719771,44723
2021-01-07,Colombia,17576,344,1737347,45067
2021-01-08,Colombia,18221,364,1755568,45431
2021-01-09,Colombia,15795,353,1771363,45784
2021-01-10,Colombia,15537,330,1786900,46114
2021-01-11,Colombia,15003,337,1801903,46451
2021-01-12,Colombia,14179,331,1816082,46782
2021-01-13,Colombia,15898,342,1831980,47124
2021-01-14,Colombia,17121,367,1849101,47491
2021-01-15,Colombia,21078,377,1870179,47868
2021-01-16,Colombia,20855,388,1891034,48256
2021-01-17,Colombia,17379,375,1908413,48631
2021-01-18,Colombia,14719,373,1923132,49004
2021-01-19,Colombia,15939,398,1939071,49402
2021-01-20,Colombia,17908,390,1956979,49792
2021-01-21,Colombia,15366,395,1972345,50187
2021-01-22,Colombia,15073,399,1987418,50586
2021-01-23,Colombia,15551,396,2002969,50982
2021-01-24,Colombia,12516,392,2015485,51374
2021-01-25,Colombia,12261,373,2027746,51747
2021-01-26,Colombia,13606,381,2041352,52128
2021-01-27,Colombia,13953,395,2055305,52523
2021-01-28,Colombia,12270,390,2067575,52913
2021-01-29,Colombia,10058,371,2077633,53284
2021-01-30,Colombia,9173,366,2086806,53650
2021-01-31,Colombia,8078,333,2094884,53983
2021-02-01,Colombia,9622,289,2104506,54272
2021-02-02,Colombia,10091,304,2114597,54576
2021-02-03,Colombia,11025,301,2125622,54877
2021-02-04,Colombia,9790,254,2135412,55131
2021-02-05,Colombia,7248,272,2142660,55403
2021-02-06,Colombia,8547,290,2151207,55693
2021-02-07,Colombia,6009,300,2157216,55993
2021-02-08,Colombia,4246,297,2161462,56290
2021-02-09,Colombia,5442,217,2166904,56507
2021-02-10,Colombia,6443,226,2173347,56733
2021-02-11,Colombia,6294,250,2179641,56983
2021-02-12,Colombia,5528,213,2185169,57196
2021-02-13,Colombia,4947,229,2190116,57425
2021-02-14,Colombia,4923,180,2195039,57605
2021-02-15,Colombia,3510,181,2198549,57786
2021-02-16,Colombia,4049,163,2202598,57949
2021-02-17,Colombia,5103,185,2207701,58134
2021-02-18,Colombia,4824,200,2212525,58334
2021-02-19,Colombia,4476,177,2217001,58511
2021-02-20,Colombia,5017,174,2222018,58685
2021-02-21,Colombia,4244,149,2226262,58834
2021-02-22,Colombia,3401,140,2229663,58974
2021-02-23,Colombia,3926,144,2233589,59118
2021-02-24,Colombia,3953,142,2237542,59260
2021-02-25,Colombia,3683,136,2241225,59396
2021-02-26,Colombia,3567,122,2244792,59518
2021-02-27,Colombia,3343,142,2248135,59660
2021-02-28,Colombia,3555,106,2251690,59766
2021-03-01,Colombia,3570,100,2255260,59866
2021-03-02,Colombia,4339,106,2259599,59972
2021-03-03,Colombia,3047,110,2262646,60082
2021-03-04,Colombia,3565,107,2266211,60189
2021-03-05,Colombia,3371,111,2269582,60300
2021-03-06,Colombia,3663,112,2273245,60412
2021-03-07,Colombia,3411,91,2276656,60503
2021-03-08,Colombia,2205,95,2278861,60598
2021-03-09,Colombia,3511,78,2282372,60676
2021-03-10,Colombia,3588,97,2285960,60773
2021-03-11,Colombia,4579,85,2290539,60858
2021-03-12,Colombia,4078,92,2294617,60950
2021-03-13,Colombia,4465,96,2299082,61046
2021-03-14,Colombia,4062,97,2303144,61143
2021-03-15,Colombia,2740,100,2305884,61243
2021-03-16,Colombia,3716,125,2309600,61368
2021-03-17,Colombia,4554,130,2314154,61498
2021-03-18,Colombia,5139,138,2319293,61636
2021-03-19,Colombia,5133,135,2324426,61771
2021-03-20,Colombia,6761,136,2331187,61907
2021-03-21,Colombia,6043,121,2337230,62028
2021-03-22,Colombia,5048,120,2342278,62148
2021-03-23,Colombia,4946,126,2347224,62274
2021-03-24,Colombia,5986,120,2353210,62394
2021-03-25,Colombia,6732,125,2359942,62519
2021-03-26,Colombia,7395,126,2367337,62645
2021-03-27,Colombia,8254,145,2375591,62790
2021-03-28,Colombia,7139,165,2382730,62955
2021-03-29,Colombia,7049,124,2389779,63079
2021-03-30,Colombia,7952,176,2397731,63255
2021-03-31,Colombia,8646,167,2406377,63422
2021-04-01,Colombia,11449,192,2417826,63614
2021-04-02,Colombia,10222,163,2428048,63777
2021-04-03,Colombia,9149,155,2437197,63932
2021-04-04,Colombia,9022,162,2446219,64094
2021-04-05,Colombia,10190,199,2456409,64293
2021-04-06,Colombia,11827,231,2468236,64524
2021-04-07,Colombia,11381,243,2479617,64767
2021-04-08,Colombia,12464,247,2492081,65014
2020-04-30,Comoros,1,0,1,0
2020-05-01,Comoros,0,0,1,0
2020-05-02,Comoros,2,0,3,0
2020-05-03,Comoros,0,0,3,0
2020-05-04,Comoros,0,0,3,0
2020-05-05,Comoros,0,0,3,0
2020-05-06,Comoros,5,1,8,1
2020-05-07,Comoros,0,0,8,1
2020-05-08,Comoros,0,0,8,1
2020-05-09,Comoros,3,0,11,1
2020-05-10,Comoros,0,0,11,1
2020-05-11,Comoros,0,0,11,1
2020-05-12,Comoros,0,0,11,1
2020-05-13,Comoros,0,0,11,1
2020-05-14,Comoros,0,0,11,1
2020-05-15,Comoros,0,0,11,1
2020-05-16,Comoros,0,0,11,1
2020-05-17,Comoros,0,0,11,1
2020-05-18,Comoros,0,0,11,1
2020-05-19,Comoros,0,0,11,1
2020-05-20,Comoros,23,0,34,1
2020-05-21,Comoros,0,0,34,1
2020-05-22,Comoros,44,0,78,1
2020-05-23,Comoros,0,0,78,1
2020-05-24,Comoros,9,0,87,1
2020-05-25,Comoros,0,0,87,1
2020-05-26,Comoros,0,0,87,1
2020-05-27,Comoros,0,1,87,2
2020-05-28,Comoros,0,0,87,2
2020-05-29,Comoros,0,0,87,2
2020-05-30,Comoros,19,0,106,2
2020-05-31,Comoros,0,0,106,2
2020-06-01,Comoros,0,0,106,2
2020-06-02,Comoros,26,0,132,2
2020-06-03,Comoros,0,0,132,2
2020-06-04,Comoros,0,0,132,2
2020-06-05,Comoros,0,0,132,2
2020-06-06,Comoros,9,0,141,2
2020-06-07,Comoros,0,0,141,2
2020-06-08,Comoros,0,0,141,2
2020-06-09,Comoros,0,0,141,2
2020-06-10,Comoros,21,0,162,2
2020-06-11,Comoros,0,0,162,2
2020-06-12,Comoros,1,0,163,2
2020-06-13,Comoros,13,0,176,2
2020-06-14,Comoros,0,0,176,2
2020-06-15,Comoros,0,0,176,2
2020-06-16,Comoros,21,1,197,3
2020-06-17,Comoros,0,0,197,3
2020-06-18,Comoros,13,2,210,5
2020-06-19,Comoros,0,0,210,5
2020-06-20,Comoros,37,0,247,5
2020-06-21,Comoros,0,0,247,5
2020-06-22,Comoros,0,0,247,5
2020-06-23,Comoros,18,2,265,7
2020-06-24,Comoros,0,0,265,7
2020-06-25,Comoros,7,0,272,7
2020-06-26,Comoros,0,0,272,7
2020-06-27,Comoros,0,0,272,7
2020-06-28,Comoros,0,0,272,7
2020-06-29,Comoros,0,0,272,7
2020-06-30,Comoros,31,0,303,7
2020-07-01,Comoros,0,0,303,7
2020-07-02,Comoros,0,0,303,7
2020-07-03,Comoros,6,0,309,7
2020-07-04,Comoros,0,0,309,7
2020-07-05,Comoros,2,0,311,7
2020-07-06,Comoros,0,0,311,7
2020-07-07,Comoros,0,0,311,7
2020-07-08,Comoros,2,0,313,7
2020-07-09,Comoros,1,0,314,7
2020-07-10,Comoros,0,0,314,7
2020-07-11,Comoros,3,0,317,7
2020-07-12,Comoros,0,0,317,7
2020-07-13,Comoros,0,0,317,7
2020-07-14,Comoros,4,0,321,7
2020-07-15,Comoros,0,0,321,7
2020-07-16,Comoros,7,0,328,7
2020-07-17,Comoros,0,0,328,7
2020-07-18,Comoros,0,0,328,7
2020-07-19,Comoros,6,0,334,7
2020-07-20,Comoros,0,0,334,7
2020-07-21,Comoros,3,0,337,7
2020-07-22,Comoros,0,0,337,7
2020-07-23,Comoros,3,0,340,7
2020-07-24,Comoros,0,0,340,7
2020-07-25,Comoros,0,0,340,7
2020-07-26,Comoros,14,0,354,7
2020-07-27,Comoros,0,0,354,7
2020-07-28,Comoros,0,0,354,7
2020-07-29,Comoros,24,0,378,7
2020-07-30,Comoros,0,0,378,7
2020-07-31,Comoros,0,0,378,7
2020-08-01,Comoros,8,0,386,7
2020-08-02,Comoros,0,0,386,7
2020-08-03,Comoros,0,0,386,7
2020-08-04,Comoros,2,0,388,7
2020-08-05,Comoros,0,0,388,7
2020-08-06,Comoros,8,0,396,7
2020-08-07,Comoros,0,0,396,7
2020-08-08,Comoros,3,0,399,7
2020-08-09,Comoros,0,0,399,7
2020-08-10,Comoros,0,0,399,7
2020-08-11,Comoros,0,0,399,7
2020-08-12,Comoros,0,0,399,7
2020-08-13,Comoros,0,0,399,7
2020-08-14,Comoros,4,0,403,7
2020-08-15,Comoros,0,0,403,7
2020-08-16,Comoros,2,0,405,7
2020-08-17,Comoros,0,0,405,7
2020-08-18,Comoros,1,0,406,7
2020-08-19,Comoros,0,0,406,7
2020-08-20,Comoros,11,0,417,7
2020-08-21,Comoros,0,0,417,7
2020-08-22,Comoros,0,0,417,7
2020-08-23,Comoros,0,0,417,7
2020-08-24,Comoros,0,0,417,7
2020-08-25,Comoros,0,0,417,7
2020-08-26,Comoros,0,0,417,7
2020-08-27,Comoros,5,0,422,7
2020-08-28,Comoros,0,0,422,7
2020-08-29,Comoros,1,0,423,7
2020-08-30,Comoros,0,0,423,7
2020-08-31,Comoros,0,0,423,7
2020-09-01,Comoros,4,0,427,7
2020-09-02,Comoros,0,0,427,7
2020-09-03,Comoros,21,0,448,7
2020-09-04,Comoros,0,0,448,7
2020-09-05,Comoros,4,0,452,7
2020-09-06,Comoros,0,0,452,7
2020-09-07,Comoros,0,0,452,7
2020-09-08,Comoros,4,0,456,7
2020-09-09,Comoros,0,0,456,7
2020-09-10,Comoros,0,0,456,7
2020-09-11,Comoros,0,0,456,7
2020-09-12,Comoros,0,0,456,7
2020-09-13,Comoros,0,0,456,7
2020-09-14,Comoros,1,0,457,7
2020-09-15,Comoros,10,0,467,7
2020-09-16,Comoros,0,0,467,7
2020-09-17,Comoros,3,0,470,7
2020-09-18,Comoros,0,0,470,7
2020-09-19,Comoros,0,0,470,7
2020-09-20,Comoros,0,0,470,7
2020-09-21,Comoros,0,0,470,7
2020-09-22,Comoros,0,0,470,7
2020-09-23,Comoros,0,0,470,7
2020-09-24,Comoros,4,0,474,7
2020-09-25,Comoros,0,0,474,7
2020-09-26,Comoros,4,0,478,7
2020-09-27,Comoros,0,0,478,7
2020-09-28,Comoros,0,0,478,7
2020-09-29,Comoros,1,0,479,7
2020-09-30,Comoros,0,0,479,7
2020-10-01,Comoros,5,0,484,7
2020-10-02,Comoros,0,0,484,7
2020-10-03,Comoros,3,0,487,7
2020-10-04,Comoros,0,0,487,7
2020-10-05,Comoros,0,0,487,7
2020-10-06,Comoros,4,0,491,7
2020-10-07,Comoros,0,0,491,7
2020-10-08,Comoros,4,0,495,7
2020-10-09,Comoros,0,0,495,7
2020-10-10,Comoros,0,0,495,7
2020-10-11,Comoros,0,0,495,7
2020-10-12,Comoros,0,0,495,7
2020-10-13,Comoros,1,0,496,7
2020-10-14,Comoros,0,0,496,7
2020-10-15,Comoros,0,0,496,7
2020-10-16,Comoros,6,0,502,7
2020-10-17,Comoros,0,0,502,7
2020-10-18,Comoros,0,0,502,7
2020-10-19,Comoros,0,0,502,7
2020-10-20,Comoros,2,0,504,7
2020-10-21,Comoros,0,0,504,7
2020-10-22,Comoros,13,0,517,7
2020-10-23,Comoros,0,0,517,7
2020-10-24,Comoros,0,0,517,7
2020-10-25,Comoros,0,0,517,7
2020-10-26,Comoros,0,0,517,7
2020-10-27,Comoros,0,0,517,7
2020-10-28,Comoros,0,0,517,7
2020-10-29,Comoros,0,0,517,7
2020-10-30,Comoros,20,0,537,7
2020-10-31,Comoros,8,0,545,7
2020-11-01,Comoros,0,0,545,7
2020-11-02,Comoros,0,0,545,7
2020-11-03,Comoros,0,0,545,7
2020-11-04,Comoros,9,0,554,7
2020-11-05,Comoros,3,0,557,7
2020-11-06,Comoros,0,0,557,7
2020-11-07,Comoros,6,0,563,7
2020-11-08,Comoros,0,0,563,7
2020-11-09,Comoros,0,0,563,7
2020-11-10,Comoros,6,0,569,7
2020-11-11,Comoros,0,0,569,7
2020-11-12,Comoros,5,0,574,7
2020-11-13,Comoros,0,0,574,7
2020-11-14,Comoros,5,0,579,7
2020-11-15,Comoros,0,0,579,7
2020-11-16,Comoros,0,0,579,7
2020-11-17,Comoros,12,0,591,7
2020-11-18,Comoros,0,0,591,7
2020-11-19,Comoros,1,0,592,7
2020-11-20,Comoros,0,0,592,7
2020-11-21,Comoros,4,0,596,7
2020-11-22,Comoros,0,0,596,7
2020-11-23,Comoros,0,0,596,7
2020-11-24,Comoros,11,0,607,7
2020-11-25,Comoros,0,0,607,7
2020-11-26,Comoros,3,0,610,7
2020-11-27,Comoros,0,0,610,7
2020-11-28,Comoros,1,0,611,7
2020-11-29,Comoros,0,0,611,7
2020-11-30,Comoros,0,0,611,7
2020-12-01,Comoros,2,0,613,7
2020-12-02,Comoros,0,0,613,7
2020-12-03,Comoros,2,0,615,7
2020-12-04,Comoros,0,0,615,7
2020-12-05,Comoros,1,0,616,7
2020-12-06,Comoros,0,0,616,7
2020-12-07,Comoros,0,0,616,7
2020-12-08,Comoros,1,0,617,7
2020-12-09,Comoros,0,0,617,7
2020-12-10,Comoros,0,0,617,7
2020-12-11,Comoros,0,0,617,7
2020-12-12,Comoros,11,0,628,7
2020-12-13,Comoros,0,0,628,7
2020-12-14,Comoros,0,0,628,7
2020-12-15,Comoros,5,0,633,7
2020-12-16,Comoros,0,0,633,7
2020-12-17,Comoros,10,0,643,7
2020-12-18,Comoros,0,0,643,7
2020-12-19,Comoros,0,0,643,7
2020-12-20,Comoros,23,0,666,7
2020-12-21,Comoros,0,0,666,7
2020-12-22,Comoros,27,0,693,7
2020-12-23,Comoros,0,0,693,7
2020-12-24,Comoros,22,0,715,7
2020-12-25,Comoros,0,0,715,7
2020-12-26,Comoros,0,0,715,7
2020-12-27,Comoros,0,0,715,7
2020-12-28,Comoros,0,0,715,7
2020-12-29,Comoros,50,2,765,9
2020-12-30,Comoros,0,0,765,9
2020-12-31,Comoros,58,1,823,10
2021-01-01,Comoros,0,0,823,10
2021-01-02,Comoros,41,3,864,13
2021-01-03,Comoros,0,0,864,13
2021-01-04,Comoros,0,0,864,13
2021-01-05,Comoros,131,0,995,13
2021-01-06,Comoros,0,0,995,13
2021-01-07,Comoros,55,3,1050,16
2021-01-08,Comoros,0,0,1050,16
2021-01-09,Comoros,100,2,1150,18
2021-01-10,Comoros,0,0,1150,18
2021-01-11,Comoros,10,0,1160,18
2021-01-12,Comoros,6,12,1166,30
2021-01-13,Comoros,3,3,1169,33
2021-01-14,Comoros,234,5,1403,38
2021-01-15,Comoros,66,0,1469,38
2021-01-16,Comoros,108,3,1577,41
2021-01-17,Comoros,15,4,1592,45
2021-01-18,Comoros,177,4,1769,49
2021-01-19,Comoros,95,2,1864,51
2021-01-20,Comoros,69,3,1933,54
2021-01-21,Comoros,2,1,1935,55
2021-01-22,Comoros,225,8,2160,63
2021-01-23,Comoros,100,7,2260,70
2021-01-24,Comoros,8,1,2268,71
2021-01-25,Comoros,82,5,2350,76
2021-01-26,Comoros,75,1,2425,77
2021-01-27,Comoros,67,4,2492,81
2021-01-28,Comoros,106,4,2598,85
2021-01-29,Comoros,48,4,2646,89
2021-01-30,Comoros,72,1,2718,90
2021-01-31,Comoros,8,3,2726,93
2021-02-01,Comoros,85,5,2811,98
2021-02-02,Comoros,37,2,2848,100
2021-02-03,Comoros,44,4,2892,104
2021-02-04,Comoros,83,1,2975,105
2021-02-05,Comoros,26,0,3001,105
2021-02-06,Comoros,85,3,3086,108
2021-02-07,Comoros,0,0,3086,108
2021-02-08,Comoros,2,4,3088,112
2021-02-09,Comoros,91,6,3179,118
2021-02-10,Comoros,30,2,3209,120
2021-02-11,Comoros,67,2,3276,122
2021-02-12,Comoros,14,3,3290,125
2021-02-13,Comoros,42,3,3332,128
2021-02-14,Comoros,2,1,3334,129
2021-02-15,Comoros,24,3,3358,132
2021-02-16,Comoros,35,1,3393,133
2021-02-17,Comoros,20,2,3413,135
2021-02-18,Comoros,45,3,3458,138
2021-02-19,Comoros,15,4,3473,142
2021-02-20,Comoros,17,1,3490,143
2021-02-21,Comoros,12,0,3502,143
2021-02-22,Comoros,16,1,3518,144
2021-02-23,Comoros,4,0,3522,144
2021-02-24,Comoros,17,0,3539,144
2021-02-25,Comoros,13,0,3552,144
2021-02-26,Comoros,6,0,3558,144
2021-02-27,Comoros,13,0,3571,144
2021-02-28,Comoros,0,0,3571,144
2021-03-01,Comoros,7,0,3578,144
2021-03-02,Comoros,0,0,3578,144
2021-03-03,Comoros,2,0,3580,144
2021-03-04,Comoros,0,0,3580,144
2021-03-05,Comoros,7,1,3587,145
2021-03-06,Comoros,9,1,3596,146
2021-03-07,Comoros,0,0,3596,146
2021-03-08,Comoros,10,0,3606,146
2021-03-09,Comoros,0,0,3606,146
2021-03-10,Comoros,5,0,3611,146
2021-03-11,Comoros,4,0,3615,146
2021-03-12,Comoros,3,0,3618,146
2021-03-13,Comoros,8,0,3626,146
2021-03-14,Comoros,9,0,3635,146
2021-03-15,Comoros,11,0,3646,146
2021-03-16,Comoros,1,0,3647,146
2021-03-17,Comoros,5,0,3652,146
2021-03-18,Comoros,5,0,3657,146
2021-03-19,Comoros,8,0,3665,146
2021-03-20,Comoros,1,0,3666,146
2021-03-21,Comoros,0,0,3666,146
2021-03-22,Comoros,0,0,3666,146
2021-03-23,Comoros,15,0,3681,146
2021-03-24,Comoros,1,0,3682,146
2021-03-25,Comoros,5,0,3687,146
2021-03-26,Comoros,2,0,3689,146
2021-03-27,Comoros,1,0,3690,146
2021-03-28,Comoros,0,0,3690,146
2021-03-29,Comoros,6,0,3696,146
2021-03-30,Comoros,0,0,3696,146
2021-03-31,Comoros,0,0,3696,146
2021-04-01,Comoros,8,0,3704,146
2021-04-02,Comoros,8,0,3712,146
2021-04-03,Comoros,0,0,3712,146
2021-04-04,Comoros,7,0,3719,146
2021-04-05,Comoros,6,0,3725,146
2021-04-06,Comoros,13,0,3738,146
2021-04-07,Comoros,20,0,3758,146
2021-04-08,Comoros,0,0,3758,146
2020-03-15,Congo,1,0,1,0
2020-03-16,Congo,0,0,1,0
2020-03-17,Congo,0,0,1,0
2020-03-18,Congo,0,0,1,0
2020-03-19,Congo,2,0,3,0
2020-03-20,Congo,0,0,3,0
2020-03-21,Congo,0,0,3,0
2020-03-22,Congo,0,0,3,0
2020-03-23,Congo,1,0,4,0
2020-03-24,Congo,0,0,4,0
2020-03-25,Congo,0,0,4,0
2020-03-26,Congo,0,0,4,0
2020-03-27,Congo,0,0,4,0
2020-03-28,Congo,0,0,4,0
2020-03-29,Congo,15,0,19,0
2020-03-30,Congo,0,0,19,0
2020-03-31,Congo,0,0,19,0
2020-04-01,Congo,0,0,19,0
2020-04-02,Congo,3,2,22,2
2020-04-03,Congo,0,0,22,2
2020-04-04,Congo,0,0,22,2
2020-04-05,Congo,23,3,45,5
2020-04-06,Congo,0,0,45,5
2020-04-07,Congo,0,0,45,5
2020-04-08,Congo,0,0,45,5
2020-04-09,Congo,15,0,60,5
2020-04-10,Congo,0,0,60,5
2020-04-11,Congo,0,0,60,5
2020-04-12,Congo,0,0,60,5
2020-04-13,Congo,0,0,60,5
2020-04-14,Congo,0,0,60,5
2020-04-15,Congo,57,0,117,5
2020-04-16,Congo,0,0,117,5
2020-04-17,Congo,26,1,143,6
2020-04-18,Congo,0,0,143,6
2020-04-19,Congo,0,0,143,6
2020-04-20,Congo,17,0,160,6
2020-04-21,Congo,5,0,165,6
2020-04-22,Congo,21,0,186,6
2020-04-23,Congo,0,0,186,6
2020-04-24,Congo,14,0,200,6
2020-04-25,Congo,0,0,200,6
2020-04-26,Congo,0,0,200,6
2020-04-27,Congo,0,0,200,6
2020-04-28,Congo,7,2,207,8
2020-04-29,Congo,0,0,207,8
2020-04-30,Congo,13,1,220,9
2020-05-01,Congo,9,0,229,9
2020-05-02,Congo,0,0,229,9
2020-05-03,Congo,0,0,229,9
2020-05-04,Congo,7,1,236,10
2020-05-05,Congo,0,0,236,10
2020-05-06,Congo,28,0,264,10
2020-05-07,Congo,0,0,264,10
2020-05-08,Congo,10,0,274,10
2020-05-09,Congo,0,0,274,10
2020-05-10,Congo,0,0,274,10
2020-05-11,Congo,59,1,333,11
2020-05-12,Congo,0,0,333,11
2020-05-13,Congo,0,0,333,11
2020-05-14,Congo,58,4,391,15
2020-05-15,Congo,0,0,391,15
2020-05-16,Congo,0,0,391,15
2020-05-17,Congo,0,0,391,15
2020-05-18,Congo,21,0,412,15
2020-05-19,Congo,8,0,420,15
2020-05-20,Congo,0,0,420,15
2020-05-21,Congo,49,1,469,16
2020-05-22,Congo,0,0,469,16
2020-05-23,Congo,18,0,487,16
2020-05-24,Congo,0,0,487,16
2020-05-25,Congo,0,0,487,16
2020-05-26,Congo,0,0,487,16
2020-05-27,Congo,84,3,571,19
2020-05-28,Congo,0,0,571,19
2020-05-29,Congo,0,0,571,19
2020-05-30,Congo,0,0,571,19
2020-05-31,Congo,40,1,611,20
2020-06-01,Congo,0,0,611,20
2020-06-02,Congo,0,0,611,20
2020-06-03,Congo,0,0,611,20
2020-06-04,Congo,0,0,611,20
2020-06-05,Congo,24,0,635,20
2020-06-06,Congo,48,2,683,22
2020-06-07,Congo,0,0,683,22
2020-06-08,Congo,0,0,683,22
2020-06-09,Congo,45,2,728,24
2020-06-10,Congo,0,0,728,24
2020-06-11,Congo,0,0,728,24
2020-06-12,Congo,0,0,728,24
2020-06-13,Congo,0,0,728,24
2020-06-14,Congo,0,0,728,24
2020-06-15,Congo,155,3,883,27
2020-06-16,Congo,0,0,883,27
2020-06-17,Congo,0,0,883,27
2020-06-18,Congo,0,0,883,27
2020-06-19,Congo,0,0,883,27
2020-06-20,Congo,0,0,883,27
2020-06-21,Congo,0,0,883,27
2020-06-22,Congo,204,10,1087,37
2020-06-23,Congo,0,0,1087,37
2020-06-24,Congo,0,0,1087,37
2020-06-25,Congo,0,0,1087,37
2020-06-26,Congo,0,0,1087,37
2020-06-27,Congo,0,0,1087,37
2020-06-28,Congo,0,0,1087,37
2020-06-29,Congo,0,0,1087,37
2020-06-30,Congo,0,0,1087,37
2020-07-01,Congo,295,4,1382,41
2020-07-02,Congo,0,0,1382,41
2020-07-03,Congo,175,3,1557,44
2020-07-04,Congo,0,0,1557,44
2020-07-05,Congo,0,0,1557,44
2020-07-06,Congo,0,0,1557,44
2020-07-07,Congo,0,0,1557,44
2020-07-08,Congo,264,3,1821,47
2020-07-09,Congo,0,0,1821,47
2020-07-10,Congo,207,0,2028,47
2020-07-11,Congo,0,0,2028,47
2020-07-12,Congo,0,0,2028,47
2020-07-13,Congo,0,0,2028,47
2020-07-14,Congo,0,0,2028,47
2020-07-15,Congo,194,0,2222,47
2020-07-16,Congo,136,1,2358,48
2020-07-17,Congo,275,1,2633,49
2020-07-18,Congo,0,0,2633,49
2020-07-19,Congo,0,0,2633,49
2020-07-20,Congo,218,1,2851,50
2020-07-21,Congo,0,0,2851,50
2020-07-22,Congo,0,0,2851,50
2020-07-23,Congo,0,0,2851,50
2020-07-24,Congo,187,1,3038,51
2020-07-25,Congo,0,0,3038,51
2020-07-26,Congo,0,0,3038,51
2020-07-27,Congo,162,3,3200,54
2020-07-28,Congo,0,0,3200,54
2020-07-29,Congo,0,0,3200,54
2020-07-30,Congo,0,0,3200,54
2020-07-31,Congo,0,0,3200,54
2020-08-01,Congo,0,0,3200,54
2020-08-02,Congo,0,0,3200,54
2020-08-03,Congo,346,4,3546,58
2020-08-04,Congo,0,0,3546,58
2020-08-05,Congo,0,0,3546,58
2020-08-06,Congo,0,0,3546,58
2020-08-07,Congo,91,0,3637,58
2020-08-08,Congo,27,0,3664,58
2020-08-09,Congo,0,0,3664,58
2020-08-10,Congo,0,0,3664,58
2020-08-11,Congo,81,2,3745,60
2020-08-12,Congo,0,0,3745,60
2020-08-13,Congo,0,0,3745,60
2020-08-14,Congo,0,0,3745,60
2020-08-15,Congo,0,0,3745,60
2020-08-16,Congo,86,16,3831,76
2020-08-17,Congo,0,0,3831,76
2020-08-18,Congo,0,0,3831,76
2020-08-19,Congo,19,1,3850,77
2020-08-20,Congo,0,0,3850,77
2020-08-21,Congo,0,0,3850,77
2020-08-22,Congo,0,0,3850,77
2020-08-23,Congo,0,0,3850,77
2020-08-24,Congo,129,1,3979,78
2020-08-25,Congo,0,0,3979,78
2020-08-26,Congo,0,0,3979,78
2020-08-27,Congo,0,0,3979,78
2020-08-28,Congo,0,0,3979,78
2020-08-29,Congo,0,0,3979,78
2020-08-30,Congo,0,0,3979,78
2020-08-31,Congo,0,0,3979,78
2020-09-01,Congo,0,0,3979,78
2020-09-02,Congo,649,24,4628,102
2020-09-03,Congo,0,0,4628,102
2020-09-04,Congo,0,0,4628,102
2020-09-05,Congo,0,0,4628,102
2020-09-06,Congo,0,0,4628,102
2020-09-07,Congo,263,0,4891,102
2020-09-08,Congo,0,12,4891,114
2020-09-09,Congo,0,0,4891,114
2020-09-10,Congo,0,-31,4891,83
2020-09-11,Congo,37,5,4928,88
2020-09-12,Congo,0,0,4928,88
2020-09-13,Congo,0,0,4928,88
2020-09-14,Congo,6,0,4934,88
2020-09-15,Congo,0,0,4934,88
2020-09-16,Congo,0,0,4934,88
2020-09-17,Congo,0,0,4934,88
2020-09-18,Congo,46,1,4980,89
2020-09-19,Congo,6,0,4986,89
2020-09-20,Congo,0,0,4986,89
2020-09-21,Congo,16,0,5002,89
2020-09-22,Congo,0,0,5002,89
2020-09-23,Congo,3,0,5005,89
2020-09-24,Congo,0,0,5005,89
2020-09-25,Congo,0,0,5005,89
2020-09-26,Congo,0,0,5005,89
2020-09-27,Congo,3,0,5008,89
2020-09-28,Congo,0,0,5008,89
2020-09-29,Congo,0,0,5008,89
2020-09-30,Congo,81,0,5089,89
2020-10-01,Congo,0,0,5089,89
2020-10-02,Congo,0,0,5089,89
2020-10-03,Congo,0,0,5089,89
2020-10-04,Congo,0,0,5089,89
2020-10-05,Congo,0,0,5089,89
2020-10-06,Congo,0,0,5089,89
2020-10-07,Congo,0,0,5089,89
2020-10-08,Congo,0,0,5089,89
2020-10-09,Congo,29,1,5118,90
2020-10-10,Congo,0,0,5118,90
2020-10-11,Congo,0,0,5118,90
2020-10-12,Congo,0,0,5118,90
2020-10-13,Congo,0,0,5118,90
2020-10-14,Congo,38,2,5156,92
2020-10-15,Congo,0,0,5156,92
2020-10-16,Congo,0,0,5156,92
2020-10-17,Congo,0,0,5156,92
2020-10-18,Congo,0,0,5156,92
2020-10-19,Congo,0,0,5156,92
2020-10-20,Congo,0,0,5156,92
2020-10-21,Congo,0,0,5156,92
2020-10-22,Congo,0,0,5156,92
2020-10-23,Congo,0,0,5156,92
2020-10-24,Congo,97,0,5253,92
2020-10-25,Congo,0,0,5253,92
2020-10-26,Congo,0,0,5253,92
2020-10-27,Congo,0,0,5253,92
2020-10-28,Congo,0,0,5253,92
2020-10-29,Congo,37,0,5290,92
2020-10-30,Congo,0,0,5290,92
2020-10-31,Congo,0,0,5290,92
2020-11-01,Congo,0,0,5290,92
2020-11-02,Congo,0,0,5290,92
2020-11-03,Congo,58,0,5348,92
2020-11-04,Congo,0,0,5348,92
2020-11-05,Congo,0,0,5348,92
2020-11-06,Congo,31,0,5379,92
2020-11-07,Congo,0,0,5379,92
2020-11-08,Congo,0,0,5379,92
2020-11-09,Congo,0,0,5379,92
2020-11-10,Congo,0,0,5379,92
2020-11-11,Congo,0,0,5379,92
2020-11-12,Congo,0,0,5379,92
2020-11-13,Congo,136,0,5515,92
2020-11-14,Congo,0,0,5515,92
2020-11-15,Congo,0,0,5515,92
2020-11-16,Congo,0,0,5515,92
2020-11-17,Congo,0,0,5515,92
2020-11-18,Congo,0,0,5515,92
2020-11-19,Congo,117,1,5632,93
2020-11-20,Congo,0,0,5632,93
2020-11-21,Congo,0,0,5632,93
2020-11-22,Congo,0,0,5632,93
2020-11-23,Congo,0,0,5632,93
2020-11-24,Congo,0,0,5632,93
2020-11-25,Congo,0,0,5632,93
2020-11-26,Congo,0,0,5632,93
2020-11-27,Congo,142,1,5774,94
2020-11-28,Congo,0,0,5774,94
2020-11-29,Congo,0,0,5774,94
2020-11-30,Congo,0,0,5774,94
2020-12-01,Congo,0,0,5774,94
2020-12-02,Congo,0,0,5774,94
2020-12-03,Congo,0,0,5774,94
2020-12-04,Congo,0,0,5774,94
2020-12-05,Congo,0,0,5774,94
2020-12-06,Congo,0,0,5774,94
2020-12-07,Congo,0,0,5774,94
2020-12-08,Congo,0,0,5774,94
2020-12-09,Congo,275,5,6049,99
2020-12-10,Congo,0,0,6049,99
2020-12-11,Congo,0,0,6049,99
2020-12-12,Congo,0,0,6049,99
2020-12-13,Congo,0,0,6049,99
2020-12-14,Congo,151,1,6200,100
2020-12-15,Congo,0,0,6200,100
2020-12-16,Congo,0,0,6200,100
2020-12-17,Congo,0,0,6200,100
2020-12-18,Congo,0,0,6200,100
2020-12-19,Congo,0,0,6200,100
2020-12-20,Congo,0,0,6200,100
2020-12-21,Congo,0,0,6200,100
2020-12-22,Congo,371,0,6571,100
2020-12-23,Congo,0,0,6571,100
2020-12-24,Congo,0,0,6571,100
2020-12-25,Congo,0,0,6571,100
2020-12-26,Congo,337,7,6908,107
2020-12-27,Congo,0,0,6908,107
2020-12-28,Congo,0,0,6908,107
2020-12-29,Congo,0,0,6908,107
2020-12-30,Congo,0,0,6908,107
2020-12-31,Congo,199,1,7107,108
2021-01-01,Congo,0,0,7107,108
2021-01-02,Congo,0,0,7107,108
2021-01-03,Congo,0,0,7107,108
2021-01-04,Congo,0,0,7107,108
2021-01-05,Congo,0,0,7107,108
2021-01-06,Congo,20,0,7127,108
2021-01-07,Congo,0,0,7127,108
2021-01-08,Congo,0,0,7127,108
2021-01-09,Congo,0,0,7127,108
2021-01-10,Congo,0,0,7127,108
2021-01-11,Congo,0,0,7127,108
2021-01-12,Congo,33,4,7160,112
2021-01-13,Congo,0,0,7160,112
2021-01-14,Congo,0,0,7160,112
2021-01-15,Congo,549,2,7709,114
2021-01-16,Congo,0,0,7709,114
2021-01-17,Congo,0,0,7709,114
2021-01-18,Congo,0,0,7709,114
2021-01-19,Congo,0,0,7709,114
2021-01-20,Congo,0,0,7709,114
2021-01-21,Congo,85,3,7794,117
2021-01-22,Congo,0,0,7794,117
2021-01-23,Congo,0,0,7794,117
2021-01-24,Congo,0,0,7794,117
2021-01-25,Congo,93,0,7887,117
2021-01-26,Congo,0,0,7887,117
2021-01-27,Congo,0,0,7887,117
2021-01-28,Congo,0,0,7887,117
2021-01-29,Congo,0,0,7887,117
2021-01-30,Congo,0,0,7887,117
2021-01-31,Congo,0,0,7887,117
2021-02-01,Congo,0,0,7887,117
2021-02-02,Congo,0,0,7887,117
2021-02-03,Congo,0,0,7887,117
2021-02-04,Congo,173,5,8060,122
2021-02-05,Congo,0,0,8060,122
2021-02-06,Congo,0,0,8060,122
2021-02-07,Congo,0,0,8060,122
2021-02-08,Congo,0,0,8060,122
2021-02-09,Congo,0,0,8060,122
2021-02-10,Congo,294,0,8354,122
2021-02-11,Congo,0,0,8354,122
2021-02-12,Congo,65,1,8419,123
2021-02-13,Congo,0,0,8419,123
2021-02-14,Congo,0,0,8419,123
2021-02-15,Congo,0,0,8419,123
2021-02-16,Congo,0,0,8419,123
2021-02-17,Congo,0,0,8419,123
2021-02-18,Congo,0,0,8419,123
2021-02-19,Congo,0,0,8419,123
2021-02-20,Congo,0,0,8419,123
2021-02-21,Congo,206,4,8625,127
2021-02-22,Congo,0,0,8625,127
2021-02-23,Congo,0,0,8625,127
2021-02-24,Congo,195,1,8820,128
2021-02-25,Congo,0,0,8820,128
2021-02-26,Congo,0,0,8820,128
2021-02-27,Congo,0,0,8820,128
2021-02-28,Congo,0,0,8820,128
2021-03-01,Congo,0,0,8820,128
2021-03-02,Congo,0,0,8820,128
2021-03-03,Congo,0,0,8820,128
2021-03-04,Congo,359,3,9179,131
2021-03-05,Congo,0,0,9179,131
2021-03-06,Congo,0,0,9179,131
2021-03-07,Congo,0,0,9179,131
2021-03-08,Congo,0,0,9179,131
2021-03-09,Congo,0,0,9179,131
2021-03-10,Congo,150,0,9329,131
2021-03-11,Congo,0,0,9329,131
2021-03-12,Congo,0,0,9329,131
2021-03-13,Congo,0,0,9329,131
2021-03-14,Congo,0,0,9329,131
2021-03-15,Congo,0,0,9329,131
2021-03-16,Congo,0,0,9329,131
2021-03-17,Congo,0,0,9329,131
2021-03-18,Congo,235,3,9564,134
2021-03-19,Congo,0,0,9564,134
2021-03-20,Congo,0,0,9564,134
2021-03-21,Congo,0,0,9564,134
2021-03-22,Congo,0,0,9564,134
2021-03-23,Congo,0,0,9564,134
2021-03-24,Congo,117,1,9681,135
2021-03-25,Congo,0,0,9681,135
2021-03-26,Congo,0,0,9681,135
2021-03-27,Congo,0,0,9681,135
2021-03-28,Congo,0,0,9681,135
2021-03-29,Congo,0,0,9681,135
2021-03-30,Congo,0,0,9681,135
2021-03-31,Congo,0,0,9681,135
2021-04-01,Congo,0,0,9681,135
2021-04-02,Congo,0,0,9681,135
2021-04-03,Congo,0,0,9681,135
2021-04-04,Congo,0,0,9681,135
2021-04-05,Congo,0,0,9681,135
2021-04-06,Congo,403,2,10084,137
2021-04-07,Congo,0,0,10084,137
2021-04-08,Congo,0,0,10084,137
2020-03-06,Costa Rica,1,0,1,0
2020-03-07,Costa Rica,0,0,1,0
2020-03-08,Costa Rica,4,0,5,0
2020-03-09,Costa Rica,4,0,9,0
2020-03-10,Costa Rica,0,0,9,0
2020-03-11,Costa Rica,4,0,13,0
2020-03-12,Costa Rica,9,0,22,0
2020-03-13,Costa Rica,1,0,23,0
2020-03-14,Costa Rica,3,0,26,0
2020-03-15,Costa Rica,1,0,27,0
2020-03-16,Costa Rica,8,0,35,0
2020-03-17,Costa Rica,6,0,41,0
2020-03-18,Costa Rica,9,0,50,0
2020-03-19,Costa Rica,19,1,69,1
2020-03-20,Costa Rica,20,0,89,1
2020-03-21,Costa Rica,28,1,117,2
2020-03-22,Costa Rica,17,0,134,2
2020-03-23,Costa Rica,24,0,158,2
2020-03-24,Costa Rica,19,0,177,2
2020-03-25,Costa Rica,24,0,201,2
2020-03-26,Costa Rica,30,0,231,2
2020-03-27,Costa Rica,32,0,263,2
2020-03-28,Costa Rica,32,0,295,2
2020-03-29,Costa Rica,19,0,314,2
2020-03-30,Costa Rica,16,0,330,2
2020-03-31,Costa Rica,17,0,347,2
2020-04-01,Costa Rica,28,0,375,2
2020-04-02,Costa Rica,21,0,396,2
2020-04-03,Costa Rica,20,0,416,2
2020-04-04,Costa Rica,19,0,435,2
2020-04-05,Costa Rica,19,0,454,2
2020-04-06,Costa Rica,13,0,467,2
2020-04-07,Costa Rica,16,0,483,2
2020-04-08,Costa Rica,19,1,502,3
2020-04-09,Costa Rica,37,0,539,3
2020-04-10,Costa Rica,19,0,558,3
2020-04-11,Costa Rica,19,0,577,3
2020-04-12,Costa Rica,18,0,595,3
2020-04-13,Costa Rica,17,0,612,3
2020-04-14,Costa Rica,6,0,618,3
2020-04-15,Costa Rica,8,1,626,4
2020-04-16,Costa Rica,16,0,642,4
2020-04-17,Costa Rica,7,0,649,4
2020-04-18,Costa Rica,6,0,655,4
2020-04-19,Costa Rica,5,1,660,5
2020-04-20,Costa Rica,2,1,662,6
2020-04-21,Costa Rica,7,0,669,6
2020-04-22,Costa Rica,12,0,681,6
2020-04-23,Costa Rica,5,0,686,6
2020-04-24,Costa Rica,1,0,687,6
2020-04-25,Costa Rica,6,0,693,6
2020-04-26,Costa Rica,2,0,695,6
2020-04-27,Costa Rica,2,0,697,6
2020-04-28,Costa Rica,8,0,705,6
2020-04-29,Costa Rica,8,0,713,6
2020-04-30,Costa Rica,6,0,719,6
2020-05-01,Costa Rica,6,0,725,6
2020-05-02,Costa Rica,8,0,733,6
2020-05-03,Costa Rica,6,0,739,6
2020-05-04,Costa Rica,3,0,742,6
2020-05-05,Costa Rica,13,0,755,6
2020-05-06,Costa Rica,6,0,761,6
2020-05-07,Costa Rica,4,0,765,6
2020-05-08,Costa Rica,8,0,773,6
2020-05-09,Costa Rica,7,0,780,6
2020-05-10,Costa Rica,12,1,792,7
2020-05-11,Costa Rica,9,0,801,7
2020-05-12,Costa Rica,3,0,804,7
2020-05-13,Costa Rica,11,1,815,8
2020-05-14,Costa Rica,15,0,830,8
2020-05-15,Costa Rica,13,1,843,9
2020-05-16,Costa Rica,10,1,853,10
2020-05-17,Costa Rica,10,0,863,10
2020-05-18,Costa Rica,3,0,866,10
2020-05-19,Costa Rica,16,0,882,10
2020-05-20,Costa Rica,15,0,897,10
2020-05-21,Costa Rica,6,0,903,10
2020-05-22,Costa Rica,8,0,911,10
2020-05-23,Costa Rica,7,0,918,10
2020-05-24,Costa Rica,12,0,930,10
2020-05-25,Costa Rica,21,0,951,10
2020-05-26,Costa Rica,5,0,956,10
2020-05-27,Costa Rica,28,0,984,10
2020-05-28,Costa Rica,16,0,1000,10
2020-05-29,Costa Rica,22,0,1022,10
2020-05-30,Costa Rica,25,0,1047,10
2020-05-31,Costa Rica,9,0,1056,10
2020-06-01,Costa Rica,28,0,1084,10
2020-06-02,Costa Rica,21,0,1105,10
2020-06-03,Costa Rica,52,0,1157,10
2020-06-04,Costa Rica,37,0,1194,10
2020-06-05,Costa Rica,34,0,1228,10
2020-06-06,Costa Rica,35,0,1263,10
2020-06-07,Costa Rica,55,0,1318,10
2020-06-08,Costa Rica,24,1,1342,11
2020-06-09,Costa Rica,33,0,1375,11
2020-06-10,Costa Rica,86,1,1461,12
2020-06-11,Costa Rica,77,0,1538,12
2020-06-12,Costa Rica,74,0,1612,12
2020-06-13,Costa Rica,50,0,1662,12
2020-06-14,Costa Rica,53,0,1715,12
2020-06-15,Costa Rica,29,0,1744,12
2020-06-16,Costa Rica,52,0,1796,12
2020-06-17,Costa Rica,75,0,1871,12
2020-06-18,Costa Rica,68,0,1939,12
2020-06-19,Costa Rica,119,0,2058,12
2020-06-20,Costa Rica,69,0,2127,12
2020-06-21,Costa Rica,86,0,2213,12
2020-06-22,Costa Rica,64,0,2277,12
2020-06-23,Costa Rica,91,0,2368,12
2020-06-24,Costa Rica,147,0,2515,12
2020-06-25,Costa Rica,169,0,2684,12
2020-06-26,Costa Rica,152,0,2836,12
2020-06-27,Costa Rica,143,2,2979,14
2020-06-28,Costa Rica,151,1,3130,15
2020-06-29,Costa Rica,139,0,3269,15
2020-06-30,Costa Rica,190,1,3459,16
2020-07-01,Costa Rica,294,1,3753,17
2020-07-02,Costa Rica,270,1,4023,18
2020-07-03,Costa Rica,288,0,4311,18
2020-07-04,Costa Rica,310,0,4621,18
2020-07-05,Costa Rica,375,1,4996,19
2020-07-06,Costa Rica,245,4,5241,23
2020-07-07,Costa Rica,245,0,5486,23
2020-07-08,Costa Rica,350,2,5836,25
2020-07-09,Costa Rica,649,0,6485,25
2020-07-10,Costa Rica,360,1,6845,26
2020-07-11,Costa Rica,386,2,7231,28
2020-07-12,Costa Rica,365,2,7596,30
2020-07-13,Costa Rica,440,4,8036,34
2020-07-14,Costa Rica,446,3,8482,37
2020-07-15,Costa Rica,504,3,8986,40
2020-07-16,Costa Rica,560,2,9546,42
2020-07-17,Costa Rica,423,5,9969,47
2020-07-18,Costa Rica,582,7,10551,54
2020-07-19,Costa Rica,563,8,11114,62
2020-07-20,Costa Rica,420,4,11534,66
2020-07-21,Costa Rica,277,2,11811,68
2020-07-22,Costa Rica,550,3,12361,71
2020-07-23,Costa Rica,768,9,13129,80
2020-07-24,Costa Rica,540,7,13669,87
2020-07-25,Costa Rica,931,11,14600,98
2020-07-26,Costa Rica,629,6,15229,104
2020-07-27,Costa Rica,612,11,15841,115
2020-07-28,Costa Rica,503,10,16344,125
2020-07-29,Costa Rica,456,8,16800,133
2020-07-30,Costa Rica,490,7,17290,140
2020-07-31,Costa Rica,530,10,17820,150
2020-08-01,Costa Rica,367,4,18187,154
2020-08-02,Costa Rica,788,8,18975,162
2020-08-03,Costa Rica,427,9,19402,171
2020-08-04,Costa Rica,435,10,19837,181
2020-08-05,Costa Rica,580,10,20417,191
2020-08-06,Costa Rica,653,9,21070,200
2020-08-07,Costa Rica,1011,18,22081,218
2020-08-08,Costa Rica,721,10,22802,228
2020-08-09,Costa Rica,484,7,23286,235
2020-08-10,Costa Rica,586,9,23872,244
2020-08-11,Costa Rica,636,11,24508,255
2020-08-12,Costa Rica,549,8,25057,263
2020-08-13,Costa Rica,1072,9,26129,272
2020-08-14,Costa Rica,802,9,26931,281
2020-08-15,Costa Rica,806,10,27737,291
2020-08-16,Costa Rica,728,3,28465,294
2020-08-17,Costa Rica,619,10,29084,304
2020-08-18,Costa Rica,559,10,29643,314
2020-08-19,Costa Rica,766,7,30409,321
2020-08-20,Costa Rica,666,12,31075,333
2020-08-21,Costa Rica,1059,7,32134,340
2020-08-22,Costa Rica,950,8,33084,348
2020-08-23,Costa Rica,736,7,33820,355
2020-08-24,Costa Rica,643,7,34463,362
2020-08-25,Costa Rica,842,14,35305,376
2020-08-26,Costa Rica,1002,10,36307,386
2020-08-27,Costa Rica,985,11,37292,397
2020-08-28,Costa Rica,1193,10,38485,407
2020-08-29,Costa Rica,1214,11,39699,418
2020-08-30,Costa Rica,0,0,39699,418
2020-08-31,Costa Rica,1588,18,41287,436
2020-09-01,Costa Rica,897,7,42184,443
2020-09-02,Costa Rica,1121,10,43305,453
2020-09-03,Costa Rica,1153,7,44458,460
2020-09-04,Costa Rica,1222,9,45680,469
2020-09-05,Costa Rica,1240,9,46920,478
2020-09-06,Costa Rica,0,0,46920,478
2020-09-07,Costa Rica,1860,32,48780,510
2020-09-08,Costa Rica,1117,21,49897,531
2020-09-09,Costa Rica,1327,12,51224,543
2020-09-10,Costa Rica,1325,24,52549,567
2020-09-11,Costa Rica,1420,16,53969,583
2020-09-12,Costa Rica,1485,7,55454,590
2020-09-13,Costa Rica,0,0,55454,590
2020-09-14,Costa Rica,1907,31,57361,621
2020-09-15,Costa Rica,776,12,58137,633
2020-09-16,Costa Rica,1379,16,59516,649
2020-09-17,Costa Rica,1302,17,60818,666
2020-09-18,Costa Rica,1556,20,62374,686
2020-09-19,Costa Rica,1338,20,63712,706
2020-09-20,Costa Rica,0,0,63712,706
2020-09-21,Costa Rica,1890,39,65602,745
2020-09-22,Costa Rica,1087,15,66689,760
2020-09-23,Costa Rica,1370,21,68059,781
2020-09-24,Costa Rica,1400,14,69459,795
2020-09-25,Costa Rica,1357,17,70816,812
2020-09-26,Costa Rica,1233,16,72049,828
2020-09-27,Costa Rica,0,0,72049,828
2020-09-28,Costa Rica,1665,33,73714,861
2020-09-29,Costa Rica,890,19,74604,880
2020-09-30,Costa Rica,1156,24,75760,904
2020-10-01,Costa Rica,1068,13,76828,917
2020-10-02,Costa Rica,1001,13,77829,930
2020-10-03,Costa Rica,1353,20,79182,950
2020-10-04,Costa Rica,0,0,79182,950
2020-10-05,Costa Rica,1947,37,81129,987
2020-10-06,Costa Rica,1013,17,82142,1004
2020-10-07,Costa Rica,1355,20,83497,1024
2020-10-08,Costa Rica,1331,16,84828,1040
2020-10-09,Costa Rica,1225,15,86053,1055
2020-10-10,Costa Rica,1386,21,87439,1076
2020-10-11,Costa Rica,0,0,87439,1076
2020-10-12,Costa Rica,1784,32,89223,1108
2020-10-13,Costa Rica,1015,16,90238,1124
2020-10-14,Costa Rica,1542,10,91780,1134
2020-10-15,Costa Rica,1372,25,93152,1159
2020-10-16,Costa Rica,1196,9,94348,1168
2020-10-17,Costa Rica,1166,15,95514,1183
2020-10-18,Costa Rica,0,0,95514,1183
2020-10-19,Costa Rica,1561,21,97075,1204
2020-10-20,Costa Rica,847,18,97922,1222
2020-10-21,Costa Rica,1503,14,99425,1236
2020-10-22,Costa Rica,1191,15,100616,1251
2020-10-23,Costa Rica,1210,14,101826,1265
2020-10-24,Costa Rica,1262,17,103088,1282
2020-10-25,Costa Rica,0,0,103088,1282
2020-10-26,Costa Rica,1372,30,104460,1312
2020-10-27,Costa Rica,862,17,105322,1329
2020-10-28,Costa Rica,1231,11,106553,1340
2020-10-29,Costa Rica,1017,17,107570,1357
2020-10-30,Costa Rica,1296,14,108866,1371
2020-10-31,Costa Rica,1105,14,109971,1385
2020-11-01,Costa Rica,0,0,109971,1385
2020-11-02,Costa Rica,1286,19,111257,1404
2020-11-03,Costa Rica,863,15,112120,1419
2020-11-04,Costa Rica,1141,12,113261,1431
2020-11-05,Costa Rica,1106,13,114367,1444
2020-11-06,Costa Rica,1050,9,115417,1453
2020-11-07,Costa Rica,946,11,116363,1464
2020-11-08,Costa Rica,0,0,116363,1464
2020-11-09,Costa Rica,1224,27,117587,1491
2020-11-10,Costa Rica,979,11,118566,1502
2020-11-11,Costa Rica,1202,11,119768,1513
2020-11-12,Costa Rica,1171,14,120939,1527
2020-11-13,Costa Rica,1184,10,122123,1537
2020-11-14,Costa Rica,1100,9,123223,1546
2020-11-15,Costa Rica,0,0,123223,1546
2020-11-16,Costa Rica,1369,20,124592,1566
2020-11-17,Costa Rica,998,12,125590,1578
2020-11-18,Costa Rica,1422,10,127012,1588
2020-11-19,Costa Rica,1219,11,128231,1599
2020-11-20,Costa Rica,1187,9,129418,1608
2020-11-21,Costa Rica,0,0,129418,1608
2020-11-22,Costa Rica,0,0,129418,1608
2020-11-23,Costa Rica,2877,33,132295,1641
2020-11-24,Costa Rica,895,21,133190,1662
2020-11-25,Costa Rica,1330,12,134520,1674
2020-11-26,Costa Rica,1222,5,135742,1679
2020-11-27,Costa Rica,1351,11,137093,1690
2020-11-28,Costa Rica,0,0,137093,1690
2020-11-29,Costa Rica,0,0,137093,1690
2020-11-30,Costa Rica,2545,36,139638,1726
2020-12-01,Costa Rica,534,5,140172,1731
2020-12-02,Costa Rica,1168,8,141340,1739
2020-12-03,Costa Rica,1165,18,142505,1757
2020-12-04,Costa Rica,1180,16,143685,1773
2020-12-05,Costa Rica,0,0,143685,1773
2020-12-06,Costa Rica,0,0,143685,1773
2020-12-07,Costa Rica,2736,52,146421,1825
2020-12-08,Costa Rica,1009,21,147430,1846
2020-12-09,Costa Rica,1258,18,148688,1864
2020-12-10,Costa Rica,1127,18,149815,1882
2020-12-11,Costa Rica,1132,13,150947,1895
2020-12-12,Costa Rica,0,0,150947,1895
2020-12-13,Costa Rica,0,0,150947,1895
2020-12-14,Costa Rica,2222,41,153169,1936
2020-12-15,Costa Rica,927,20,154096,1956
2020-12-16,Costa Rica,1167,11,155263,1967
2020-12-17,Costa Rica,1125,13,156388,1980
2020-12-18,Costa Rica,1084,16,157472,1996
2020-12-19,Costa Rica,0,0,157472,1996
2020-12-20,Costa Rica,0,0,157472,1996
2020-12-21,Costa Rica,2421,41,159893,2037
2020-12-22,Costa Rica,911,14,160804,2051
2020-12-23,Costa Rica,1138,14,161942,2065
2020-12-24,Costa Rica,1048,21,162990,2086
2020-12-25,Costa Rica,0,0,162990,2086
2020-12-26,Costa Rica,0,0,162990,2086
2020-12-27,Costa Rica,0,0,162990,2086
2020-12-28,Costa Rica,2772,58,165762,2144
2020-12-29,Costa Rica,1037,12,166799,2156
2020-12-30,Costa Rica,1315,15,168114,2171
2020-12-31,Costa Rica,1207,14,169321,2185
2021-01-01,Costa Rica,0,0,169321,2185
2021-01-02,Costa Rica,0,0,169321,2185
2021-01-03,Costa Rica,0,0,169321,2185
2021-01-04,Costa Rica,3115,44,172436,2229
2021-01-05,Costa Rica,1155,19,173591,2248
2021-01-06,Costa Rica,1447,19,175038,2267
2021-01-07,Costa Rica,1369,19,176407,2286
2021-01-08,Costa Rica,1207,19,177614,2305
2021-01-09,Costa Rica,0,0,177614,2305
2021-01-10,Costa Rica,0,0,177614,2305
2021-01-11,Costa Rica,2447,48,180061,2353
2021-01-12,Costa Rica,1032,14,181093,2367
2021-01-13,Costa Rica,1063,17,182156,2384
2021-01-14,Costa Rica,1086,17,183242,2401
2021-01-15,Costa Rica,945,15,184187,2416
2021-01-16,Costa Rica,0,0,184187,2416
2021-01-17,Costa Rica,0,0,184187,2416
2021-01-18,Costa Rica,1829,42,186016,2458
2021-01-19,Costa Rica,861,19,186877,2477
2021-01-20,Costa Rica,835,15,187712,2492
2021-01-21,Costa Rica,765,14,188477,2506
2021-01-22,Costa Rica,831,12,189308,2518
2021-01-23,Costa Rica,0,0,189308,2518
2021-01-24,Costa Rica,0,0,189308,2518
2021-01-25,Costa Rica,1437,40,190745,2558
2021-01-26,Costa Rica,600,9,191345,2567
2021-01-27,Costa Rica,721,17,192066,2584
2021-01-28,Costa Rica,571,15,192637,2599
2021-01-29,Costa Rica,639,5,193276,2604
2021-01-30,Costa Rica,0,0,193276,2604
2021-01-31,Costa Rica,0,0,193276,2604
2021-02-01,Costa Rica,1293,30,194569,2634
2021-02-02,Costa Rica,440,7,195009,2641
2021-02-03,Costa Rica,528,9,195537,2650
2021-02-04,Costa Rica,455,12,195992,2662
2021-02-05,Costa Rica,446,10,196438,2672
2021-02-06,Costa Rica,0,0,196438,2672
2021-02-07,Costa Rica,0,0,196438,2672
2021-02-08,Costa Rica,997,20,197435,2692
2021-02-09,Costa Rica,417,6,197852,2698
2021-02-10,Costa Rica,486,3,198338,2701
2021-02-11,Costa Rica,418,9,198756,2710
2021-02-12,Costa Rica,431,4,199187,2714
2021-02-13,Costa Rica,0,0,199187,2714
2021-02-14,Costa Rica,0,0,199187,2714
2021-02-15,Costa Rica,837,16,200024,2730
2021-02-16,Costa Rica,430,7,200454,2737
2021-02-17,Costa Rica,434,8,200888,2745
2021-02-18,Costa Rica,353,11,201241,2756
2021-02-19,Costa Rica,437,7,201678,2763
2021-02-20,Costa Rica,0,0,201678,2763
2021-02-21,Costa Rica,0,0,201678,2763
2021-02-22,Costa Rica,996,19,202674,2782
2021-02-23,Costa Rica,423,3,203097,2785
2021-02-24,Costa Rica,399,8,203496,2793
2021-02-25,Costa Rica,418,3,203914,2796
2021-02-26,Costa Rica,427,4,204341,2800
2021-02-27,Costa Rica,0,0,204341,2800
2021-02-28,Costa Rica,0,0,204341,2800
2021-03-01,Costa Rica,745,12,205086,2812
2021-03-02,Costa Rica,428,8,205514,2820
2021-03-03,Costa Rica,376,4,205890,2824
2021-03-04,Costa Rica,403,5,206293,2829
2021-03-05,Costa Rica,347,4,206640,2833
2021-03-06,Costa Rica,0,0,206640,2833
2021-03-07,Costa Rica,0,0,206640,2833
2021-03-08,Costa Rica,0,0,206640,2833
2021-03-09,Costa Rica,1192,15,207832,2848
2021-03-10,Costa Rica,0,0,207832,2848
2021-03-11,Costa Rica,0,0,207832,2848
2021-03-12,Costa Rica,1261,14,209093,2862
2021-03-13,Costa Rica,0,0,209093,2862
2021-03-14,Costa Rica,0,0,209093,2862
2021-03-15,Costa Rica,0,0,209093,2862
2021-03-16,Costa Rica,1354,24,210447,2886
2021-03-17,Costa Rica,0,0,210447,2886
2021-03-18,Costa Rica,0,0,210447,2886
2021-03-19,Costa Rica,1456,10,211903,2896
2021-03-20,Costa Rica,0,0,211903,2896
2021-03-21,Costa Rica,0,0,211903,2896
2021-03-22,Costa Rica,0,0,211903,2896
2021-03-23,Costa Rica,1535,12,213438,2908
2021-03-24,Costa Rica,0,0,213438,2908
2021-03-25,Costa Rica,0,0,213438,2908
2021-03-26,Costa Rica,1740,23,215178,2931
2021-03-27,Costa Rica,0,0,215178,2931
2021-03-28,Costa Rica,0,0,215178,2931
2021-03-29,Costa Rica,0,0,215178,2931
2021-03-30,Costa Rica,1586,26,216764,2957
2021-03-31,Costa Rica,0,0,216764,2957
2021-04-01,Costa Rica,0,0,216764,2957
2021-04-02,Costa Rica,0,0,216764,2957
2021-04-03,Costa Rica,0,0,216764,2957
2021-04-04,Costa Rica,0,0,216764,2957
2021-04-05,Costa Rica,0,0,216764,2957
2021-04-06,Costa Rica,3082,43,219846,3000
2021-04-07,Costa Rica,0,0,219846,3000
2021-04-08,Costa Rica,0,0,219846,3000
2020-03-11,Cote d'Ivoire,1,0,1,0
2020-03-12,Cote d'Ivoire,0,0,1,0
2020-03-13,Cote d'Ivoire,0,0,1,0
2020-03-14,Cote d'Ivoire,0,0,1,0
2020-03-15,Cote d'Ivoire,0,0,1,0
2020-03-16,Cote d'Ivoire,0,0,1,0
2020-03-17,Cote d'Ivoire,4,0,5,0
2020-03-18,Cote d'Ivoire,1,0,6,0
2020-03-19,Cote d'Ivoire,3,0,9,0
2020-03-20,Cote d'Ivoire,0,0,9,0
2020-03-21,Cote d'Ivoire,5,0,14,0
2020-03-22,Cote d'Ivoire,0,0,14,0
2020-03-23,Cote d'Ivoire,11,0,25,0
2020-03-24,Cote d'Ivoire,48,0,73,0
2020-03-25,Cote d'Ivoire,7,0,80,0
2020-03-26,Cote d'Ivoire,16,0,96,0
2020-03-27,Cote d'Ivoire,5,0,101,0
2020-03-28,Cote d'Ivoire,0,0,101,0
2020-03-29,Cote d'Ivoire,64,1,165,1
2020-03-30,Cote d'Ivoire,3,0,168,1
2020-03-31,Cote d'Ivoire,11,0,179,1
2020-04-01,Cote d'Ivoire,11,0,190,1
2020-04-02,Cote d'Ivoire,4,0,194,1
2020-04-03,Cote d'Ivoire,24,0,218,1
2020-04-04,Cote d'Ivoire,27,0,245,1
2020-04-05,Cote d'Ivoire,16,2,261,3
2020-04-06,Cote d'Ivoire,62,0,323,3
2020-04-07,Cote d'Ivoire,26,0,349,3
2020-04-08,Cote d'Ivoire,35,0,384,3
2020-04-09,Cote d'Ivoire,60,0,444,3
2020-04-10,Cote d'Ivoire,0,0,444,3
2020-04-11,Cote d'Ivoire,89,1,533,4
2020-04-12,Cote d'Ivoire,41,1,574,5
2020-04-13,Cote d'Ivoire,52,1,626,6
2020-04-14,Cote d'Ivoire,12,0,638,6
2020-04-15,Cote d'Ivoire,0,0,638,6
2020-04-16,Cote d'Ivoire,16,0,654,6
2020-04-17,Cote d'Ivoire,34,0,688,6
2020-04-18,Cote d'Ivoire,113,2,801,8
2020-04-19,Cote d'Ivoire,46,1,847,9
2020-04-20,Cote d'Ivoire,0,0,847,9
2020-04-21,Cote d'Ivoire,69,4,916,13
2020-04-22,Cote d'Ivoire,36,1,952,14
2020-04-23,Cote d'Ivoire,52,0,1004,14
2020-04-24,Cote d'Ivoire,73,0,1077,14
2020-04-25,Cote d'Ivoire,0,0,1077,14
2020-04-26,Cote d'Ivoire,73,0,1150,14
2020-04-27,Cote d'Ivoire,14,0,1164,14
2020-04-28,Cote d'Ivoire,19,0,1183,14
2020-04-29,Cote d'Ivoire,55,0,1238,14
2020-04-30,Cote d'Ivoire,37,0,1275,14
2020-05-01,Cote d'Ivoire,58,1,1333,15
2020-05-02,Cote d'Ivoire,29,0,1362,15
2020-05-03,Cote d'Ivoire,36,2,1398,17
2020-05-04,Cote d'Ivoire,34,0,1432,17
2020-05-05,Cote d'Ivoire,32,1,1464,18
2020-05-06,Cote d'Ivoire,52,0,1516,18
2020-05-07,Cote d'Ivoire,55,2,1571,20
2020-05-08,Cote d'Ivoire,31,0,1602,20
2020-05-09,Cote d'Ivoire,65,1,1667,21
2020-05-10,Cote d'Ivoire,33,0,1700,21
2020-05-11,Cote d'Ivoire,30,0,1730,21
2020-05-12,Cote d'Ivoire,127,0,1857,21
2020-05-13,Cote d'Ivoire,55,3,1912,24
2020-05-14,Cote d'Ivoire,59,0,1971,24
2020-05-15,Cote d'Ivoire,46,0,2017,24
2020-05-16,Cote d'Ivoire,44,1,2061,25
2020-05-17,Cote d'Ivoire,48,2,2109,27
2020-05-18,Cote d'Ivoire,10,1,2119,28
2020-05-19,Cote d'Ivoire,34,0,2153,28
2020-05-20,Cote d'Ivoire,78,1,2231,29
2020-05-21,Cote d'Ivoire,70,0,2301,29
2020-05-22,Cote d'Ivoire,40,0,2341,29
2020-05-23,Cote d'Ivoire,25,1,2366,30
2020-05-24,Cote d'Ivoire,10,0,2376,30
2020-05-25,Cote d'Ivoire,47,0,2423,30
2020-05-26,Cote d'Ivoire,54,0,2477,30
2020-05-27,Cote d'Ivoire,79,1,2556,31
2020-05-28,Cote d'Ivoire,85,1,2641,32
2020-05-29,Cote d'Ivoire,109,0,2750,32
2020-05-30,Cote d'Ivoire,49,1,2799,33
2020-05-31,Cote d'Ivoire,34,0,2833,33
2020-06-01,Cote d'Ivoire,118,0,2951,33
2020-06-02,Cote d'Ivoire,73,0,3024,33
2020-06-03,Cote d'Ivoire,86,2,3110,35
2020-06-04,Cote d'Ivoire,152,0,3262,35
2020-06-05,Cote d'Ivoire,169,1,3431,36
2020-06-06,Cote d'Ivoire,126,0,3557,36
2020-06-07,Cote d'Ivoire,182,0,3739,36
2020-06-08,Cote d'Ivoire,142,2,3881,38
2020-06-09,Cote d'Ivoire,114,0,3995,38
2020-06-10,Cote d'Ivoire,186,3,4181,41
2020-06-11,Cote d'Ivoire,223,0,4404,41
2020-06-12,Cote d'Ivoire,280,4,4684,45
2020-06-13,Cote d'Ivoire,164,0,4848,45
2020-06-14,Cote d'Ivoire,236,0,5084,45
2020-06-15,Cote d'Ivoire,355,1,5439,46
2020-06-16,Cote d'Ivoire,240,0,5679,46
2020-06-17,Cote d'Ivoire,384,2,6063,48
2020-06-18,Cote d'Ivoire,381,1,6444,49
2020-06-19,Cote d'Ivoire,430,0,6874,49
2020-06-20,Cote d'Ivoire,402,3,7276,52
2020-06-21,Cote d'Ivoire,216,2,7492,54
2020-06-22,Cote d'Ivoire,185,2,7677,56
2020-06-23,Cote d'Ivoire,227,2,7904,58
2020-06-24,Cote d'Ivoire,260,0,8164,58
2020-06-25,Cote d'Ivoire,170,2,8334,60
2020-06-26,Cote d'Ivoire,405,4,8739,64
2020-06-27,Cote d'Ivoire,205,2,8944,66
2020-06-28,Cote d'Ivoire,157,0,9101,66
2020-06-29,Cote d'Ivoire,113,0,9214,66
2020-06-30,Cote d'Ivoire,285,2,9499,68
2020-07-01,Cote d'Ivoire,203,0,9702,68
2020-07-02,Cote d'Ivoire,290,0,9992,68
2020-07-03,Cote d'Ivoire,252,2,10244,70
2020-07-04,Cote d'Ivoire,218,2,10462,72
2020-07-05,Cote d'Ivoire,310,2,10772,74
2020-07-06,Cote d'Ivoire,194,1,10966,75
2020-07-07,Cote d'Ivoire,228,1,11194,76
2020-07-08,Cote d'Ivoire,310,2,11504,78
2020-07-09,Cote d'Ivoire,246,1,11750,79
2020-07-10,Cote d'Ivoire,302,2,12052,81
2020-07-11,Cote d'Ivoire,391,1,12443,82
2020-07-12,Cote d'Ivoire,323,2,12766,84
2020-07-13,Cote d'Ivoire,106,0,12872,84
2020-07-14,Cote d'Ivoire,165,3,13037,87
2020-07-15,Cote d'Ivoire,366,0,13403,87
2020-07-16,Cote d'Ivoire,151,0,13554,87
2020-07-17,Cote d'Ivoire,142,0,13696,87
2020-07-18,Cote d'Ivoire,216,4,13912,91
2020-07-19,Cote d'Ivoire,207,1,14119,92
2020-07-20,Cote d'Ivoire,193,0,14312,92
2020-07-21,Cote d'Ivoire,219,1,14531,93
2020-07-22,Cote d'Ivoire,202,0,14733,93
2020-07-23,Cote d'Ivoire,268,0,15001,93
2020-07-24,Cote d'Ivoire,252,1,15253,94
2020-07-25,Cote d'Ivoire,241,0,15494,94
2020-07-26,Cote d'Ivoire,102,2,15596,96
2020-07-27,Cote d'Ivoire,59,0,15655,96
2020-07-28,Cote d'Ivoire,58,2,15713,98
2020-07-29,Cote d'Ivoire,100,1,15813,99
2020-07-30,Cote d'Ivoire,165,1,15978,100
2020-07-31,Cote d'Ivoire,69,2,16047,102
2020-08-01,Cote d'Ivoire,62,0,16109,102
2020-08-02,Cote d'Ivoire,73,0,16182,102
2020-08-03,Cote d'Ivoire,38,0,16220,102
2020-08-04,Cote d'Ivoire,73,1,16293,103
2020-08-05,Cote d'Ivoire,56,0,16349,103
2020-08-06,Cote d'Ivoire,98,0,16447,103
2020-08-07,Cote d'Ivoire,77,1,16524,104
2020-08-08,Cote d'Ivoire,96,0,16620,104
2020-08-09,Cote d'Ivoire,95,1,16715,105
2020-08-10,Cote d'Ivoire,83,0,16798,105
2020-08-11,Cote d'Ivoire,49,0,16847,105
2020-08-12,Cote d'Ivoire,0,0,16847,105
2020-08-13,Cote d'Ivoire,42,2,16889,107
2020-08-14,Cote d'Ivoire,46,1,16935,108
2020-08-15,Cote d'Ivoire,58,0,16993,108
2020-08-16,Cote d'Ivoire,33,2,17026,110
2020-08-17,Cote d'Ivoire,81,0,17107,110
2020-08-18,Cote d'Ivoire,43,0,17150,110
2020-08-19,Cote d'Ivoire,82,1,17232,111
2020-08-20,Cote d'Ivoire,17,1,17249,112
2020-08-21,Cote d'Ivoire,61,0,17310,112
2020-08-22,Cote d'Ivoire,64,1,17374,113
2020-08-23,Cote d'Ivoire,97,0,17471,113
2020-08-24,Cote d'Ivoire,35,1,17506,114
2020-08-25,Cote d'Ivoire,56,0,17562,114
2020-08-26,Cote d'Ivoire,41,0,17603,114
2020-08-27,Cote d'Ivoire,99,1,17702,115
2020-08-28,Cote d'Ivoire,95,0,17797,115
2020-08-29,Cote d'Ivoire,96,0,17893,115
2020-08-30,Cote d'Ivoire,55,0,17948,115
2020-08-31,Cote d'Ivoire,119,2,18067,117
2020-09-01,Cote d'Ivoire,36,0,18103,117
2020-09-02,Cote d'Ivoire,58,0,18161,117
2020-09-03,Cote d'Ivoire,47,2,18208,119
2020-09-04,Cote d'Ivoire,61,0,18269,119
2020-09-05,Cote d'Ivoire,203,0,18472,119
2020-09-06,Cote d'Ivoire,116,0,18588,119
2020-09-07,Cote d'Ivoire,113,0,18701,119
2020-09-08,Cote d'Ivoire,77,0,18778,119
2020-09-09,Cote d'Ivoire,37,0,18815,119
2020-09-10,Cote d'Ivoire,54,0,18869,119
2020-09-11,Cote d'Ivoire,47,0,18916,119
2020-09-12,Cote d'Ivoire,0,0,18916,119
2020-09-13,Cote d'Ivoire,97,1,19013,120
2020-09-14,Cote d'Ivoire,53,0,19066,120
2020-09-15,Cote d'Ivoire,34,0,19100,120
2020-09-16,Cote d'Ivoire,32,0,19132,120
2020-09-17,Cote d'Ivoire,26,0,19158,120
2020-09-18,Cote d'Ivoire,42,0,19200,120
2020-09-19,Cote d'Ivoire,69,0,19269,120
2020-09-20,Cote d'Ivoire,51,0,19320,120
2020-09-21,Cote d'Ivoire,7,0,19327,120
2020-09-22,Cote d'Ivoire,16,0,19343,120
2020-09-23,Cote d'Ivoire,87,0,19430,120
2020-09-24,Cote d'Ivoire,71,0,19501,120
2020-09-25,Cote d'Ivoire,55,0,19556,120
2020-09-26,Cote d'Ivoire,44,0,19600,120
2020-09-27,Cote d'Ivoire,29,0,19629,120
2020-09-28,Cote d'Ivoire,12,0,19641,120
2020-09-29,Cote d'Ivoire,28,0,19669,120
2020-09-30,Cote d'Ivoire,55,0,19724,120
2020-10-01,Cote d'Ivoire,31,0,19755,120
2020-10-02,Cote d'Ivoire,38,0,19793,120
2020-10-03,Cote d'Ivoire,56,0,19849,120
2020-10-04,Cote d'Ivoire,33,0,19882,120
2020-10-05,Cote d'Ivoire,3,0,19885,120
2020-10-06,Cote d'Ivoire,18,0,19903,120
2020-10-07,Cote d'Ivoire,32,0,19935,120
2020-10-08,Cote d'Ivoire,47,0,19982,120
2020-10-09,Cote d'Ivoire,54,0,20036,120
2020-10-10,Cote d'Ivoire,92,0,20128,120
2020-10-11,Cote d'Ivoire,26,0,20154,120
2020-10-12,Cote d'Ivoire,1,0,20155,120
2020-10-13,Cote d'Ivoire,28,0,20183,120
2020-10-14,Cote d'Ivoire,34,0,20217,120
2020-10-15,Cote d'Ivoire,40,0,20257,120
2020-10-16,Cote d'Ivoire,18,1,20275,121
2020-10-17,Cote d'Ivoire,26,0,20301,121
2020-10-18,Cote d'Ivoire,22,0,20323,121
2020-10-19,Cote d'Ivoire,1,0,20324,121
2020-10-20,Cote d'Ivoire,18,0,20342,121
2020-10-21,Cote d'Ivoire,21,0,20363,121
2020-10-22,Cote d'Ivoire,27,0,20390,121
2020-10-23,Cote d'Ivoire,15,0,20405,121
2020-10-24,Cote d'Ivoire,24,0,20429,121
2020-10-25,Cote d'Ivoire,41,1,20470,122
2020-10-26,Cote d'Ivoire,16,0,20486,122
2020-10-27,Cote d'Ivoire,2,0,20488,122
2020-10-28,Cote d'Ivoire,67,2,20555,124
2020-10-29,Cote d'Ivoire,73,0,20628,124
2020-10-30,Cote d'Ivoire,64,0,20692,124
2020-10-31,Cote d'Ivoire,24,2,20716,126
2020-11-01,Cote d'Ivoire,0,0,20716,126
2020-11-02,Cote d'Ivoire,37,0,20753,126
2020-11-03,Cote d'Ivoire,12,0,20765,126
2020-11-04,Cote d'Ivoire,13,0,20778,126
2020-11-05,Cote d'Ivoire,11,0,20789,126
2020-11-06,Cote d'Ivoire,12,0,20801,126
2020-11-07,Cote d'Ivoire,12,0,20813,126
2020-11-08,Cote d'Ivoire,19,0,20832,126
2020-11-09,Cote d'Ivoire,3,0,20835,126
2020-11-10,Cote d'Ivoire,12,0,20847,126
2020-11-11,Cote d'Ivoire,8,1,20855,127
2020-11-12,Cote d'Ivoire,27,0,20882,127
2020-11-13,Cote d'Ivoire,17,0,20899,127
2020-11-14,Cote d'Ivoire,46,0,20945,127
2020-11-15,Cote d'Ivoire,31,1,20976,128
2020-11-16,Cote d'Ivoire,12,0,20988,128
2020-11-17,Cote d'Ivoire,16,1,21004,129
2020-11-18,Cote d'Ivoire,41,0,21045,129
2020-11-19,Cote d'Ivoire,38,0,21083,129
2020-11-20,Cote d'Ivoire,16,0,21099,129
2020-11-21,Cote d'Ivoire,27,0,21126,129
2020-11-22,Cote d'Ivoire,12,2,21138,131
2020-11-23,Cote d'Ivoire,10,0,21148,131
2020-11-24,Cote d'Ivoire,8,0,21156,131
2020-11-25,Cote d'Ivoire,12,0,21168,131
2020-11-26,Cote d'Ivoire,31,0,21199,131
2020-11-27,Cote d'Ivoire,33,0,21232,131
2020-11-28,Cote d'Ivoire,29,0,21261,131
2020-11-29,Cote d'Ivoire,49,0,21310,131
2020-11-30,Cote d'Ivoire,21,1,21331,132
2020-12-01,Cote d'Ivoire,3,0,21334,132
2020-12-02,Cote d'Ivoire,27,0,21361,132
2020-12-03,Cote d'Ivoire,28,0,21389,132
2020-12-04,Cote d'Ivoire,23,0,21412,132
2020-12-05,Cote d'Ivoire,29,0,21441,132
2020-12-06,Cote d'Ivoire,44,0,21485,132
2020-12-07,Cote d'Ivoire,22,0,21507,132
2020-12-08,Cote d'Ivoire,6,0,21513,132
2020-12-09,Cote d'Ivoire,34,1,21547,133
2020-12-10,Cote d'Ivoire,43,0,21590,133
2020-12-11,Cote d'Ivoire,28,0,21618,133
2020-12-12,Cote d'Ivoire,21,0,21639,133
2020-12-13,Cote d'Ivoire,41,0,21680,133
2020-12-14,Cote d'Ivoire,25,0,21705,133
2020-12-15,Cote d'Ivoire,70,0,21775,133
2020-12-16,Cote d'Ivoire,-34,0,21741,133
2020-12-17,Cote d'Ivoire,31,0,21772,133
2020-12-18,Cote d'Ivoire,73,0,21845,133
2020-12-19,Cote d'Ivoire,45,0,21890,133
2020-12-20,Cote d'Ivoire,28,0,21918,133
2020-12-21,Cote d'Ivoire,14,0,21932,133
2020-12-22,Cote d'Ivoire,10,0,21942,133
2020-12-23,Cote d'Ivoire,42,0,21984,133
2020-12-24,Cote d'Ivoire,87,0,22071,133
2020-12-25,Cote d'Ivoire,10,0,22081,133
2020-12-26,Cote d'Ivoire,0,0,22081,133
2020-12-27,Cote d'Ivoire,71,2,22152,135
2020-12-28,Cote d'Ivoire,24,2,22176,137
2020-12-29,Cote d'Ivoire,74,0,22250,137
2020-12-30,Cote d'Ivoire,116,0,22366,137
2020-12-31,Cote d'Ivoire,124,0,22490,137
2021-01-01,Cote d'Ivoire,73,1,22563,138
2021-01-02,Cote d'Ivoire,0,0,22563,138
2021-01-03,Cote d'Ivoire,85,0,22648,138
2021-01-04,Cote d'Ivoire,152,0,22800,138
2021-01-05,Cote d'Ivoire,55,0,22855,138
2021-01-06,Cote d'Ivoire,108,0,22963,138
2021-01-07,Cote d'Ivoire,210,0,23173,138
2021-01-08,Cote d'Ivoire,81,1,23254,139
2021-01-09,Cote d'Ivoire,228,0,23482,139
2021-01-10,Cote d'Ivoire,268,0,23750,139
2021-01-11,Cote d'Ivoire,144,0,23894,139
2021-01-12,Cote d'Ivoire,292,1,24186,140
2021-01-13,Cote d'Ivoire,183,0,24369,140
2021-01-14,Cote d'Ivoire,209,0,24578,140
2021-01-15,Cote d'Ivoire,278,1,24856,141
2021-01-16,Cote d'Ivoire,0,0,24856,141
2021-01-17,Cote d'Ivoire,385,0,25241,141
2021-01-18,Cote d'Ivoire,63,1,25304,142
2021-01-19,Cote d'Ivoire,79,0,25383,142
2021-01-20,Cote d'Ivoire,214,0,25597,142
2021-01-21,Cote d'Ivoire,154,0,25751,142
2021-01-22,Cote d'Ivoire,564,1,26315,143
2021-01-23,Cote d'Ivoire,297,2,26612,145
2021-01-24,Cote d'Ivoire,238,1,26850,146
2021-01-25,Cote d'Ivoire,246,0,27096,146
2021-01-26,Cote d'Ivoire,141,1,27237,147
2021-01-27,Cote d'Ivoire,218,4,27455,151
2021-01-28,Cote d'Ivoire,239,0,27694,151
2021-01-29,Cote d'Ivoire,240,1,27934,152
2021-01-30,Cote d'Ivoire,244,0,28178,152
2021-01-31,Cote d'Ivoire,221,2,28399,154
2021-02-01,Cote d'Ivoire,76,2,28475,156
2021-02-02,Cote d'Ivoire,132,2,28607,158
2021-02-03,Cote d'Ivoire,132,0,28739,158
2021-02-04,Cote d'Ivoire,363,0,29102,158
2021-02-05,Cote d'Ivoire,193,2,29295,160
2021-02-06,Cote d'Ivoire,272,2,29567,162
2021-02-07,Cote d'Ivoire,258,0,29825,162
2021-02-08,Cote d'Ivoire,142,3,29967,165
2021-02-09,Cote d'Ivoire,0,0,29967,165
2021-02-10,Cote d'Ivoire,273,4,30240,169
2021-02-11,Cote d'Ivoire,286,2,30526,171
2021-02-12,Cote d'Ivoire,191,2,30717,173
2021-02-13,Cote d'Ivoire,167,0,30884,173
2021-02-14,Cote d'Ivoire,256,1,31140,174
2021-02-15,Cote d'Ivoire,95,1,31235,175
2021-02-16,Cote d'Ivoire,130,4,31365,179
2021-02-17,Cote d'Ivoire,132,1,31497,180
2021-02-18,Cote d'Ivoire,115,3,31612,183
2021-02-19,Cote d'Ivoire,213,2,31825,185
2021-02-20,Cote d'Ivoire,89,0,31914,185
2021-02-21,Cote d'Ivoire,112,1,32026,186
2021-02-22,Cote d'Ivoire,13,2,32039,188
2021-02-23,Cote d'Ivoire,85,0,32124,188
2021-02-24,Cote d'Ivoire,171,0,32295,188
2021-02-25,Cote d'Ivoire,0,0,32295,188
2021-02-26,Cote d'Ivoire,183,2,32478,190
2021-02-27,Cote d'Ivoire,153,2,32631,192
2021-02-28,Cote d'Ivoire,123,0,32754,192
2021-03-01,Cote d'Ivoire,37,1,32791,193
2021-03-02,Cote d'Ivoire,138,0,32929,193
2021-03-03,Cote d'Ivoire,356,1,33285,194
2021-03-04,Cote d'Ivoire,691,2,33976,196
2021-03-05,Cote d'Ivoire,436,3,34412,199
2021-03-06,Cote d'Ivoire,523,1,34935,200
2021-03-07,Cote d'Ivoire,252,2,35187,202
2021-03-08,Cote d'Ivoire,144,2,35331,204
2021-03-09,Cote d'Ivoire,146,2,35477,206
2021-03-10,Cote d'Ivoire,551,0,36028,206
2021-03-11,Cote d'Ivoire,483,3,36511,209
2021-03-12,Cote d'Ivoire,313,2,36824,211
2021-03-13,Cote d'Ivoire,480,0,37304,211
2021-03-14,Cote d'Ivoire,349,0,37653,211
2021-03-15,Cote d'Ivoire,255,2,37908,213
2021-03-16,Cote d'Ivoire,212,1,38120,214
2021-03-17,Cote d'Ivoire,162,0,38282,214
2021-03-18,Cote d'Ivoire,641,1,38923,215
2021-03-19,Cote d'Ivoire,511,1,39434,216
2021-03-20,Cote d'Ivoire,479,1,39913,217
2021-03-21,Cote d'Ivoire,397,3,40310,220
2021-03-22,Cote d'Ivoire,291,2,40601,222
2021-03-23,Cote d'Ivoire,267,0,40868,222
2021-03-24,Cote d'Ivoire,439,2,41307,224
2021-03-25,Cote d'Ivoire,767,5,42074,229
2021-03-26,Cote d'Ivoire,394,0,42468,229
2021-03-27,Cote d'Ivoire,393,3,42861,232
2021-03-28,Cote d'Ivoire,319,5,43180,237
2021-03-29,Cote d'Ivoire,242,2,43422,239
2021-03-30,Cote d'Ivoire,120,3,43542,242
2021-03-31,Cote d'Ivoire,347,2,43889,244
2021-04-01,Cote d'Ivoire,0,0,43889,244
2021-04-02,Cote d'Ivoire,556,6,44445,250
2021-04-03,Cote d'Ivoire,173,2,44618,252
2021-04-04,Cote d'Ivoire,131,3,44749,255
2021-04-05,Cote d'Ivoire,92,1,44841,256
2021-04-06,Cote d'Ivoire,13,0,44854,256
2021-04-07,Cote d'Ivoire,26,1,44880,257
2021-04-08,Cote d'Ivoire,95,1,44975,258
2020-02-25,Croatia,1,0,1,0
2020-02-26,Croatia,2,0,3,0
2020-02-27,Croatia,0,0,3,0
2020-02-28,Croatia,2,0,5,0
2020-02-29,Croatia,1,0,6,0
2020-03-01,Croatia,1,0,7,0
2020-03-02,Croatia,0,0,7,0
2020-03-03,Croatia,2,0,9,0
2020-03-04,Croatia,1,0,10,0
2020-03-05,Croatia,0,0,10,0
2020-03-06,Croatia,1,0,11,0
2020-03-07,Croatia,1,0,12,0
2020-03-08,Croatia,0,0,12,0
2020-03-09,Croatia,0,0,12,0
2020-03-10,Croatia,2,0,14,0
2020-03-11,Croatia,5,0,19,0
2020-03-12,Croatia,0,0,19,0
2020-03-13,Croatia,13,0,32,0
2020-03-14,Croatia,6,0,38,0
2020-03-15,Croatia,11,0,49,0
2020-03-16,Croatia,8,0,57,0
2020-03-17,Croatia,8,0,65,0
2020-03-18,Croatia,16,0,81,0
2020-03-19,Croatia,24,1,105,1
2020-03-20,Croatia,23,0,128,1
2020-03-21,Croatia,78,0,206,1
2020-03-22,Croatia,48,0,254,1
2020-03-23,Croatia,61,0,315,1
2020-03-24,Croatia,67,0,382,1
2020-03-25,Croatia,60,0,442,1
2020-03-26,Croatia,53,2,495,3
2020-03-27,Croatia,91,0,586,3
2020-03-28,Croatia,71,2,657,5
2020-03-29,Croatia,56,1,713,6
2020-03-30,Croatia,77,0,790,6
2020-03-31,Croatia,77,0,867,6
2020-04-01,Croatia,96,0,963,6
2020-04-02,Croatia,48,1,1011,7
2020-04-03,Croatia,68,1,1079,8
2020-04-04,Croatia,47,4,1126,12
2020-04-05,Croatia,56,3,1182,15
2020-04-06,Croatia,40,1,1222,16
2020-04-07,Croatia,60,2,1282,18
2020-04-08,Croatia,61,1,1343,19
2020-04-09,Croatia,64,1,1407,20
2020-04-10,Croatia,88,1,1495,21
2020-04-11,Croatia,39,0,1534,21
2020-04-12,Croatia,66,2,1600,23
2020-04-13,Croatia,50,2,1650,25
2020-04-14,Croatia,54,6,1704,31
2020-04-15,Croatia,37,2,1741,33
2020-04-16,Croatia,50,2,1791,35
2020-04-17,Croatia,23,1,1814,36
2020-04-18,Croatia,18,3,1832,39
2020-04-19,Croatia,39,8,1871,47
2020-04-20,Croatia,10,0,1881,47
2020-04-21,Croatia,27,1,1908,48
2020-04-22,Croatia,42,0,1950,48
2020-04-23,Croatia,31,2,1981,50
2020-04-24,Croatia,28,1,2009,51
2020-04-25,Croatia,7,3,2016,54
2020-04-26,Croatia,14,1,2030,55
2020-04-27,Croatia,9,4,2039,59
2020-04-28,Croatia,8,4,2047,63
2020-04-29,Croatia,15,4,2062,67
2020-04-30,Croatia,14,2,2076,69
2020-05-01,Croatia,9,6,2085,75
2020-05-02,Croatia,3,2,2088,77
2020-05-03,Croatia,8,2,2096,79
2020-05-04,Croatia,5,1,2101,80
2020-05-05,Croatia,11,3,2112,83
2020-05-06,Croatia,7,2,2119,85
2020-05-07,Croatia,6,1,2125,86
2020-05-08,Croatia,36,0,2161,86
2020-05-09,Croatia,15,1,2176,87
2020-05-10,Croatia,11,3,2187,90
2020-05-11,Croatia,9,1,2196,91
2020-05-12,Croatia,11,0,2207,91
2020-05-13,Croatia,6,3,2213,94
2020-05-14,Croatia,8,0,2221,94
2020-05-15,Croatia,1,1,2222,95
2020-05-16,Croatia,2,0,2224,95
2020-05-17,Croatia,2,0,2226,95
2020-05-18,Croatia,2,0,2228,95
2020-05-19,Croatia,4,1,2232,96
2020-05-20,Croatia,2,0,2234,96
2020-05-21,Croatia,3,1,2237,97
2020-05-22,Croatia,6,2,2243,99
2020-05-23,Croatia,0,0,2243,99
2020-05-24,Croatia,1,0,2244,99
2020-05-25,Croatia,0,1,2244,100
2020-05-26,Croatia,0,1,2244,101
2020-05-27,Croatia,0,0,2244,101
2020-05-28,Croatia,1,1,2245,102
2020-05-29,Croatia,0,1,2245,103
2020-05-30,Croatia,1,0,2246,103
2020-05-31,Croatia,0,0,2246,103
2020-06-01,Croatia,0,0,2246,103
2020-06-02,Croatia,0,0,2246,103
2020-06-03,Croatia,0,0,2246,103
2020-06-04,Croatia,1,0,2247,103
2020-06-05,Croatia,0,0,2247,103
2020-06-06,Croatia,0,1,2247,104
2020-06-07,Croatia,0,0,2247,104
2020-06-08,Croatia,0,0,2247,104
2020-06-09,Croatia,0,2,2247,106
2020-06-10,Croatia,2,0,2249,106
2020-06-11,Croatia,0,0,2249,106
2020-06-12,Croatia,0,1,2249,107
2020-06-13,Croatia,2,0,2251,107
2020-06-14,Croatia,1,0,2252,107
2020-06-15,Croatia,2,0,2254,107
2020-06-16,Croatia,1,0,2255,107
2020-06-17,Croatia,3,0,2258,107
2020-06-18,Croatia,11,0,2269,107
2020-06-19,Croatia,11,0,2280,107
2020-06-20,Croatia,19,0,2299,107
2020-06-21,Croatia,18,0,2317,107
2020-06-22,Croatia,19,0,2336,107
2020-06-23,Croatia,30,0,2366,107
2020-06-24,Croatia,22,0,2388,107
2020-06-25,Croatia,95,0,2483,107
2020-06-26,Croatia,56,0,2539,107
2020-06-27,Croatia,85,0,2624,107
2020-06-28,Croatia,67,0,2691,107
2020-06-29,Croatia,34,0,2725,107
2020-06-30,Croatia,52,0,2777,107
2020-07-01,Croatia,54,1,2831,108
2020-07-02,Croatia,81,2,2912,110
2020-07-03,Croatia,96,2,3008,112
2020-07-04,Croatia,86,1,3094,113
2020-07-05,Croatia,57,0,3151,113
2020-07-06,Croatia,69,0,3220,113
2020-07-07,Croatia,52,0,3272,113
2020-07-08,Croatia,53,1,3325,114
2020-07-09,Croatia,91,1,3416,115
2020-07-10,Croatia,116,2,3532,117
2020-07-11,Croatia,140,1,3672,118
2020-07-12,Croatia,50,1,3722,119
2020-07-13,Croatia,53,0,3775,119
2020-07-14,Croatia,52,1,3827,120
2020-07-15,Croatia,126,0,3953,120
2020-07-16,Croatia,86,0,4039,120
2020-07-17,Croatia,98,0,4137,120
2020-07-18,Croatia,116,0,4253,120
2020-07-19,Croatia,92,0,4345,120
2020-07-20,Croatia,25,2,4370,122
2020-07-21,Croatia,52,1,4422,123
2020-07-22,Croatia,108,2,4530,125
2020-07-23,Croatia,104,3,4634,128
2020-07-24,Croatia,81,0,4715,128
2020-07-25,Croatia,77,5,4792,133
2020-07-26,Croatia,65,3,4857,136
2020-07-27,Croatia,24,3,4881,139
2020-07-28,Croatia,42,1,4923,140
2020-07-29,Croatia,70,1,4993,141
2020-07-30,Croatia,78,3,5071,144
2020-07-31,Croatia,68,1,5139,145
2020-08-01,Croatia,85,0,5224,145
2020-08-02,Croatia,36,4,5260,149
2020-08-03,Croatia,34,4,5294,153
2020-08-04,Croatia,24,1,5318,154
2020-08-05,Croatia,58,0,5376,154
2020-08-06,Croatia,28,1,5404,155
2020-08-07,Croatia,62,0,5466,155
2020-08-08,Croatia,77,2,5543,157
2020-08-09,Croatia,61,0,5604,157
2020-08-10,Croatia,45,1,5649,158
2020-08-11,Croatia,91,2,5740,160
2020-08-12,Croatia,130,0,5870,160
2020-08-13,Croatia,180,1,6050,161
2020-08-14,Croatia,208,2,6258,163
2020-08-15,Croatia,162,2,6420,165
2020-08-16,Croatia,151,1,6571,166
2020-08-17,Croatia,85,0,6656,166
2020-08-18,Croatia,199,0,6855,166
2020-08-19,Croatia,219,2,7074,168
2020-08-20,Croatia,255,0,7329,168
2020-08-21,Croatia,265,1,7594,169
2020-08-22,Croatia,306,1,7900,170
2020-08-23,Croatia,275,1,8175,171
2020-08-24,Croatia,136,2,8311,173
2020-08-25,Croatia,219,2,8530,175
2020-08-26,Croatia,358,0,8888,175
2020-08-27,Croatia,304,2,9192,177
2020-08-28,Croatia,357,3,9549,180
2020-08-29,Croatia,312,3,9861,183
2020-08-30,Croatia,262,1,10123,184
2020-08-31,Croatia,146,2,10269,186
2020-09-01,Croatia,145,1,10414,187
2020-09-02,Croatia,311,4,10725,191
2020-09-03,Croatia,369,3,11094,194
2020-09-04,Croatia,334,1,11428,195
2020-09-05,Croatia,311,2,11739,197
2020-09-06,Croatia,225,1,11964,198
2020-09-07,Croatia,117,3,12081,201
2020-09-08,Croatia,204,2,12285,203
2020-09-09,Croatia,341,3,12626,206
2020-09-10,Croatia,291,2,12917,208
2020-09-11,Croatia,190,3,13107,211
2020-09-12,Croatia,261,7,13368,218
2020-09-13,Croatia,165,6,13533,224
2020-09-14,Croatia,65,3,13598,227
2020-09-15,Croatia,151,3,13749,230
2020-09-16,Croatia,280,6,14029,236
2020-09-17,Croatia,250,2,14279,238
2020-09-18,Croatia,234,6,14513,244
2020-09-19,Croatia,212,0,14725,244
2020-09-20,Croatia,197,4,14922,248
2020-09-21,Croatia,70,5,14992,253
2020-09-22,Croatia,144,2,15136,255
2020-09-23,Croatia,204,2,15340,257
2020-09-24,Croatia,232,4,15572,261
2020-09-25,Croatia,223,5,15795,266
2020-09-26,Croatia,212,3,16007,269
2020-09-27,Croatia,190,3,16197,272
2020-09-28,Croatia,48,0,16245,272
2020-09-29,Croatia,135,3,16380,275
2020-09-30,Croatia,213,5,16593,280
2020-10-01,Croatia,234,4,16827,284
2020-10-02,Croatia,333,7,17160,291
2020-10-03,Croatia,241,2,17401,293
2020-10-04,Croatia,258,5,17659,298
2020-10-05,Croatia,138,2,17797,300
2020-10-06,Croatia,287,4,18084,304
2020-10-07,Croatia,363,5,18447,309
2020-10-08,Croatia,542,1,18989,310
2020-10-09,Croatia,457,3,19446,313
2020-10-10,Croatia,486,4,19932,317
2020-10-11,Croatia,508,7,20440,324
2020-10-12,Croatia,181,3,20621,327
2020-10-13,Croatia,372,3,20993,330
2020-10-14,Croatia,748,4,21741,334
2020-10-15,Croatia,793,10,22534,344
2020-10-16,Croatia,1131,1,23665,345
2020-10-17,Croatia,1096,10,24761,355
2020-10-18,Croatia,819,8,25580,363
2020-10-19,Croatia,393,11,25973,374
2020-10-20,Croatia,890,8,26863,382
2020-10-21,Croatia,1424,11,28287,393
2020-10-22,Croatia,1563,13,29850,406
2020-10-23,Croatia,1867,7,31717,413
2020-10-24,Croatia,2242,16,33959,429
2020-10-25,Croatia,2421,8,36380,437
2020-10-26,Croatia,828,15,37208,452
2020-10-27,Croatia,1413,18,38621,470
2020-10-28,Croatia,2378,23,40999,493
2020-10-29,Croatia,2776,18,43775,511
2020-10-30,Croatia,2772,20,46547,531
2020-10-31,Croatia,2769,15,49316,546
2020-11-01,Croatia,2179,16,51495,562
2020-11-02,Croatia,1165,32,52660,594
2020-11-03,Croatia,1427,34,54087,628
2020-11-04,Croatia,2480,26,56567,654
2020-11-05,Croatia,2848,29,59415,683
2020-11-06,Croatia,2890,34,62305,717
2020-11-07,Croatia,2399,35,64704,752
2020-11-08,Croatia,2543,42,67247,794
2020-11-09,Croatia,1529,38,68776,832
2020-11-10,Croatia,1467,33,70243,865
2020-11-11,Croatia,2597,28,72840,893
2020-11-12,Croatia,3082,32,75922,925
2020-11-13,Croatia,3056,43,78978,968
2020-11-14,Croatia,2866,38,81844,1006
2020-11-15,Croatia,2362,43,84206,1049
2020-11-16,Croatia,1313,33,85519,1082
2020-11-17,Croatia,1945,31,87464,1113
2020-11-18,Croatia,3251,38,90715,1151
2020-11-19,Croatia,3164,49,93879,1200
2020-11-20,Croatia,2958,57,96837,1257
2020-11-21,Croatia,3573,47,100410,1304
2020-11-22,Croatia,3308,49,103718,1353
2020-11-23,Croatia,1973,45,105691,1398
2020-11-24,Croatia,2323,47,108014,1445
2020-11-25,Croatia,3603,56,111617,1501
2020-11-26,Croatia,4009,51,115626,1552
2020-11-27,Croatia,4080,48,119706,1600
2020-11-28,Croatia,3987,55,123693,1655
2020-11-29,Croatia,2919,57,126612,1712
2020-11-30,Croatia,1830,74,128442,1786
2020-12-01,Croatia,2900,75,131342,1861
2020-12-02,Croatia,3539,55,134881,1916
2020-12-03,Croatia,4534,48,139415,1964
2020-12-04,Croatia,3955,68,143370,2032
2020-12-05,Croatia,4084,70,147454,2102
2020-12-06,Croatia,2899,72,150353,2174
2020-12-07,Croatia,1886,59,152239,2233
2020-12-08,Croatia,2613,65,154852,2298
2020-12-09,Croatia,4520,69,159372,2367
2020-12-10,Croatia,4620,53,163992,2420
2020-12-11,Croatia,4396,64,168388,2484
2020-12-12,Croatia,4135,78,172523,2562
2020-12-13,Croatia,3363,78,175886,2640
2020-12-14,Croatia,1472,65,177358,2705
2020-12-15,Croatia,2360,73,179718,2778
2020-12-16,Croatia,3327,92,183045,2870
2020-12-17,Croatia,3918,85,186963,2955
2020-12-18,Croatia,3272,68,190235,3023
2020-12-19,Croatia,2752,78,192987,3101
2020-12-20,Croatia,1975,76,194962,3177
2020-12-21,Croatia,766,80,195728,3257
2020-12-22,Croatia,1595,71,197323,3328
2020-12-23,Croatia,2763,66,200086,3394
2020-12-24,Croatia,2233,70,202319,3464
2020-12-25,Croatia,1643,84,203962,3548
2020-12-26,Croatia,350,65,204312,3613
2020-12-27,Croatia,618,58,204930,3671
2020-12-28,Croatia,316,68,205246,3739
2020-12-29,Croatia,1350,56,206596,3795
2020-12-30,Croatia,1850,65,208446,3860
2020-12-31,Croatia,2391,60,210837,3920
2021-01-01,Croatia,1170,41,212007,3961
2021-01-02,Croatia,255,55,212262,4016
2021-01-03,Croatia,696,56,212958,4072
2021-01-04,Croatia,361,54,213319,4126
2021-01-05,Croatia,1071,53,214390,4179
2021-01-06,Croatia,1896,44,216286,4223
2021-01-07,Croatia,562,43,216848,4266
2021-01-08,Croatia,1098,38,217946,4304
2021-01-09,Croatia,1401,38,219347,4342
2021-01-10,Croatia,646,26,219993,4368
2021-01-11,Croatia,230,35,220223,4403
2021-01-12,Croatia,759,43,220982,4446
2021-01-13,Croatia,1135,26,222117,4472
2021-01-14,Croatia,980,45,223097,4517
2021-01-15,Croatia,715,33,223812,4550
2021-01-16,Croatia,763,38,224575,4588
2021-01-17,Croatia,379,28,224954,4616
2021-01-18,Croatia,174,39,225128,4655
2021-01-19,Croatia,520,29,225648,4684
2021-01-20,Croatia,902,27,226550,4711
2021-01-21,Croatia,776,27,227326,4738
2021-01-22,Croatia,643,32,227969,4770
2021-01-23,Croatia,599,29,228568,4799
2021-01-24,Croatia,352,28,228920,4827
2021-01-25,Croatia,134,32,229054,4859
2021-01-26,Croatia,448,23,229502,4882
2021-01-27,Croatia,857,31,230359,4913
2021-01-28,Croatia,619,30,230978,4943
2021-01-29,Croatia,561,29,231539,4972
2021-01-30,Croatia,551,26,232090,4998
2021-01-31,Croatia,336,29,232426,5027
2021-02-01,Croatia,94,27,232520,5054
2021-02-02,Croatia,387,17,232907,5071
2021-02-03,Croatia,730,17,233637,5088
2021-02-04,Croatia,516,18,234153,5106
2021-02-05,Croatia,549,16,234702,5122
2021-02-06,Croatia,424,22,235126,5144
2021-02-07,Croatia,276,25,235402,5169
2021-02-08,Croatia,71,29,235473,5198
2021-02-09,Croatia,283,26,235756,5224
2021-02-10,Croatia,577,14,236333,5238
2021-02-11,Croatia,376,25,236709,5263
2021-02-12,Croatia,371,19,237080,5282
2021-02-13,Croatia,379,17,237459,5299
2021-02-14,Croatia,198,19,237657,5318
2021-02-15,Croatia,68,21,237725,5339
2021-02-16,Croatia,274,18,237999,5357
2021-02-17,Croatia,502,18,238501,5375
2021-02-18,Croatia,365,24,238866,5399
2021-02-19,Croatia,388,8,239254,5407
2021-02-20,Croatia,431,13,239685,5420
2021-02-21,Croatia,260,9,239945,5429
2021-02-22,Croatia,72,20,240017,5449
2021-02-23,Croatia,343,13,240360,5462
2021-02-24,Croatia,688,15,241048,5477
2021-02-25,Croatia,544,12,241592,5489
2021-02-26,Croatia,505,14,242097,5503
2021-02-27,Croatia,520,8,242617,5511
2021-02-28,Croatia,356,15,242973,5526
2021-03-01,Croatia,91,11,243064,5537
2021-03-02,Croatia,394,11,243458,5548
2021-03-03,Croatia,747,7,244205,5555
2021-03-04,Croatia,667,9,244872,5564
2021-03-05,Croatia,590,6,245462,5570
2021-03-06,Croatia,658,15,246120,5585
2021-03-07,Croatia,394,5,246514,5590
2021-03-08,Croatia,94,19,246608,5609
2021-03-09,Croatia,491,12,247099,5621
2021-03-10,Croatia,962,4,248061,5625
2021-03-11,Croatia,777,10,248838,5635
2021-03-12,Croatia,823,12,249661,5647
2021-03-13,Croatia,823,23,250484,5670
2021-03-14,Croatia,561,7,251045,5677
2021-03-15,Croatia,129,8,251174,5685
2021-03-16,Croatia,691,12,251865,5697
2021-03-17,Croatia,1445,12,253310,5709
2021-03-18,Croatia,1197,17,254507,5726
2021-03-19,Croatia,1112,17,255619,5743
2021-03-20,Croatia,1186,10,256805,5753
2021-03-21,Croatia,834,20,257639,5773
2021-03-22,Croatia,150,13,257789,5786
2021-03-23,Croatia,956,22,258745,5808
2021-03-24,Croatia,1891,20,260636,5828
2021-03-25,Croatia,1673,10,262309,5838
2021-03-26,Croatia,1802,16,264111,5854
2021-03-27,Croatia,1790,18,265901,5872
2021-03-28,Croatia,1321,21,267222,5893
2021-03-29,Croatia,300,18,267522,5911
2021-03-30,Croatia,1487,17,269009,5928
2021-03-31,Croatia,2623,19,271632,5947
2021-04-01,Croatia,2422,20,274054,5967
2021-04-02,Croatia,2362,29,276416,5996
2021-04-03,Croatia,2234,29,278650,6025
2021-04-04,Croatia,1376,33,280026,6058
2021-04-05,Croatia,138,25,280164,6083
2021-04-06,Croatia,735,30,280899,6113
2021-04-07,Croatia,1649,36,282548,6149
2021-04-08,Croatia,3217,36,285765,6185
2020-03-12,Cuba,3,0,3,0
2020-03-13,Cuba,1,0,4,0
2020-03-14,Cuba,0,0,4,0
2020-03-15,Cuba,0,0,4,0
2020-03-16,Cuba,0,0,4,0
2020-03-17,Cuba,1,0,5,0
2020-03-18,Cuba,2,1,7,1
2020-03-19,Cuba,4,0,11,1
2020-03-20,Cuba,5,0,16,1
2020-03-21,Cuba,5,0,21,1
2020-03-22,Cuba,14,0,35,1
2020-03-23,Cuba,5,0,40,1
2020-03-24,Cuba,8,0,48,1
2020-03-25,Cuba,9,0,57,1
2020-03-26,Cuba,10,1,67,2
2020-03-27,Cuba,13,0,80,2
2020-03-28,Cuba,39,1,119,3
2020-03-29,Cuba,20,0,139,3
2020-03-30,Cuba,31,1,170,4
2020-03-31,Cuba,16,2,186,6
2020-04-01,Cuba,26,0,212,6
2020-04-02,Cuba,21,0,233,6
2020-04-03,Cuba,36,0,269,6
2020-04-04,Cuba,19,0,288,6
2020-04-05,Cuba,32,2,320,8
2020-04-06,Cuba,30,1,350,9
2020-04-07,Cuba,46,2,396,11
2020-04-08,Cuba,61,1,457,12
2020-04-09,Cuba,58,3,515,15
2020-04-10,Cuba,49,0,564,15
2020-04-11,Cuba,56,1,620,16
2020-04-12,Cuba,49,2,669,18
2020-04-13,Cuba,57,3,726,21
2020-04-14,Cuba,40,0,766,21
2020-04-15,Cuba,48,3,814,24
2020-04-16,Cuba,48,3,862,27
2020-04-17,Cuba,61,4,923,31
2020-04-18,Cuba,63,1,986,32
2020-04-19,Cuba,49,2,1035,34
2020-04-20,Cuba,52,2,1087,36
2020-04-21,Cuba,50,2,1137,38
2020-04-22,Cuba,52,2,1189,40
2020-04-23,Cuba,46,3,1235,43
2020-04-24,Cuba,50,6,1285,49
2020-04-25,Cuba,52,2,1337,51
2020-04-26,Cuba,32,3,1369,54
2020-04-27,Cuba,20,2,1389,56
2020-04-28,Cuba,48,2,1437,58
2020-04-29,Cuba,30,0,1467,58
2020-04-30,Cuba,34,3,1501,61
2020-05-01,Cuba,36,3,1537,64
2020-05-02,Cuba,74,2,1611,66
2020-05-03,Cuba,38,1,1649,67
2020-05-04,Cuba,19,2,1668,69
2020-05-05,Cuba,17,0,1685,69
2020-05-06,Cuba,18,0,1703,69
2020-05-07,Cuba,26,4,1729,73
2020-05-08,Cuba,12,1,1741,74
2020-05-09,Cuba,13,0,1754,74
2020-05-10,Cuba,12,3,1766,77
2020-05-11,Cuba,17,0,1783,77
2020-05-12,Cuba,21,1,1804,78
2020-05-13,Cuba,6,1,1810,79
2020-05-14,Cuba,20,0,1830,79
2020-05-15,Cuba,10,0,1840,79
2020-05-16,Cuba,22,0,1862,79
2020-05-17,Cuba,10,0,1872,79
2020-05-18,Cuba,9,0,1881,79
2020-05-19,Cuba,6,0,1887,79
2020-05-20,Cuba,13,0,1900,79
2020-05-21,Cuba,8,1,1908,80
2020-05-22,Cuba,8,1,1916,81
2020-05-23,Cuba,15,0,1931,81
2020-05-24,Cuba,10,1,1941,82
2020-05-25,Cuba,6,0,1947,82
2020-05-26,Cuba,16,0,1963,82
2020-05-27,Cuba,11,0,1974,82
2020-05-28,Cuba,9,0,1983,82
2020-05-29,Cuba,22,0,2005,82
2020-05-30,Cuba,20,1,2025,83
2020-05-31,Cuba,20,0,2045,83
2020-06-01,Cuba,38,0,2083,83
2020-06-02,Cuba,9,0,2092,83
2020-06-03,Cuba,15,0,2107,83
2020-06-04,Cuba,12,0,2119,83
2020-06-05,Cuba,14,0,2133,83
2020-06-06,Cuba,40,0,2173,83
2020-06-07,Cuba,18,0,2191,83
2020-06-08,Cuba,9,0,2200,83
2020-06-09,Cuba,5,0,2205,83
2020-06-10,Cuba,6,0,2211,83
2020-06-11,Cuba,8,1,2219,84
2020-06-12,Cuba,14,0,2233,84
2020-06-13,Cuba,5,0,2238,84
2020-06-14,Cuba,10,0,2248,84
2020-06-15,Cuba,14,0,2262,84
2020-06-16,Cuba,11,0,2273,84
2020-06-17,Cuba,7,0,2280,84
2020-06-18,Cuba,15,1,2295,85
2020-06-19,Cuba,10,0,2305,85
2020-06-20,Cuba,4,0,2309,85
2020-06-21,Cuba,3,0,2312,85
2020-06-22,Cuba,3,0,2315,85
2020-06-23,Cuba,3,0,2318,85
2020-06-24,Cuba,1,0,2319,85
2020-06-25,Cuba,2,0,2321,85
2020-06-26,Cuba,4,0,2325,85
2020-06-27,Cuba,5,1,2330,86
2020-06-28,Cuba,2,0,2332,86
2020-06-29,Cuba,8,0,2340,86
2020-06-30,Cuba,1,0,2341,86
2020-07-01,Cuba,7,0,2348,86
2020-07-02,Cuba,5,0,2353,86
2020-07-03,Cuba,8,0,2361,86
2020-07-04,Cuba,8,0,2369,86
2020-07-05,Cuba,3,0,2372,86
2020-07-06,Cuba,8,0,2380,86
2020-07-07,Cuba,15,0,2395,86
2020-07-08,Cuba,4,0,2399,86
2020-07-09,Cuba,4,0,2403,86
2020-07-10,Cuba,10,0,2413,86
2020-07-11,Cuba,7,1,2420,87
2020-07-12,Cuba,6,0,2426,87
2020-07-13,Cuba,2,0,2428,87
2020-07-14,Cuba,4,0,2432,87
2020-07-15,Cuba,6,0,2438,87
2020-07-16,Cuba,2,0,2440,87
2020-07-17,Cuba,4,0,2444,87
2020-07-18,Cuba,1,0,2445,87
2020-07-19,Cuba,1,0,2446,87
2020-07-20,Cuba,0,0,2446,87
2020-07-21,Cuba,3,0,2449,87
2020-07-22,Cuba,13,0,2462,87
2020-07-23,Cuba,4,0,2466,87
2020-07-24,Cuba,3,0,2469,87
2020-07-25,Cuba,9,0,2478,87
2020-07-26,Cuba,17,0,2495,87
2020-07-27,Cuba,37,0,2532,87
2020-07-28,Cuba,23,0,2555,87
2020-07-29,Cuba,33,0,2588,87
2020-07-30,Cuba,9,0,2597,87
2020-07-31,Cuba,11,0,2608,87
2020-08-01,Cuba,25,0,2633,87
2020-08-02,Cuba,13,0,2646,87
2020-08-03,Cuba,24,0,2670,87
2020-08-04,Cuba,31,1,2701,88
2020-08-05,Cuba,25,0,2726,88
2020-08-06,Cuba,49,0,2775,88
2020-08-07,Cuba,54,0,2829,88
2020-08-08,Cuba,59,0,2888,88
2020-08-09,Cuba,65,0,2953,88
2020-08-10,Cuba,93,0,3046,88
2020-08-11,Cuba,47,0,3093,88
2020-08-12,Cuba,35,0,3128,88
2020-08-13,Cuba,46,1,3174,89
2020-08-14,Cuba,55,-1,3229,88
2020-08-15,Cuba,63,0,3292,88
2020-08-16,Cuba,24,0,3316,88
2020-08-17,Cuba,48,0,3364,88
2020-08-18,Cuba,44,0,3408,88
2020-08-19,Cuba,74,0,3482,88
2020-08-20,Cuba,83,0,3565,88
2020-08-21,Cuba,17,1,3582,89
2020-08-22,Cuba,35,0,3617,89
2020-08-23,Cuba,65,2,3682,91
2020-08-24,Cuba,35,0,3717,91
2020-08-25,Cuba,27,0,3744,91
2020-08-26,Cuba,15,1,3759,92
2020-08-27,Cuba,47,0,3806,92
2020-08-28,Cuba,60,0,3866,92
2020-08-29,Cuba,59,2,3925,94
2020-08-30,Cuba,48,0,3973,94
2020-08-31,Cuba,59,0,4032,94
2020-09-01,Cuba,33,1,4065,95
2020-09-02,Cuba,61,3,4126,98
2020-09-03,Cuba,88,2,4214,100
2020-09-04,Cuba,52,0,4266,100
2020-09-05,Cuba,32,0,4298,100
2020-09-06,Cuba,11,1,4309,101
2020-09-07,Cuba,43,1,4352,102
2020-09-08,Cuba,25,2,4377,104
2020-09-09,Cuba,82,0,4459,104
2020-09-10,Cuba,92,2,4551,106
2020-09-11,Cuba,42,0,4593,106
2020-09-12,Cuba,60,2,4653,108
2020-09-13,Cuba,31,0,4684,108
2020-09-14,Cuba,42,0,4726,108
2020-09-15,Cuba,77,0,4803,108
2020-09-16,Cuba,73,1,4876,109
2020-09-17,Cuba,57,0,4933,109
2020-09-18,Cuba,71,2,5004,111
2020-09-19,Cuba,51,2,5055,113
2020-09-20,Cuba,36,2,5091,115
2020-09-21,Cuba,50,1,5141,116
2020-09-22,Cuba,81,1,5222,117
2020-09-23,Cuba,48,1,5270,118
2020-09-24,Cuba,40,0,5310,118
2020-09-25,Cuba,40,0,5350,118
2020-09-26,Cuba,62,2,5412,120
2020-09-27,Cuba,45,2,5457,122
2020-09-28,Cuba,26,0,5483,122
2020-09-29,Cuba,48,0,5531,122
2020-09-30,Cuba,66,0,5597,122
2020-10-01,Cuba,73,0,5670,122
2020-10-02,Cuba,48,0,5718,122
2020-10-03,Cuba,62,0,5780,122
2020-10-04,Cuba,29,0,5809,122
2020-10-05,Cuba,36,1,5845,123
2020-10-06,Cuba,38,0,5883,123
2020-10-07,Cuba,15,0,5898,123
2020-10-08,Cuba,19,0,5917,123
2020-10-09,Cuba,26,0,5943,123
2020-10-10,Cuba,5,0,5948,123
2020-10-11,Cuba,30,0,5978,123
2020-10-12,Cuba,22,0,6000,123
2020-10-13,Cuba,17,0,6017,123
2020-10-14,Cuba,18,0,6035,123
2020-10-15,Cuba,27,0,6062,123
2020-10-16,Cuba,56,1,6118,124
2020-10-17,Cuba,52,1,6170,125
2020-10-18,Cuba,50,0,6220,125
2020-10-19,Cuba,38,2,6258,127
2020-10-20,Cuba,47,0,6305,127
2020-10-21,Cuba,63,0,6368,127
2020-10-22,Cuba,53,1,6421,128
2020-10-23,Cuba,58,0,6479,128
2020-10-24,Cuba,55,0,6534,128
2020-10-25,Cuba,32,0,6566,128
2020-10-26,Cuba,29,0,6595,128
2020-10-27,Cuba,83,0,6678,128
2020-10-28,Cuba,49,0,6727,128
2020-10-29,Cuba,39,0,6766,128
2020-10-30,Cuba,35,0,6801,128
2020-10-31,Cuba,86,0,6887,128
2020-11-01,Cuba,48,0,6935,128
2020-11-02,Cuba,35,1,6970,129
2020-11-03,Cuba,65,0,7035,129
2020-11-04,Cuba,109,0,7144,129
2020-11-05,Cuba,40,0,7184,129
2020-11-06,Cuba,44,1,7228,130
2020-11-07,Cuba,39,0,7267,130
2020-11-08,Cuba,30,0,7297,130
2020-11-09,Cuba,52,0,7349,130
2020-11-10,Cuba,43,0,7392,130
2020-11-11,Cuba,37,0,7429,130
2020-11-12,Cuba,58,1,7487,131
2020-11-13,Cuba,54,0,7541,131
2020-11-14,Cuba,27,0,7568,131
2020-11-15,Cuba,22,0,7590,131
2020-11-16,Cuba,49,0,7639,131
2020-11-17,Cuba,28,0,7667,131
2020-11-18,Cuba,37,0,7704,131
2020-11-19,Cuba,21,0,7725,131
2020-11-20,Cuba,38,0,7763,131
2020-11-21,Cuba,35,1,7798,132
2020-11-22,Cuba,48,0,7846,132
2020-11-23,Cuba,33,0,7879,132
2020-11-24,Cuba,71,1,7950,133
2020-11-25,Cuba,76,0,8026,133
2020-11-26,Cuba,49,0,8075,133
2020-11-27,Cuba,35,0,8110,133
2020-11-28,Cuba,63,0,8173,133
2020-11-29,Cuba,60,1,8233,134
2020-11-30,Cuba,51,1,8284,135
2020-12-01,Cuba,97,1,8381,136
2020-12-02,Cuba,75,0,8456,136
2020-12-03,Cuba,75,0,8531,136
2020-12-04,Cuba,79,0,8610,136
2020-12-05,Cuba,104,0,8714,136
2020-12-06,Cuba,68,0,8782,136
2020-12-07,Cuba,124,0,8906,136
2020-12-08,Cuba,76,0,8982,136
2020-12-09,Cuba,124,0,9106,136
2020-12-10,Cuba,75,0,9181,136
2020-12-11,Cuba,86,0,9267,136
2020-12-12,Cuba,87,1,9354,137
2020-12-13,Cuba,69,0,9423,137
2020-12-14,Cuba,69,0,9492,137
2020-12-15,Cuba,96,0,9588,137
2020-12-16,Cuba,83,0,9671,137
2020-12-17,Cuba,100,0,9771,137
2020-12-18,Cuba,122,0,9893,137
2020-12-19,Cuba,131,0,10024,137
2020-12-20,Cuba,103,0,10127,137
2020-12-21,Cuba,115,0,10242,137
2020-12-22,Cuba,142,2,10384,139
2020-12-23,Cuba,116,0,10500,139
2020-12-24,Cuba,217,0,10717,139
2020-12-25,Cuba,183,1,10900,140
2020-12-26,Cuba,138,1,11038,141
2020-12-27,Cuba,167,1,11205,142
2020-12-28,Cuba,229,1,11434,143
2020-12-29,Cuba,167,0,11601,143
2020-12-30,Cuba,86,2,11687,145
2020-12-31,Cuba,176,1,11863,146
2021-01-01,Cuba,193,0,12056,146
2021-01-02,Cuba,169,0,12225,146
2021-01-03,Cuba,199,1,12424,147
2021-01-04,Cuba,316,0,12740,147
2021-01-05,Cuba,224,0,12964,147
2021-01-06,Cuba,201,1,13165,148
2021-01-07,Cuba,314,0,13479,148
2021-01-08,Cuba,344,0,13823,148
2021-01-09,Cuba,365,0,14188,148
2021-01-10,Cuba,388,3,14576,151
2021-01-11,Cuba,431,2,15007,153
2021-01-12,Cuba,487,2,15494,155
2021-01-13,Cuba,550,3,16044,158
2021-01-14,Cuba,505,2,16549,160
2021-01-15,Cuba,547,2,17096,162
2021-01-16,Cuba,405,4,17501,166
2021-01-17,Cuba,650,4,18151,170
2021-01-18,Cuba,292,3,18443,173
2021-01-19,Cuba,330,2,18773,175
2021-01-20,Cuba,349,5,19122,180
2021-01-21,Cuba,408,4,19530,184
2021-01-22,Cuba,530,4,20060,188
2021-01-23,Cuba,567,3,20627,191
2021-01-24,Cuba,634,3,21261,194
2021-01-25,Cuba,567,3,21828,197
2021-01-26,Cuba,786,3,22614,200
2021-01-27,Cuba,825,4,23439,204
2021-01-28,Cuba,666,4,24105,208
2021-01-29,Cuba,659,2,24764,210
2021-01-30,Cuba,910,3,25674,213
2021-01-31,Cuba,1012,1,26686,214
2021-02-01,Cuba,906,2,27592,216
2021-02-02,Cuba,1044,2,28636,218
2021-02-03,Cuba,893,2,29529,220
2021-02-04,Cuba,816,5,30345,225
2021-02-05,Cuba,845,4,31190,229
2021-02-06,Cuba,821,4,32011,233
2021-02-07,Cuba,820,5,32831,238
2021-02-08,Cuba,653,2,33484,240
2021-02-09,Cuba,580,4,34064,244
2021-02-10,Cuba,858,5,34922,249
2021-02-11,Cuba,850,4,35772,253
2021-02-12,Cuba,823,4,36595,257
2021-02-13,Cuba,888,4,37483,261
2021-02-14,Cuba,806,5,38289,266
2021-02-15,Cuba,715,3,39004,269
2021-02-16,Cuba,937,5,39941,274
2021-02-17,Cuba,824,3,40765,277
2021-02-18,Cuba,923,5,41688,282
2021-02-19,Cuba,859,5,42547,287
2021-02-20,Cuba,937,4,43484,291
2021-02-21,Cuba,1039,5,44523,296
2021-02-22,Cuba,838,4,45361,300
2021-02-23,Cuba,836,4,46197,304
2021-02-24,Cuba,699,4,46896,308
2021-02-25,Cuba,670,4,47566,312
2021-02-26,Cuba,875,2,48441,314
2021-02-27,Cuba,720,4,49161,318
2021-02-28,Cuba,618,4,49779,322
2021-03-01,Cuba,811,2,50590,324
2021-03-02,Cuba,997,4,51587,328
2021-03-03,Cuba,914,5,52501,333
2021-03-04,Cuba,807,3,53308,336
2021-03-05,Cuba,777,5,54085,341
2021-03-06,Cuba,750,3,54835,344
2021-03-07,Cuba,858,4,55693,348
2021-03-08,Cuba,873,2,56566,350
2021-03-09,Cuba,1041,2,57607,352
2021-03-10,Cuba,772,5,58379,357
2021-03-11,Cuba,778,4,59157,361
2021-03-12,Cuba,762,4,59919,365
2021-03-13,Cuba,639,1,60558,366
2021-03-14,Cuba,914,4,61472,370
2021-03-15,Cuba,734,3,62206,373
2021-03-16,Cuba,792,3,62998,376
2021-03-17,Cuba,727,4,63725,380
2021-03-18,Cuba,689,4,64414,384
2021-03-19,Cuba,735,3,65149,387
2021-03-20,Cuba,813,5,65962,392
2021-03-21,Cuba,796,2,66758,394
2021-03-22,Cuba,718,3,67476,397
2021-03-23,Cuba,774,4,68250,401
2021-03-24,Cuba,736,4,68986,405
2021-03-25,Cuba,816,3,69802,408
2021-03-26,Cuba,832,5,70634,413
2021-03-27,Cuba,950,1,71584,414
2021-03-28,Cuba,919,1,72503,415
2021-03-29,Cuba,701,2,73204,417
2021-03-30,Cuba,1008,4,74212,421
2021-03-31,Cuba,1051,3,75263,424
2021-04-01,Cuba,1013,1,76276,425
2021-04-02,Cuba,1077,4,77353,429
2021-04-03,Cuba,1029,2,78382,431
2021-04-04,Cuba,1162,5,79544,436
2021-04-05,Cuba,1066,0,80610,436
2021-04-06,Cuba,1030,4,81640,440
2021-04-07,Cuba,961,2,82601,442
2021-04-08,Cuba,914,1,83515,443
2020-03-09,Cyprus,2,0,2,0
2020-03-10,Cyprus,1,0,3,0
2020-03-11,Cyprus,3,0,6,0
2020-03-12,Cyprus,0,0,6,0
2020-03-13,Cyprus,8,0,14,0
2020-03-14,Cyprus,12,0,26,0
2020-03-15,Cyprus,0,0,26,0
2020-03-16,Cyprus,7,0,33,0
2020-03-17,Cyprus,13,0,46,0
2020-03-18,Cyprus,3,0,49,0
2020-03-19,Cyprus,18,0,67,0
2020-03-20,Cyprus,0,0,67,0
2020-03-21,Cyprus,17,0,84,0
2020-03-22,Cyprus,11,1,95,1
2020-03-23,Cyprus,21,0,116,1
2020-03-24,Cyprus,8,2,124,3
2020-03-25,Cyprus,8,0,132,3
2020-03-26,Cyprus,14,0,146,3
2020-03-27,Cyprus,16,2,162,5
2020-03-28,Cyprus,17,0,179,5
2020-03-29,Cyprus,35,0,214,5
2020-03-30,Cyprus,16,2,230,7
2020-03-31,Cyprus,32,1,262,8
2020-04-01,Cyprus,58,1,320,9
2020-04-02,Cyprus,36,1,356,10
2020-04-03,Cyprus,40,1,396,11
2020-04-04,Cyprus,30,0,426,11
2020-04-05,Cyprus,20,-2,446,9
2020-04-06,Cyprus,19,0,465,9
2020-04-07,Cyprus,29,0,494,9
2020-04-08,Cyprus,32,0,526,9
2020-04-09,Cyprus,38,1,564,10
2020-04-10,Cyprus,31,0,595,10
2020-04-11,Cyprus,21,0,616,10
2020-04-12,Cyprus,17,1,633,11
2020-04-13,Cyprus,29,1,662,12
2020-04-14,Cyprus,33,0,695,12
2020-04-15,Cyprus,20,0,715,12
2020-04-16,Cyprus,20,0,735,12
2020-04-17,Cyprus,15,0,750,12
2020-04-18,Cyprus,11,0,761,12
2020-04-19,Cyprus,6,0,767,12
2020-04-20,Cyprus,5,0,772,12
2020-04-21,Cyprus,12,0,784,12
2020-04-22,Cyprus,6,1,790,13
2020-04-23,Cyprus,5,0,795,13
2020-04-24,Cyprus,9,1,804,14
2020-04-25,Cyprus,6,0,810,14
2020-04-26,Cyprus,7,0,817,14
2020-04-27,Cyprus,5,1,822,15
2020-04-28,Cyprus,15,0,837,15
2020-04-29,Cyprus,6,0,843,15
2020-04-30,Cyprus,7,0,850,15
2020-05-01,Cyprus,7,0,857,15
2020-05-02,Cyprus,7,0,864,15
2020-05-03,Cyprus,8,0,872,15
2020-05-04,Cyprus,2,0,874,15
2020-05-05,Cyprus,4,0,878,15
2020-05-06,Cyprus,5,0,883,15
2020-05-07,Cyprus,6,0,889,15
2020-05-08,Cyprus,2,0,891,15
2020-05-09,Cyprus,1,0,892,15
2020-05-10,Cyprus,6,1,898,16
2020-05-11,Cyprus,3,0,901,16
2020-05-12,Cyprus,2,0,903,16
2020-05-13,Cyprus,2,1,905,17
2020-05-14,Cyprus,2,0,907,17
2020-05-15,Cyprus,3,0,910,17
2020-05-16,Cyprus,4,0,914,17
2020-05-17,Cyprus,2,0,916,17
2020-05-18,Cyprus,1,0,917,17
2020-05-19,Cyprus,1,0,918,17
2020-05-20,Cyprus,4,0,922,17
2020-05-21,Cyprus,1,0,923,17
2020-05-22,Cyprus,4,0,927,17
2020-05-23,Cyprus,0,0,927,17
2020-05-24,Cyprus,8,0,935,17
2020-05-25,Cyprus,2,0,937,17
2020-05-26,Cyprus,2,0,939,17
2020-05-27,Cyprus,0,0,939,17
2020-05-28,Cyprus,2,0,941,17
2020-05-29,Cyprus,1,0,942,17
2020-05-30,Cyprus,2,0,944,17
2020-05-31,Cyprus,0,0,944,17
2020-06-01,Cyprus,5,0,949,17
2020-06-02,Cyprus,3,0,952,17
2020-06-03,Cyprus,6,0,958,17
2020-06-04,Cyprus,0,0,958,17
2020-06-05,Cyprus,2,0,960,17
2020-06-06,Cyprus,0,1,960,18
2020-06-07,Cyprus,4,0,964,18
2020-06-08,Cyprus,6,0,970,18
2020-06-09,Cyprus,2,0,972,18
2020-06-10,Cyprus,2,0,974,18
2020-06-11,Cyprus,1,0,975,18
2020-06-12,Cyprus,5,0,980,18
2020-06-13,Cyprus,0,0,980,18
2020-06-14,Cyprus,3,0,983,18
2020-06-15,Cyprus,2,0,985,18
2020-06-16,Cyprus,0,0,985,18
2020-06-17,Cyprus,0,0,985,18
2020-06-18,Cyprus,0,1,985,19
2020-06-19,Cyprus,0,0,985,19
2020-06-20,Cyprus,0,0,985,19
2020-06-21,Cyprus,1,0,986,19
2020-06-22,Cyprus,2,0,988,19
2020-06-23,Cyprus,2,0,990,19
2020-06-24,Cyprus,1,0,991,19
2020-06-25,Cyprus,1,0,992,19
2020-06-26,Cyprus,0,0,992,19
2020-06-27,Cyprus,2,0,994,19
2020-06-28,Cyprus,0,0,994,19
2020-06-29,Cyprus,2,0,996,19
2020-06-30,Cyprus,2,0,998,19
2020-07-01,Cyprus,1,0,999,19
2020-07-02,Cyprus,0,0,999,19
2020-07-03,Cyprus,0,0,999,19
2020-07-04,Cyprus,3,0,1002,19
2020-07-05,Cyprus,1,0,1003,19
2020-07-06,Cyprus,1,0,1004,19
2020-07-07,Cyprus,1,0,1005,19
2020-07-08,Cyprus,3,0,1008,19
2020-07-09,Cyprus,2,0,1010,19
2020-07-10,Cyprus,3,0,1013,19
2020-07-11,Cyprus,1,0,1014,19
2020-07-12,Cyprus,7,0,1021,19
2020-07-13,Cyprus,1,0,1022,19
2020-07-14,Cyprus,1,0,1023,19
2020-07-15,Cyprus,2,0,1025,19
2020-07-16,Cyprus,6,0,1031,19
2020-07-17,Cyprus,2,0,1033,19
2020-07-18,Cyprus,4,0,1037,19
2020-07-19,Cyprus,1,0,1038,19
2020-07-20,Cyprus,0,0,1038,19
2020-07-21,Cyprus,2,0,1040,19
2020-07-22,Cyprus,0,0,1040,19
2020-07-23,Cyprus,5,0,1045,19
2020-07-24,Cyprus,2,0,1047,19
2020-07-25,Cyprus,6,0,1053,19
2020-07-26,Cyprus,4,0,1057,19
2020-07-27,Cyprus,3,0,1060,19
2020-07-28,Cyprus,7,0,1067,19
2020-07-29,Cyprus,13,0,1080,19
2020-07-30,Cyprus,10,0,1090,19
2020-07-31,Cyprus,24,0,1114,19
2020-08-01,Cyprus,10,0,1124,19
2020-08-02,Cyprus,26,0,1150,19
2020-08-03,Cyprus,5,0,1155,19
2020-08-04,Cyprus,25,0,1180,19
2020-08-05,Cyprus,15,0,1195,19
2020-08-06,Cyprus,13,0,1208,19
2020-08-07,Cyprus,14,0,1222,19
2020-08-08,Cyprus,11,0,1233,19
2020-08-09,Cyprus,9,0,1242,19
2020-08-10,Cyprus,10,0,1252,19
2020-08-11,Cyprus,25,1,1277,20
2020-08-12,Cyprus,14,0,1291,20
2020-08-13,Cyprus,14,0,1305,20
2020-08-14,Cyprus,13,0,1318,20
2020-08-15,Cyprus,14,0,1332,20
2020-08-16,Cyprus,7,0,1339,20
2020-08-17,Cyprus,12,0,1351,20
2020-08-18,Cyprus,8,0,1359,20
2020-08-19,Cyprus,26,0,1385,20
2020-08-20,Cyprus,10,0,1395,20
2020-08-21,Cyprus,11,0,1406,20
2020-08-22,Cyprus,11,0,1417,20
2020-08-23,Cyprus,4,0,1421,20
2020-08-24,Cyprus,30,0,1451,20
2020-08-25,Cyprus,23,0,1474,20
2020-08-26,Cyprus,10,0,1484,20
2020-08-27,Cyprus,-17,0,1467,20
2020-08-28,Cyprus,14,0,1481,20
2020-08-29,Cyprus,2,0,1483,20
2020-08-30,Cyprus,4,0,1487,20
2020-08-31,Cyprus,1,0,1488,20
2020-09-01,Cyprus,2,1,1490,21
2020-09-02,Cyprus,5,0,1495,21
2020-09-03,Cyprus,3,0,1498,21
2020-09-04,Cyprus,4,0,1502,21
2020-09-05,Cyprus,5,0,1507,21
2020-09-06,Cyprus,2,0,1509,21
2020-09-07,Cyprus,1,1,1510,22
2020-09-08,Cyprus,1,0,1511,22
2020-09-09,Cyprus,3,0,1514,22
2020-09-10,Cyprus,3,0,1517,22
2020-09-11,Cyprus,3,0,1520,22
2020-09-12,Cyprus,3,0,1523,22
2020-09-13,Cyprus,3,0,1526,22
2020-09-14,Cyprus,8,0,1534,22
2020-09-15,Cyprus,6,0,1540,22
2020-09-16,Cyprus,8,0,1548,22
2020-09-17,Cyprus,10,0,1558,22
2020-09-18,Cyprus,7,0,1565,22
2020-09-19,Cyprus,25,0,1590,22
2020-09-20,Cyprus,10,0,1600,22
2020-09-21,Cyprus,3,0,1603,22
2020-09-22,Cyprus,15,0,1618,22
2020-09-23,Cyprus,36,0,1654,22
2020-09-24,Cyprus,9,0,1663,22
2020-09-25,Cyprus,8,0,1671,22
2020-09-26,Cyprus,13,0,1684,22
2020-09-27,Cyprus,12,0,1696,22
2020-09-28,Cyprus,17,0,1713,22
2020-09-29,Cyprus,30,0,1743,22
2020-09-30,Cyprus,12,0,1755,22
2020-10-01,Cyprus,17,0,1772,22
2020-10-02,Cyprus,17,0,1789,22
2020-10-03,Cyprus,22,0,1811,22
2020-10-04,Cyprus,13,0,1824,22
2020-10-05,Cyprus,23,0,1847,22
2020-10-06,Cyprus,29,1,1876,23
2020-10-07,Cyprus,21,1,1897,24
2020-10-08,Cyprus,21,0,1918,24
2020-10-09,Cyprus,33,1,1951,25
2020-10-10,Cyprus,35,0,1986,25
2020-10-11,Cyprus,20,0,2006,25
2020-10-12,Cyprus,41,0,2047,25
2020-10-13,Cyprus,83,0,2130,25
2020-10-14,Cyprus,51,0,2181,25
2020-10-15,Cyprus,104,0,2285,25
2020-10-16,Cyprus,94,0,2379,25
2020-10-17,Cyprus,202,0,2581,25
2020-10-18,Cyprus,63,0,2644,25
2020-10-19,Cyprus,43,0,2687,25
2020-10-20,Cyprus,152,0,2839,25
2020-10-21,Cyprus,127,0,2966,25
2020-10-22,Cyprus,188,0,3154,25
2020-10-23,Cyprus,160,0,3314,25
2020-10-24,Cyprus,130,0,3444,25
2020-10-25,Cyprus,101,0,3545,25
2020-10-26,Cyprus,91,0,3636,25
2020-10-27,Cyprus,181,0,3817,25
2020-10-28,Cyprus,113,0,3930,25
2020-10-29,Cyprus,121,0,4051,25
2020-10-30,Cyprus,166,0,4217,25
2020-10-31,Cyprus,149,1,4366,26
2020-11-01,Cyprus,197,0,4563,26
2020-11-02,Cyprus,197,1,4760,27
2020-11-03,Cyprus,174,0,4934,27
2020-11-04,Cyprus,166,0,5100,27
2020-11-05,Cyprus,233,0,5333,27
2020-11-06,Cyprus,224,0,5557,27
2020-11-07,Cyprus,314,8,5871,35
2020-11-08,Cyprus,116,-7,5987,28
2020-11-09,Cyprus,111,0,6098,28
2020-11-10,Cyprus,198,1,6296,29
2020-11-11,Cyprus,165,4,6461,33
2020-11-12,Cyprus,185,1,6646,34
2020-11-13,Cyprus,207,4,6853,38
2020-11-14,Cyprus,198,1,7051,39
2020-11-15,Cyprus,127,0,7178,39
2020-11-16,Cyprus,107,1,7285,40
2020-11-17,Cyprus,228,0,7513,40
2020-11-18,Cyprus,198,1,7711,41
2020-11-19,Cyprus,268,0,7979,41
2020-11-20,Cyprus,232,2,8211,43
2020-11-21,Cyprus,245,0,8456,43
2020-11-22,Cyprus,187,1,8643,44
2020-11-23,Cyprus,304,0,8947,44
2020-11-24,Cyprus,252,2,9199,46
2020-11-25,Cyprus,254,1,9453,47
2020-11-26,Cyprus,220,1,9673,48
2020-11-27,Cyprus,310,0,9983,48
2020-11-28,Cyprus,248,0,10231,48
2020-11-29,Cyprus,152,0,10383,48
2020-11-30,Cyprus,182,1,10565,49
2020-12-01,Cyprus,318,0,10883,49
2020-12-02,Cyprus,292,3,11175,52
2020-12-03,Cyprus,348,2,11523,54
2020-12-04,Cyprus,289,3,11812,57
2020-12-05,Cyprus,369,0,12181,57
2020-12-06,Cyprus,270,4,12451,61
2020-12-07,Cyprus,416,2,12867,63
2020-12-08,Cyprus,419,5,13286,68
2020-12-09,Cyprus,0,0,13286,68
2020-12-10,Cyprus,363,2,13649,70
2020-12-11,Cyprus,0,0,13649,70
2020-12-12,Cyprus,827,5,14476,75
2020-12-13,Cyprus,625,3,15101,78
2020-12-14,Cyprus,349,4,15450,82
2020-12-15,Cyprus,339,2,15789,84
2020-12-16,Cyprus,401,1,16190,85
2020-12-17,Cyprus,0,0,16190,85
2020-12-18,Cyprus,457,0,16647,85
2020-12-19,Cyprus,829,4,17476,89
2020-12-20,Cyprus,212,2,17688,91
2020-12-21,Cyprus,316,5,18004,96
2020-12-22,Cyprus,0,0,18004,96
2020-12-23,Cyprus,879,8,18883,104
2020-12-24,Cyprus,433,3,19316,107
2020-12-25,Cyprus,50,2,19366,109
2020-12-26,Cyprus,25,2,19391,111
2020-12-27,Cyprus,266,1,19657,112
2020-12-28,Cyprus,751,1,20408,113
2020-12-29,Cyprus,907,4,21315,117
2020-12-30,Cyprus,704,2,22019,119
2020-12-31,Cyprus,0,0,22019,119
2021-01-01,Cyprus,799,8,22818,127
2021-01-02,Cyprus,627,2,23445,129
2021-01-03,Cyprus,529,2,23974,131
2021-01-04,Cyprus,665,2,24639,133
2021-01-05,Cyprus,569,1,25208,134
2021-01-06,Cyprus,573,4,25781,138
2021-01-07,Cyprus,427,2,26208,140
2021-01-08,Cyprus,466,1,26674,141
2021-01-09,Cyprus,337,6,27011,147
2021-01-10,Cyprus,339,1,27350,148
2021-01-11,Cyprus,288,5,27638,153
2021-01-12,Cyprus,259,4,27897,157
2021-01-13,Cyprus,227,6,28124,163
2021-01-14,Cyprus,0,0,28124,163
2021-01-15,Cyprus,485,3,28609,166
2021-01-16,Cyprus,202,1,28811,167
2021-01-17,Cyprus,157,3,28968,170
2021-01-18,Cyprus,162,5,29130,175
2021-01-19,Cyprus,164,1,29294,176
2021-01-20,Cyprus,178,0,29472,176
2021-01-21,Cyprus,164,2,29636,178
2021-01-22,Cyprus,122,1,29758,179
2021-01-23,Cyprus,129,4,29887,183
2021-01-24,Cyprus,130,3,30017,186
2021-01-25,Cyprus,126,2,30143,188
2021-01-26,Cyprus,109,2,30252,190
2021-01-27,Cyprus,128,3,30380,193
2021-01-28,Cyprus,158,4,30538,197
2021-01-29,Cyprus,119,0,30657,197
2021-01-30,Cyprus,113,0,30770,197
2021-01-31,Cyprus,106,2,30876,199
2021-02-01,Cyprus,120,3,30996,202
2021-02-02,Cyprus,128,0,31124,202
2021-02-03,Cyprus,139,1,31263,203
2021-02-04,Cyprus,116,5,31379,208
2021-02-05,Cyprus,133,2,31512,210
2021-02-06,Cyprus,132,1,31644,211
2021-02-07,Cyprus,115,1,31759,212
2021-02-08,Cyprus,105,2,31864,214
2021-02-09,Cyprus,95,0,31959,214
2021-02-10,Cyprus,113,3,32072,217
2021-02-11,Cyprus,103,1,32175,218
2021-02-12,Cyprus,113,1,32288,219
2021-02-13,Cyprus,102,1,32390,220
2021-02-14,Cyprus,123,1,32513,221
2021-02-15,Cyprus,113,1,32626,222
2021-02-16,Cyprus,81,3,32707,225
2021-02-17,Cyprus,121,2,32828,227
2021-02-18,Cyprus,107,1,32935,228
2021-02-19,Cyprus,111,1,33046,229
2021-02-20,Cyprus,107,0,33153,229
2021-02-21,Cyprus,107,0,33260,229
2021-02-22,Cyprus,131,1,33391,230
2021-02-23,Cyprus,176,0,33567,230
2021-02-24,Cyprus,143,1,33710,231
2021-02-25,Cyprus,199,0,33909,231
2021-02-26,Cyprus,272,0,34181,231
2021-02-27,Cyprus,243,0,34424,231
2021-02-28,Cyprus,283,0,34707,231
2021-03-01,Cyprus,302,0,35009,231
2021-03-02,Cyprus,288,1,35297,232
2021-03-03,Cyprus,323,0,35620,232
2021-03-04,Cyprus,384,0,36004,232
2021-03-05,Cyprus,273,0,36277,232
2021-03-06,Cyprus,298,0,36575,232
2021-03-07,Cyprus,303,1,36878,233
2021-03-08,Cyprus,352,0,37230,233
2021-03-09,Cyprus,420,0,37650,233
2021-03-10,Cyprus,415,2,38065,235
2021-03-11,Cyprus,431,1,38496,236
2021-03-12,Cyprus,383,2,38879,238
2021-03-13,Cyprus,398,0,39277,238
2021-03-14,Cyprus,374,2,39651,240
2021-03-15,Cyprus,218,0,39869,240
2021-03-16,Cyprus,475,1,40344,241
2021-03-17,Cyprus,382,0,40726,241
2021-03-18,Cyprus,385,0,41111,241
2021-03-19,Cyprus,364,0,41475,241
2021-03-20,Cyprus,407,1,41882,242
2021-03-21,Cyprus,336,1,42218,243
2021-03-22,Cyprus,410,2,42628,245
2021-03-23,Cyprus,365,1,42993,246
2021-03-24,Cyprus,293,2,43286,248
2021-03-25,Cyprus,324,0,43610,248
2021-03-26,Cyprus,361,0,43971,248
2021-03-27,Cyprus,334,2,44305,250
2021-03-28,Cyprus,326,2,44631,252
2021-03-29,Cyprus,360,2,44991,254
2021-03-30,Cyprus,439,2,45430,256
2021-03-31,Cyprus,434,0,45864,256
2021-04-01,Cyprus,309,4,46173,260
2021-04-02,Cyprus,705,1,46878,261
2021-04-03,Cyprus,404,0,47282,261
2021-04-04,Cyprus,431,0,47713,261
2021-04-05,Cyprus,565,1,48278,262
2021-04-06,Cyprus,559,2,48837,264
2021-04-07,Cyprus,529,2,49366,266
2021-04-08,Cyprus,622,2,49988,268
2020-03-01,Czechia,3,0,3,0
2020-03-02,Czechia,0,0,3,0
2020-03-03,Czechia,2,0,5,0
2020-03-04,Czechia,3,0,8,0
2020-03-05,Czechia,4,0,12,0
2020-03-06,Czechia,6,0,18,0
2020-03-07,Czechia,1,0,19,0
2020-03-08,Czechia,12,0,31,0
2020-03-09,Czechia,0,0,31,0
2020-03-10,Czechia,10,0,41,0
2020-03-11,Czechia,50,0,91,0
2020-03-12,Czechia,3,0,94,0
2020-03-13,Czechia,47,0,141,0
2020-03-14,Czechia,48,0,189,0
2020-03-15,Czechia,64,0,253,0
2020-03-16,Czechia,45,0,298,0
2020-03-17,Czechia,98,0,396,0
2020-03-18,Czechia,68,0,464,0
2020-03-19,Czechia,230,0,694,0
2020-03-20,Czechia,139,0,833,0
2020-03-21,Czechia,162,0,995,0
2020-03-22,Czechia,125,1,1120,1
2020-03-23,Czechia,116,0,1236,1
2020-03-24,Czechia,158,2,1394,3
2020-03-25,Czechia,260,3,1654,6
2020-03-26,Czechia,271,3,1925,9
2020-03-27,Czechia,354,0,2279,9
2020-03-28,Czechia,352,2,2631,11
2020-03-29,Czechia,186,5,2817,16
2020-03-30,Czechia,184,7,3001,23
2020-03-31,Czechia,307,8,3308,31
2020-04-01,Czechia,200,8,3508,39
2020-04-02,Czechia,350,5,3858,44
2020-04-03,Czechia,233,9,4091,53
2020-04-04,Czechia,381,6,4472,59
2020-04-05,Czechia,115,8,4587,67
2020-04-06,Czechia,235,11,4822,78
2020-04-07,Czechia,195,10,5017,88
2020-04-08,Czechia,295,11,5312,99
2020-04-09,Czechia,257,13,5569,112
2020-04-10,Czechia,163,7,5732,119
2020-04-11,Czechia,99,10,5831,129
2020-04-12,Czechia,160,9,5991,138
2020-04-13,Czechia,68,5,6059,143
2020-04-14,Czechia,52,18,6111,161
2020-04-15,Czechia,105,5,6216,166
2020-04-16,Czechia,217,3,6433,169
2020-04-17,Czechia,116,4,6549,173
2020-04-18,Czechia,57,8,6606,181
2020-04-19,Czechia,140,5,6746,186
2020-04-20,Czechia,154,8,6900,194
2020-04-21,Czechia,133,7,7033,201
2020-04-22,Czechia,99,7,7132,208
2020-04-23,Czechia,55,2,7187,210
2020-04-24,Czechia,86,4,7273,214
2020-04-25,Czechia,79,4,7352,218
2020-04-26,Czechia,52,2,7404,220
2020-04-27,Czechia,41,3,7445,223
2020-04-28,Czechia,59,4,7504,227
2020-04-29,Czechia,75,0,7579,227
2020-04-30,Czechia,103,9,7682,236
2020-05-01,Czechia,55,4,7737,240
2020-05-02,Czechia,18,5,7755,245
2020-05-03,Czechia,26,3,7781,248
2020-05-04,Czechia,38,4,7819,252
2020-05-05,Czechia,77,5,7896,257
2020-05-06,Czechia,78,5,7974,262
2020-05-07,Czechia,57,8,8031,270
2020-05-08,Czechia,46,3,8077,273
2020-05-09,Czechia,18,3,8095,276
2020-05-10,Czechia,28,4,8123,280
2020-05-11,Czechia,53,2,8176,282
2020-05-12,Czechia,45,1,8221,283
2020-05-13,Czechia,48,7,8269,290
2020-05-14,Czechia,82,3,8351,293
2020-05-15,Czechia,55,2,8406,295
2020-05-16,Czechia,49,1,8455,296
2020-05-17,Czechia,20,2,8475,298
2020-05-18,Czechia,111,-1,8586,297
2020-05-19,Czechia,61,5,8647,302
2020-05-20,Czechia,74,2,8721,304
2020-05-21,Czechia,33,2,8754,306
2020-05-22,Czechia,59,6,8813,312
2020-05-23,Czechia,77,2,8890,314
2020-05-24,Czechia,65,1,8955,315
2020-05-25,Czechia,47,2,9002,317
2020-05-26,Czechia,48,0,9050,317
2020-05-27,Czechia,36,0,9086,317
2020-05-28,Czechia,54,2,9140,319
2020-05-29,Czechia,56,0,9196,319
2020-05-30,Czechia,34,0,9230,319
2020-05-31,Czechia,38,1,9268,320
2020-06-01,Czechia,34,1,9302,321
2020-06-02,Czechia,62,2,9364,323
2020-06-03,Czechia,74,2,9438,325
2020-06-04,Czechia,56,1,9494,326
2020-06-05,Czechia,35,1,9529,327
2020-06-06,Czechia,38,0,9567,327
2020-06-07,Czechia,61,0,9628,327
2020-06-08,Czechia,69,1,9697,328
2020-06-09,Czechia,54,0,9751,328
2020-06-10,Czechia,73,2,9824,330
2020-06-11,Czechia,31,-2,9855,328
2020-06-12,Czechia,83,1,9938,329
2020-06-13,Czechia,53,-1,9991,328
2020-06-14,Czechia,33,1,10024,329
2020-06-15,Czechia,40,1,10064,330
2020-06-16,Czechia,47,1,10111,331
2020-06-17,Czechia,51,2,10162,333
2020-06-18,Czechia,118,1,10280,334
2020-06-19,Czechia,126,1,10406,335
2020-06-20,Czechia,42,1,10448,336
2020-06-21,Czechia,50,0,10498,336
2020-06-22,Czechia,25,0,10523,336
2020-06-23,Czechia,127,3,10650,339
2020-06-24,Czechia,127,4,10777,343
2020-06-25,Czechia,93,2,10870,345
2020-06-26,Czechia,168,4,11038,349
2020-06-27,Czechia,260,0,11298,349
2020-06-28,Czechia,305,-1,11603,348
2020-06-29,Czechia,202,0,11805,348
2020-06-30,Czechia,149,1,11954,349
2020-07-01,Czechia,92,0,12046,349
2020-07-02,Czechia,132,4,12178,353
2020-07-03,Czechia,141,0,12319,353
2020-07-04,Czechia,121,-2,12440,351
2020-07-05,Czechia,75,-3,12515,348
2020-07-06,Czechia,51,2,12566,350
2020-07-07,Czechia,119,1,12685,351
2020-07-08,Czechia,129,0,12814,351
2020-07-09,Czechia,105,1,12919,352
2020-07-10,Czechia,82,0,13001,352
2020-07-11,Czechia,114,0,13115,352
2020-07-12,Czechia,59,0,13174,352
2020-07-13,Czechia,64,1,13238,353
2020-07-14,Czechia,103,2,13341,355
2020-07-15,Czechia,134,0,13475,355
2020-07-16,Czechia,137,0,13612,355
2020-07-17,Czechia,130,3,13742,358
2020-07-18,Czechia,113,0,13855,358
2020-07-19,Czechia,90,1,13945,359
2020-07-20,Czechia,153,0,14098,359
2020-07-21,Czechia,226,1,14324,360
2020-07-22,Czechia,246,4,14570,364
2020-07-23,Czechia,230,1,14800,365
2020-07-24,Czechia,281,4,15081,369
2020-07-25,Czechia,131,0,15212,369
2020-07-26,Czechia,112,2,15324,371
2020-07-27,Czechia,192,2,15516,373
2020-07-28,Czechia,283,1,15799,374
2020-07-29,Czechia,294,0,16093,374
2020-07-30,Czechia,278,5,16371,379
2020-07-31,Czechia,203,3,16574,382
2020-08-01,Czechia,125,1,16699,383
2020-08-02,Czechia,101,1,16800,384
2020-08-03,Czechia,208,2,17008,386
2020-08-04,Czechia,278,-3,17286,383
2020-08-05,Czechia,243,5,17529,388
2020-08-06,Czechia,202,2,17731,390
2020-08-07,Czechia,329,-1,18060,389
2020-08-08,Czechia,175,0,18235,389
2020-08-09,Czechia,118,1,18353,390
2020-08-10,Czechia,141,0,18494,390
2020-08-11,Czechia,289,1,18783,391
2020-08-12,Czechia,292,0,19075,391
2020-08-13,Czechia,326,0,19401,391
2020-08-14,Czechia,292,3,19693,394
2020-08-15,Czechia,198,1,19891,395
2020-08-16,Czechia,121,2,20012,397
2020-08-17,Czechia,190,2,20202,399
2020-08-18,Czechia,281,2,20483,401
2020-08-19,Czechia,315,3,20798,404
2020-08-20,Czechia,247,2,21045,406
2020-08-21,Czechia,506,5,21551,411
2020-08-22,Czechia,239,0,21790,411
2020-08-23,Czechia,133,1,21923,412
2020-08-24,Czechia,258,3,22181,415
2020-08-25,Czechia,367,1,22548,416
2020-08-26,Czechia,403,2,22951,418
2020-08-27,Czechia,218,0,23169,418
2020-08-28,Czechia,608,1,23777,419
2020-08-29,Czechia,317,2,24094,421
2020-08-30,Czechia,273,2,24367,423
2020-08-31,Czechia,251,1,24618,424
2020-09-01,Czechia,499,1,25117,425
2020-09-02,Czechia,656,0,25773,425
2020-09-03,Czechia,679,1,26452,426
2020-09-04,Czechia,797,3,27249,429
2020-09-05,Czechia,503,2,27752,431
2020-09-06,Czechia,404,5,28156,436
2020-09-07,Czechia,560,1,28716,437
2020-09-08,Czechia,1161,4,29877,441
2020-09-09,Czechia,1159,3,31036,444
2020-09-10,Czechia,1377,4,32413,448
2020-09-11,Czechia,1447,2,33860,450
2020-09-12,Czechia,1541,3,35401,453
2020-09-13,Czechia,787,3,36188,456
2020-09-14,Czechia,1034,9,37222,465
2020-09-15,Czechia,1674,11,38896,476
2020-09-16,Czechia,2136,6,41032,482
2020-09-17,Czechia,3123,7,44155,489
2020-09-18,Czechia,2107,6,46262,495
2020-09-19,Czechia,2044,4,48306,499
2020-09-20,Czechia,984,4,49290,503
2020-09-21,Czechia,1474,19,50764,522
2020-09-22,Czechia,2394,9,53158,531
2020-09-23,Czechia,2306,24,55464,555
2020-09-24,Czechia,2910,12,58374,567
2020-09-25,Czechia,2944,14,61318,581
2020-09-26,Czechia,1976,10,63294,591
2020-09-27,Czechia,1303,15,64597,606
2020-09-28,Czechia,1286,12,65883,618
2020-09-29,Czechia,1960,18,67843,636
2020-09-30,Czechia,2920,19,70763,655
2020-10-01,Czechia,3492,23,74255,678
2020-10-02,Czechia,3796,21,78051,699
2020-10-03,Czechia,2554,12,80605,711
2020-10-04,Czechia,1841,16,82446,727
2020-10-05,Czechia,3120,31,85566,758
2020-10-06,Czechia,4456,36,90022,794
2020-10-07,Czechia,5338,35,95360,829
2020-10-08,Czechia,5397,40,100757,869
2020-10-09,Czechia,8617,36,109374,905
2020-10-10,Czechia,4631,43,114005,948
2020-10-11,Czechia,3105,39,117110,987
2020-10-12,Czechia,4311,64,121421,1051
2020-10-13,Czechia,8326,55,129747,1106
2020-10-14,Czechia,9543,66,139290,1172
2020-10-15,Czechia,9720,58,149010,1230
2020-10-16,Czechia,11102,53,160112,1283
2020-10-17,Czechia,8715,69,168827,1352
2020-10-18,Czechia,5058,70,173885,1422
2020-10-19,Czechia,8077,91,181962,1513
2020-10-20,Czechia,11984,106,193946,1619
2020-10-21,Czechia,14969,120,208915,1739
2020-10-22,Czechia,14150,106,223065,1845
2020-10-23,Czechia,15258,126,238323,1971
2020-10-24,Czechia,12474,106,250797,2077
2020-10-25,Czechia,7300,124,258097,2201
2020-10-26,Czechia,10273,164,268370,2365
2020-10-27,Czechia,15663,182,284033,2547
2020-10-28,Czechia,12980,128,297013,2675
2020-10-29,Czechia,13055,187,310068,2862
2020-10-30,Czechia,13605,216,323673,3078
2020-10-31,Czechia,11429,173,335102,3251
2020-11-01,Czechia,6542,178,341644,3429
2020-11-02,Czechia,9252,225,350896,3654
2020-11-03,Czechia,12089,259,362985,3913
2020-11-04,Czechia,15731,220,378716,4133
2020-11-05,Czechia,13229,197,391945,4330
2020-11-06,Czechia,11552,154,403497,4484
2020-11-07,Czechia,7723,197,411220,4681
2020-11-08,Czechia,3608,177,414828,4858
2020-11-09,Czechia,2353,170,417181,5028
2020-11-10,Czechia,12699,295,429880,5323
2020-11-11,Czechia,8925,247,438805,5570
2020-11-12,Czechia,7870,185,446675,5755
2020-11-13,Czechia,7355,171,454030,5926
2020-11-14,Czechia,4199,132,458229,6058
2020-11-15,Czechia,1887,150,460116,6208
2020-11-16,Czechia,5407,208,465523,6416
2020-11-17,Czechia,4246,142,469769,6558
2020-11-18,Czechia,5515,182,475284,6740
2020-11-19,Czechia,6471,134,481755,6874
2020-11-20,Czechia,5808,147,487563,7021
2020-11-21,Czechia,3187,74,490750,7095
2020-11-22,Czechia,1513,101,492263,7196
2020-11-23,Czechia,4375,164,496638,7360
2020-11-24,Czechia,5896,139,502534,7499
2020-11-25,Czechia,2681,112,505215,7611
2020-11-26,Czechia,6305,168,511520,7779
2020-11-27,Czechia,4464,188,515984,7967
2020-11-28,Czechia,2665,87,518649,8054
2020-11-29,Czechia,1074,84,519723,8138
2020-11-30,Czechia,3575,157,523298,8295
2020-12-01,Czechia,5176,112,528474,8407
2020-12-02,Czechia,4568,108,533042,8515
2020-12-03,Czechia,4621,126,537663,8641
2020-12-04,Czechia,4743,97,542406,8738
2020-12-05,Czechia,1773,77,544179,8815
2020-12-06,Czechia,2654,87,546833,8902
2020-12-07,Czechia,0,0,546833,8902
2020-12-08,Czechia,4237,134,551070,9036
2020-12-09,Czechia,5857,100,556927,9136
2020-12-10,Czechia,6406,90,563333,9226
2020-12-11,Czechia,5872,115,569205,9341
2020-12-12,Czechia,6217,109,575422,9450
2020-12-13,Czechia,3657,85,579079,9535
2020-12-14,Czechia,2000,74,581079,9609
2020-12-15,Czechia,5172,134,586251,9743
2020-12-16,Czechia,7897,139,594148,9882
2020-12-17,Czechia,8256,154,602404,10036
2020-12-18,Czechia,7602,127,610006,10163
2020-12-19,Czechia,8830,108,618836,10271
2020-12-20,Czechia,5304,60,624140,10331
2020-12-21,Czechia,3383,80,627523,10411
2020-12-22,Czechia,7891,151,635414,10562
2020-12-23,Czechia,10898,102,646312,10664
2020-12-24,Czechia,14149,112,660461,10776
2020-12-25,Czechia,4402,83,664863,10859
2020-12-26,Czechia,2706,91,667569,10950
2020-12-27,Czechia,3030,94,670599,11044
2020-12-28,Czechia,3741,108,674340,11152
2020-12-29,Czechia,10862,150,685202,11302
2020-12-30,Czechia,16420,127,701622,11429
2020-12-31,Czechia,17039,151,718661,11580
2021-01-01,Czechia,13361,131,732022,11711
2021-01-02,Czechia,3447,116,735469,11827
2021-01-03,Czechia,5012,133,740481,11960
2021-01-04,Czechia,6233,110,746714,12070
2021-01-05,Czechia,12921,187,759635,12257
2021-01-06,Czechia,17332,179,776967,12436
2021-01-07,Czechia,17773,185,794740,12621
2021-01-08,Czechia,14861,179,809601,12800
2021-01-09,Czechia,13115,178,822716,12978
2021-01-10,Czechia,8449,137,831165,13115
2021-01-11,Czechia,4289,157,835454,13272
2021-01-12,Czechia,9345,213,844799,13485
2021-01-13,Czechia,10801,171,855600,13656
2021-01-14,Czechia,10922,200,866522,13856
2021-01-15,Czechia,8083,173,874605,14029
2021-01-16,Czechia,9301,186,883906,14215
2021-01-17,Czechia,5253,123,889159,14338
2021-01-18,Czechia,2693,111,891852,14449
2021-01-19,Czechia,7651,197,899503,14646
2021-01-20,Czechia,9628,174,909131,14820
2021-01-21,Czechia,8228,153,917359,14973
2021-01-22,Czechia,7488,157,924847,15130
2021-01-23,Czechia,8514,140,933361,15270
2021-01-24,Czechia,4256,99,937617,15369
2021-01-25,Czechia,2387,84,940004,15453
2021-01-26,Czechia,6942,165,946946,15618
2021-01-27,Czechia,9209,173,956155,15791
2021-01-28,Czechia,8505,153,964660,15944
2021-01-29,Czechia,7982,128,972642,16072
2021-01-30,Czechia,8072,139,980714,16211
2021-01-31,Czechia,4060,97,984774,16308
2021-02-01,Czechia,2555,84,987329,16392
2021-02-02,Czechia,7185,153,994514,16545
2021-02-03,Czechia,9143,138,1003657,16683
2021-02-04,Czechia,9695,143,1013352,16826
2021-02-05,Czechia,8125,150,1021477,16976
2021-02-06,Czechia,8635,153,1030112,17129
2021-02-07,Czechia,4863,106,1034975,17235
2021-02-08,Czechia,2430,98,1037405,17333
2021-02-09,Czechia,7727,164,1045132,17497
2021-02-10,Czechia,10283,145,1055415,17642
2021-02-11,Czechia,9537,130,1064952,17772
2021-02-12,Czechia,9014,130,1073966,17902
2021-02-13,Czechia,8883,156,1082849,18058
2021-02-14,Czechia,5160,85,1088009,18143
2021-02-15,Czechia,2851,107,1090860,18250
2021-02-16,Czechia,8794,180,1099654,18430
2021-02-17,Czechia,12668,166,1112322,18596
2021-02-18,Czechia,10930,143,1123252,18739
2021-02-19,Czechia,11705,174,1134957,18913
2021-02-20,Czechia,11364,184,1146321,19097
2021-02-21,Czechia,6838,117,1153159,19214
2021-02-22,Czechia,4021,116,1157180,19330
2021-02-23,Czechia,11311,207,1168491,19537
2021-02-24,Czechia,15861,145,1184352,19682
2021-02-25,Czechia,13816,153,1198168,19835
2021-02-26,Czechia,14612,164,1212780,19999
2021-02-27,Czechia,14815,195,1227595,20194
2021-02-28,Czechia,7885,145,1235480,20339
2021-03-01,Czechia,4571,130,1240051,20469
2021-03-02,Czechia,12191,232,1252242,20701
2021-03-03,Czechia,16816,240,1269058,20941
2021-03-04,Czechia,15230,187,1284288,21128
2021-03-05,Czechia,14714,197,1299002,21325
2021-03-06,Czechia,13162,233,1312164,21558
2021-03-07,Czechia,9167,159,1321331,21717
2021-03-08,Czechia,3960,165,1325291,21882
2021-03-09,Czechia,10524,265,1335815,22147
2021-03-10,Czechia,15380,238,1351195,22385
2021-03-11,Czechia,14529,239,1365724,22624
2021-03-12,Czechia,11274,241,1376998,22865
2021-03-13,Czechia,15110,218,1392108,23083
2021-03-14,Czechia,6970,143,1399078,23226
2021-03-15,Czechia,3342,153,1402420,23379
2021-03-16,Czechia,10542,278,1412962,23657
2021-03-17,Czechia,14029,245,1426991,23902
2021-03-18,Czechia,12028,215,1439019,24117
2021-03-19,Czechia,10677,214,1449696,24331
2021-03-20,Czechia,9710,199,1459406,24530
2021-03-21,Czechia,10141,137,1469547,24667
2021-03-22,Czechia,-2214,143,1467333,24810
2021-03-23,Czechia,8205,245,1475538,25055
2021-03-24,Czechia,10972,203,1486510,25258
2021-03-25,Czechia,8851,192,1495361,25450
2021-03-26,Czechia,7946,189,1503307,25639
2021-03-27,Czechia,7714,139,1511021,25778
2021-03-28,Czechia,4008,96,1515029,25874
2021-03-29,Czechia,1743,162,1516772,26036
2021-03-30,Czechia,6896,186,1523668,26222
2021-03-31,Czechia,8664,199,1532332,26421
2021-04-01,Czechia,7285,165,1539617,26586
2021-04-02,Czechia,6248,179,1545865,26765
2021-04-03,Czechia,3869,102,1549734,26867
2021-04-04,Czechia,2162,78,1551896,26945
2021-04-05,Czechia,1924,112,1553820,27057
2021-04-06,Czechia,1425,112,1555245,27169
2021-04-07,Czechia,5532,160,1560777,27329
2021-04-08,Czechia,7071,137,1567848,27466
2020-03-11,Democratic Republic of Congo,1,0,1,0
2020-03-12,Democratic Republic of Congo,0,0,1,0
2020-03-13,Democratic Republic of Congo,1,0,2,0
2020-03-14,Democratic Republic of Congo,0,0,2,0
2020-03-15,Democratic Republic of Congo,0,0,2,0
2020-03-16,Democratic Republic of Congo,0,0,2,0
2020-03-17,Democratic Republic of Congo,1,0,3,0
2020-03-18,Democratic Republic of Congo,1,0,4,0
2020-03-19,Democratic Republic of Congo,10,0,14,0
2020-03-20,Democratic Republic of Congo,4,0,18,0
2020-03-21,Democratic Republic of Congo,5,1,23,1
2020-03-22,Democratic Republic of Congo,7,0,30,1
2020-03-23,Democratic Republic of Congo,6,0,36,1
2020-03-24,Democratic Republic of Congo,9,1,45,2
2020-03-25,Democratic Republic of Congo,3,0,48,2
2020-03-26,Democratic Republic of Congo,3,1,51,3
2020-03-27,Democratic Republic of Congo,0,0,51,3
2020-03-28,Democratic Republic of Congo,14,3,65,6
2020-03-29,Democratic Republic of Congo,0,0,65,6
2020-03-30,Democratic Republic of Congo,16,2,81,8
2020-03-31,Democratic Republic of Congo,17,0,98,8
2020-04-01,Democratic Republic of Congo,11,1,109,9
2020-04-02,Democratic Republic of Congo,25,4,134,13
2020-04-03,Democratic Republic of Congo,0,0,134,13
2020-04-04,Democratic Republic of Congo,20,5,154,18
2020-04-05,Democratic Republic of Congo,0,0,154,18
2020-04-06,Democratic Republic of Congo,7,0,161,18
2020-04-07,Democratic Republic of Congo,19,0,180,18
2020-04-08,Democratic Republic of Congo,0,0,180,18
2020-04-09,Democratic Republic of Congo,0,0,180,18
2020-04-10,Democratic Republic of Congo,35,2,215,20
2020-04-11,Democratic Republic of Congo,8,0,223,20
2020-04-12,Democratic Republic of Congo,11,0,234,20
2020-04-13,Democratic Republic of Congo,1,0,235,20
2020-04-14,Democratic Republic of Congo,6,0,241,20
2020-04-15,Democratic Republic of Congo,13,1,254,21
2020-04-16,Democratic Republic of Congo,13,1,267,22
2020-04-17,Democratic Republic of Congo,20,1,287,23
2020-04-18,Democratic Republic of Congo,20,2,307,25
2020-04-19,Democratic Republic of Congo,20,0,327,25
2020-04-20,Democratic Republic of Congo,5,0,332,25
2020-04-21,Democratic Republic of Congo,18,0,350,25
2020-04-22,Democratic Republic of Congo,9,0,359,25
2020-04-23,Democratic Republic of Congo,18,0,377,25
2020-04-24,Democratic Republic of Congo,17,0,394,25
2020-04-25,Democratic Republic of Congo,22,3,416,28
2020-04-26,Democratic Republic of Congo,26,0,442,28
2020-04-27,Democratic Republic of Congo,17,0,459,28
2020-04-28,Democratic Republic of Congo,12,2,471,30
2020-04-29,Democratic Republic of Congo,20,0,491,30
2020-04-30,Democratic Republic of Congo,81,1,572,31
2020-05-01,Democratic Republic of Congo,32,1,604,32
2020-05-02,Democratic Republic of Congo,70,1,674,33
2020-05-03,Democratic Republic of Congo,0,0,674,33
2020-05-04,Democratic Republic of Congo,8,1,682,34
2020-05-05,Democratic Republic of Congo,23,0,705,34
2020-05-06,Democratic Republic of Congo,92,1,797,35
2020-05-07,Democratic Republic of Congo,66,1,863,36
2020-05-08,Democratic Republic of Congo,74,3,937,39
2020-05-09,Democratic Republic of Congo,0,0,937,39
2020-05-10,Democratic Republic of Congo,54,2,991,41
2020-05-11,Democratic Republic of Congo,33,0,1024,41
2020-05-12,Democratic Republic of Congo,78,3,1102,44
2020-05-13,Democratic Republic of Congo,67,6,1169,50
2020-05-14,Democratic Republic of Congo,73,0,1242,50
2020-05-15,Democratic Republic of Congo,56,0,1298,50
2020-05-16,Democratic Republic of Congo,157,11,1455,61
2020-05-17,Democratic Republic of Congo,0,0,1455,61
2020-05-18,Democratic Republic of Congo,83,0,1538,61
2020-05-19,Democratic Republic of Congo,91,0,1629,61
2020-05-20,Democratic Republic of Congo,102,0,1731,61
2020-05-21,Democratic Republic of Congo,104,0,1835,61
2020-05-22,Democratic Republic of Congo,110,2,1945,63
2020-05-23,Democratic Republic of Congo,80,0,2025,63
2020-05-24,Democratic Republic of Congo,116,0,2141,63
2020-05-25,Democratic Republic of Congo,156,4,2297,67
2020-05-26,Democratic Republic of Congo,106,1,2403,68
2020-05-27,Democratic Republic of Congo,143,0,2546,68
2020-05-28,Democratic Republic of Congo,114,1,2660,69
2020-05-29,Democratic Republic of Congo,173,0,2833,69
2020-05-30,Democratic Republic of Congo,133,0,2966,69
2020-05-31,Democratic Republic of Congo,104,3,3070,72
2020-06-01,Democratic Republic of Congo,125,0,3195,72
2020-06-02,Democratic Republic of Congo,131,0,3326,72
2020-06-03,Democratic Republic of Congo,169,3,3495,75
2020-06-04,Democratic Republic of Congo,149,3,3644,78
2020-06-05,Democratic Republic of Congo,120,3,3764,81
2020-06-06,Democratic Republic of Congo,114,1,3878,82
2020-06-07,Democratic Republic of Congo,138,3,4016,85
2020-06-08,Democratic Republic of Congo,90,3,4106,88
2020-06-09,Democratic Republic of Congo,153,2,4259,90
2020-06-10,Democratic Republic of Congo,131,6,4390,96
2020-06-11,Democratic Republic of Congo,125,2,4515,98
2020-06-12,Democratic Republic of Congo,122,3,4637,101
2020-06-13,Democratic Republic of Congo,87,5,4724,106
2020-06-14,Democratic Republic of Congo,54,1,4778,107
2020-06-15,Democratic Republic of Congo,59,5,4837,112
2020-06-16,Democratic Republic of Congo,137,0,4974,112
2020-06-17,Democratic Republic of Congo,126,3,5100,115
2020-06-18,Democratic Republic of Congo,183,2,5283,117
2020-06-19,Democratic Republic of Congo,194,5,5477,122
2020-06-20,Democratic Republic of Congo,195,3,5672,125
2020-06-21,Democratic Republic of Congo,154,5,5826,130
2020-06-22,Democratic Republic of Congo,98,5,5924,135
2020-06-23,Democratic Republic of Congo,103,0,6027,135
2020-06-24,Democratic Republic of Congo,186,7,6213,142
2020-06-25,Democratic Republic of Congo,198,0,6411,142
2020-06-26,Democratic Republic of Congo,141,7,6552,149
2020-06-27,Democratic Republic of Congo,138,4,6690,153
2020-06-28,Democratic Republic of Congo,137,4,6827,157
2020-06-29,Democratic Republic of Congo,112,10,6939,167
2020-06-30,Democratic Republic of Congo,100,3,7039,170
2020-07-01,Democratic Republic of Congo,83,5,7122,175
2020-07-02,Democratic Republic of Congo,67,1,7189,176
2020-07-03,Democratic Republic of Congo,122,3,7311,179
2020-07-04,Democratic Republic of Congo,68,3,7379,182
2020-07-05,Democratic Republic of Congo,32,0,7411,182
2020-07-06,Democratic Republic of Congo,21,0,7432,182
2020-07-07,Democratic Republic of Congo,0,0,7432,182
2020-07-08,Democratic Republic of Congo,0,0,7432,182
2020-07-09,Democratic Republic of Congo,414,7,7846,189
2020-07-10,Democratic Republic of Congo,59,0,7905,189
2020-07-11,Democratic Republic of Congo,66,0,7971,189
2020-07-12,Democratic Republic of Congo,62,0,8033,189
2020-07-13,Democratic Republic of Congo,42,1,8075,190
2020-07-14,Democratic Republic of Congo,60,0,8135,190
2020-07-15,Democratic Republic of Congo,28,2,8163,192
2020-07-16,Democratic Republic of Congo,36,1,8199,193
2020-07-17,Democratic Republic of Congo,50,0,8249,193
2020-07-18,Democratic Republic of Congo,75,0,8324,193
2020-07-19,Democratic Republic of Congo,79,1,8403,194
2020-07-20,Democratic Republic of Congo,40,0,8443,194
2020-07-21,Democratic Republic of Congo,91,2,8534,196
2020-07-22,Democratic Republic of Congo,92,1,8626,197
2020-07-23,Democratic Republic of Congo,94,4,8720,201
2020-07-24,Democratic Republic of Congo,47,0,8767,201
2020-07-25,Democratic Republic of Congo,34,3,8801,204
2020-07-26,Democratic Republic of Congo,30,0,8831,204
2020-07-27,Democratic Republic of Congo,13,4,8844,208
2020-07-28,Democratic Republic of Congo,29,0,8873,208
2020-07-29,Democratic Republic of Congo,58,2,8931,210
2020-07-30,Democratic Republic of Congo,79,5,9010,215
2020-07-31,Democratic Republic of Congo,60,0,9070,215
2020-08-01,Democratic Republic of Congo,14,0,9084,215
2020-08-02,Democratic Republic of Congo,31,0,9115,215
2020-08-03,Democratic Republic of Congo,18,0,9133,215
2020-08-04,Democratic Republic of Congo,45,0,9178,215
2020-08-05,Democratic Republic of Congo,75,0,9253,215
2020-08-06,Democratic Republic of Congo,56,0,9309,215
2020-08-07,Democratic Republic of Congo,46,3,9355,218
2020-08-08,Democratic Republic of Congo,81,0,9436,218
2020-08-09,Democratic Republic of Congo,18,6,9454,224
2020-08-10,Democratic Republic of Congo,35,0,9489,224
2020-08-11,Democratic Republic of Congo,10,1,9499,225
2020-08-12,Democratic Republic of Congo,39,0,9538,225
2020-08-13,Democratic Republic of Congo,51,9,9589,234
2020-08-14,Democratic Republic of Congo,16,4,9605,238
2020-08-15,Democratic Republic of Congo,33,1,9638,239
2020-08-16,Democratic Republic of Congo,38,1,9676,240
2020-08-17,Democratic Republic of Congo,30,3,9706,243
2020-08-18,Democratic Republic of Congo,15,0,9721,243
2020-08-19,Democratic Republic of Congo,20,3,9741,246
2020-08-20,Democratic Republic of Congo,16,1,9757,247
2020-08-21,Democratic Republic of Congo,45,1,9802,248
2020-08-22,Democratic Republic of Congo,9,3,9811,251
2020-08-23,Democratic Republic of Congo,19,0,9830,251
2020-08-24,Democratic Republic of Congo,12,0,9842,251
2020-08-25,Democratic Republic of Congo,49,0,9891,251
2020-08-26,Democratic Republic of Congo,21,3,9912,254
2020-08-27,Democratic Republic of Congo,3,1,9915,255
2020-08-28,Democratic Republic of Congo,79,0,9994,255
2020-08-29,Democratic Republic of Congo,13,3,10007,258
2020-08-30,Democratic Republic of Congo,38,0,10045,258
2020-08-31,Democratic Republic of Congo,52,0,10097,258
2020-09-01,Democratic Republic of Congo,7,1,10104,259
2020-09-02,Democratic Republic of Congo,10,0,10114,259
2020-09-03,Democratic Republic of Congo,11,0,10125,259
2020-09-04,Democratic Republic of Congo,24,0,10149,259
2020-09-05,Democratic Republic of Congo,29,0,10178,259
2020-09-06,Democratic Republic of Congo,32,1,10210,260
2020-09-07,Democratic Republic of Congo,23,0,10233,260
2020-09-08,Democratic Republic of Congo,59,0,10292,260
2020-09-09,Democratic Republic of Congo,32,0,10324,260
2020-09-10,Democratic Republic of Congo,19,2,10343,262
2020-09-11,Democratic Republic of Congo,18,0,10361,262
2020-09-12,Democratic Republic of Congo,24,0,10385,262
2020-09-13,Democratic Republic of Congo,5,2,10390,264
2020-09-14,Democratic Republic of Congo,0,0,10390,264
2020-09-15,Democratic Republic of Congo,11,3,10401,267
2020-09-16,Democratic Republic of Congo,13,0,10414,267
2020-09-17,Democratic Republic of Congo,28,0,10442,267
2020-09-18,Democratic Republic of Congo,14,1,10456,268
2020-09-19,Democratic Republic of Congo,32,0,10488,268
2020-09-20,Democratic Republic of Congo,27,3,10515,271
2020-09-21,Democratic Republic of Congo,4,0,10519,271
2020-09-22,Democratic Republic of Congo,4,0,10523,271
2020-09-23,Democratic Republic of Congo,14,0,10537,271
2020-09-24,Democratic Republic of Congo,18,0,10555,271
2020-09-25,Democratic Republic of Congo,23,0,10578,271
2020-09-26,Democratic Republic of Congo,15,0,10593,271
2020-09-27,Democratic Republic of Congo,19,0,10612,271
2020-09-28,Democratic Republic of Congo,12,0,10624,271
2020-09-29,Democratic Republic of Congo,7,1,10631,272
2020-09-30,Democratic Republic of Congo,28,0,10659,272
2020-10-01,Democratic Republic of Congo,26,0,10685,272
2020-10-02,Democratic Republic of Congo,44,0,10729,272
2020-10-03,Democratic Republic of Congo,23,2,10752,274
2020-10-04,Democratic Republic of Congo,8,0,10760,274
2020-10-05,Democratic Republic of Congo,18,0,10778,274
2020-10-06,Democratic Republic of Congo,11,0,10789,274
2020-10-07,Democratic Republic of Congo,15,2,10804,276
2020-10-08,Democratic Republic of Congo,18,0,10822,276
2020-10-09,Democratic Republic of Congo,13,0,10835,276
2020-10-10,Democratic Republic of Congo,6,0,10841,276
2020-10-11,Democratic Republic of Congo,10,0,10851,276
2020-10-12,Democratic Republic of Congo,17,0,10868,276
2020-10-13,Democratic Republic of Congo,4,0,10872,276
2020-10-14,Democratic Republic of Congo,63,5,10935,281
2020-10-15,Democratic Republic of Congo,0,0,10935,281
2020-10-16,Democratic Republic of Congo,64,20,10999,301
2020-10-17,Democratic Republic of Congo,1,1,11000,302
2020-10-18,Democratic Republic of Congo,6,0,11006,302
2020-10-19,Democratic Republic of Congo,46,1,11052,303
2020-10-20,Democratic Republic of Congo,14,0,11066,303
2020-10-21,Democratic Republic of Congo,0,0,11066,303
2020-10-22,Democratic Republic of Congo,31,1,11097,304
2020-10-23,Democratic Republic of Congo,25,0,11122,304
2020-10-24,Democratic Republic of Congo,21,1,11143,305
2020-10-25,Democratic Republic of Congo,0,0,11143,305
2020-10-26,Democratic Republic of Congo,31,0,11174,305
2020-10-27,Democratic Republic of Congo,17,0,11191,305
2020-10-28,Democratic Republic of Congo,20,0,11211,305
2020-10-29,Democratic Republic of Congo,0,0,11211,305
2020-10-30,Democratic Republic of Congo,95,2,11306,307
2020-10-31,Democratic Republic of Congo,0,0,11306,307
2020-11-01,Democratic Republic of Congo,67,1,11373,308
2020-11-02,Democratic Republic of Congo,22,0,11395,308
2020-11-03,Democratic Republic of Congo,32,7,11427,315
2020-11-04,Democratic Republic of Congo,23,0,11450,315
2020-11-05,Democratic Republic of Congo,0,0,11450,315
2020-11-06,Democratic Republic of Congo,67,0,11517,315
2020-11-07,Democratic Republic of Congo,33,1,11550,316
2020-11-08,Democratic Republic of Congo,41,0,11591,316
2020-11-09,Democratic Republic of Congo,17,0,11608,316
2020-11-10,Democratic Republic of Congo,34,0,11642,316
2020-11-11,Democratic Republic of Congo,14,0,11656,316
2020-11-12,Democratic Republic of Congo,36,2,11692,318
2020-11-13,Democratic Republic of Congo,0,0,11692,318
2020-11-14,Democratic Republic of Congo,68,1,11760,319
2020-11-15,Democratic Republic of Congo,0,0,11760,319
2020-11-16,Democratic Republic of Congo,79,2,11839,321
2020-11-17,Democratic Republic of Congo,27,1,11866,322
2020-11-18,Democratic Republic of Congo,52,1,11918,323
2020-11-19,Democratic Republic of Congo,90,0,12008,323
2020-11-20,Democratic Republic of Congo,121,1,12129,324
2020-11-21,Democratic Republic of Congo,51,3,12180,327
2020-11-22,Democratic Republic of Congo,0,0,12180,327
2020-11-23,Democratic Republic of Congo,98,2,12278,329
2020-11-24,Democratic Republic of Congo,32,2,12310,331
2020-11-25,Democratic Republic of Congo,55,0,12365,331
2020-11-26,Democratic Republic of Congo,105,2,12470,333
2020-11-27,Democratic Republic of Congo,0,0,12470,333
2020-11-28,Democratic Republic of Congo,138,0,12608,333
2020-11-29,Democratic Republic of Congo,94,0,12702,333
2020-11-30,Democratic Republic of Congo,70,0,12772,333
2020-12-01,Democratic Republic of Congo,87,2,12859,335
2020-12-02,Democratic Republic of Congo,128,1,12987,336
2020-12-03,Democratic Republic of Congo,145,1,13132,337
2020-12-04,Democratic Republic of Congo,149,0,13281,337
2020-12-05,Democratic Republic of Congo,132,5,13413,342
2020-12-06,Democratic Republic of Congo,114,2,13527,344
2020-12-07,Democratic Republic of Congo,68,0,13595,344
2020-12-08,Democratic Republic of Congo,155,0,13750,344
2020-12-09,Democratic Republic of Congo,93,6,13843,350
2020-12-10,Democratic Republic of Congo,154,0,13997,350
2020-12-11,Democratic Republic of Congo,172,0,14169,350
2020-12-12,Democratic Republic of Congo,173,2,14342,352
2020-12-13,Democratic Republic of Congo,119,0,14461,352
2020-12-14,Democratic Republic of Congo,52,4,14513,356
2020-12-15,Democratic Republic of Congo,84,2,14597,358
2020-12-16,Democratic Republic of Congo,333,6,14930,364
2020-12-17,Democratic Republic of Congo,159,2,15089,366
2020-12-18,Democratic Republic of Congo,0,0,15089,366
2020-12-19,Democratic Republic of Congo,308,3,15397,369
2020-12-20,Democratic Republic of Congo,98,1,15495,370
2020-12-21,Democratic Republic of Congo,174,0,15669,370
2020-12-22,Democratic Republic of Congo,141,0,15810,370
2020-12-23,Democratic Republic of Congo,229,196,16039,566
2020-12-24,Democratic Republic of Congo,243,7,16282,573
2020-12-25,Democratic Republic of Congo,190,0,16472,573
2020-12-26,Democratic Republic of Congo,291,0,16763,573
2020-12-27,Democratic Republic of Congo,76,6,16839,579
2020-12-28,Democratic Republic of Congo,78,0,16917,579
2020-12-29,Democratic Republic of Congo,265,5,17182,584
2020-12-30,Democratic Republic of Congo,194,0,17376,584
2020-12-31,Democratic Republic of Congo,282,7,17658,591
2021-01-01,Democratic Republic of Congo,191,0,17849,591
2021-01-02,Democratic Republic of Congo,149,4,17998,595
2021-01-03,Democratic Republic of Congo,104,1,18102,596
2021-01-04,Democratic Republic of Congo,51,3,18153,599
2021-01-05,Democratic Republic of Congo,95,0,18248,599
2021-01-06,Democratic Republic of Congo,239,0,18487,599
2021-01-07,Democratic Republic of Congo,251,11,18738,610
2021-01-08,Democratic Republic of Congo,231,1,18969,611
2021-01-09,Democratic Republic of Congo,190,0,19159,611
2021-01-10,Democratic Republic of Congo,277,0,19436,611
2021-01-11,Democratic Republic of Congo,60,8,19496,619
2021-01-12,Democratic Republic of Congo,211,6,19707,625
2021-01-13,Democratic Republic of Congo,296,1,20003,626
2021-01-14,Democratic Republic of Congo,476,0,20479,626
2021-01-15,Democratic Republic of Congo,77,2,20556,628
2021-01-16,Democratic Republic of Congo,137,2,20693,630
2021-01-17,Democratic Republic of Congo,215,1,20908,631
2021-01-18,Democratic Republic of Congo,152,3,21060,634
2021-01-19,Democratic Republic of Congo,80,6,21140,640
2021-01-20,Democratic Republic of Congo,162,0,21302,640
2021-01-21,Democratic Republic of Congo,96,4,21398,644
2021-01-22,Democratic Republic of Congo,199,3,21597,647
2021-01-23,Democratic Republic of Congo,116,7,21713,654
2021-01-24,Democratic Republic of Congo,156,7,21869,661
2021-01-25,Democratic Republic of Congo,85,0,21954,661
2021-01-26,Democratic Republic of Congo,94,0,22048,661
2021-01-27,Democratic Republic of Congo,130,0,22178,661
2021-01-28,Democratic Republic of Congo,144,4,22322,665
2021-01-29,Democratic Republic of Congo,133,0,22455,665
2021-01-30,Democratic Republic of Congo,149,6,22604,671
2021-01-31,Democratic Republic of Congo,167,0,22771,671
2021-02-01,Democratic Republic of Congo,71,2,22842,673
2021-02-02,Democratic Republic of Congo,201,2,23043,675
2021-02-03,Democratic Republic of Congo,139,0,23182,675
2021-02-04,Democratic Republic of Congo,40,3,23222,678
2021-02-05,Democratic Republic of Congo,149,0,23371,678
2021-02-06,Democratic Republic of Congo,114,1,23485,679
2021-02-07,Democratic Republic of Congo,114,2,23599,681
2021-02-08,Democratic Republic of Congo,72,0,23671,681
2021-02-09,Democratic Republic of Congo,100,3,23771,684
2021-02-10,Democratic Republic of Congo,119,2,23890,686
2021-02-11,Democratic Republic of Congo,136,0,24026,686
2021-02-12,Democratic Republic of Congo,126,5,24152,691
2021-02-13,Democratic Republic of Congo,88,2,24240,693
2021-02-14,Democratic Republic of Congo,55,0,24295,693
2021-02-15,Democratic Republic of Congo,91,0,24386,693
2021-02-16,Democratic Republic of Congo,37,2,24423,695
2021-02-17,Democratic Republic of Congo,179,0,24602,695
2021-02-18,Democratic Republic of Congo,192,0,24794,695
2021-02-19,Democratic Republic of Congo,170,0,24964,695
2021-02-20,Democratic Republic of Congo,116,5,25080,700
2021-02-21,Democratic Republic of Congo,0,0,25080,700
2021-02-22,Democratic Republic of Congo,64,0,25144,700
2021-02-23,Democratic Republic of Congo,0,0,25144,700
2021-02-24,Democratic Republic of Congo,0,0,25144,700
2021-02-25,Democratic Republic of Congo,0,0,25144,700
2021-02-26,Democratic Republic of Congo,547,7,25691,707
2021-02-27,Democratic Republic of Congo,101,0,25792,707
2021-02-28,Democratic Republic of Congo,121,0,25913,707
2021-03-01,Democratic Republic of Congo,49,0,25962,707
2021-03-02,Democratic Republic of Congo,88,4,26050,711
2021-03-03,Democratic Republic of Congo,197,0,26247,711
2021-03-04,Democratic Republic of Congo,93,0,26340,711
2021-03-05,Democratic Republic of Congo,0,0,26340,711
2021-03-06,Democratic Republic of Congo,129,1,26469,712
2021-03-07,Democratic Republic of Congo,72,0,26541,712
2021-03-08,Democratic Republic of Congo,86,0,26627,712
2021-03-09,Democratic Republic of Congo,57,0,26684,712
2021-03-10,Democratic Republic of Congo,54,0,26738,712
2021-03-11,Democratic Republic of Congo,21,0,26759,712
2021-03-12,Democratic Republic of Congo,87,0,26846,712
2021-03-13,Democratic Republic of Congo,92,5,26938,717
2021-03-14,Democratic Republic of Congo,76,0,27014,717
2021-03-15,Democratic Republic of Congo,63,0,27077,717
2021-03-16,Democratic Republic of Congo,23,5,27100,722
2021-03-17,Democratic Republic of Congo,152,0,27252,722
2021-03-18,Democratic Republic of Congo,38,4,27290,726
2021-03-19,Democratic Republic of Congo,66,0,27356,726
2021-03-20,Democratic Republic of Congo,112,0,27468,726
2021-03-21,Democratic Republic of Congo,85,0,27553,726
2021-03-22,Democratic Republic of Congo,19,0,27572,726
2021-03-23,Democratic Republic of Congo,8,0,27580,726
2021-03-24,Democratic Republic of Congo,80,0,27660,726
2021-03-25,Democratic Republic of Congo,69,0,27729,726
2021-03-26,Democratic Republic of Congo,65,0,27794,726
2021-03-27,Democratic Republic of Congo,93,8,27887,734
2021-03-28,Democratic Republic of Congo,43,5,27930,739
2021-03-29,Democratic Republic of Congo,82,0,28012,739
2021-03-30,Democratic Republic of Congo,64,4,28076,743
2021-03-31,Democratic Republic of Congo,66,0,28142,743
2021-04-01,Democratic Republic of Congo,57,2,28199,745
2021-04-02,Democratic Republic of Congo,18,0,28217,745
2021-04-03,Democratic Republic of Congo,75,0,28292,745
2021-04-04,Democratic Republic of Congo,33,0,28325,745
2021-04-05,Democratic Republic of Congo,29,0,28354,745
2021-04-06,Democratic Republic of Congo,23,0,28377,745
2021-04-07,Democratic Republic of Congo,33,0,28410,745
2021-04-08,Democratic Republic of Congo,64,0,28474,745
2020-02-27,Denmark,1,0,1,0
2020-02-28,Denmark,0,0,1,0
2020-02-29,Denmark,2,0,3,0
2020-03-01,Denmark,1,0,4,0
2020-03-02,Denmark,0,0,4,0
2020-03-03,Denmark,2,0,6,0
2020-03-04,Denmark,5,0,11,0
2020-03-05,Denmark,0,0,11,0
2020-03-06,Denmark,13,0,24,0
2020-03-07,Denmark,0,0,24,0
2020-03-08,Denmark,13,0,37,0
2020-03-09,Denmark,55,0,92,0
2020-03-10,Denmark,172,0,264,0
2020-03-11,Denmark,180,0,444,0
2020-03-12,Denmark,173,0,617,0
2020-03-13,Denmark,187,0,804,0
2020-03-14,Denmark,32,1,836,1
2020-03-15,Denmark,39,1,875,2
2020-03-16,Denmark,58,1,933,3
2020-03-17,Denmark,92,1,1025,4
2020-03-18,Denmark,91,0,1116,4
2020-03-19,Denmark,109,2,1225,6
2020-03-20,Denmark,112,3,1337,9
2020-03-21,Denmark,83,4,1420,13
2020-03-22,Denmark,94,0,1514,13
2020-03-23,Denmark,58,11,1572,24
2020-03-24,Denmark,146,8,1718,32
2020-03-25,Denmark,144,2,1862,34
2020-03-26,Denmark,161,7,2023,41
2020-03-27,Denmark,177,11,2200,52
2020-03-28,Denmark,166,13,2366,65
2020-03-29,Denmark,198,7,2564,72
2020-03-30,Denmark,191,5,2755,77
2020-03-31,Denmark,284,13,3039,90
2020-04-01,Denmark,251,14,3290,104
2020-04-02,Denmark,283,19,3573,123
2020-04-03,Denmark,373,16,3946,139
2020-04-04,Denmark,323,22,4269,161
2020-04-05,Denmark,292,18,4561,179
2020-04-06,Denmark,314,8,4875,187
2020-04-07,Denmark,391,16,5266,203
2020-04-08,Denmark,331,15,5597,218
2020-04-09,Denmark,233,19,5830,237
2020-04-10,Denmark,184,10,6014,247
2020-04-11,Denmark,177,13,6191,260
2020-04-12,Denmark,178,13,6369,273
2020-04-13,Denmark,144,12,6513,285
2020-04-14,Denmark,193,14,6706,299
2020-04-15,Denmark,170,10,6876,309
2020-04-16,Denmark,198,12,7074,321
2020-04-17,Denmark,194,15,7268,336
2020-04-18,Denmark,169,10,7437,346
2020-04-19,Denmark,143,9,7580,355
2020-04-20,Denmark,131,9,7711,364
2020-04-21,Denmark,180,6,7891,370
2020-04-22,Denmark,217,14,8108,384
2020-04-23,Denmark,163,10,8271,394
2020-04-24,Denmark,137,9,8408,403
2020-04-25,Denmark,235,15,8643,418
2020-04-26,Denmark,130,4,8773,422
2020-04-27,Denmark,123,5,8896,427
2020-04-28,Denmark,153,7,9049,434
2020-04-29,Denmark,157,9,9206,443
2020-04-30,Denmark,150,9,9356,452
2020-05-01,Denmark,153,8,9509,460
2020-05-02,Denmark,96,15,9605,475
2020-05-03,Denmark,116,9,9721,484
2020-05-04,Denmark,147,9,9868,493
2020-05-05,Denmark,151,10,10019,503
2020-05-06,Denmark,117,3,10136,506
2020-05-07,Denmark,145,8,10281,514
2020-05-08,Denmark,135,8,10416,522
2020-05-09,Denmark,101,4,10517,526
2020-05-10,Denmark,110,3,10627,529
2020-05-11,Denmark,84,4,10711,533
2020-05-12,Denmark,78,-6,10789,527
2020-05-13,Denmark,76,6,10865,533
2020-05-14,Denmark,46,4,10911,537
2020-05-15,Denmark,78,0,10989,537
2020-05-16,Denmark,67,6,11056,543
2020-05-17,Denmark,69,4,11125,547
2020-05-18,Denmark,41,1,11166,548
2020-05-19,Denmark,76,3,11242,551
2020-05-20,Denmark,73,3,11315,554
2020-05-21,Denmark,65,7,11380,561
2020-05-22,Denmark,48,0,11428,561
2020-05-23,Denmark,59,0,11487,561
2020-05-24,Denmark,72,1,11559,562
2020-05-25,Denmark,27,1,11586,563
2020-05-26,Denmark,41,0,11627,563
2020-05-27,Denmark,53,2,11680,565
2020-05-28,Denmark,32,3,11712,568
2020-05-29,Denmark,81,0,11793,568
2020-05-30,Denmark,40,3,11833,571
2020-05-31,Denmark,36,3,11869,574
2020-06-01,Denmark,30,2,11899,576
2020-06-02,Denmark,35,4,11934,580
2020-06-03,Denmark,37,0,11971,580
2020-06-04,Denmark,40,2,12011,582
2020-06-05,Denmark,64,4,12075,586
2020-06-06,Denmark,49,1,12124,587
2020-06-07,Denmark,24,2,12148,589
2020-06-08,Denmark,14,4,12162,593
2020-06-09,Denmark,39,0,12201,593
2020-06-10,Denmark,15,0,12216,593
2020-06-11,Denmark,19,0,12235,593
2020-06-12,Denmark,64,1,12299,594
2020-06-13,Denmark,40,3,12339,597
2020-06-14,Denmark,54,0,12393,597
2020-06-15,Denmark,24,1,12417,598
2020-06-16,Denmark,33,0,12450,598
2020-06-17,Denmark,44,0,12494,598
2020-06-18,Denmark,50,2,12544,600
2020-06-19,Denmark,47,0,12591,600
2020-06-20,Denmark,0,0,12591,600
2020-06-21,Denmark,0,0,12591,600
2020-06-22,Denmark,136,2,12727,602
2020-06-23,Denmark,34,1,12761,603
2020-06-24,Denmark,54,0,12815,603
2020-06-25,Denmark,21,0,12836,603
2020-06-26,Denmark,39,1,12875,604
2020-06-27,Denmark,0,0,12875,604
2020-06-28,Denmark,0,0,12875,604
2020-06-29,Denmark,76,1,12951,605
2020-06-30,Denmark,17,0,12968,605
2020-07-01,Denmark,26,1,12994,606
2020-07-02,Denmark,21,0,13015,606
2020-07-03,Denmark,17,0,13032,606
2020-07-04,Denmark,0,0,13032,606
2020-07-05,Denmark,1,0,13033,606
2020-07-06,Denmark,46,1,13079,607
2020-07-07,Denmark,10,2,13089,609
2020-07-08,Denmark,12,0,13101,609
2020-07-09,Denmark,16,0,13117,609
2020-07-10,Denmark,30,0,13147,609
2020-07-11,Denmark,0,0,13147,609
2020-07-12,Denmark,0,0,13147,609
2020-07-13,Denmark,91,1,13238,610
2020-07-14,Denmark,24,0,13262,610
2020-07-15,Denmark,31,0,13293,610
2020-07-16,Denmark,32,0,13325,610
2020-07-17,Denmark,49,1,13374,611
2020-07-18,Denmark,0,0,13374,611
2020-07-19,Denmark,3,0,13377,611
2020-07-20,Denmark,89,0,13466,611
2020-07-21,Denmark,40,0,13506,611
2020-07-22,Denmark,48,0,13554,611
2020-07-23,Denmark,40,1,13594,612
2020-07-24,Denmark,48,1,13642,613
2020-07-25,Denmark,1,0,13643,613
2020-07-26,Denmark,22,0,13665,613
2020-07-27,Denmark,110,0,13775,613
2020-07-28,Denmark,36,0,13811,613
2020-07-29,Denmark,57,1,13868,614
2020-07-30,Denmark,96,1,13964,615
2020-07-31,Denmark,64,0,14028,615
2020-08-01,Denmark,0,0,14028,615
2020-08-02,Denmark,0,0,14028,615
2020-08-03,Denmark,207,1,14235,616
2020-08-04,Denmark,79,0,14314,616
2020-08-05,Denmark,126,0,14440,616
2020-08-06,Denmark,146,1,14586,617
2020-08-07,Denmark,161,0,14747,617
2020-08-08,Denmark,4,0,14751,617
2020-08-09,Denmark,8,0,14759,617
2020-08-10,Denmark,376,3,15135,620
2020-08-11,Denmark,156,1,15291,621
2020-08-12,Denmark,132,0,15423,621
2020-08-13,Denmark,167,0,15590,621
2020-08-14,Denmark,168,0,15758,621
2020-08-15,Denmark,109,0,15867,621
2020-08-16,Denmark,136,0,16003,621
2020-08-17,Denmark,124,0,16127,621
2020-08-18,Denmark,119,0,16246,621
2020-08-19,Denmark,90,0,16336,621
2020-08-20,Denmark,117,0,16453,621
2020-08-21,Denmark,72,0,16525,621
2020-08-22,Denmark,112,1,16637,622
2020-08-23,Denmark,78,0,16715,622
2020-08-24,Denmark,106,1,16821,623
2020-08-25,Denmark,84,0,16905,623
2020-08-26,Denmark,57,0,16962,623
2020-08-27,Denmark,90,1,17052,624
2020-08-28,Denmark,73,0,17125,624
2020-08-29,Denmark,79,0,17204,624
2020-08-30,Denmark,112,0,17316,624
2020-08-31,Denmark,94,0,17410,624
2020-09-01,Denmark,99,1,17509,625
2020-09-02,Denmark,111,1,17620,626
2020-09-03,Denmark,180,0,17800,626
2020-09-04,Denmark,174,1,17974,627
2020-09-05,Denmark,189,0,18163,627
2020-09-06,Denmark,147,0,18310,627
2020-09-07,Denmark,230,1,18540,628
2020-09-08,Denmark,244,0,18784,628
2020-09-09,Denmark,252,0,19036,628
2020-09-10,Denmark,317,1,19353,629
2020-09-11,Denmark,293,0,19646,629
2020-09-12,Denmark,343,1,19989,630
2020-09-13,Denmark,338,1,20327,631
2020-09-14,Denmark,347,2,20674,633
2020-09-15,Denmark,339,0,21013,633
2020-09-16,Denmark,0,0,21013,633
2020-09-17,Denmark,823,2,21836,635
2020-09-18,Denmark,455,0,22291,635
2020-09-19,Denmark,590,0,22881,635
2020-09-20,Denmark,472,3,23353,638
2020-09-21,Denmark,421,2,23774,640
2020-09-22,Denmark,487,1,24261,641
2020-09-23,Denmark,561,2,24822,643
2020-09-24,Denmark,563,2,25385,645
2020-09-25,Denmark,681,2,26066,647
2020-09-26,Denmark,621,1,26687,648
2020-09-27,Denmark,424,1,27111,649
2020-09-28,Denmark,435,0,27546,649
2020-09-29,Denmark,395,1,27941,650
2020-09-30,Denmark,538,0,28479,650
2020-10-01,Denmark,403,1,28882,651
2020-10-02,Denmark,536,1,29418,652
2020-10-03,Denmark,371,2,29789,654
2020-10-04,Denmark,379,4,30168,658
2020-10-05,Denmark,378,1,30546,659
2020-10-06,Denmark,322,4,30868,663
2020-10-07,Denmark,333,0,31201,663
2020-10-08,Denmark,447,2,31648,665
2020-10-09,Denmark,483,0,32131,665
2020-10-10,Denmark,444,2,32575,667
2020-10-11,Denmark,340,2,32915,669
2020-10-12,Denmark,389,2,33304,671
2020-10-13,Denmark,290,3,33594,674
2020-10-14,Denmark,493,1,34087,675
2020-10-15,Denmark,432,2,34519,677
2020-10-16,Denmark,420,0,34939,677
2020-10-17,Denmark,501,2,35440,679
2020-10-18,Denmark,453,1,35893,680
2020-10-19,Denmark,452,6,36345,686
2020-10-20,Denmark,532,2,36877,688
2020-10-21,Denmark,630,2,37507,690
2020-10-22,Denmark,763,4,38270,694
2020-10-23,Denmark,859,3,39129,697
2020-10-24,Denmark,789,3,39918,700
2020-10-25,Denmark,945,2,40863,702
2020-10-26,Denmark,1056,6,41919,708
2020-10-27,Denmark,749,1,42668,709
2020-10-28,Denmark,1017,6,43685,715
2020-10-29,Denmark,860,1,44545,716
2020-10-30,Denmark,1191,3,45736,719
2020-10-31,Denmark,1127,2,46863,721
2020-11-01,Denmark,948,2,47811,723
2020-11-02,Denmark,942,1,48753,724
2020-11-03,Denmark,1353,4,50106,728
2020-11-04,Denmark,936,1,51042,729
2020-11-05,Denmark,1223,4,52265,733
2020-11-06,Denmark,1427,5,53692,738
2020-11-07,Denmark,1050,2,54742,740
2020-11-08,Denmark,893,3,55635,743
2020-11-09,Denmark,771,4,56406,747
2020-11-10,Denmark,1066,3,57472,750
2020-11-11,Denmark,994,3,58466,753
2020-11-12,Denmark,1012,2,59478,755
2020-11-13,Denmark,1037,1,60515,756
2020-11-14,Denmark,1078,1,61593,757
2020-11-15,Denmark,1059,3,62652,760
2020-11-16,Denmark,1195,4,63847,764
2020-11-17,Denmark,1220,4,65067,768
2020-11-18,Denmark,1257,2,66324,770
2020-11-19,Denmark,1297,3,67621,773
2020-11-20,Denmark,1257,5,68878,778
2020-11-21,Denmark,1274,3,70152,781
2020-11-22,Denmark,851,3,71003,784
2020-11-23,Denmark,1169,5,72172,789
2020-11-24,Denmark,1367,8,73539,797
2020-11-25,Denmark,1183,5,74722,802
2020-11-26,Denmark,1191,9,75913,811
2020-11-27,Denmark,1323,5,77236,816
2020-11-28,Denmark,1638,7,78874,823
2020-11-29,Denmark,998,6,79872,829
2020-11-30,Denmark,1130,8,81002,837
2020-12-01,Denmark,1468,9,82470,846
2020-12-02,Denmark,1586,6,84056,852
2020-12-03,Denmark,1607,6,85663,858
2020-12-04,Denmark,1603,9,87266,867
2020-12-05,Denmark,2116,11,89382,878
2020-12-06,Denmark,1749,7,91131,885
2020-12-07,Denmark,2046,9,93177,894
2020-12-08,Denmark,2155,7,95332,901
2020-12-09,Denmark,2563,3,97895,904
2020-12-10,Denmark,3132,14,101027,918
2020-12-11,Denmark,3076,9,104103,927
2020-12-12,Denmark,3557,8,107660,935
2020-12-13,Denmark,2645,6,110305,941
2020-12-14,Denmark,3337,9,113642,950
2020-12-15,Denmark,2994,11,116636,961
2020-12-16,Denmark,3694,14,120330,975
2020-12-17,Denmark,4036,17,124366,992
2020-12-18,Denmark,4508,15,128874,1007
2020-12-19,Denmark,3290,12,132164,1019
2020-12-20,Denmark,2835,16,134999,1035
2020-12-21,Denmark,3205,18,138204,1053
2020-12-22,Denmark,2546,17,140750,1070
2020-12-23,Denmark,3303,26,144053,1096
2020-12-24,Denmark,2874,18,146927,1114
2020-12-25,Denmark,2999,20,149926,1134
2020-12-26,Denmark,1838,19,151764,1153
2020-12-27,Denmark,2188,21,153952,1174
2020-12-28,Denmark,2482,30,156434,1204
2020-12-29,Denmark,2640,22,159074,1226
2020-12-30,Denmark,2788,30,161862,1256
2020-12-31,Denmark,2254,42,164116,1298
2021-01-01,Denmark,2451,24,166567,1322
2021-01-02,Denmark,1615,23,168182,1345
2021-01-03,Denmark,1176,29,169358,1374
2021-01-04,Denmark,2078,15,171436,1389
2021-01-05,Denmark,1997,31,173433,1420
2021-01-06,Denmark,2230,31,175663,1451
2021-01-07,Denmark,1844,37,177507,1488
2021-01-08,Denmark,1663,30,179170,1518
2021-01-09,Denmark,1745,25,180915,1543
2021-01-10,Denmark,1246,28,182161,1571
2021-01-11,Denmark,1239,27,183400,1598
2021-01-12,Denmark,1076,26,184476,1624
2021-01-13,Denmark,1359,37,185835,1661
2021-01-14,Denmark,1,0,185836,1661
2021-01-15,Denmark,2162,60,187998,1721
2021-01-16,Denmark,880,27,188878,1748
2021-01-17,Denmark,889,28,189767,1776
2021-01-18,Denmark,807,30,190574,1806
2021-01-19,Denmark,725,32,191299,1838
2021-01-20,Denmark,888,35,192187,1873
2021-01-21,Denmark,760,37,192947,1910
2021-01-22,Denmark,773,32,193720,1942
2021-01-23,Denmark,879,28,194599,1970
2021-01-24,Denmark,754,14,195353,1984
2021-01-25,Denmark,625,27,195978,2011
2021-01-26,Denmark,654,20,196632,2031
2021-01-27,Denmark,592,20,197224,2051
2021-01-28,Denmark,668,21,197892,2072
2021-01-29,Denmark,456,13,198348,2085
2021-01-30,Denmark,431,22,198779,2107
2021-01-31,Denmark,377,19,199156,2126
2021-02-01,Denmark,488,20,199644,2146
2021-02-02,Denmark,397,15,200041,2161
2021-02-03,Denmark,425,10,200466,2171
2021-02-04,Denmark,554,14,201020,2185
2021-02-05,Denmark,438,17,201458,2202
2021-02-06,Denmark,413,14,201871,2216
2021-02-07,Denmark,436,1,202307,2217
2021-02-08,Denmark,430,0,202737,2217
2021-02-09,Denmark,367,28,203104,2245
2021-02-10,Denmark,470,11,203574,2256
2021-02-11,Denmark,478,14,204052,2270
2021-02-12,Denmark,428,11,204480,2281
2021-02-13,Denmark,274,4,204754,2285
2021-02-14,Denmark,295,8,205049,2293
2021-02-15,Denmark,437,9,205486,2302
2021-02-16,Denmark,385,7,205871,2309
2021-02-17,Denmark,414,8,206285,2317
2021-02-18,Denmark,468,3,206753,2320
2021-02-19,Denmark,552,8,207305,2328
2021-02-20,Denmark,464,6,207769,2334
2021-02-21,Denmark,496,5,208265,2339
2021-02-22,Denmark,450,5,208715,2344
2021-02-23,Denmark,529,0,209244,2344
2021-02-24,Denmark,523,2,209767,2346
2021-02-25,Denmark,603,6,210370,2352
2021-02-26,Denmark,530,2,210900,2354
2021-02-27,Denmark,520,5,211420,2359
2021-02-28,Denmark,463,3,211883,2362
2021-03-01,Denmark,497,4,212380,2366
2021-03-02,Denmark,532,2,212912,2368
2021-03-03,Denmark,574,3,213486,2371
2021-03-04,Denmark,521,4,214007,2375
2021-03-05,Denmark,614,3,214621,2378
2021-03-06,Denmark,394,0,215015,2378
2021-03-07,Denmark,513,2,215528,2380
2021-03-08,Denmark,427,2,215955,2382
2021-03-09,Denmark,527,0,216482,2382
2021-03-10,Denmark,2007,1,218489,2383
2021-03-11,Denmark,862,2,219351,2385
2021-03-12,Denmark,645,3,219996,2388
2021-03-13,Denmark,613,3,220609,2391
2021-03-14,Denmark,542,1,221151,2392
2021-03-15,Denmark,612,2,221763,2394
2021-03-16,Denmark,771,2,222534,2396
2021-03-17,Denmark,787,1,223321,2397
2021-03-18,Denmark,786,1,224107,2398
2021-03-19,Denmark,843,0,224950,2398
2021-03-20,Denmark,590,2,225540,2400
2021-03-21,Denmark,657,1,226197,2401
2021-03-22,Denmark,1272,2,227469,2403
2021-03-23,Denmark,254,1,227723,2404
2021-03-24,Denmark,-2001,1,225722,2405
2021-03-25,Denmark,814,5,226536,2410
2021-03-26,Denmark,789,2,227325,2412
2021-03-27,Denmark,416,2,227741,2414
2021-03-28,Denmark,964,1,228705,2415
2021-03-29,Denmark,679,1,229384,2416
2021-03-30,Denmark,1210,2,230594,2418
2021-03-31,Denmark,701,2,231295,2420
2021-04-01,Denmark,662,4,231957,2424
2021-04-02,Denmark,708,1,232665,2425
2021-04-03,Denmark,745,4,233410,2429
2021-04-04,Denmark,600,1,234010,2430
2021-04-05,Denmark,479,1,234489,2431
2021-04-06,Denmark,520,2,235009,2433
2021-04-07,Denmark,614,3,235623,2436
2021-04-08,Denmark,717,1,236340,2437
2020-03-18,Djibouti,1,0,1,0
2020-03-19,Djibouti,0,0,1,0
2020-03-20,Djibouti,0,0,1,0
2020-03-21,Djibouti,0,0,1,0
2020-03-22,Djibouti,0,0,1,0
2020-03-23,Djibouti,2,0,3,0
2020-03-24,Djibouti,0,0,3,0
2020-03-25,Djibouti,8,0,11,0
2020-03-26,Djibouti,0,0,11,0
2020-03-27,Djibouti,1,0,12,0
2020-03-28,Djibouti,2,0,14,0
2020-03-29,Djibouti,4,0,18,0
2020-03-30,Djibouti,0,0,18,0
2020-03-31,Djibouti,12,0,30,0
2020-04-01,Djibouti,3,0,33,0
2020-04-02,Djibouti,7,0,40,0
2020-04-03,Djibouti,9,0,49,0
2020-04-04,Djibouti,1,0,50,0
2020-04-05,Djibouti,9,0,59,0
2020-04-06,Djibouti,31,0,90,0
2020-04-07,Djibouti,0,0,90,0
2020-04-08,Djibouti,45,0,135,0
2020-04-09,Djibouti,0,0,135,0
2020-04-10,Djibouti,15,1,150,1
2020-04-11,Djibouti,37,1,187,2
2020-04-12,Djibouti,27,0,214,2
2020-04-13,Djibouti,84,0,298,2
2020-04-14,Djibouti,65,0,363,2
2020-04-15,Djibouti,72,0,435,2
2020-04-16,Djibouti,156,0,591,2
2020-04-17,Djibouti,141,0,732,2
2020-04-18,Djibouti,0,0,732,2
2020-04-19,Djibouti,114,0,846,2
2020-04-20,Djibouti,0,0,846,2
2020-04-21,Djibouti,99,0,945,2
2020-04-22,Djibouti,29,0,974,2
2020-04-23,Djibouti,12,0,986,2
2020-04-24,Djibouti,13,0,999,2
2020-04-25,Djibouti,9,0,1008,2
2020-04-26,Djibouti,15,0,1023,2
2020-04-27,Djibouti,12,0,1035,2
2020-04-28,Djibouti,37,0,1072,2
2020-04-29,Djibouti,5,0,1077,2
2020-04-30,Djibouti,12,0,1089,2
2020-05-01,Djibouti,8,0,1097,2
2020-05-02,Djibouti,15,0,1112,2
2020-05-03,Djibouti,0,0,1112,2
2020-05-04,Djibouti,4,0,1116,2
2020-05-05,Djibouti,4,0,1120,2
2020-05-06,Djibouti,4,1,1124,3
2020-05-07,Djibouti,9,0,1133,3
2020-05-08,Djibouti,2,0,1135,3
2020-05-09,Djibouti,54,0,1189,3
2020-05-10,Djibouti,21,0,1210,3
2020-05-11,Djibouti,17,0,1227,3
2020-05-12,Djibouti,29,0,1256,3
2020-05-13,Djibouti,12,0,1268,3
2020-05-14,Djibouti,16,0,1284,3
2020-05-15,Djibouti,25,1,1309,4
2020-05-16,Djibouti,22,0,1331,4
2020-05-17,Djibouti,70,0,1401,4
2020-05-18,Djibouti,117,3,1518,7
2020-05-19,Djibouti,100,0,1618,7
2020-05-20,Djibouti,210,2,1828,9
2020-05-21,Djibouti,219,1,2047,10
2020-05-22,Djibouti,223,0,2270,10
2020-05-23,Djibouti,0,0,2270,10
2020-05-24,Djibouti,0,0,2270,10
2020-05-25,Djibouti,198,4,2468,14
2020-05-26,Djibouti,0,0,2468,14
2020-05-27,Djibouti,229,4,2697,18
2020-05-28,Djibouti,217,2,2914,20
2020-05-29,Djibouti,0,0,2914,20
2020-05-30,Djibouti,280,2,3194,22
2020-05-31,Djibouti,160,2,3354,24
2020-06-01,Djibouti,215,0,3569,24
2020-06-02,Djibouti,210,1,3779,25
2020-06-03,Djibouti,156,1,3935,26
2020-06-04,Djibouti,119,0,4054,26
2020-06-05,Djibouti,69,0,4123,26
2020-06-06,Djibouti,46,0,4169,26
2020-06-07,Djibouti,38,2,4207,28
2020-06-08,Djibouti,71,3,4278,31
2020-06-09,Djibouti,53,3,4331,34
2020-06-10,Djibouti,42,0,4373,34
2020-06-11,Djibouti,25,3,4398,37
2020-06-12,Djibouti,43,1,4441,38
2020-06-13,Djibouti,8,3,4449,41
2020-06-14,Djibouti,16,2,4465,43
2020-06-15,Djibouti,36,0,4501,43
2020-06-16,Djibouti,38,0,4539,43
2020-06-17,Djibouti,6,0,4545,43
2020-06-18,Djibouti,12,0,4557,43
2020-06-19,Djibouti,8,2,4565,45
2020-06-20,Djibouti,0,0,4565,45
2020-06-21,Djibouti,17,0,4582,45
2020-06-22,Djibouti,17,3,4599,48
2020-06-23,Djibouti,18,1,4617,49
2020-06-24,Djibouti,13,3,4630,52
2020-06-25,Djibouti,5,0,4635,52
2020-06-26,Djibouti,8,0,4643,52
2020-06-27,Djibouti,0,0,4643,52
2020-06-28,Djibouti,0,0,4643,52
2020-06-29,Djibouti,13,1,4656,53
2020-06-30,Djibouti,26,1,4682,54
2020-07-01,Djibouti,22,1,4704,55
2020-07-02,Djibouti,11,0,4715,55
2020-07-03,Djibouti,21,0,4736,55
2020-07-04,Djibouti,0,0,4736,55
2020-07-05,Djibouti,56,0,4792,55
2020-07-06,Djibouti,30,0,4822,55
2020-07-07,Djibouti,56,0,4878,55
2020-07-08,Djibouti,11,0,4889,55
2020-07-09,Djibouti,66,1,4955,56
2020-07-10,Djibouti,13,0,4968,56
2020-07-11,Djibouti,0,0,4968,56
2020-07-12,Djibouti,4,0,4972,56
2020-07-13,Djibouti,5,0,4977,56
2020-07-14,Djibouti,2,0,4979,56
2020-07-15,Djibouti,6,0,4985,56
2020-07-16,Djibouti,8,0,4993,56
2020-07-17,Djibouti,10,0,5003,56
2020-07-18,Djibouti,0,0,5003,56
2020-07-19,Djibouti,8,0,5011,56
2020-07-20,Djibouti,9,0,5020,56
2020-07-21,Djibouti,7,0,5027,56
2020-07-22,Djibouti,3,2,5030,58
2020-07-23,Djibouti,1,0,5031,58
2020-07-24,Djibouti,8,0,5039,58
2020-07-25,Djibouti,0,0,5039,58
2020-07-26,Djibouti,11,0,5050,58
2020-07-27,Djibouti,9,0,5059,58
2020-07-28,Djibouti,9,0,5068,58
2020-07-29,Djibouti,13,0,5081,58
2020-07-30,Djibouti,0,0,5081,58
2020-07-31,Djibouti,3,0,5084,58
2020-08-01,Djibouti,0,0,5084,58
2020-08-02,Djibouti,77,1,5161,59
2020-08-03,Djibouti,79,0,5240,59
2020-08-04,Djibouti,8,0,5248,59
2020-08-05,Djibouti,82,0,5330,59
2020-08-06,Djibouti,0,0,5330,59
2020-08-07,Djibouti,8,0,5338,59
2020-08-08,Djibouti,0,0,5338,59
2020-08-09,Djibouti,6,0,5344,59
2020-08-10,Djibouti,3,0,5347,59
2020-08-11,Djibouti,1,0,5348,59
2020-08-12,Djibouti,10,0,5358,59
2020-08-13,Djibouti,0,0,5358,59
2020-08-14,Djibouti,9,0,5367,59
2020-08-15,Djibouti,0,0,5367,59
2020-08-16,Djibouti,2,0,5369,59
2020-08-17,Djibouti,3,0,5372,59
2020-08-18,Djibouti,2,0,5374,59
2020-08-19,Djibouti,0,0,5374,59
2020-08-20,Djibouti,0,0,5374,59
2020-08-21,Djibouti,8,1,5382,60
2020-08-22,Djibouti,0,0,5382,60
2020-08-23,Djibouti,0,0,5382,60
2020-08-24,Djibouti,1,0,5383,60
2020-08-25,Djibouti,0,0,5383,60
2020-08-26,Djibouti,0,0,5383,60
2020-08-27,Djibouti,0,0,5383,60
2020-08-28,Djibouti,0,0,5383,60
2020-08-29,Djibouti,2,0,5385,60
2020-08-30,Djibouti,0,0,5385,60
2020-08-31,Djibouti,2,0,5387,60
2020-09-01,Djibouti,0,0,5387,60
2020-09-02,Djibouti,0,0,5387,60
2020-09-03,Djibouti,0,0,5387,60
2020-09-04,Djibouti,0,0,5387,60
2020-09-05,Djibouti,0,0,5387,60
2020-09-06,Djibouti,1,1,5388,61
2020-09-07,Djibouti,0,0,5388,61
2020-09-08,Djibouti,0,0,5388,61
2020-09-09,Djibouti,3,0,5391,61
2020-09-10,Djibouti,3,0,5394,61
2020-09-11,Djibouti,0,0,5394,61
2020-09-12,Djibouti,0,0,5394,61
2020-09-13,Djibouti,1,0,5395,61
2020-09-14,Djibouti,1,0,5396,61
2020-09-15,Djibouti,0,0,5396,61
2020-09-16,Djibouti,3,0,5399,61
2020-09-17,Djibouti,0,0,5399,61
2020-09-18,Djibouti,4,0,5403,61
2020-09-19,Djibouti,0,0,5403,61
2020-09-20,Djibouti,0,0,5403,61
2020-09-21,Djibouti,1,0,5404,61
2020-09-22,Djibouti,3,0,5407,61
2020-09-23,Djibouti,0,0,5407,61
2020-09-24,Djibouti,0,0,5407,61
2020-09-25,Djibouti,2,0,5409,61
2020-09-26,Djibouti,0,0,5409,61
2020-09-27,Djibouti,0,0,5409,61
2020-09-28,Djibouti,1,0,5410,61
2020-09-29,Djibouti,6,0,5416,61
2020-09-30,Djibouti,0,0,5416,61
2020-10-01,Djibouti,1,0,5417,61
2020-10-02,Djibouti,0,0,5417,61
2020-10-03,Djibouti,1,0,5418,61
2020-10-04,Djibouti,1,0,5419,61
2020-10-05,Djibouti,2,0,5421,61
2020-10-06,Djibouti,2,0,5423,61
2020-10-07,Djibouti,0,0,5423,61
2020-10-08,Djibouti,0,0,5423,61
2020-10-09,Djibouti,0,0,5423,61
2020-10-10,Djibouti,0,0,5423,61
2020-10-11,Djibouti,0,0,5423,61
2020-10-12,Djibouti,3,0,5426,61
2020-10-13,Djibouti,2,0,5428,61
2020-10-14,Djibouti,12,0,5440,61
2020-10-15,Djibouti,3,0,5443,61
2020-10-16,Djibouti,6,0,5449,61
2020-10-17,Djibouti,3,0,5452,61
2020-10-18,Djibouti,7,0,5459,61
2020-10-19,Djibouti,10,0,5469,61
2020-10-20,Djibouti,30,0,5499,61
2020-10-21,Djibouti,13,0,5512,61
2020-10-22,Djibouti,10,0,5522,61
2020-10-23,Djibouti,6,0,5528,61
2020-10-24,Djibouti,2,0,5530,61
2020-10-25,Djibouti,6,0,5536,61
2020-10-26,Djibouti,5,0,5541,61
2020-10-27,Djibouti,3,0,5544,61
2020-10-28,Djibouti,11,0,5555,61
2020-10-29,Djibouti,3,0,5558,61
2020-10-30,Djibouti,1,0,5559,61
2020-10-31,Djibouti,2,0,5561,61
2020-11-01,Djibouti,2,0,5563,61
2020-11-02,Djibouti,10,0,5573,61
2020-11-03,Djibouti,2,0,5575,61
2020-11-04,Djibouti,5,0,5580,61
2020-11-05,Djibouti,19,0,5599,61
2020-11-06,Djibouti,5,0,5604,61
2020-11-07,Djibouti,1,0,5605,61
2020-11-08,Djibouti,3,0,5608,61
2020-11-09,Djibouti,19,0,5627,61
2020-11-10,Djibouti,6,0,5633,61
2020-11-11,Djibouti,2,0,5635,61
2020-11-12,Djibouti,6,0,5641,61
2020-11-13,Djibouti,0,0,5641,61
2020-11-14,Djibouti,4,0,5645,61
2020-11-15,Djibouti,4,0,5649,61
2020-11-16,Djibouti,6,0,5655,61
2020-11-17,Djibouti,1,0,5656,61
2020-11-18,Djibouti,2,0,5658,61
2020-11-19,Djibouti,0,0,5658,61
2020-11-20,Djibouti,2,0,5660,61
2020-11-21,Djibouti,1,0,5661,61
2020-11-22,Djibouti,7,0,5668,61
2020-11-23,Djibouti,0,0,5668,61
2020-11-24,Djibouti,1,0,5669,61
2020-11-25,Djibouti,1,0,5670,61
2020-11-26,Djibouti,6,0,5676,61
2020-11-27,Djibouti,0,0,5676,61
2020-11-28,Djibouti,0,0,5676,61
2020-11-29,Djibouti,1,0,5677,61
2020-11-30,Djibouti,2,0,5679,61
2020-12-01,Djibouti,1,0,5680,61
2020-12-02,Djibouti,2,0,5682,61
2020-12-03,Djibouti,7,0,5689,61
2020-12-04,Djibouti,1,0,5690,61
2020-12-05,Djibouti,2,0,5692,61
2020-12-06,Djibouti,9,0,5701,61
2020-12-07,Djibouti,7,0,5708,61
2020-12-08,Djibouti,6,0,5714,61
2020-12-09,Djibouti,3,0,5717,61
2020-12-10,Djibouti,0,0,5717,61
2020-12-11,Djibouti,4,0,5721,61
2020-12-12,Djibouti,4,0,5725,61
2020-12-13,Djibouti,3,0,5728,61
2020-12-14,Djibouti,5,0,5733,61
2020-12-15,Djibouti,16,0,5749,61
2020-12-16,Djibouti,10,0,5759,61
2020-12-17,Djibouti,11,0,5770,61
2020-12-18,Djibouti,10,0,5780,61
2020-12-19,Djibouti,1,0,5781,61
2020-12-20,Djibouti,0,0,5781,61
2020-12-21,Djibouti,2,0,5783,61
2020-12-22,Djibouti,3,0,5786,61
2020-12-23,Djibouti,3,0,5789,61
2020-12-24,Djibouti,11,0,5800,61
2020-12-25,Djibouti,4,0,5804,61
2020-12-26,Djibouti,1,0,5805,61
2020-12-27,Djibouti,8,0,5813,61
2020-12-28,Djibouti,0,0,5813,61
2020-12-29,Djibouti,0,0,5813,61
2020-12-30,Djibouti,11,0,5824,61
2020-12-31,Djibouti,7,0,5831,61
2021-01-01,Djibouti,9,0,5840,61
2021-01-02,Djibouti,1,0,5841,61
2021-01-03,Djibouti,1,0,5842,61
2021-01-04,Djibouti,4,0,5846,61
2021-01-05,Djibouti,8,0,5854,61
2021-01-06,Djibouti,1,0,5855,61
2021-01-07,Djibouti,2,0,5857,61
2021-01-08,Djibouti,8,0,5865,61
2021-01-09,Djibouti,1,0,5866,61
2021-01-10,Djibouti,5,0,5871,61
2021-01-11,Djibouti,6,0,5877,61
2021-01-12,Djibouti,2,0,5879,61
2021-01-13,Djibouti,12,0,5891,61
2021-01-14,Djibouti,9,0,5900,61
2021-01-15,Djibouti,3,0,5903,61
2021-01-16,Djibouti,0,0,5903,61
2021-01-17,Djibouti,2,0,5905,61
2021-01-18,Djibouti,0,0,5905,61
2021-01-19,Djibouti,5,0,5910,61
2021-01-20,Djibouti,3,0,5913,61
2021-01-21,Djibouti,3,0,5916,61
2021-01-22,Djibouti,1,0,5917,61
2021-01-23,Djibouti,1,0,5918,61
2021-01-24,Djibouti,1,0,5919,61
2021-01-25,Djibouti,1,0,5920,61
2021-01-26,Djibouti,3,1,5923,62
2021-01-27,Djibouti,3,0,5926,62
2021-01-28,Djibouti,3,0,5929,62
2021-01-29,Djibouti,1,0,5930,62
2021-01-30,Djibouti,1,0,5931,62
2021-01-31,Djibouti,1,1,5932,63
2021-02-01,Djibouti,0,0,5932,63
2021-02-02,Djibouti,3,0,5935,63
2021-02-03,Djibouti,1,0,5936,63
2021-02-04,Djibouti,0,0,5936,63
2021-02-05,Djibouti,5,0,5941,63
2021-02-06,Djibouti,0,0,5941,63
2021-02-07,Djibouti,6,0,5947,63
2021-02-08,Djibouti,3,0,5950,63
2021-02-09,Djibouti,9,0,5959,63
2021-02-10,Djibouti,3,0,5962,63
2021-02-11,Djibouti,4,0,5966,63
2021-02-12,Djibouti,1,0,5967,63
2021-02-13,Djibouti,1,0,5968,63
2021-02-14,Djibouti,3,0,5971,63
2021-02-15,Djibouti,9,0,5980,63
2021-02-16,Djibouti,1,0,5981,63
2021-02-17,Djibouti,25,0,6006,63
2021-02-18,Djibouti,2,0,6008,63
2021-02-19,Djibouti,14,0,6022,63
2021-02-20,Djibouti,0,0,6022,63
2021-02-21,Djibouti,2,0,6024,63
2021-02-22,Djibouti,2,0,6026,63
2021-02-23,Djibouti,26,0,6052,63
2021-02-24,Djibouti,0,0,6052,63
2021-02-25,Djibouti,8,0,6060,63
2021-02-26,Djibouti,2,0,6062,63
2021-02-27,Djibouti,3,0,6065,63
2021-02-28,Djibouti,1,0,6066,63
2021-03-01,Djibouti,21,0,6087,63
2021-03-02,Djibouti,2,0,6089,63
2021-03-03,Djibouti,13,0,6102,63
2021-03-04,Djibouti,8,0,6110,63
2021-03-05,Djibouti,20,0,6130,63
2021-03-06,Djibouti,4,0,6134,63
2021-03-07,Djibouti,12,0,6146,63
2021-03-08,Djibouti,11,0,6157,63
2021-03-09,Djibouti,24,0,6181,63
2021-03-10,Djibouti,46,0,6227,63
2021-03-11,Djibouti,7,0,6234,63
2021-03-12,Djibouti,2,0,6236,63
2021-03-13,Djibouti,16,0,6252,63
2021-03-14,Djibouti,16,0,6268,63
2021-03-15,Djibouti,26,0,6294,63
2021-03-16,Djibouti,42,0,6336,63
2021-03-17,Djibouti,49,0,6385,63
2021-03-18,Djibouti,67,0,6452,63
2021-03-19,Djibouti,49,0,6501,63
2021-03-20,Djibouti,17,0,6518,63
2021-03-21,Djibouti,70,1,6588,64
2021-03-22,Djibouti,70,0,6658,64
2021-03-23,Djibouti,113,0,6771,64
2021-03-24,Djibouti,124,0,6895,64
2021-03-25,Djibouti,121,0,7016,64
2021-03-26,Djibouti,153,2,7169,66
2021-03-27,Djibouti,80,0,7249,66
2021-03-28,Djibouti,112,1,7361,67
2021-03-29,Djibouti,249,1,7610,68
2021-03-30,Djibouti,180,1,7790,69
2021-03-31,Djibouti,212,1,8002,70
2021-04-01,Djibouti,178,1,8180,71
2021-04-02,Djibouti,251,1,8431,72
2021-04-03,Djibouti,78,0,8509,72
2021-04-04,Djibouti,0,0,8509,72
2021-04-05,Djibouti,187,4,8696,76
2021-04-06,Djibouti,415,9,9111,85
2021-04-07,Djibouti,195,5,9306,90
2021-04-08,Djibouti,173,2,9479,92
2020-03-22,Dominica,1,0,1,0
2020-03-23,Dominica,1,0,2,0
2020-03-24,Dominica,0,0,2,0
2020-03-25,Dominica,5,0,7,0
2020-03-26,Dominica,4,0,11,0
2020-03-27,Dominica,0,0,11,0
2020-03-28,Dominica,0,0,11,0
2020-03-29,Dominica,0,0,11,0
2020-03-30,Dominica,0,0,11,0
2020-03-31,Dominica,1,0,12,0
2020-04-01,Dominica,0,0,12,0
2020-04-02,Dominica,0,0,12,0
2020-04-03,Dominica,0,0,12,0
2020-04-04,Dominica,2,0,14,0
2020-04-05,Dominica,0,0,14,0
2020-04-06,Dominica,1,0,15,0
2020-04-07,Dominica,0,0,15,0
2020-04-08,Dominica,0,0,15,0
2020-04-09,Dominica,0,0,15,0
2020-04-10,Dominica,1,0,16,0
2020-04-11,Dominica,0,0,16,0
2020-04-12,Dominica,0,0,16,0
2020-04-13,Dominica,0,0,16,0
2020-04-14,Dominica,0,0,16,0
2020-04-15,Dominica,0,0,16,0
2020-04-16,Dominica,0,0,16,0
2020-04-17,Dominica,0,0,16,0
2020-04-18,Dominica,0,0,16,0
2020-04-19,Dominica,0,0,16,0
2020-04-20,Dominica,0,0,16,0
2020-04-21,Dominica,0,0,16,0
2020-04-22,Dominica,0,0,16,0
2020-04-23,Dominica,0,0,16,0
2020-04-24,Dominica,0,0,16,0
2020-04-25,Dominica,0,0,16,0
2020-04-26,Dominica,0,0,16,0
2020-04-27,Dominica,0,0,16,0
2020-04-28,Dominica,0,0,16,0
2020-04-29,Dominica,0,0,16,0
2020-04-30,Dominica,0,0,16,0
2020-05-01,Dominica,0,0,16,0
2020-05-02,Dominica,0,0,16,0
2020-05-03,Dominica,0,0,16,0
2020-05-04,Dominica,0,0,16,0
2020-05-05,Dominica,0,0,16,0
2020-05-06,Dominica,0,0,16,0
2020-05-07,Dominica,0,0,16,0
2020-05-08,Dominica,0,0,16,0
2020-05-09,Dominica,0,0,16,0
2020-05-10,Dominica,0,0,16,0
2020-05-11,Dominica,0,0,16,0
2020-05-12,Dominica,0,0,16,0
2020-05-13,Dominica,0,0,16,0
2020-05-14,Dominica,0,0,16,0
2020-05-15,Dominica,0,0,16,0
2020-05-16,Dominica,0,0,16,0
2020-05-17,Dominica,0,0,16,0
2020-05-18,Dominica,0,0,16,0
2020-05-19,Dominica,0,0,16,0
2020-05-20,Dominica,0,0,16,0
2020-05-21,Dominica,0,0,16,0
2020-05-22,Dominica,0,0,16,0
2020-05-23,Dominica,0,0,16,0
2020-05-24,Dominica,0,0,16,0
2020-05-25,Dominica,0,0,16,0
2020-05-26,Dominica,0,0,16,0
2020-05-27,Dominica,0,0,16,0
2020-05-28,Dominica,0,0,16,0
2020-05-29,Dominica,0,0,16,0
2020-05-30,Dominica,0,0,16,0
2020-05-31,Dominica,0,0,16,0
2020-06-01,Dominica,0,0,16,0
2020-06-02,Dominica,2,0,18,0
2020-06-03,Dominica,0,0,18,0
2020-06-04,Dominica,0,0,18,0
2020-06-05,Dominica,0,0,18,0
2020-06-06,Dominica,0,0,18,0
2020-06-07,Dominica,0,0,18,0
2020-06-08,Dominica,0,0,18,0
2020-06-09,Dominica,0,0,18,0
2020-06-10,Dominica,0,0,18,0
2020-06-11,Dominica,0,0,18,0
2020-06-12,Dominica,0,0,18,0
2020-06-13,Dominica,0,0,18,0
2020-06-14,Dominica,0,0,18,0
2020-06-15,Dominica,0,0,18,0
2020-06-16,Dominica,0,0,18,0
2020-06-17,Dominica,0,0,18,0
2020-06-18,Dominica,0,0,18,0
2020-06-19,Dominica,0,0,18,0
2020-06-20,Dominica,0,0,18,0
2020-06-21,Dominica,0,0,18,0
2020-06-22,Dominica,0,0,18,0
2020-06-23,Dominica,0,0,18,0
2020-06-24,Dominica,0,0,18,0
2020-06-25,Dominica,0,0,18,0
2020-06-26,Dominica,0,0,18,0
2020-06-27,Dominica,0,0,18,0
2020-06-28,Dominica,0,0,18,0
2020-06-29,Dominica,0,0,18,0
2020-06-30,Dominica,0,0,18,0
2020-07-01,Dominica,0,0,18,0
2020-07-02,Dominica,0,0,18,0
2020-07-03,Dominica,0,0,18,0
2020-07-04,Dominica,0,0,18,0
2020-07-05,Dominica,0,0,18,0
2020-07-06,Dominica,0,0,18,0
2020-07-07,Dominica,0,0,18,0
2020-07-08,Dominica,0,0,18,0
2020-07-09,Dominica,0,0,18,0
2020-07-10,Dominica,0,0,18,0
2020-07-11,Dominica,0,0,18,0
2020-07-12,Dominica,0,0,18,0
2020-07-13,Dominica,0,0,18,0
2020-07-14,Dominica,0,0,18,0
2020-07-15,Dominica,0,0,18,0
2020-07-16,Dominica,0,0,18,0
2020-07-17,Dominica,0,0,18,0
2020-07-18,Dominica,0,0,18,0
2020-07-19,Dominica,0,0,18,0
2020-07-20,Dominica,0,0,18,0
2020-07-21,Dominica,0,0,18,0
2020-07-22,Dominica,0,0,18,0
2020-07-23,Dominica,0,0,18,0
2020-07-24,Dominica,0,0,18,0
2020-07-25,Dominica,0,0,18,0
2020-07-26,Dominica,0,0,18,0
2020-07-27,Dominica,0,0,18,0
2020-07-28,Dominica,0,0,18,0
2020-07-29,Dominica,0,0,18,0
2020-07-30,Dominica,0,0,18,0
2020-07-31,Dominica,0,0,18,0
2020-08-01,Dominica,0,0,18,0
2020-08-02,Dominica,0,0,18,0
2020-08-03,Dominica,0,0,18,0
2020-08-04,Dominica,0,0,18,0
2020-08-05,Dominica,0,0,18,0
2020-08-06,Dominica,0,0,18,0
2020-08-07,Dominica,0,0,18,0
2020-08-08,Dominica,0,0,18,0
2020-08-09,Dominica,0,0,18,0
2020-08-10,Dominica,0,0,18,0
2020-08-11,Dominica,0,0,18,0
2020-08-12,Dominica,0,0,18,0
2020-08-13,Dominica,0,0,18,0
2020-08-14,Dominica,0,0,18,0
2020-08-15,Dominica,0,0,18,0
2020-08-16,Dominica,0,0,18,0
2020-08-17,Dominica,0,0,18,0
2020-08-18,Dominica,0,0,18,0
2020-08-19,Dominica,0,0,18,0
2020-08-20,Dominica,0,0,18,0
2020-08-21,Dominica,0,0,18,0
2020-08-22,Dominica,1,0,19,0
2020-08-23,Dominica,0,0,19,0
2020-08-24,Dominica,1,0,20,0
2020-08-25,Dominica,0,0,20,0
2020-08-26,Dominica,0,0,20,0
2020-08-27,Dominica,0,0,20,0
2020-08-28,Dominica,0,0,20,0
2020-08-29,Dominica,0,0,20,0
2020-08-30,Dominica,0,0,20,0
2020-08-31,Dominica,0,0,20,0
2020-09-01,Dominica,0,0,20,0
2020-09-02,Dominica,0,0,20,0
2020-09-03,Dominica,0,0,20,0
2020-09-04,Dominica,0,0,20,0
2020-09-05,Dominica,2,0,22,0
2020-09-06,Dominica,0,0,22,0
2020-09-07,Dominica,0,0,22,0
2020-09-08,Dominica,0,0,22,0
2020-09-09,Dominica,0,0,22,0
2020-09-10,Dominica,2,0,24,0
2020-09-11,Dominica,0,0,24,0
2020-09-12,Dominica,0,0,24,0
2020-09-13,Dominica,0,0,24,0
2020-09-14,Dominica,0,0,24,0
2020-09-15,Dominica,0,0,24,0
2020-09-16,Dominica,0,0,24,0
2020-09-17,Dominica,0,0,24,0
2020-09-18,Dominica,0,0,24,0
2020-09-19,Dominica,0,0,24,0
2020-09-20,Dominica,0,0,24,0
2020-09-21,Dominica,0,0,24,0
2020-09-22,Dominica,0,0,24,0
2020-09-23,Dominica,0,0,24,0
2020-09-24,Dominica,0,0,24,0
2020-09-25,Dominica,0,0,24,0
2020-09-26,Dominica,0,0,24,0
2020-09-27,Dominica,6,0,30,0
2020-09-28,Dominica,0,0,30,0
2020-09-29,Dominica,0,0,30,0
2020-09-30,Dominica,0,0,30,0
2020-10-01,Dominica,1,0,31,0
2020-10-02,Dominica,0,0,31,0
2020-10-03,Dominica,0,0,31,0
2020-10-04,Dominica,0,0,31,0
2020-10-05,Dominica,0,0,31,0
2020-10-06,Dominica,0,0,31,0
2020-10-07,Dominica,0,0,31,0
2020-10-08,Dominica,0,0,31,0
2020-10-09,Dominica,1,0,32,0
2020-10-10,Dominica,0,0,32,0
2020-10-11,Dominica,0,0,32,0
2020-10-12,Dominica,0,0,32,0
2020-10-13,Dominica,0,0,32,0
2020-10-14,Dominica,0,0,32,0
2020-10-15,Dominica,1,0,33,0
2020-10-16,Dominica,0,0,33,0
2020-10-17,Dominica,0,0,33,0
2020-10-18,Dominica,0,0,33,0
2020-10-19,Dominica,0,0,33,0
2020-10-20,Dominica,0,0,33,0
2020-10-21,Dominica,0,0,33,0
2020-10-22,Dominica,0,0,33,0
2020-10-23,Dominica,4,0,37,0
2020-10-24,Dominica,1,0,38,0
2020-10-25,Dominica,0,0,38,0
2020-10-26,Dominica,0,0,38,0
2020-10-27,Dominica,0,0,38,0
2020-10-28,Dominica,0,0,38,0
2020-10-29,Dominica,0,0,38,0
2020-10-30,Dominica,4,0,42,0
2020-10-31,Dominica,8,0,50,0
2020-11-01,Dominica,0,0,50,0
2020-11-02,Dominica,0,0,50,0
2020-11-03,Dominica,0,0,50,0
2020-11-04,Dominica,0,0,50,0
2020-11-05,Dominica,7,0,57,0
2020-11-06,Dominica,0,0,57,0
2020-11-07,Dominica,6,0,63,0
2020-11-08,Dominica,0,0,63,0
2020-11-09,Dominica,0,0,63,0
2020-11-10,Dominica,0,0,63,0
2020-11-11,Dominica,5,0,68,0
2020-11-12,Dominica,0,0,68,0
2020-11-13,Dominica,0,0,68,0
2020-11-14,Dominica,0,0,68,0
2020-11-15,Dominica,0,0,68,0
2020-11-16,Dominica,0,0,68,0
2020-11-17,Dominica,0,0,68,0
2020-11-18,Dominica,0,0,68,0
2020-11-19,Dominica,0,0,68,0
2020-11-20,Dominica,0,0,68,0
2020-11-21,Dominica,4,0,72,0
2020-11-22,Dominica,0,0,72,0
2020-11-23,Dominica,5,0,77,0
2020-11-24,Dominica,0,0,77,0
2020-11-25,Dominica,0,0,77,0
2020-11-26,Dominica,0,0,77,0
2020-11-27,Dominica,3,0,80,0
2020-11-28,Dominica,5,0,85,0
2020-11-29,Dominica,0,0,85,0
2020-11-30,Dominica,0,0,85,0
2020-12-01,Dominica,0,0,85,0
2020-12-02,Dominica,0,0,85,0
2020-12-03,Dominica,0,0,85,0
2020-12-04,Dominica,0,0,85,0
2020-12-05,Dominica,0,0,85,0
2020-12-06,Dominica,0,0,85,0
2020-12-07,Dominica,0,0,85,0
2020-12-08,Dominica,0,0,85,0
2020-12-09,Dominica,0,0,85,0
2020-12-10,Dominica,0,0,85,0
2020-12-11,Dominica,2,0,87,0
2020-12-12,Dominica,0,0,87,0
2020-12-13,Dominica,1,0,88,0
2020-12-14,Dominica,0,0,88,0
2020-12-15,Dominica,0,0,88,0
2020-12-16,Dominica,0,0,88,0
2020-12-17,Dominica,0,0,88,0
2020-12-18,Dominica,0,0,88,0
2020-12-19,Dominica,0,0,88,0
2020-12-20,Dominica,0,0,88,0
2020-12-21,Dominica,0,0,88,0
2020-12-22,Dominica,0,0,88,0
2020-12-23,Dominica,0,0,88,0
2020-12-24,Dominica,0,0,88,0
2020-12-25,Dominica,0,0,88,0
2020-12-26,Dominica,0,0,88,0
2020-12-27,Dominica,0,0,88,0
2020-12-28,Dominica,0,0,88,0
2020-12-29,Dominica,0,0,88,0
2020-12-30,Dominica,0,0,88,0
2020-12-31,Dominica,0,0,88,0
2021-01-01,Dominica,0,0,88,0
2021-01-02,Dominica,0,0,88,0
2021-01-03,Dominica,0,0,88,0
2021-01-04,Dominica,0,0,88,0
2021-01-05,Dominica,0,0,88,0
2021-01-06,Dominica,17,0,105,0
2021-01-07,Dominica,0,0,105,0
2021-01-08,Dominica,1,0,106,0
2021-01-09,Dominica,0,0,106,0
2021-01-10,Dominica,0,0,106,0
2021-01-11,Dominica,3,0,109,0
2021-01-12,Dominica,0,0,109,0
2021-01-13,Dominica,0,0,109,0
2021-01-14,Dominica,0,0,109,0
2021-01-15,Dominica,0,0,109,0
2021-01-16,Dominica,1,0,110,0
2021-01-17,Dominica,0,0,110,0
2021-01-18,Dominica,0,0,110,0
2021-01-19,Dominica,0,0,110,0
2021-01-20,Dominica,3,0,113,0
2021-01-21,Dominica,0,0,113,0
2021-01-22,Dominica,0,0,113,0
2021-01-23,Dominica,0,0,113,0
2021-01-24,Dominica,0,0,113,0
2021-01-25,Dominica,0,0,113,0
2021-01-26,Dominica,0,0,113,0
2021-01-27,Dominica,0,0,113,0
2021-01-28,Dominica,4,0,117,0
2021-01-29,Dominica,0,0,117,0
2021-01-30,Dominica,0,0,117,0
2021-01-31,Dominica,0,0,117,0
2021-02-01,Dominica,0,0,117,0
2021-02-02,Dominica,4,0,121,0
2021-02-03,Dominica,0,0,121,0
2021-02-04,Dominica,0,0,121,0
2021-02-05,Dominica,0,0,121,0
2021-02-06,Dominica,0,0,121,0
2021-02-07,Dominica,0,0,121,0
2021-02-08,Dominica,0,0,121,0
2021-02-09,Dominica,0,0,121,0
2021-02-10,Dominica,0,0,121,0
2021-02-11,Dominica,0,0,121,0
2021-02-12,Dominica,0,0,121,0
2021-02-13,Dominica,0,0,121,0
2021-02-14,Dominica,0,0,121,0
2021-02-15,Dominica,13,0,134,0
2021-02-16,Dominica,0,0,134,0
2021-02-17,Dominica,0,0,134,0
2021-02-18,Dominica,0,0,134,0
2021-02-19,Dominica,0,0,134,0
2021-02-20,Dominica,0,0,134,0
2021-02-21,Dominica,0,0,134,0
2021-02-22,Dominica,0,0,134,0
2021-02-23,Dominica,7,0,141,0
2021-02-24,Dominica,0,0,141,0
2021-02-25,Dominica,1,0,142,0
2021-02-26,Dominica,0,0,142,0
2021-02-27,Dominica,0,0,142,0
2021-02-28,Dominica,0,0,142,0
2021-03-01,Dominica,0,0,142,0
2021-03-02,Dominica,2,0,144,0
2021-03-03,Dominica,0,0,144,0
2021-03-04,Dominica,0,0,144,0
2021-03-05,Dominica,0,0,144,0
2021-03-06,Dominica,0,0,144,0
2021-03-07,Dominica,0,0,144,0
2021-03-08,Dominica,0,0,144,0
2021-03-09,Dominica,7,0,151,0
2021-03-10,Dominica,0,0,151,0
2021-03-11,Dominica,0,0,151,0
2021-03-12,Dominica,5,0,156,0
2021-03-13,Dominica,0,0,156,0
2021-03-14,Dominica,0,0,156,0
2021-03-15,Dominica,0,0,156,0
2021-03-16,Dominica,0,0,156,0
2021-03-17,Dominica,0,0,156,0
2021-03-18,Dominica,0,0,156,0
2021-03-19,Dominica,0,0,156,0
2021-03-20,Dominica,0,0,156,0
2021-03-21,Dominica,0,0,156,0
2021-03-22,Dominica,0,0,156,0
2021-03-23,Dominica,0,0,156,0
2021-03-24,Dominica,4,0,160,0
2021-03-25,Dominica,0,0,160,0
2021-03-26,Dominica,1,0,161,0
2021-03-27,Dominica,0,0,161,0
2021-03-28,Dominica,0,0,161,0
2021-03-29,Dominica,0,0,161,0
2021-03-30,Dominica,0,0,161,0
2021-03-31,Dominica,0,0,161,0
2021-04-01,Dominica,3,0,164,0
2021-04-02,Dominica,1,0,165,0
2021-04-03,Dominica,0,0,165,0
2021-04-04,Dominica,0,0,165,0
2021-04-05,Dominica,0,0,165,0
2021-04-06,Dominica,0,0,165,0
2021-04-07,Dominica,0,0,165,0
2021-04-08,Dominica,0,0,165,0
2020-03-01,Dominican Republic,1,0,1,0
2020-03-02,Dominican Republic,0,0,1,0
2020-03-03,Dominican Republic,0,0,1,0
2020-03-04,Dominican Republic,0,0,1,0
2020-03-05,Dominican Republic,0,0,1,0
2020-03-06,Dominican Republic,1,0,2,0
2020-03-07,Dominican Republic,0,0,2,0
2020-03-08,Dominican Republic,3,0,5,0
2020-03-09,Dominican Republic,0,0,5,0
2020-03-10,Dominican Republic,0,0,5,0
2020-03-11,Dominican Republic,0,0,5,0
2020-03-12,Dominican Republic,0,0,5,0
2020-03-13,Dominican Republic,0,0,5,0
2020-03-14,Dominican Republic,6,0,11,0
2020-03-15,Dominican Republic,0,0,11,0
2020-03-16,Dominican Republic,0,0,11,0
2020-03-17,Dominican Republic,10,1,21,1
2020-03-18,Dominican Republic,0,0,21,1
2020-03-19,Dominican Republic,13,1,34,2
2020-03-20,Dominican Republic,38,0,72,2
2020-03-21,Dominican Republic,40,0,112,2
2020-03-22,Dominican Republic,90,1,202,3
2020-03-23,Dominican Republic,43,0,245,3
2020-03-24,Dominican Republic,67,3,312,6
2020-03-25,Dominican Republic,80,4,392,10
2020-03-26,Dominican Republic,96,0,488,10
2020-03-27,Dominican Republic,93,10,581,20
2020-03-28,Dominican Republic,138,8,719,28
2020-03-29,Dominican Republic,140,11,859,39
2020-03-30,Dominican Republic,42,3,901,42
2020-03-31,Dominican Republic,208,9,1109,51
2020-04-01,Dominican Republic,175,6,1284,57
2020-04-02,Dominican Republic,96,3,1380,60
2020-04-03,Dominican Republic,108,8,1488,68
2020-04-04,Dominican Republic,0,0,1488,68
2020-04-05,Dominican Republic,257,14,1745,82
2020-04-06,Dominican Republic,83,4,1828,86
2020-04-07,Dominican Republic,128,12,1956,98
2020-04-08,Dominican Republic,155,10,2111,108
2020-04-09,Dominican Republic,238,10,2349,118
2020-04-10,Dominican Republic,271,8,2620,126
2020-04-11,Dominican Republic,139,9,2759,135
2020-04-12,Dominican Republic,208,38,2967,173
2020-04-13,Dominican Republic,200,4,3167,177
2020-04-14,Dominican Republic,119,6,3286,183
2020-04-15,Dominican Republic,328,6,3614,189
2020-04-16,Dominican Republic,141,7,3755,196
2020-04-17,Dominican Republic,371,4,4126,200
2020-04-18,Dominican Republic,209,17,4335,217
2020-04-19,Dominican Republic,345,9,4680,226
2020-04-20,Dominican Republic,284,9,4964,235
2020-04-21,Dominican Republic,80,10,5044,245
2020-04-22,Dominican Republic,256,15,5300,260
2020-04-23,Dominican Republic,243,5,5543,265
2020-04-24,Dominican Republic,206,2,5749,267
2020-04-25,Dominican Republic,177,6,5926,273
2020-04-26,Dominican Republic,209,5,6135,278
2020-04-27,Dominican Republic,158,4,6293,282
2020-04-28,Dominican Republic,123,4,6416,286
2020-04-29,Dominican Republic,236,7,6652,293
2020-04-30,Dominican Republic,320,8,6972,301
2020-05-01,Dominican Republic,316,12,7288,313
2020-05-02,Dominican Republic,290,13,7578,326
2020-05-03,Dominican Republic,376,7,7954,333
2020-05-04,Dominican Republic,281,13,8235,346
2020-05-05,Dominican Republic,245,8,8480,354
2020-05-06,Dominican Republic,327,8,8807,362
2020-05-07,Dominican Republic,288,11,9095,373
2020-05-08,Dominican Republic,281,7,9376,380
2020-05-09,Dominican Republic,506,5,9882,385
2020-05-10,Dominican Republic,465,3,10347,388
2020-05-11,Dominican Republic,287,5,10634,393
2020-05-12,Dominican Republic,266,9,10900,402
2020-05-13,Dominican Republic,296,7,11196,409
2020-05-14,Dominican Republic,124,13,11320,422
2020-05-15,Dominican Republic,419,2,11739,424
2020-05-16,Dominican Republic,371,4,12110,428
2020-05-17,Dominican Republic,204,0,12314,428
2020-05-18,Dominican Republic,411,6,12725,434
2020-05-19,Dominican Republic,498,7,13223,441
2020-05-20,Dominican Republic,254,5,13477,446
2020-05-21,Dominican Republic,180,2,13657,448
2020-05-22,Dominican Republic,332,8,13989,456
2020-05-23,Dominican Republic,433,2,14422,458
2020-05-24,Dominican Republic,379,0,14801,458
2020-05-25,Dominican Republic,272,2,15073,460
2020-05-26,Dominican Republic,191,8,15264,468
2020-05-27,Dominican Republic,459,6,15723,474
2020-05-28,Dominican Republic,345,11,16068,485
2020-05-29,Dominican Republic,463,3,16531,488
2020-05-30,Dominican Republic,377,10,16908,498
2020-05-31,Dominican Republic,377,4,17285,502
2020-06-01,Dominican Republic,287,0,17572,502
2020-06-02,Dominican Republic,180,13,17752,515
2020-06-03,Dominican Republic,288,1,18040,516
2020-06-04,Dominican Republic,279,4,18319,520
2020-06-05,Dominican Republic,389,5,18708,525
2020-06-06,Dominican Republic,487,11,19195,536
2020-06-07,Dominican Republic,405,2,19600,538
2020-06-08,Dominican Republic,526,1,20126,539
2020-06-09,Dominican Republic,289,5,20415,544
2020-06-10,Dominican Republic,393,6,20808,550
2020-06-11,Dominican Republic,629,11,21437,561
2020-06-12,Dominican Republic,571,7,22008,568
2020-06-13,Dominican Republic,564,9,22572,577
2020-06-14,Dominican Republic,390,15,22962,592
2020-06-15,Dominican Republic,309,13,23271,605
2020-06-16,Dominican Republic,415,10,23686,615
2020-06-17,Dominican Republic,419,18,24105,633
2020-06-18,Dominican Republic,540,2,24645,635
2020-06-19,Dominican Republic,423,12,25068,647
2020-06-20,Dominican Republic,710,8,25778,655
2020-06-21,Dominican Republic,899,7,26677,662
2020-06-22,Dominican Republic,693,7,27370,669
2020-06-23,Dominican Republic,566,6,27936,675
2020-06-24,Dominican Republic,695,16,28631,691
2020-06-25,Dominican Republic,510,7,29141,698
2020-06-26,Dominican Republic,623,14,29764,712
2020-06-27,Dominican Republic,855,6,30619,718
2020-06-28,Dominican Republic,754,8,31373,726
2020-06-29,Dominican Republic,443,7,31816,733
2020-06-30,Dominican Republic,752,14,32568,747
2020-07-01,Dominican Republic,819,7,33387,754
2020-07-02,Dominican Republic,810,11,34197,765
2020-07-03,Dominican Republic,951,10,35148,775
2020-07-04,Dominican Republic,1036,11,36184,786
2020-07-05,Dominican Republic,1241,8,37425,794
2020-07-06,Dominican Republic,703,10,38128,804
2020-07-07,Dominican Republic,302,17,38430,821
2020-07-08,Dominican Republic,1158,8,39588,829
2020-07-09,Dominican Republic,1202,13,40790,842
2020-07-10,Dominican Republic,1125,22,41915,864
2020-07-11,Dominican Republic,1199,16,43114,880
2020-07-12,Dominican Republic,1418,17,44532,897
2020-07-13,Dominican Republic,974,6,45506,903
2020-07-14,Dominican Republic,799,7,46305,910
2020-07-15,Dominican Republic,1366,19,47671,929
2020-07-16,Dominican Republic,1072,12,48743,941
2020-07-17,Dominican Republic,1370,1,50113,942
2020-07-18,Dominican Republic,1406,29,51519,971
2020-07-19,Dominican Republic,1336,10,52855,981
2020-07-20,Dominican Republic,1101,12,53956,993
2020-07-21,Dominican Republic,841,6,54797,999
2020-07-22,Dominican Republic,1246,6,56043,1005
2020-07-23,Dominican Republic,1572,1,57615,1006
2020-07-24,Dominican Republic,1462,30,59077,1036
2020-07-25,Dominican Republic,1819,19,60896,1055
2020-07-26,Dominican Republic,2012,8,62908,1063
2020-07-27,Dominican Republic,1248,20,64156,1083
2020-07-28,Dominican Republic,534,18,64690,1101
2020-07-29,Dominican Republic,1492,22,66182,1123
2020-07-30,Dominican Republic,1733,23,67915,1146
2020-07-31,Dominican Republic,1734,14,69649,1160
2020-08-01,Dominican Republic,1766,10,71415,1170
2020-08-02,Dominican Republic,828,8,72243,1178
2020-08-03,Dominican Republic,874,5,73117,1183
2020-08-04,Dominican Republic,1178,30,74295,1213
2020-08-05,Dominican Republic,1365,9,75660,1222
2020-08-06,Dominican Republic,876,24,76536,1246
2020-08-07,Dominican Republic,1173,13,77709,1259
2020-08-08,Dominican Republic,1069,30,78778,1289
2020-08-09,Dominican Republic,954,20,79732,1309
2020-08-10,Dominican Republic,767,19,80499,1328
2020-08-11,Dominican Republic,595,18,81094,1346
2020-08-12,Dominican Republic,1130,25,82224,1371
2020-08-13,Dominican Republic,910,22,83134,1393
2020-08-14,Dominican Republic,1354,16,84488,1409
2020-08-15,Dominican Republic,1057,29,85545,1438
2020-08-16,Dominican Republic,764,15,86309,1453
2020-08-17,Dominican Republic,428,28,86737,1481
2020-08-18,Dominican Republic,386,8,87123,1489
2020-08-19,Dominican Republic,1004,12,88127,1501
2020-08-20,Dominican Republic,883,4,89010,1505
2020-08-21,Dominican Republic,857,28,89867,1533
2020-08-22,Dominican Republic,694,21,90561,1554
2020-08-23,Dominican Republic,600,13,91161,1567
2020-08-24,Dominican Republic,447,6,91608,1573
2020-08-25,Dominican Republic,609,12,92217,1585
2020-08-26,Dominican Republic,340,28,92557,1613
2020-08-27,Dominican Republic,407,17,92964,1630
2020-08-28,Dominican Republic,426,18,93390,1648
2020-08-29,Dominican Republic,342,25,93732,1673
2020-08-30,Dominican Republic,509,8,94241,1681
2020-08-31,Dominican Republic,474,29,94715,1710
2020-09-01,Dominican Republic,264,28,94979,1738
2020-09-02,Dominican Republic,648,27,95627,1765
2020-09-03,Dominican Republic,1002,36,96629,1801
2020-09-04,Dominican Republic,0,0,96629,1801
2020-09-05,Dominican Republic,2147,39,98776,1840
2020-09-06,Dominican Republic,557,5,99333,1845
2020-09-07,Dominican Republic,565,19,99898,1864
2020-09-08,Dominican Republic,233,25,100131,1889
2020-09-09,Dominican Republic,806,25,100937,1914
2020-09-10,Dominican Republic,779,12,101716,1926
2020-09-11,Dominican Republic,516,15,102232,1941
2020-09-12,Dominican Republic,860,12,103092,1953
2020-09-13,Dominican Republic,568,15,103660,1968
2020-09-14,Dominican Republic,450,16,104110,1984
2020-09-15,Dominican Republic,693,14,104803,1998
2020-09-16,Dominican Republic,718,11,105521,2009
2020-09-17,Dominican Republic,615,13,106136,2022
2020-09-18,Dominican Republic,596,12,106732,2034
2020-09-19,Dominican Republic,968,10,107700,2044
2020-09-20,Dominican Republic,589,3,108289,2047
2020-09-21,Dominican Republic,494,7,108783,2054
2020-09-22,Dominican Republic,486,10,109269,2064
2020-09-23,Dominican Republic,468,10,109737,2074
2020-09-24,Dominican Republic,385,2,110122,2076
2020-09-25,Dominican Republic,475,11,110597,2087
2020-09-26,Dominican Republic,360,6,110957,2093
2020-09-27,Dominican Republic,429,2,111386,2095
2020-09-28,Dominican Republic,280,3,111666,2098
2020-09-29,Dominican Republic,234,3,111900,2101
2020-09-30,Dominican Republic,309,4,112209,2105
2020-10-01,Dominican Republic,519,3,112728,2108
2020-10-02,Dominican Republic,622,9,113350,2117
2020-10-03,Dominican Republic,576,11,113926,2128
2020-10-04,Dominican Republic,554,6,114480,2134
2020-10-05,Dominican Republic,574,10,115054,2144
2020-10-06,Dominican Republic,317,5,115371,2149
2020-10-07,Dominican Republic,777,10,116148,2159
2020-10-08,Dominican Republic,724,4,116872,2163
2020-10-09,Dominican Republic,585,2,117457,2165
2020-10-10,Dominican Republic,557,2,118014,2167
2020-10-11,Dominican Republic,463,6,118477,2173
2020-10-12,Dominican Republic,366,6,118843,2179
2020-10-13,Dominican Republic,165,4,119008,2183
2020-10-14,Dominican Republic,654,3,119662,2186
2020-10-15,Dominican Republic,404,3,120066,2189
2020-10-16,Dominican Republic,384,3,120450,2192
2020-10-17,Dominican Republic,475,3,120925,2195
2020-10-18,Dominican Republic,422,4,121347,2199
2020-10-19,Dominican Republic,320,4,121667,2203
2020-10-20,Dominican Republic,306,1,121973,2204
2020-10-21,Dominican Republic,425,2,122398,2206
2020-10-22,Dominican Republic,475,6,122873,2212
2020-10-23,Dominican Republic,0,0,122873,2212
2020-10-24,Dominican Republic,1145,8,124018,2220
2020-10-25,Dominican Republic,509,3,124527,2223
2020-10-26,Dominican Republic,316,2,124843,2225
2020-10-27,Dominican Republic,165,1,125008,2226
2020-10-28,Dominican Republic,562,6,125570,2232
2020-10-29,Dominican Republic,343,2,125913,2234
2020-10-30,Dominican Republic,419,2,126332,2236
2020-10-31,Dominican Republic,686,9,127018,2245
2020-11-01,Dominican Republic,314,4,127332,2249
2020-11-02,Dominican Republic,259,1,127591,2250
2020-11-03,Dominican Republic,257,2,127848,2252
2020-11-04,Dominican Republic,430,5,128278,2257
2020-11-05,Dominican Republic,546,3,128824,2260
2020-11-06,Dominican Republic,476,1,129300,2261
2020-11-07,Dominican Republic,345,2,129645,2263
2020-11-08,Dominican Republic,537,2,130182,2265
2020-11-09,Dominican Republic,421,2,130603,2267
2020-11-10,Dominican Republic,528,2,131131,2269
2020-11-11,Dominican Republic,134,3,131265,2272
2020-11-12,Dominican Republic,371,2,131636,2274
2020-11-13,Dominican Republic,918,6,132554,2280
2020-11-14,Dominican Republic,671,2,133225,2282
2020-11-15,Dominican Republic,499,3,133724,2285
2020-11-16,Dominican Republic,479,1,134203,2286
2020-11-17,Dominican Republic,494,4,134697,2290
2020-11-18,Dominican Republic,460,3,135157,2293
2020-11-19,Dominican Republic,1026,8,136183,2301
2020-11-20,Dominican Republic,601,5,136784,2306
2020-11-21,Dominican Republic,986,2,137770,2308
2020-11-22,Dominican Republic,640,2,138410,2310
2020-11-23,Dominican Republic,419,1,138829,2311
2020-11-24,Dominican Republic,282,2,139111,2313
2020-11-25,Dominican Republic,285,2,139396,2315
2020-11-26,Dominican Republic,1526,2,140922,2317
2020-11-27,Dominican Republic,855,7,141777,2324
2020-11-28,Dominican Republic,876,4,142653,2328
2020-11-29,Dominican Republic,820,2,143473,2330
2020-11-30,Dominican Republic,515,1,143988,2331
2020-12-01,Dominican Republic,314,2,144302,2333
2020-12-02,Dominican Republic,895,1,145197,2334
2020-12-03,Dominican Republic,812,1,146009,2335
2020-12-04,Dominican Republic,671,8,146680,2343
2020-12-05,Dominican Republic,975,2,147655,2345
2020-12-06,Dominican Republic,798,0,148453,2345
2020-12-07,Dominican Republic,685,1,149138,2346
2020-12-08,Dominican Republic,492,1,149630,2347
2020-12-09,Dominican Republic,531,3,150161,2350
2020-12-10,Dominican Republic,1560,8,151721,2358
2020-12-11,Dominican Republic,731,1,152452,2359
2020-12-12,Dominican Republic,1133,1,153585,2360
2020-12-13,Dominican Republic,1107,1,154692,2361
2020-12-14,Dominican Republic,492,3,155184,2364
2020-12-15,Dominican Republic,613,3,155797,2367
2020-12-16,Dominican Republic,788,5,156585,2372
2020-12-17,Dominican Republic,720,3,157305,2375
2020-12-18,Dominican Republic,624,1,157929,2376
2020-12-19,Dominican Republic,1135,6,159064,2382
2020-12-20,Dominican Republic,1322,2,160386,2384
2020-12-21,Dominican Republic,666,1,161052,2385
2020-12-22,Dominican Republic,878,13,161930,2398
2020-12-23,Dominican Republic,566,3,162496,2401
2020-12-24,Dominican Republic,1158,3,163654,2404
2020-12-25,Dominican Republic,1381,0,165035,2404
2020-12-26,Dominican Republic,905,0,165940,2404
2020-12-27,Dominican Republic,824,0,166764,2404
2020-12-28,Dominican Republic,641,0,167405,2404
2020-12-29,Dominican Republic,860,1,168265,2405
2020-12-30,Dominican Republic,1314,4,169579,2409
2020-12-31,Dominican Republic,1206,5,170785,2414
2021-01-01,Dominican Republic,1433,2,172218,2416
2021-01-02,Dominican Republic,747,0,172965,2416
2021-01-03,Dominican Republic,366,2,173331,2418
2021-01-04,Dominican Republic,2043,1,175374,2419
2021-01-05,Dominican Republic,475,0,175849,2419
2021-01-06,Dominican Republic,529,0,176378,2419
2021-01-07,Dominican Republic,1115,4,177493,2423
2021-01-08,Dominican Republic,1045,1,178538,2424
2021-01-09,Dominican Republic,2106,0,180644,2424
2021-01-10,Dominican Republic,1459,3,182103,2427
2021-01-11,Dominican Republic,1179,0,183282,2427
2021-01-12,Dominican Republic,1506,0,184788,2427
2021-01-13,Dominican Republic,1595,1,186383,2428
2021-01-14,Dominican Republic,1104,0,187487,2428
2021-01-15,Dominican Republic,1482,4,188969,2432
2021-01-16,Dominican Republic,2370,0,191339,2432
2021-01-17,Dominican Republic,1779,5,193118,2437
2021-01-18,Dominican Republic,1848,11,194966,2448
2021-01-19,Dominican Republic,1625,13,196591,2461
2021-01-20,Dominican Republic,1532,9,198123,2470
2021-01-21,Dominican Republic,1549,12,199672,2482
2021-01-22,Dominican Republic,1473,14,201145,2496
2021-01-23,Dominican Republic,1362,17,202507,2513
2021-01-24,Dominican Republic,1439,18,203946,2531
2021-01-25,Dominican Republic,1216,14,205162,2545
2021-01-26,Dominican Republic,1143,19,206305,2564
2021-01-27,Dominican Republic,1150,15,207455,2579
2021-01-28,Dominican Republic,1155,24,208610,2603
2021-01-29,Dominican Republic,1802,23,210412,2626
2021-01-30,Dominican Republic,2141,20,212553,2646
2021-01-31,Dominican Republic,1507,20,214060,2666
2021-02-01,Dominican Republic,1026,22,215086,2688
2021-02-02,Dominican Republic,834,16,215920,2704
2021-02-03,Dominican Republic,1357,15,217277,2719
2021-02-04,Dominican Republic,1671,28,218948,2747
2021-02-05,Dominican Republic,1478,26,220426,2773
2021-02-06,Dominican Republic,1722,28,222148,2801
2021-02-07,Dominican Republic,1250,30,223398,2831
2021-02-08,Dominican Republic,721,12,224119,2843
2021-02-09,Dominican Republic,419,21,224538,2864
2021-02-10,Dominican Republic,934,19,225472,2883
2021-02-11,Dominican Republic,1242,21,226714,2904
2021-02-12,Dominican Republic,1050,13,227764,2917
2021-02-13,Dominican Republic,1131,15,228895,2932
2021-02-14,Dominican Republic,873,12,229768,2944
2021-02-15,Dominican Republic,795,15,230563,2959
2021-02-16,Dominican Republic,532,16,231095,2975
2021-02-17,Dominican Republic,642,15,231737,2990
2021-02-18,Dominican Republic,1043,17,232780,3007
2021-02-19,Dominican Republic,818,17,233598,3024
2021-02-20,Dominican Republic,904,4,234502,3028
2021-02-21,Dominican Republic,960,10,235462,3038
2021-02-22,Dominican Republic,420,10,235882,3048
2021-02-23,Dominican Republic,328,9,236210,3057
2021-02-24,Dominican Republic,673,9,236883,3066
2021-02-25,Dominican Republic,746,9,237629,3075
2021-02-26,Dominican Republic,576,7,238205,3082
2021-02-27,Dominican Republic,804,11,239009,3093
2021-02-28,Dominican Republic,608,7,239617,3100
2021-03-01,Dominican Republic,381,6,239998,3106
2021-03-02,Dominican Republic,203,12,240201,3118
2021-03-03,Dominican Republic,572,12,240773,3130
2021-03-04,Dominican Republic,619,9,241392,3139
2021-03-05,Dominican Republic,695,11,242087,3150
2021-03-06,Dominican Republic,573,12,242660,3162
2021-03-07,Dominican Republic,587,10,243247,3172
2021-03-08,Dominican Republic,279,7,243526,3179
2021-03-09,Dominican Republic,252,12,243778,3191
2021-03-10,Dominican Republic,390,7,244168,3198
2021-03-11,Dominican Republic,755,6,244923,3204
2021-03-12,Dominican Republic,529,9,245452,3213
2021-03-13,Dominican Republic,164,0,245616,3213
2021-03-14,Dominican Republic,429,9,246045,3222
2021-03-15,Dominican Republic,254,4,246299,3226
2021-03-16,Dominican Republic,495,11,246794,3237
2021-03-17,Dominican Republic,570,11,247364,3248
2021-03-18,Dominican Republic,615,9,247979,3257
2021-03-19,Dominican Republic,523,5,248502,3262
2021-03-20,Dominican Republic,487,7,248989,3269
2021-03-21,Dominican Republic,474,3,249463,3272
2021-03-22,Dominican Republic,313,3,249776,3275
2021-03-23,Dominican Republic,401,8,250177,3283
2021-03-24,Dominican Republic,402,6,250579,3289
2021-03-25,Dominican Republic,389,6,250968,3295
2021-03-26,Dominican Republic,364,3,251332,3298
2021-03-27,Dominican Republic,250,4,251582,3302
2021-03-28,Dominican Republic,401,2,251983,3304
2021-03-29,Dominican Republic,199,3,252182,3307
2021-03-30,Dominican Republic,202,10,252384,3317
2021-03-31,Dominican Republic,343,8,252727,3325
2021-04-01,Dominican Republic,469,5,253196,3330
2021-04-02,Dominican Republic,585,4,253781,3334
2021-04-03,Dominican Republic,355,7,254136,3341
2021-04-04,Dominican Republic,159,5,254295,3346
2021-04-05,Dominican Republic,140,5,254435,3351
2021-04-06,Dominican Republic,168,4,254603,3355
2021-04-07,Dominican Republic,334,14,254937,3369
2021-04-08,Dominican Republic,1094,9,256031,3378
2020-03-01,Ecuador,6,0,6,0
2020-03-02,Ecuador,0,0,6,0
2020-03-03,Ecuador,1,0,7,0
2020-03-04,Ecuador,3,0,10,0
2020-03-05,Ecuador,3,0,13,0
2020-03-06,Ecuador,0,0,13,0
2020-03-07,Ecuador,0,0,13,0
2020-03-08,Ecuador,1,0,14,0
2020-03-09,Ecuador,1,0,15,0
2020-03-10,Ecuador,0,0,15,0
2020-03-11,Ecuador,2,0,17,0
2020-03-12,Ecuador,0,0,17,0
2020-03-13,Ecuador,0,0,17,0
2020-03-14,Ecuador,11,2,28,2
2020-03-15,Ecuador,0,0,28,2
2020-03-16,Ecuador,9,0,37,2
2020-03-17,Ecuador,21,0,58,2
2020-03-18,Ecuador,53,0,111,2
2020-03-19,Ecuador,88,1,199,3
2020-03-20,Ecuador,168,2,367,5
2020-03-21,Ecuador,139,2,506,7
2020-03-22,Ecuador,283,7,789,14
2020-03-23,Ecuador,192,4,981,18
2020-03-24,Ecuador,101,9,1082,27
2020-03-25,Ecuador,91,1,1173,28
2020-03-26,Ecuador,230,6,1403,34
2020-03-27,Ecuador,192,2,1595,36
2020-03-28,Ecuador,228,12,1823,48
2020-03-29,Ecuador,101,10,1924,58
2020-03-30,Ecuador,38,2,1962,60
2020-03-31,Ecuador,278,15,2240,75
2020-04-01,Ecuador,508,18,2748,93
2020-04-02,Ecuador,415,27,3163,120
2020-04-03,Ecuador,205,25,3368,145
2020-04-04,Ecuador,97,27,3465,172
2020-04-05,Ecuador,181,8,3646,180
2020-04-06,Ecuador,101,11,3747,191
2020-04-07,Ecuador,0,0,3747,191
2020-04-08,Ecuador,703,51,4450,242
2020-04-09,Ecuador,515,30,4965,272
2020-04-10,Ecuador,2196,25,7161,297
2020-04-11,Ecuador,96,18,7257,315
2020-04-12,Ecuador,209,18,7466,333
2020-04-13,Ecuador,63,22,7529,355
2020-04-14,Ecuador,74,14,7603,369
2020-04-15,Ecuador,255,19,7858,388
2020-04-16,Ecuador,367,15,8225,403
2020-04-17,Ecuador,225,18,8450,421
2020-04-18,Ecuador,572,35,9022,456
2020-04-19,Ecuador,446,18,9468,474
2020-04-20,Ecuador,660,33,10128,507
2020-04-21,Ecuador,270,13,10398,520
2020-04-22,Ecuador,452,17,10850,537
2020-04-23,Ecuador,333,23,11183,560
2020-04-24,Ecuador,11536,16,22719,576
2020-04-25,Ecuador,0,0,22719,576
2020-04-26,Ecuador,0,0,22719,576
2020-04-27,Ecuador,521,87,23240,663
2020-04-28,Ecuador,1018,208,24258,871
2020-04-29,Ecuador,417,12,24675,883
2020-04-30,Ecuador,259,17,24934,900
2020-05-01,Ecuador,1402,163,26336,1063
2020-05-02,Ecuador,1128,308,27464,1371
2020-05-03,Ecuador,2074,193,29538,1564
2020-05-04,Ecuador,2343,5,31881,1569
2020-05-05,Ecuador,0,0,31881,1569
2020-05-06,Ecuador,0,49,31881,1618
2020-05-07,Ecuador,-1583,36,30298,1654
2020-05-08,Ecuador,-1480,50,28818,1704
2020-05-09,Ecuador,253,13,29071,1717
2020-05-10,Ecuador,488,410,29559,2127
2020-05-11,Ecuador,-50,18,29509,2145
2020-05-12,Ecuador,910,182,30419,2327
2020-05-13,Ecuador,67,7,30486,2334
2020-05-14,Ecuador,16,4,30502,2338
2020-05-15,Ecuador,965,256,31467,2594
2020-05-16,Ecuador,1296,94,32763,2688
2020-05-17,Ecuador,419,48,33182,2736
2020-05-18,Ecuador,400,63,33582,2799
2020-05-19,Ecuador,569,40,34151,2839
2020-05-20,Ecuador,703,49,34854,2888
2020-05-21,Ecuador,452,51,35306,2939
2020-05-22,Ecuador,522,117,35828,3056
2020-05-23,Ecuador,430,40,36258,3096
2020-05-24,Ecuador,498,12,36756,3108
2020-05-25,Ecuador,599,95,37355,3203
2020-05-26,Ecuador,0,0,37355,3203
2020-05-27,Ecuador,748,72,38103,3275
2020-05-28,Ecuador,368,38,38471,3313
2020-05-29,Ecuador,100,21,38571,3334
2020-05-30,Ecuador,0,0,38571,3334
2020-05-31,Ecuador,527,24,39098,3358
2020-06-01,Ecuador,0,0,39098,3358
2020-06-02,Ecuador,1316,80,40414,3438
2020-06-03,Ecuador,552,48,40966,3486
2020-06-04,Ecuador,0,0,40966,3486
2020-06-05,Ecuador,609,48,41575,3534
2020-06-06,Ecuador,1153,74,42728,3608
2020-06-07,Ecuador,392,13,43120,3621
2020-06-08,Ecuador,258,21,43378,3642
2020-06-09,Ecuador,539,48,43917,3690
2020-06-10,Ecuador,523,30,44440,3720
2020-06-11,Ecuador,0,0,44440,3720
2020-06-12,Ecuador,1338,108,45778,3828
2020-06-13,Ecuador,578,46,46356,3874
2020-06-14,Ecuador,395,22,46751,3896
2020-06-15,Ecuador,571,33,47322,3929
2020-06-16,Ecuador,621,41,47943,3970
2020-06-17,Ecuador,547,37,48490,4007
2020-06-18,Ecuador,607,80,49097,4087
2020-06-19,Ecuador,634,69,49731,4156
2020-06-20,Ecuador,0,0,49731,4156
2020-06-21,Ecuador,909,67,50640,4223
2020-06-22,Ecuador,0,0,50640,4223
2020-06-23,Ecuador,1003,51,51643,4274
2020-06-24,Ecuador,0,0,51643,4274
2020-06-25,Ecuador,1513,69,53156,4343
2020-06-26,Ecuador,700,63,53856,4406
2020-06-27,Ecuador,718,18,54574,4424
2020-06-28,Ecuador,681,5,55255,4429
2020-06-29,Ecuador,410,73,55665,4502
2020-06-30,Ecuador,767,25,56432,4527
2020-07-01,Ecuador,1825,49,58257,4576
2020-07-02,Ecuador,1211,63,59468,4639
2020-07-03,Ecuador,1189,61,60657,4700
2020-07-04,Ecuador,878,69,61535,4769
2020-07-05,Ecuador,423,12,61958,4781
2020-07-06,Ecuador,422,40,62380,4821
2020-07-07,Ecuador,865,52,63245,4873
2020-07-08,Ecuador,0,0,63245,4873
2020-07-09,Ecuador,976,27,64221,4900
2020-07-10,Ecuador,797,39,65018,4939
2020-07-11,Ecuador,2191,92,67209,5031
2020-07-12,Ecuador,661,16,67870,5047
2020-07-13,Ecuador,589,16,68459,5063
2020-07-14,Ecuador,1111,67,69570,5130
2020-07-15,Ecuador,759,28,70329,5158
2020-07-16,Ecuador,1036,49,71365,5207
2020-07-17,Ecuador,1079,43,72444,5250
2020-07-18,Ecuador,938,32,73382,5282
2020-07-19,Ecuador,631,31,74013,5313
2020-07-20,Ecuador,607,5,74620,5318
2020-07-21,Ecuador,1597,48,76217,5366
2020-07-22,Ecuador,1040,52,77257,5418
2020-07-23,Ecuador,891,21,78148,5439
2020-07-24,Ecuador,901,29,79049,5468
2020-07-25,Ecuador,987,39,80036,5507
2020-07-26,Ecuador,658,8,80694,5515
2020-07-27,Ecuador,467,17,81161,5532
2020-07-28,Ecuador,1118,52,82279,5584
2020-07-29,Ecuador,914,39,83193,5623
2020-07-30,Ecuador,1177,34,84370,5657
2020-07-31,Ecuador,985,45,85355,5702
2020-08-01,Ecuador,877,34,86232,5736
2020-08-02,Ecuador,0,0,86232,5736
2020-08-03,Ecuador,809,31,87041,5767
2020-08-04,Ecuador,922,41,87963,5808
2020-08-05,Ecuador,903,39,88866,5847
2020-08-06,Ecuador,1671,30,90537,5877
2020-08-07,Ecuador,1432,20,91969,5897
2020-08-08,Ecuador,1603,19,93572,5916
2020-08-09,Ecuador,887,6,94459,5922
2020-08-10,Ecuador,242,10,94701,5932
2020-08-11,Ecuador,862,19,95563,5951
2020-08-12,Ecuador,1547,33,97110,5984
2020-08-13,Ecuador,1233,26,98343,6010
2020-08-14,Ecuador,1066,20,99409,6030
2020-08-15,Ecuador,1279,35,100688,6065
2020-08-16,Ecuador,854,5,101542,6070
2020-08-17,Ecuador,209,13,101751,6083
2020-08-18,Ecuador,1190,22,102941,6105
2020-08-19,Ecuador,1534,41,104475,6146
2020-08-20,Ecuador,1033,54,105508,6200
2020-08-21,Ecuador,973,48,106481,6248
2020-08-22,Ecuador,608,29,107089,6277
2020-08-23,Ecuador,680,33,107769,6310
2020-08-24,Ecuador,520,12,108289,6322
2020-08-25,Ecuador,741,46,109030,6368
2020-08-26,Ecuador,1519,42,110549,6410
2020-08-27,Ecuador,670,61,111219,6471
2020-08-28,Ecuador,922,33,112141,6504
2020-08-29,Ecuador,765,33,112906,6537
2020-08-30,Ecuador,742,18,113648,6555
2020-08-31,Ecuador,119,1,113767,6556
2020-09-01,Ecuador,542,15,114309,6571
2020-09-02,Ecuador,1148,48,115457,6619
2020-09-03,Ecuador,903,29,116360,6648
2020-09-04,Ecuador,815,26,117175,6674
2020-09-05,Ecuador,870,50,118045,6724
2020-09-06,Ecuador,0,0,118045,6724
2020-09-07,Ecuador,-7953,3852,110092,10576
2020-09-08,Ecuador,665,51,110757,10627
2020-09-09,Ecuador,1409,74,112166,10701
2020-09-10,Ecuador,1040,48,113206,10749
2020-09-11,Ecuador,1526,87,114732,10836
2020-09-12,Ecuador,1719,28,116451,10864
2020-09-13,Ecuador,2143,39,118594,10903
2020-09-14,Ecuador,317,19,118911,10922
2020-09-15,Ecuador,642,41,119553,10963
2020-09-16,Ecuador,1972,33,121525,10996
2020-09-17,Ecuador,732,33,122257,11029
2020-09-18,Ecuador,1872,15,124129,11044
2020-09-19,Ecuador,1491,40,125620,11084
2020-09-20,Ecuador,799,6,126419,11090
2020-09-21,Ecuador,292,5,126711,11095
2020-09-22,Ecuador,932,31,127643,11126
2020-09-23,Ecuador,2249,45,129892,11171
2020-09-24,Ecuador,1254,42,131146,11213
2020-09-25,Ecuador,1329,23,132475,11236
2020-09-26,Ecuador,1506,37,133981,11273
2020-09-27,Ecuador,766,6,134747,11279
2020-09-28,Ecuador,218,1,134965,11280
2020-09-29,Ecuador,784,32,135749,11312
2020-09-30,Ecuador,1298,43,137047,11355
2020-10-01,Ecuador,1537,78,138584,11433
2020-10-02,Ecuador,950,62,139534,11495
2020-10-03,Ecuador,817,102,140351,11597
2020-10-04,Ecuador,683,50,141034,11647
2020-10-05,Ecuador,305,34,141339,11681
2020-10-06,Ecuador,717,21,142056,11702
2020-10-07,Ecuador,1475,41,143531,11743
2020-10-08,Ecuador,1514,398,145045,12141
2020-10-09,Ecuador,803,34,145848,12175
2020-10-10,Ecuador,980,13,146828,12188
2020-10-11,Ecuador,205,3,147033,12191
2020-10-12,Ecuador,282,27,147315,12218
2020-10-13,Ecuador,856,17,148171,12235
2020-10-14,Ecuador,912,29,149083,12264
2020-10-15,Ecuador,1277,42,150360,12306
2020-10-16,Ecuador,1299,51,151659,12357
2020-10-17,Ecuador,763,18,152422,12375
2020-10-18,Ecuador,867,12,153289,12387
2020-10-19,Ecuador,134,8,153423,12395
2020-10-20,Ecuador,692,9,154115,12404
2020-10-21,Ecuador,1510,49,155625,12453
2020-10-22,Ecuador,826,47,156451,12500
2020-10-23,Ecuador,1819,28,158270,12528
2020-10-24,Ecuador,1344,14,159614,12542
2020-10-25,Ecuador,2021,11,161635,12553
2020-10-26,Ecuador,543,20,162178,12573
2020-10-27,Ecuador,1014,15,163192,12588
2020-10-28,Ecuador,1716,20,164908,12608
2020-10-29,Ecuador,1394,14,166302,12622
2020-10-30,Ecuador,845,10,167147,12632
2020-10-31,Ecuador,1045,38,168192,12670
2020-11-01,Ecuador,1002,14,169194,12684
2020-11-02,Ecuador,368,8,169562,12692
2020-11-03,Ecuador,548,6,170110,12698
2020-11-04,Ecuador,1323,6,171433,12704
2020-11-05,Ecuador,350,26,171783,12730
2020-11-06,Ecuador,725,31,172508,12761
2020-11-07,Ecuador,978,54,173486,12815
2020-11-08,Ecuador,1421,15,174907,12830
2020-11-09,Ecuador,362,9,175269,12839
2020-11-10,Ecuador,442,10,175711,12849
2020-11-11,Ecuador,919,71,176630,12920
2020-11-12,Ecuador,883,26,177513,12946
2020-11-13,Ecuador,1161,31,178674,12977
2020-11-14,Ecuador,953,20,179627,12997
2020-11-15,Ecuador,668,11,180295,13008
2020-11-16,Ecuador,381,8,180676,13016
2020-11-17,Ecuador,428,9,181104,13025
2020-11-18,Ecuador,1146,27,182250,13052
2020-11-19,Ecuador,996,21,183246,13073
2020-11-20,Ecuador,594,22,183840,13095
2020-11-21,Ecuador,1036,44,184876,13139
2020-11-22,Ecuador,767,62,185643,13201
2020-11-23,Ecuador,301,24,185944,13225
2020-11-24,Ecuador,492,39,186436,13264
2020-11-25,Ecuador,794,24,187230,13288
2020-11-26,Ecuador,908,28,188138,13316
2020-11-27,Ecuador,1396,42,189534,13358
2020-11-28,Ecuador,1375,13,190909,13371
2020-11-29,Ecuador,1208,52,192117,13423
2020-11-30,Ecuador,568,38,192685,13461
2020-12-01,Ecuador,988,40,193673,13501
2020-12-02,Ecuador,1203,61,194876,13562
2020-12-03,Ecuador,1008,50,195884,13612
2020-12-04,Ecuador,598,84,196482,13696
2020-12-05,Ecuador,909,60,197391,13756
2020-12-06,Ecuador,607,22,197998,13778
2020-12-07,Ecuador,246,2,198244,13780
2020-12-08,Ecuador,508,14,198752,13794
2020-12-09,Ecuador,476,20,199228,13814
2020-12-10,Ecuador,1151,36,200379,13850
2020-12-11,Ecuador,386,8,200765,13858
2020-12-12,Ecuador,759,16,201524,13874
2020-12-13,Ecuador,586,1,202110,13875
2020-12-14,Ecuador,70,0,202180,13875
2020-12-15,Ecuador,176,21,202356,13896
2020-12-16,Ecuador,1105,19,203461,13915
2020-12-17,Ecuador,788,17,204249,13932
2020-12-18,Ecuador,754,10,205003,13942
2020-12-19,Ecuador,917,6,205920,13948
2020-12-20,Ecuador,337,0,206257,13948
2020-12-21,Ecuador,72,1,206329,13949
2020-12-22,Ecuador,35,0,206364,13949
2020-12-23,Ecuador,720,13,207084,13962
2020-12-24,Ecuador,926,15,208010,13977
2020-12-25,Ecuador,818,7,208828,13984
2020-12-26,Ecuador,446,6,209274,13990
2020-12-27,Ecuador,81,2,209355,13992
2020-12-28,Ecuador,403,2,209758,13994
2020-12-29,Ecuador,568,7,210326,14001
2020-12-30,Ecuador,1186,22,211512,14023
2020-12-31,Ecuador,1000,11,212512,14034
2021-01-01,Ecuador,866,17,213378,14051
2021-01-02,Ecuador,1135,8,214513,14059
2021-01-03,Ecuador,101,0,214614,14059
2021-01-04,Ecuador,466,10,215080,14069
2021-01-05,Ecuador,1003,34,216083,14103
2021-01-06,Ecuador,1294,43,217377,14146
2021-01-07,Ecuador,1008,12,218385,14158
2021-01-08,Ecuador,763,7,219148,14165
2021-01-09,Ecuador,1201,12,220349,14177
2021-01-10,Ecuador,721,0,221070,14177
2021-01-11,Ecuador,436,7,221506,14184
2021-01-12,Ecuador,1061,12,222567,14196
2021-01-13,Ecuador,1748,33,224315,14229
2021-01-14,Ecuador,1687,17,226002,14246
2021-01-15,Ecuador,864,27,226866,14273
2021-01-16,Ecuador,3942,43,230808,14316
2021-01-17,Ecuador,674,3,231482,14319
2021-01-18,Ecuador,162,3,231644,14322
2021-01-19,Ecuador,924,60,232568,14382
2021-01-20,Ecuador,1747,55,234315,14437
2021-01-21,Ecuador,1874,89,236189,14526
2021-01-22,Ecuador,969,36,237158,14562
2021-01-23,Ecuador,1074,34,238232,14596
2021-01-24,Ecuador,3060,27,241292,14623
2021-01-25,Ecuador,275,16,241567,14639
2021-01-26,Ecuador,579,29,242146,14668
2021-01-27,Ecuador,1389,36,243535,14704
2021-01-28,Ecuador,2465,62,246000,14766
2021-01-29,Ecuador,687,36,246687,14802
2021-01-30,Ecuador,3092,49,249779,14851
2021-01-31,Ecuador,1049,8,250828,14859
2021-02-01,Ecuador,158,31,250986,14890
2021-02-02,Ecuador,293,25,251279,14915
2021-02-03,Ecuador,1111,34,252390,14949
2021-02-04,Ecuador,949,19,253339,14968
2021-02-05,Ecuador,2073,14,255412,14982
2021-02-06,Ecuador,1703,22,257115,15004
2021-02-07,Ecuador,1167,8,258282,15012
2021-02-08,Ecuador,325,1,258607,15013
2021-02-09,Ecuador,1176,73,259783,15086
2021-02-10,Ecuador,293,30,260076,15116
2021-02-11,Ecuador,2137,58,262213,15174
2021-02-12,Ecuador,1304,46,263517,15220
2021-02-13,Ecuador,2010,49,265527,15269
2021-02-14,Ecuador,1696,52,267223,15321
2021-02-15,Ecuador,478,34,267701,15355
2021-02-16,Ecuador,372,37,268073,15392
2021-02-17,Ecuador,146,2,268219,15394
2021-02-18,Ecuador,1641,50,269860,15444
2021-02-19,Ecuador,1416,30,271276,15474
2021-02-20,Ecuador,1821,39,273097,15513
2021-02-21,Ecuador,1576,23,274673,15536
2021-02-22,Ecuador,295,11,274968,15547
2021-02-23,Ecuador,812,20,275780,15567
2021-02-24,Ecuador,2999,67,278779,15634
2021-02-25,Ecuador,2390,35,281169,15669
2021-02-26,Ecuador,1430,44,282599,15713
2021-02-27,Ecuador,1748,66,284347,15779
2021-02-28,Ecuador,1808,32,286155,15811
2021-03-01,Ecuador,212,21,286367,15832
2021-03-02,Ecuador,358,18,286725,15850
2021-03-03,Ecuador,2747,71,289472,15921
2021-03-04,Ecuador,263,38,289735,15959
2021-03-05,Ecuador,1335,38,291070,15997
2021-03-06,Ecuador,1873,23,292943,16020
2021-03-07,Ecuador,1560,19,294503,16039
2021-03-08,Ecuador,115,4,294618,16043
2021-03-09,Ecuador,496,26,295114,16069
2021-03-10,Ecuador,1727,36,296841,16105
2021-03-11,Ecuador,1116,23,297957,16128
2021-03-12,Ecuador,1259,65,299216,16193
2021-03-13,Ecuador,1450,22,300666,16215
2021-03-14,Ecuador,1555,21,302221,16236
2021-03-15,Ecuador,277,4,302498,16240
2021-03-16,Ecuador,356,19,302854,16259
2021-03-17,Ecuador,2744,41,305598,16300
2021-03-18,Ecuador,1831,33,307429,16333
2021-03-19,Ecuador,2214,79,309643,16412
2021-03-20,Ecuador,1225,23,310868,16435
2021-03-21,Ecuador,1730,16,312598,16451
2021-03-22,Ecuador,253,27,312851,16478
2021-03-23,Ecuador,719,26,313570,16504
2021-03-24,Ecuador,3237,36,316807,16540
2021-03-25,Ecuador,1849,42,318656,16582
2021-03-26,Ecuador,2795,50,321451,16632
2021-03-27,Ecuador,1248,47,322699,16679
2021-03-28,Ecuador,1783,59,324482,16738
2021-03-29,Ecuador,642,8,325124,16746
2021-03-30,Ecuador,2201,34,327325,16780
2021-03-31,Ecuador,1430,67,328755,16847
2021-04-01,Ecuador,1633,30,330388,16877
2021-04-02,Ecuador,1650,33,332038,16910
2021-04-03,Ecuador,1137,19,333175,16929
2021-04-04,Ecuador,2506,27,335681,16956
2021-04-05,Ecuador,1096,31,336777,16987
2021-04-06,Ecuador,925,17,337702,17004
2021-04-07,Ecuador,1902,53,339604,17057
2021-04-08,Ecuador,2015,58,341619,17115
2020-02-14,Egypt,1,0,1,0
2020-02-15,Egypt,0,0,1,0
2020-02-16,Egypt,0,0,1,0
2020-02-17,Egypt,0,0,1,0
2020-02-18,Egypt,0,0,1,0
2020-02-19,Egypt,0,0,1,0
2020-02-20,Egypt,0,0,1,0
2020-02-21,Egypt,0,0,1,0
2020-02-22,Egypt,0,0,1,0
2020-02-23,Egypt,0,0,1,0
2020-02-24,Egypt,0,0,1,0
2020-02-25,Egypt,0,0,1,0
2020-02-26,Egypt,0,0,1,0
2020-02-27,Egypt,0,0,1,0
2020-02-28,Egypt,0,0,1,0
2020-02-29,Egypt,0,0,1,0
2020-03-01,Egypt,1,0,2,0
2020-03-02,Egypt,0,0,2,0
2020-03-03,Egypt,0,0,2,0
2020-03-04,Egypt,0,0,2,0
2020-03-05,Egypt,1,0,3,0
2020-03-06,Egypt,12,0,15,0
2020-03-07,Egypt,0,0,15,0
2020-03-08,Egypt,34,1,49,1
2020-03-09,Egypt,6,0,55,1
2020-03-10,Egypt,4,0,59,1
2020-03-11,Egypt,1,0,60,1
2020-03-12,Egypt,7,0,67,1
2020-03-13,Egypt,13,1,80,2
2020-03-14,Egypt,29,0,109,2
2020-03-15,Egypt,1,0,110,2
2020-03-16,Egypt,40,0,150,2
2020-03-17,Egypt,46,2,196,4
2020-03-18,Egypt,0,2,196,6
2020-03-19,Egypt,60,0,256,6
2020-03-20,Egypt,29,2,285,8
2020-03-21,Egypt,9,2,294,10
2020-03-22,Egypt,33,4,327,14
2020-03-23,Egypt,39,5,366,19
2020-03-24,Egypt,36,1,402,20
2020-03-25,Egypt,54,1,456,21
2020-03-26,Egypt,39,3,495,24
2020-03-27,Egypt,41,6,536,30
2020-03-28,Egypt,40,6,576,36
2020-03-29,Egypt,33,4,609,40
2020-03-30,Egypt,47,1,656,41
2020-03-31,Egypt,54,5,710,46
2020-04-01,Egypt,69,6,779,52
2020-04-02,Egypt,86,6,865,58
2020-04-03,Egypt,120,8,985,66
2020-04-04,Egypt,85,5,1070,71
2020-04-05,Egypt,103,7,1173,78
2020-04-06,Egypt,149,7,1322,85
2020-04-07,Egypt,128,9,1450,94
2020-04-08,Egypt,110,9,1560,103
2020-04-09,Egypt,139,15,1699,118
2020-04-10,Egypt,95,17,1794,135
2020-04-11,Egypt,145,11,1939,146
2020-04-12,Egypt,126,13,2065,159
2020-04-13,Egypt,125,5,2190,164
2020-04-14,Egypt,160,14,2350,178
2020-04-15,Egypt,155,5,2505,183
2020-04-16,Egypt,168,13,2673,196
2020-04-17,Egypt,171,9,2844,205
2020-04-18,Egypt,188,19,3032,224
2020-04-19,Egypt,112,15,3144,239
2020-04-20,Egypt,189,11,3333,250
2020-04-21,Egypt,157,14,3490,264
2020-04-22,Egypt,169,12,3659,276
2020-04-23,Egypt,232,11,3891,287
2020-04-24,Egypt,201,7,4092,294
2020-04-25,Egypt,227,13,4319,307
2020-04-26,Egypt,215,10,4534,317
2020-04-27,Egypt,248,20,4782,337
2020-04-28,Egypt,260,22,5042,359
2020-04-29,Egypt,226,21,5268,380
2020-04-30,Egypt,269,12,5537,392
2020-05-01,Egypt,358,14,5895,406
2020-05-02,Egypt,298,9,6193,415
2020-05-03,Egypt,272,14,6465,429
2020-05-04,Egypt,348,7,6813,436
2020-05-05,Egypt,388,16,7201,452
2020-05-06,Egypt,387,17,7588,469
2020-05-07,Egypt,393,13,7981,482
2020-05-08,Egypt,495,21,8476,503
2020-05-09,Egypt,488,11,8964,514
2020-05-10,Egypt,436,11,9400,525
2020-05-11,Egypt,346,8,9746,533
2020-05-12,Egypt,347,11,10093,544
2020-05-13,Egypt,338,12,10431,556
2020-05-14,Egypt,398,15,10829,571
2020-05-15,Egypt,399,21,11228,592
2020-05-16,Egypt,491,20,11719,612
2020-05-17,Egypt,510,18,12229,630
2020-05-18,Egypt,535,15,12764,645
2020-05-19,Egypt,720,14,13484,659
2020-05-20,Egypt,745,21,14229,680
2020-05-21,Egypt,774,16,15003,696
2020-05-22,Egypt,783,11,15786,707
2020-05-23,Egypt,727,28,16513,735
2020-05-24,Egypt,752,29,17265,764
2020-05-25,Egypt,702,19,17967,783
2020-05-26,Egypt,789,14,18756,797
2020-05-27,Egypt,910,19,19666,816
2020-05-28,Egypt,1127,29,20793,845
2020-05-29,Egypt,1289,34,22082,879
2020-05-30,Egypt,1367,34,23449,913
2020-05-31,Egypt,1536,46,24985,959
2020-06-01,Egypt,1399,46,26384,1005
2020-06-02,Egypt,1152,47,27536,1052
2020-06-03,Egypt,1079,36,28615,1088
2020-06-04,Egypt,1152,38,29767,1126
2020-06-05,Egypt,1348,40,31115,1166
2020-06-06,Egypt,1497,32,32612,1198
2020-06-07,Egypt,1467,39,34079,1237
2020-06-08,Egypt,1365,34,35444,1271
2020-06-09,Egypt,1385,35,36829,1306
2020-06-10,Egypt,1455,36,38284,1342
2020-06-11,Egypt,1442,35,39726,1377
2020-06-12,Egypt,1577,45,41303,1422
2020-06-13,Egypt,1677,62,42980,1484
2020-06-14,Egypt,1618,91,44598,1575
2020-06-15,Egypt,1691,97,46289,1672
2020-06-16,Egypt,1567,94,47856,1766
2020-06-17,Egypt,1363,84,49219,1850
2020-06-18,Egypt,1218,88,50437,1938
2020-06-19,Egypt,1774,79,52211,2017
2020-06-20,Egypt,1547,89,53758,2106
2020-06-21,Egypt,1475,87,55233,2193
2020-06-22,Egypt,1576,85,56809,2278
2020-06-23,Egypt,1332,87,58141,2365
2020-06-24,Egypt,1420,85,59561,2450
2020-06-25,Egypt,1569,83,61130,2533
2020-06-26,Egypt,1625,87,62755,2620
2020-06-27,Egypt,1168,88,63923,2708
2020-06-28,Egypt,1265,81,65188,2789
2020-06-29,Egypt,1566,83,66754,2872
2020-06-30,Egypt,1557,81,68311,2953
2020-07-01,Egypt,1503,81,69814,3034
2020-07-02,Egypt,1485,86,71299,3120
2020-07-03,Egypt,1412,81,72711,3201
2020-07-04,Egypt,1324,79,74035,3280
2020-07-05,Egypt,1218,63,75253,3343
2020-07-06,Egypt,969,79,76222,3422
2020-07-07,Egypt,1057,67,77279,3489
2020-07-08,Egypt,1025,75,78304,3564
2020-07-09,Egypt,950,53,79254,3617
2020-07-10,Egypt,981,85,80235,3702
2020-07-11,Egypt,923,67,81158,3769
2020-07-12,Egypt,912,89,82070,3858
2020-07-13,Egypt,931,77,83001,3935
2020-07-14,Egypt,929,73,83930,4008
2020-07-15,Egypt,913,59,84843,4067
2020-07-16,Egypt,928,53,85771,4120
2020-07-17,Egypt,703,68,86474,4188
2020-07-18,Egypt,698,63,87172,4251
2020-07-19,Egypt,603,51,87775,4302
2020-07-20,Egypt,627,50,88402,4352
2020-07-21,Egypt,676,47,89078,4399
2020-07-22,Egypt,667,41,89745,4440
2020-07-23,Egypt,668,40,90413,4480
2020-07-24,Egypt,659,38,91072,4518
2020-07-25,Egypt,511,40,91583,4558
2020-07-26,Egypt,479,48,92062,4606
2020-07-27,Egypt,420,46,92482,4652
2020-07-28,Egypt,465,39,92947,4691
2020-07-29,Egypt,409,37,93356,4728
2020-07-30,Egypt,401,46,93757,4774
2020-07-31,Egypt,321,31,94078,4805
2020-08-01,Egypt,238,29,94316,4834
2020-08-02,Egypt,167,31,94483,4865
2020-08-03,Egypt,157,23,94640,4888
2020-08-04,Egypt,112,24,94752,4912
2020-08-05,Egypt,123,18,94875,4930
2020-08-06,Egypt,131,21,95006,4951
2020-08-07,Egypt,141,20,95147,4971
2020-08-08,Egypt,167,21,95314,4992
2020-08-09,Egypt,178,17,95492,5009
2020-08-10,Egypt,174,26,95666,5035
2020-08-11,Egypt,168,24,95834,5059
2020-08-12,Egypt,129,26,95963,5085
2020-08-13,Egypt,145,22,96108,5107
2020-08-14,Egypt,112,17,96220,5124
2020-08-15,Egypt,116,17,96336,5141
2020-08-16,Egypt,139,19,96475,5160
2020-08-17,Egypt,115,13,96590,5173
2020-08-18,Egypt,163,11,96753,5184
2020-08-19,Egypt,161,13,96914,5197
2020-08-20,Egypt,111,15,97025,5212
2020-08-21,Egypt,123,19,97148,5231
2020-08-22,Egypt,89,12,97237,5243
2020-08-23,Egypt,103,19,97340,5262
2020-08-24,Egypt,138,18,97478,5280
2020-08-25,Egypt,141,18,97619,5298
2020-08-26,Egypt,206,19,97825,5317
2020-08-27,Egypt,237,25,98062,5342
2020-08-28,Egypt,223,20,98285,5362
2020-08-29,Egypt,212,14,98497,5376
2020-08-30,Egypt,230,23,98727,5399
2020-08-31,Egypt,212,22,98939,5421
2020-09-01,Egypt,176,19,99115,5440
2020-09-02,Egypt,165,21,99280,5461
2020-09-03,Egypt,145,18,99425,5479
2020-09-04,Egypt,157,16,99582,5495
2020-09-05,Egypt,130,16,99712,5511
2020-09-06,Egypt,151,19,99863,5530
2020-09-07,Egypt,178,11,100041,5541
2020-09-08,Egypt,187,19,100228,5560
2020-09-09,Egypt,175,17,100403,5577
2020-09-10,Egypt,154,13,100557,5590
2020-09-11,Egypt,151,17,100708,5607
2020-09-12,Egypt,148,20,100856,5627
2020-09-13,Egypt,153,21,101009,5648
2020-09-14,Egypt,168,13,101177,5661
2020-09-15,Egypt,163,18,101340,5679
2020-09-16,Egypt,160,17,101500,5696
2020-09-17,Egypt,141,19,101641,5715
2020-09-18,Egypt,131,18,101772,5733
2020-09-19,Egypt,128,17,101900,5750
2020-09-20,Egypt,115,20,102015,5770
2020-09-21,Egypt,126,17,102141,5787
2020-09-22,Egypt,113,19,102254,5806
2020-09-23,Egypt,121,16,102375,5822
2020-09-24,Egypt,138,13,102513,5835
2020-09-25,Egypt,112,18,102625,5853
2020-09-26,Egypt,111,16,102736,5869
2020-09-27,Egypt,104,14,102840,5883
2020-09-28,Egypt,115,18,102955,5901
2020-09-29,Egypt,124,13,103079,5914
2020-09-30,Egypt,119,16,103198,5930
2020-10-01,Egypt,119,16,103317,5946
2020-10-02,Egypt,149,10,103466,5956
2020-10-03,Egypt,109,14,103575,5970
2020-10-04,Egypt,108,11,103683,5981
2020-10-05,Egypt,98,9,103781,5990
2020-10-06,Egypt,121,11,103902,6001
2020-10-07,Egypt,133,9,104035,6010
2020-10-08,Egypt,121,7,104156,6017
2020-10-09,Egypt,106,12,104262,6029
2020-10-10,Egypt,125,11,104387,6040
2020-10-11,Egypt,129,12,104516,6052
2020-10-12,Egypt,132,10,104648,6062
2020-10-13,Egypt,139,9,104787,6071
2020-10-14,Egypt,128,6,104915,6077
2020-10-15,Egypt,118,11,105033,6088
2020-10-16,Egypt,126,11,105159,6099
2020-10-17,Egypt,138,10,105297,6109
2020-10-18,Egypt,127,11,105424,6120
2020-10-19,Egypt,123,10,105547,6130
2020-10-20,Egypt,158,12,105705,6142
2020-10-21,Egypt,178,13,105883,6155
2020-10-22,Egypt,177,11,106060,6166
2020-10-23,Egypt,170,10,106230,6176
2020-10-24,Egypt,167,11,106397,6187
2020-10-25,Egypt,143,12,106540,6199
2020-10-26,Egypt,167,12,106707,6211
2020-10-27,Egypt,170,11,106877,6222
2020-10-28,Egypt,153,12,107030,6234
2020-10-29,Egypt,179,13,107209,6247
2020-10-30,Egypt,167,11,107376,6258
2020-10-31,Egypt,179,8,107555,6266
2020-11-01,Egypt,181,12,107736,6278
2020-11-02,Egypt,189,13,107925,6291
2020-11-03,Egypt,197,14,108122,6305
2020-11-04,Egypt,207,13,108329,6318
2020-11-05,Egypt,201,11,108530,6329
2020-11-06,Egypt,224,14,108754,6343
2020-11-07,Egypt,208,12,108962,6355
2020-11-08,Egypt,239,13,109201,6368
2020-11-09,Egypt,221,12,109422,6380
2020-11-10,Egypt,232,14,109654,6394
2020-11-11,Egypt,227,11,109881,6405
2020-11-12,Egypt,214,12,110095,6417
2020-11-13,Egypt,224,12,110319,6429
2020-11-14,Egypt,228,13,110547,6442
2020-11-15,Egypt,220,11,110767,6453
2020-11-16,Egypt,242,12,111009,6465
2020-11-17,Egypt,275,16,111284,6481
2020-11-18,Egypt,329,14,111613,6495
2020-11-19,Egypt,342,13,111955,6508
2020-11-20,Egypt,363,13,112318,6521
2020-11-21,Egypt,358,14,112676,6535
2020-11-22,Egypt,351,13,113027,6548
2020-11-23,Egypt,354,12,113381,6560
2020-11-24,Egypt,361,13,113742,6573
2020-11-25,Egypt,365,12,114107,6585
2020-11-26,Egypt,368,11,114475,6596
2020-11-27,Egypt,357,12,114832,6608
2020-11-28,Egypt,351,13,115183,6621
2020-11-29,Egypt,358,15,115541,6636
2020-11-30,Egypt,370,14,115911,6650
2020-12-01,Egypt,392,16,116303,6666
2020-12-02,Egypt,421,28,116724,6694
2020-12-03,Egypt,432,19,117156,6713
2020-12-04,Egypt,427,19,117583,6732
2020-12-05,Egypt,431,18,118014,6750
2020-12-06,Egypt,418,21,118432,6771
2020-12-07,Egypt,415,19,118847,6790
2020-12-08,Egypt,434,23,119281,6813
2020-12-09,Egypt,421,19,119702,6832
2020-12-10,Egypt,445,22,120147,6854
2020-12-11,Egypt,464,23,120611,6877
2020-12-12,Egypt,478,21,121089,6898
2020-12-13,Egypt,486,22,121575,6920
2020-12-14,Egypt,511,23,122086,6943
2020-12-15,Egypt,523,23,122609,6966
2020-12-16,Egypt,544,24,123153,6990
2020-12-17,Egypt,548,25,123701,7015
2020-12-18,Egypt,579,26,124280,7041
2020-12-19,Egypt,611,28,124891,7069
2020-12-20,Egypt,664,29,125555,7098
2020-12-21,Egypt,718,32,126273,7130
2020-12-22,Egypt,788,37,127061,7167
2020-12-23,Egypt,911,42,127972,7209
2020-12-24,Egypt,1021,51,128993,7260
2020-12-25,Egypt,1133,49,130126,7309
2020-12-26,Egypt,1189,43,131315,7352
2020-12-27,Egypt,1226,53,132541,7405
2020-12-28,Egypt,1359,61,133900,7466
2020-12-29,Egypt,1333,54,135233,7520
2020-12-30,Egypt,1411,56,136644,7576
2020-12-31,Egypt,1418,55,138062,7631
2021-01-01,Egypt,1409,56,139471,7687
2021-01-02,Egypt,1407,54,140878,7741
2021-01-03,Egypt,1309,64,142187,7805
2021-01-04,Egypt,1277,58,143464,7863
2021-01-05,Egypt,1119,55,144583,7918
2021-01-06,Egypt,1007,57,145590,7975
2021-01-07,Egypt,1219,54,146809,8029
2021-01-08,Egypt,1001,56,147810,8085
2021-01-09,Egypt,989,57,148799,8142
2021-01-10,Egypt,993,55,149792,8197
2021-01-11,Egypt,961,52,150753,8249
2021-01-12,Egypt,970,55,151723,8304
2021-01-13,Egypt,996,58,152719,8362
2021-01-14,Egypt,1022,59,153741,8421
2021-01-15,Egypt,879,52,154620,8473
2021-01-16,Egypt,887,54,155507,8527
2021-01-17,Egypt,890,56,156397,8583
2021-01-18,Egypt,878,55,157275,8638
2021-01-19,Egypt,899,58,158174,8696
2021-01-20,Egypt,789,51,158963,8747
2021-01-21,Egypt,752,54,159715,8801
2021-01-22,Egypt,748,52,160463,8853
2021-01-23,Egypt,680,49,161143,8902
2021-01-24,Egypt,674,57,161817,8959
2021-01-25,Egypt,669,53,162486,9012
2021-01-26,Egypt,643,55,163129,9067
2021-01-27,Egypt,632,48,163761,9115
2021-01-28,Egypt,521,54,164282,9169
2021-01-29,Egypt,589,48,164871,9217
2021-01-30,Egypt,547,46,165418,9263
2021-01-31,Egypt,533,53,165951,9316
2021-02-01,Egypt,541,44,166492,9360
2021-02-02,Egypt,521,47,167013,9407
2021-02-03,Egypt,512,53,167525,9460
2021-02-04,Egypt,532,52,168057,9512
2021-02-05,Egypt,540,48,168597,9560
2021-02-06,Egypt,509,44,169106,9604
2021-02-07,Egypt,534,47,169640,9651
2021-02-08,Egypt,567,48,170207,9699
2021-02-09,Egypt,573,52,170780,9751
2021-02-10,Egypt,610,53,171390,9804
2021-02-11,Egypt,603,53,171993,9857
2021-02-12,Egypt,609,42,172602,9899
2021-02-13,Egypt,600,36,173202,9935
2021-02-14,Egypt,611,59,173813,9994
2021-02-15,Egypt,613,56,174426,10050
2021-02-16,Egypt,633,51,175059,10101
2021-02-17,Egypt,618,49,175677,10150
2021-02-18,Egypt,656,51,176333,10201
2021-02-19,Egypt,610,49,176943,10250
2021-02-20,Egypt,600,48,177543,10298
2021-02-21,Egypt,608,55,178151,10353
2021-02-22,Egypt,623,51,178774,10404
2021-02-23,Egypt,633,39,179407,10443
2021-02-24,Egypt,644,52,180051,10495
2021-02-25,Egypt,589,46,180640,10541
2021-02-26,Egypt,601,49,181241,10590
2021-02-27,Egypt,588,49,181829,10639
2021-02-28,Egypt,595,49,182424,10688
2021-03-01,Egypt,586,48,183010,10736
2021-03-02,Egypt,581,42,183591,10778
2021-03-03,Egypt,577,44,184168,10822
2021-03-04,Egypt,587,49,184755,10871
2021-03-05,Egypt,579,45,185334,10916
2021-03-06,Egypt,588,38,185922,10954
2021-03-07,Egypt,581,41,186503,10995
2021-03-08,Egypt,591,43,187094,11038
2021-03-09,Egypt,622,44,187716,11082
2021-03-10,Egypt,645,46,188361,11128
2021-03-11,Egypt,639,41,189000,11169
2021-03-12,Egypt,639,45,189639,11214
2021-03-13,Egypt,641,42,190280,11256
2021-03-14,Egypt,644,44,190924,11300
2021-03-15,Egypt,631,40,191555,11340
2021-03-16,Egypt,640,44,192195,11384
2021-03-17,Egypt,645,47,192840,11431
2021-03-18,Egypt,642,41,193482,11472
2021-03-19,Egypt,645,40,194127,11512
2021-03-20,Egypt,644,45,194771,11557
2021-03-21,Egypt,647,41,195418,11598
2021-03-22,Egypt,643,39,196061,11637
2021-03-23,Egypt,648,43,196709,11680
2021-03-24,Egypt,641,40,197350,11720
2021-03-25,Egypt,661,48,198011,11768
2021-03-26,Egypt,670,36,198681,11804
2021-03-27,Egypt,683,41,199364,11845
2021-03-28,Egypt,686,37,200050,11882
2021-03-29,Egypt,689,32,200739,11914
2021-03-30,Egypt,693,42,201432,11956
2021-03-31,Egypt,699,39,202131,11995
2021-04-01,Egypt,712,46,202843,12041
2021-04-02,Egypt,703,43,203546,12084
2021-04-03,Egypt,710,39,204256,12123
2021-04-04,Egypt,709,40,204965,12163
2021-04-05,Egypt,767,47,205732,12210
2021-04-06,Egypt,778,43,206510,12253
2021-04-07,Egypt,783,37,207293,12290
2021-04-08,Egypt,789,33,208082,12323
2020-03-19,El Salvador,1,0,1,0
2020-03-20,El Salvador,0,0,1,0
2020-03-21,El Salvador,2,0,3,0
2020-03-22,El Salvador,0,0,3,0
2020-03-23,El Salvador,0,0,3,0
2020-03-24,El Salvador,2,0,5,0
2020-03-25,El Salvador,4,0,9,0
2020-03-26,El Salvador,4,0,13,0
2020-03-27,El Salvador,0,0,13,0
2020-03-28,El Salvador,6,0,19,0
2020-03-29,El Salvador,5,0,24,0
2020-03-30,El Salvador,6,0,30,0
2020-03-31,El Salvador,2,1,32,1
2020-04-01,El Salvador,0,0,32,1
2020-04-02,El Salvador,9,1,41,2
2020-04-03,El Salvador,5,0,46,2
2020-04-04,El Salvador,10,1,56,3
2020-04-05,El Salvador,6,0,62,3
2020-04-06,El Salvador,7,1,69,4
2020-04-07,El Salvador,9,0,78,4
2020-04-08,El Salvador,15,1,93,5
2020-04-09,El Salvador,10,1,103,6
2020-04-10,El Salvador,14,0,117,6
2020-04-11,El Salvador,1,0,118,6
2020-04-12,El Salvador,7,0,125,6
2020-04-13,El Salvador,12,0,137,6
2020-04-14,El Salvador,12,0,149,6
2020-04-15,El Salvador,10,0,159,6
2020-04-16,El Salvador,5,0,164,6
2020-04-17,El Salvador,13,1,177,7
2020-04-18,El Salvador,13,0,190,7
2020-04-19,El Salvador,11,0,201,7
2020-04-20,El Salvador,17,0,218,7
2020-04-21,El Salvador,7,0,225,7
2020-04-22,El Salvador,12,0,237,7
2020-04-23,El Salvador,13,1,250,8
2020-04-24,El Salvador,24,0,274,8
2020-04-25,El Salvador,0,0,274,8
2020-04-26,El Salvador,24,0,298,8
2020-04-27,El Salvador,25,0,323,8
2020-04-28,El Salvador,22,0,345,8
2020-04-29,El Salvador,32,1,377,9
2020-04-30,El Salvador,18,1,395,10
2020-05-01,El Salvador,29,0,424,10
2020-05-02,El Salvador,22,1,446,11
2020-05-03,El Salvador,44,0,490,11
2020-05-04,El Salvador,65,2,555,13
2020-05-05,El Salvador,32,1,587,14
2020-05-06,El Salvador,46,1,633,15
2020-05-07,El Salvador,62,0,695,15
2020-05-08,El Salvador,47,1,742,16
2020-05-09,El Salvador,42,1,784,17
2020-05-10,El Salvador,105,0,889,17
2020-05-11,El Salvador,69,1,958,18
2020-05-12,El Salvador,40,2,998,20
2020-05-13,El Salvador,39,0,1037,20
2020-05-14,El Salvador,75,3,1112,23
2020-05-15,El Salvador,98,2,1210,25
2020-05-16,El Salvador,55,1,1265,26
2020-05-17,El Salvador,73,4,1338,30
2020-05-18,El Salvador,75,0,1413,30
2020-05-19,El Salvador,85,0,1498,30
2020-05-20,El Salvador,73,1,1571,31
2020-05-21,El Salvador,69,2,1640,33
2020-05-22,El Salvador,85,0,1725,33
2020-05-23,El Salvador,94,0,1819,33
2020-05-24,El Salvador,96,2,1915,35
2020-05-25,El Salvador,68,0,1983,35
2020-05-26,El Salvador,59,1,2042,36
2020-05-27,El Salvador,67,3,2109,39
2020-05-28,El Salvador,85,0,2194,39
2020-05-29,El Salvador,84,3,2278,42
2020-05-30,El Salvador,117,4,2395,46
2020-05-31,El Salvador,122,0,2517,46
2020-06-01,El Salvador,65,0,2582,46
2020-06-02,El Salvador,71,3,2653,49
2020-06-03,El Salvador,52,2,2705,51
2020-06-04,El Salvador,76,1,2781,52
2020-06-05,El Salvador,68,1,2849,53
2020-06-06,El Salvador,85,0,2934,53
2020-06-07,El Salvador,81,0,3015,53
2020-06-08,El Salvador,89,3,3104,56
2020-06-09,El Salvador,87,4,3191,60
2020-06-10,El Salvador,83,4,3274,64
2020-06-11,El Salvador,99,4,3373,68
2020-06-12,El Salvador,108,0,3481,68
2020-06-13,El Salvador,122,4,3603,72
2020-06-14,El Salvador,117,2,3720,74
2020-06-15,El Salvador,106,0,3826,74
2020-06-16,El Salvador,115,2,3941,76
2020-06-17,El Salvador,125,3,4066,79
2020-06-18,El Salvador,134,3,4200,82
2020-06-19,El Salvador,129,4,4329,86
2020-06-20,El Salvador,146,7,4475,93
2020-06-21,El Salvador,151,5,4626,98
2020-06-22,El Salvador,182,9,4808,107
2020-06-23,El Salvador,165,6,4973,113
2020-06-24,El Salvador,177,6,5150,119
2020-06-25,El Salvador,186,7,5336,126
2020-06-26,El Salvador,181,7,5517,133
2020-06-27,El Salvador,210,10,5727,143
2020-06-28,El Salvador,207,9,5934,152
2020-06-29,El Salvador,239,12,6173,164
2020-06-30,El Salvador,265,10,6438,174
2020-07-01,El Salvador,298,8,6736,182
2020-07-02,El Salvador,264,9,7000,191
2020-07-03,El Salvador,267,11,7267,202
2020-07-04,El Salvador,240,8,7507,210
2020-07-05,El Salvador,270,7,7777,217
2020-07-06,El Salvador,250,6,8027,223
2020-07-07,El Salvador,280,6,8307,229
2020-07-08,El Salvador,259,6,8566,235
2020-07-09,El Salvador,278,8,8844,243
2020-07-10,El Salvador,298,6,9142,249
2020-07-11,El Salvador,249,5,9391,254
2020-07-12,El Salvador,283,6,9674,260
2020-07-13,El Salvador,304,7,9978,267
2020-07-14,El Salvador,325,11,10303,278
2020-07-15,El Salvador,342,8,10645,286
2020-07-16,El Salvador,312,12,10957,298
2020-07-17,El Salvador,250,11,11207,309
2020-07-18,El Salvador,301,15,11508,324
2020-07-19,El Salvador,338,11,11846,335
2020-07-20,El Salvador,361,9,12207,344
2020-07-21,El Salvador,375,8,12582,352
2020-07-22,El Salvador,393,11,12975,363
2020-07-23,El Salvador,402,9,13377,372
2020-07-24,El Salvador,415,7,13792,379
2020-07-25,El Salvador,429,11,14221,390
2020-07-26,El Salvador,409,10,14630,400
2020-07-27,El Salvador,405,8,15035,408
2020-07-28,El Salvador,411,9,15446,417
2020-07-29,El Salvador,395,13,15841,430
2020-07-30,El Salvador,389,9,16230,439
2020-07-31,El Salvador,402,9,16632,448
2020-08-01,El Salvador,418,11,17050,459
2020-08-02,El Salvador,398,8,17448,467
2020-08-03,El Salvador,395,10,17843,477
2020-08-04,El Salvador,419,9,18262,486
2020-08-05,El Salvador,439,12,18701,498
2020-08-06,El Salvador,425,15,19126,513
2020-08-07,El Salvador,418,7,19544,520
2020-08-08,El Salvador,434,16,19978,536
2020-08-09,El Salvador,445,13,20423,549
2020-08-10,El Salvador,449,14,20872,563
2020-08-11,El Salvador,397,7,21269,570
2020-08-12,El Salvador,375,7,21644,577
2020-08-13,El Salvador,349,7,21993,584
2020-08-14,El Salvador,321,11,22314,595
2020-08-15,El Salvador,305,8,22619,603
2020-08-16,El Salvador,293,9,22912,612
2020-08-17,El Salvador,281,6,23193,618
2020-08-18,El Salvador,269,7,23462,625
2020-08-19,El Salvador,255,8,23717,633
2020-08-20,El Salvador,247,7,23964,640
2020-08-21,El Salvador,236,6,24200,646
2020-08-22,El Salvador,220,8,24420,654
2020-08-23,El Salvador,202,7,24622,661
2020-08-24,El Salvador,189,8,24811,669
2020-08-25,El Salvador,175,9,24986,678
2020-08-26,El Salvador,154,9,25140,687
2020-08-27,El Salvador,144,7,25284,694
2020-08-28,El Salvador,131,8,25415,702
2020-08-29,El Salvador,122,6,25537,708
2020-08-30,El Salvador,98,5,25635,713
2020-08-31,El Salvador,94,4,25729,717
2020-09-01,El Salvador,91,7,25820,724
2020-09-02,El Salvador,84,7,25904,731
2020-09-03,El Salvador,96,8,26000,739
2020-09-04,El Salvador,99,5,26099,744
2020-09-05,El Salvador,107,8,26206,752
2020-09-06,El Salvador,102,7,26308,759
2020-09-07,El Salvador,105,5,26413,764
2020-09-08,El Salvador,98,1,26511,765
2020-09-09,El Salvador,91,5,26602,770
2020-09-10,El Salvador,86,4,26688,774
2020-09-11,El Salvador,85,3,26773,777
2020-09-12,El Salvador,78,5,26851,782
2020-09-13,El Salvador,77,3,26928,785
2020-09-14,El Salvador,81,3,27009,788
2020-09-15,El Salvador,79,4,27088,792
2020-09-16,El Salvador,75,4,27163,796
2020-09-17,El Salvador,86,5,27249,801
2020-09-18,El Salvador,97,3,27346,804
2020-09-19,El Salvador,82,4,27428,808
2020-09-20,El Salvador,125,3,27553,811
2020-09-21,El Salvador,245,1,27798,812
2020-09-22,El Salvador,156,2,27954,814
2020-09-23,El Salvador,247,5,28201,819
2020-09-24,El Salvador,214,4,28415,823
2020-09-25,El Salvador,215,3,28630,826
2020-09-26,El Salvador,92,0,28722,826
2020-09-27,El Salvador,-92,0,28630,826
2020-09-28,El Salvador,179,5,28809,831
2020-09-29,El Salvador,172,8,28981,839
2020-09-30,El Salvador,96,4,29077,843
2020-10-01,El Salvador,98,5,29175,848
2020-10-02,El Salvador,94,5,29269,853
2020-10-03,El Salvador,89,4,29358,857
2020-10-04,El Salvador,92,6,29450,863
2020-10-05,El Salvador,89,2,29539,865
2020-10-06,El Salvador,95,4,29634,869
2020-10-07,El Salvador,103,4,29737,873
2020-10-08,El Salvador,105,4,29842,877
2020-10-09,El Salvador,109,4,29951,881
2020-10-10,El Salvador,119,6,30070,887
2020-10-11,El Salvador,126,3,30196,890
2020-10-12,El Salvador,139,4,30335,894
2020-10-13,El Salvador,145,5,30480,899
2020-10-14,El Salvador,286,5,30766,904
2020-10-15,El Salvador,295,4,31061,908
2020-10-16,El Salvador,204,4,31265,912
2020-10-17,El Salvador,191,5,31456,917
2020-10-18,El Salvador,210,5,31666,922
2020-10-19,El Salvador,160,4,31826,926
2020-10-20,El Salvador,149,3,31975,929
2020-10-21,El Salvador,145,4,32120,933
2020-10-22,El Salvador,142,3,32262,936
2020-10-23,El Salvador,159,4,32421,940
2020-10-24,El Salvador,164,4,32585,944
2020-10-25,El Salvador,167,5,32752,949
2020-10-26,El Salvador,173,4,32925,953
2020-10-27,El Salvador,165,4,33090,957
2020-10-28,El Salvador,174,5,33264,962
2020-10-29,El Salvador,181,5,33445,967
2020-10-30,El Salvador,186,4,33631,971
2020-10-31,El Salvador,195,4,33826,975
2020-11-01,El Salvador,189,4,34015,979
2020-11-02,El Salvador,199,4,34214,983
2020-11-03,El Salvador,190,4,34404,987
2020-11-04,El Salvador,173,5,34577,992
2020-11-05,El Salvador,205,5,34782,997
2020-11-06,El Salvador,184,5,34966,1002
2020-11-07,El Salvador,179,4,35145,1006
2020-11-08,El Salvador,181,4,35326,1010
2020-11-09,El Salvador,183,4,35509,1014
2020-11-10,El Salvador,175,6,35684,1020
2020-11-11,El Salvador,178,4,35862,1024
2020-11-12,El Salvador,168,4,36030,1028
2020-11-13,El Salvador,165,5,36195,1033
2020-11-14,El Salvador,163,6,36358,1039
2020-11-15,El Salvador,158,5,36516,1044
2020-11-16,El Salvador,153,3,36669,1047
2020-11-17,El Salvador,150,5,36819,1052
2020-11-18,El Salvador,146,4,36965,1056
2020-11-19,El Salvador,144,5,37109,1061
2020-11-20,El Salvador,141,3,37250,1064
2020-11-21,El Salvador,154,6,37404,1070
2020-11-22,El Salvador,158,5,37562,1075
2020-11-23,El Salvador,157,6,37719,1081
2020-11-24,El Salvador,165,5,37884,1086
2020-11-25,El Salvador,174,0,38058,1086
2020-11-26,El Salvador,170,12,38228,1098
2020-11-27,El Salvador,177,4,38405,1102
2020-11-28,El Salvador,181,5,38586,1107
2020-11-29,El Salvador,172,4,38758,1111
2020-11-30,El Salvador,183,3,38941,1114
2020-12-01,El Salvador,189,6,39130,1120
2020-12-02,El Salvador,197,9,39327,1129
2020-12-03,El Salvador,188,5,39515,1134
2020-12-04,El Salvador,203,8,39718,1142
2020-12-05,El Salvador,212,11,39930,1153
2020-12-06,El Salvador,201,6,40131,1159
2020-12-07,El Salvador,214,5,40345,1164
2020-12-08,El Salvador,206,4,40551,1168
2020-12-09,El Salvador,190,6,40741,1174
2020-12-10,El Salvador,205,6,40946,1180
2020-12-11,El Salvador,217,6,41163,1186
2020-12-12,El Salvador,231,7,41394,1193
2020-12-13,El Salvador,237,7,41631,1200
2020-12-14,El Salvador,249,5,41880,1205
2020-12-15,El Salvador,252,7,42132,1212
2020-12-16,El Salvador,265,7,42397,1219
2020-12-17,El Salvador,244,8,42641,1227
2020-12-18,El Salvador,273,7,42914,1234
2020-12-19,El Salvador,281,8,43195,1242
2020-12-20,El Salvador,282,8,43477,1250
2020-12-21,El Salvador,295,7,43772,1257
2020-12-22,El Salvador,286,8,44058,1265
2020-12-23,El Salvador,270,9,44328,1274
2020-12-24,El Salvador,291,9,44619,1283
2020-12-25,El Salvador,273,6,44892,1289
2020-12-26,El Salvador,0,8,44892,1297
2020-12-27,El Salvador,265,8,45157,1305
2020-12-28,El Salvador,258,8,45415,1313
2020-12-29,El Salvador,269,0,45684,1313
2020-12-30,El Salvador,276,14,45960,1327
2020-12-31,El Salvador,282,0,46242,1327
2021-01-01,El Salvador,273,0,46515,1327
2021-01-02,El Salvador,288,0,46803,1327
2021-01-03,El Salvador,0,31,46803,1358
2021-01-04,El Salvador,284,6,47087,1364
2021-01-05,El Salvador,268,9,47355,1373
2021-01-06,El Salvador,290,9,47645,1382
2021-01-07,El Salvador,303,8,47948,1390
2021-01-08,El Salvador,307,8,48255,1398
2021-01-09,El Salvador,319,10,48574,1408
2021-01-10,El Salvador,331,11,48905,1419
2021-01-11,El Salvador,319,9,49224,1428
2021-01-12,El Salvador,315,9,49539,1437
2021-01-13,El Salvador,320,10,49859,1447
2021-01-14,El Salvador,298,12,50157,1459
2021-01-15,El Salvador,310,10,50467,1469
2021-01-16,El Salvador,317,10,50784,1479
2021-01-17,El Salvador,323,8,51107,1487
2021-01-18,El Salvador,330,11,51437,1498
2021-01-19,El Salvador,335,11,51772,1509
2021-01-20,El Salvador,322,12,52094,1521
2021-01-21,El Salvador,294,9,52388,1530
2021-01-22,El Salvador,284,10,52672,1540
2021-01-23,El Salvador,277,11,52949,1551
2021-01-24,El Salvador,269,10,53218,1561
2021-01-25,El Salvador,261,11,53479,1572
2021-01-26,El Salvador,259,11,53738,1583
2021-01-27,El Salvador,251,6,53989,1589
2021-01-28,El Salvador,252,10,54241,1599
2021-01-29,El Salvador,247,5,54488,1604
2021-01-30,El Salvador,235,10,54723,1614
2021-01-31,El Salvador,243,9,54966,1623
2021-02-01,El Salvador,229,9,55195,1632
2021-02-02,El Salvador,221,6,55416,1638
2021-02-03,El Salvador,207,8,55623,1646
2021-02-04,El Salvador,198,7,55821,1653
2021-02-05,El Salvador,204,9,56025,1662
2021-02-06,El Salvador,212,11,56237,1673
2021-02-07,El Salvador,205,8,56442,1681
2021-02-08,El Salvador,211,11,56653,1692
2021-02-09,El Salvador,206,9,56859,1701
2021-02-10,El Salvador,187,8,57046,1709
2021-02-11,El Salvador,183,10,57229,1719
2021-02-12,El Salvador,199,8,57428,1727
2021-02-13,El Salvador,210,7,57638,1734
2021-02-14,El Salvador,201,8,57839,1742
2021-02-15,El Salvador,184,8,58023,1750
2021-02-16,El Salvador,177,8,58200,1758
2021-02-17,El Salvador,174,9,58374,1767
2021-02-18,El Salvador,172,9,58546,1776
2021-02-19,El Salvador,182,9,58728,1785
2021-02-20,El Salvador,175,7,58903,1792
2021-02-21,El Salvador,168,7,59071,1799
2021-02-22,El Salvador,164,8,59235,1807
2021-02-23,El Salvador,161,8,59396,1815
2021-02-24,El Salvador,159,8,59555,1823
2021-02-25,El Salvador,157,9,59712,1832
2021-02-26,El Salvador,154,9,59866,1841
2021-02-27,El Salvador,155,6,60021,1847
2021-02-28,El Salvador,160,7,60181,1854
2021-03-01,El Salvador,156,7,60337,1861
2021-03-02,El Salvador,154,8,60491,1869
2021-03-03,El Salvador,149,9,60640,1878
2021-03-04,El Salvador,160,9,60800,1887
2021-03-05,El Salvador,152,7,60952,1894
2021-03-06,El Salvador,149,0,61101,1894
2021-03-07,El Salvador,150,13,61251,1907
2021-03-08,El Salvador,147,8,61398,1915
2021-03-09,El Salvador,141,8,61539,1923
2021-03-10,El Salvador,138,6,61677,1929
2021-03-11,El Salvador,137,6,61814,1935
2021-03-12,El Salvador,133,5,61947,1940
2021-03-13,El Salvador,139,5,62086,1945
2021-03-14,El Salvador,143,5,62229,1950
2021-03-15,El Salvador,148,4,62377,1954
2021-03-16,El Salvador,154,4,62531,1958
2021-03-17,El Salvador,160,4,62691,1962
2021-03-18,El Salvador,162,0,62853,1962
2021-03-19,El Salvador,164,9,63017,1971
2021-03-20,El Salvador,171,4,63188,1975
2021-03-21,El Salvador,156,4,63344,1979
2021-03-22,El Salvador,146,4,63490,1983
2021-03-23,El Salvador,141,3,63631,1986
2021-03-24,El Salvador,135,4,63766,1990
2021-03-25,El Salvador,134,0,63900,1990
2021-03-26,El Salvador,139,6,64039,1996
2021-03-27,El Salvador,129,2,64168,1998
2021-03-28,El Salvador,130,2,64298,2000
2021-03-29,El Salvador,133,3,64431,2003
2021-03-30,El Salvador,142,3,64573,2006
2021-03-31,El Salvador,153,0,64726,2006
2021-04-01,El Salvador,149,0,64875,2006
2021-04-02,El Salvador,155,11,65030,2017
2021-04-03,El Salvador,150,4,65180,2021
2021-04-04,El Salvador,157,4,65337,2025
2021-04-05,El Salvador,154,5,65491,2030
2021-04-06,El Salvador,0,0,65491,2030
2021-04-07,El Salvador,0,7,65491,2037
2021-04-08,El Salvador,0,3,65491,2040
2020-03-15,Equatorial Guinea,1,0,1,0
2020-03-16,Equatorial Guinea,0,0,1,0
2020-03-17,Equatorial Guinea,0,0,1,0
2020-03-18,Equatorial Guinea,3,0,4,0
2020-03-19,Equatorial Guinea,2,0,6,0
2020-03-20,Equatorial Guinea,0,0,6,0
2020-03-21,Equatorial Guinea,0,0,6,0
2020-03-22,Equatorial Guinea,0,0,6,0
2020-03-23,Equatorial Guinea,3,0,9,0
2020-03-24,Equatorial Guinea,0,0,9,0
2020-03-25,Equatorial Guinea,0,0,9,0
2020-03-26,Equatorial Guinea,3,0,12,0
2020-03-27,Equatorial Guinea,0,0,12,0
2020-03-28,Equatorial Guinea,0,0,12,0
2020-03-29,Equatorial Guinea,0,0,12,0
2020-03-30,Equatorial Guinea,0,0,12,0
2020-03-31,Equatorial Guinea,0,0,12,0
2020-04-01,Equatorial Guinea,3,0,15,0
2020-04-02,Equatorial Guinea,0,0,15,0
2020-04-03,Equatorial Guinea,1,0,16,0
2020-04-04,Equatorial Guinea,0,0,16,0
2020-04-05,Equatorial Guinea,0,0,16,0
2020-04-06,Equatorial Guinea,0,0,16,0
2020-04-07,Equatorial Guinea,0,0,16,0
2020-04-08,Equatorial Guinea,2,0,18,0
2020-04-09,Equatorial Guinea,0,0,18,0
2020-04-10,Equatorial Guinea,0,0,18,0
2020-04-11,Equatorial Guinea,0,0,18,0
2020-04-12,Equatorial Guinea,3,0,21,0
2020-04-13,Equatorial Guinea,0,0,21,0
2020-04-14,Equatorial Guinea,20,0,41,0
2020-04-15,Equatorial Guinea,10,0,51,0
2020-04-16,Equatorial Guinea,0,0,51,0
2020-04-17,Equatorial Guinea,28,0,79,0
2020-04-18,Equatorial Guinea,0,0,79,0
2020-04-19,Equatorial Guinea,0,0,79,0
2020-04-20,Equatorial Guinea,0,0,79,0
2020-04-21,Equatorial Guinea,4,0,83,0
2020-04-22,Equatorial Guinea,1,1,84,1
2020-04-23,Equatorial Guinea,0,0,84,1
2020-04-24,Equatorial Guinea,130,0,214,1
2020-04-25,Equatorial Guinea,44,0,258,1
2020-04-26,Equatorial Guinea,0,0,258,1
2020-04-27,Equatorial Guinea,0,0,258,1
2020-04-28,Equatorial Guinea,57,0,315,1
2020-04-29,Equatorial Guinea,0,0,315,1
2020-04-30,Equatorial Guinea,0,0,315,1
2020-05-01,Equatorial Guinea,0,0,315,1
2020-05-02,Equatorial Guinea,0,0,315,1
2020-05-03,Equatorial Guinea,0,0,315,1
2020-05-04,Equatorial Guinea,0,2,315,3
2020-05-05,Equatorial Guinea,0,0,315,3
2020-05-06,Equatorial Guinea,124,1,439,4
2020-05-07,Equatorial Guinea,0,0,439,4
2020-05-08,Equatorial Guinea,0,0,439,4
2020-05-09,Equatorial Guinea,0,0,439,4
2020-05-10,Equatorial Guinea,0,0,439,4
2020-05-11,Equatorial Guinea,0,0,439,4
2020-05-12,Equatorial Guinea,0,0,439,4
2020-05-13,Equatorial Guinea,83,2,522,6
2020-05-14,Equatorial Guinea,61,1,583,7
2020-05-15,Equatorial Guinea,11,0,594,7
2020-05-16,Equatorial Guinea,0,0,594,7
2020-05-17,Equatorial Guinea,0,0,594,7
2020-05-18,Equatorial Guinea,125,0,719,7
2020-05-19,Equatorial Guinea,106,0,825,7
2020-05-20,Equatorial Guinea,65,0,890,7
2020-05-21,Equatorial Guinea,13,3,903,10
2020-05-22,Equatorial Guinea,57,1,960,11
2020-05-23,Equatorial Guinea,0,0,960,11
2020-05-24,Equatorial Guinea,0,0,960,11
2020-05-25,Equatorial Guinea,83,1,1043,12
2020-05-26,Equatorial Guinea,0,0,1043,12
2020-05-27,Equatorial Guinea,0,0,1043,12
2020-05-28,Equatorial Guinea,0,0,1043,12
2020-05-29,Equatorial Guinea,263,0,1306,12
2020-05-30,Equatorial Guinea,0,0,1306,12
2020-05-31,Equatorial Guinea,0,0,1306,12
2020-06-01,Equatorial Guinea,0,0,1306,12
2020-06-02,Equatorial Guinea,0,0,1306,12
2020-06-03,Equatorial Guinea,0,0,1306,12
2020-06-04,Equatorial Guinea,0,0,1306,12
2020-06-05,Equatorial Guinea,0,0,1306,12
2020-06-06,Equatorial Guinea,0,0,1306,12
2020-06-07,Equatorial Guinea,0,0,1306,12
2020-06-08,Equatorial Guinea,0,0,1306,12
2020-06-09,Equatorial Guinea,0,0,1306,12
2020-06-10,Equatorial Guinea,0,0,1306,12
2020-06-11,Equatorial Guinea,0,0,1306,12
2020-06-12,Equatorial Guinea,0,0,1306,12
2020-06-13,Equatorial Guinea,0,0,1306,12
2020-06-14,Equatorial Guinea,0,0,1306,12
2020-06-15,Equatorial Guinea,0,0,1306,12
2020-06-16,Equatorial Guinea,358,20,1664,32
2020-06-17,Equatorial Guinea,0,0,1664,32
2020-06-18,Equatorial Guinea,0,0,1664,32
2020-06-19,Equatorial Guinea,0,0,1664,32
2020-06-20,Equatorial Guinea,0,0,1664,32
2020-06-21,Equatorial Guinea,0,0,1664,32
2020-06-22,Equatorial Guinea,0,0,1664,32
2020-06-23,Equatorial Guinea,0,0,1664,32
2020-06-24,Equatorial Guinea,0,0,1664,32
2020-06-25,Equatorial Guinea,337,0,2001,32
2020-06-26,Equatorial Guinea,0,0,2001,32
2020-06-27,Equatorial Guinea,0,0,2001,32
2020-06-28,Equatorial Guinea,0,0,2001,32
2020-06-29,Equatorial Guinea,0,0,2001,32
2020-06-30,Equatorial Guinea,0,0,2001,32
2020-07-01,Equatorial Guinea,0,0,2001,32
2020-07-02,Equatorial Guinea,1070,19,3071,51
2020-07-03,Equatorial Guinea,0,0,3071,51
2020-07-04,Equatorial Guinea,0,0,3071,51
2020-07-05,Equatorial Guinea,0,0,3071,51
2020-07-06,Equatorial Guinea,0,0,3071,51
2020-07-07,Equatorial Guinea,0,0,3071,51
2020-07-08,Equatorial Guinea,0,0,3071,51
2020-07-09,Equatorial Guinea,0,0,3071,51
2020-07-10,Equatorial Guinea,0,0,3071,51
2020-07-11,Equatorial Guinea,0,0,3071,51
2020-07-12,Equatorial Guinea,0,0,3071,51
2020-07-13,Equatorial Guinea,0,0,3071,51
2020-07-14,Equatorial Guinea,0,0,3071,51
2020-07-15,Equatorial Guinea,0,0,3071,51
2020-07-16,Equatorial Guinea,0,0,3071,51
2020-07-17,Equatorial Guinea,0,0,3071,51
2020-07-18,Equatorial Guinea,0,0,3071,51
2020-07-19,Equatorial Guinea,0,0,3071,51
2020-07-20,Equatorial Guinea,0,0,3071,51
2020-07-21,Equatorial Guinea,0,0,3071,51
2020-07-22,Equatorial Guinea,0,0,3071,51
2020-07-23,Equatorial Guinea,0,0,3071,51
2020-07-24,Equatorial Guinea,0,0,3071,51
2020-07-25,Equatorial Guinea,0,0,3071,51
2020-07-26,Equatorial Guinea,0,0,3071,51
2020-07-27,Equatorial Guinea,0,0,3071,51
2020-07-28,Equatorial Guinea,0,0,3071,51
2020-07-29,Equatorial Guinea,0,0,3071,51
2020-07-30,Equatorial Guinea,0,0,3071,51
2020-07-31,Equatorial Guinea,1750,32,4821,83
2020-08-01,Equatorial Guinea,0,0,4821,83
2020-08-02,Equatorial Guinea,0,0,4821,83
2020-08-03,Equatorial Guinea,0,0,4821,83
2020-08-04,Equatorial Guinea,0,0,4821,83
2020-08-05,Equatorial Guinea,0,0,4821,83
2020-08-06,Equatorial Guinea,0,0,4821,83
2020-08-07,Equatorial Guinea,0,0,4821,83
2020-08-08,Equatorial Guinea,0,0,4821,83
2020-08-09,Equatorial Guinea,0,0,4821,83
2020-08-10,Equatorial Guinea,0,0,4821,83
2020-08-11,Equatorial Guinea,0,0,4821,83
2020-08-12,Equatorial Guinea,0,0,4821,83
2020-08-13,Equatorial Guinea,0,0,4821,83
2020-08-14,Equatorial Guinea,0,0,4821,83
2020-08-15,Equatorial Guinea,0,0,4821,83
2020-08-16,Equatorial Guinea,0,0,4821,83
2020-08-17,Equatorial Guinea,0,0,4821,83
2020-08-18,Equatorial Guinea,0,0,4821,83
2020-08-19,Equatorial Guinea,71,0,4892,83
2020-08-20,Equatorial Guinea,0,0,4892,83
2020-08-21,Equatorial Guinea,34,0,4926,83
2020-08-22,Equatorial Guinea,0,0,4926,83
2020-08-23,Equatorial Guinea,0,0,4926,83
2020-08-24,Equatorial Guinea,0,0,4926,83
2020-08-25,Equatorial Guinea,0,0,4926,83
2020-08-26,Equatorial Guinea,2,0,4928,83
2020-08-27,Equatorial Guinea,0,0,4928,83
2020-08-28,Equatorial Guinea,13,0,4941,83
2020-08-29,Equatorial Guinea,0,0,4941,83
2020-08-30,Equatorial Guinea,0,0,4941,83
2020-08-31,Equatorial Guinea,0,0,4941,83
2020-09-01,Equatorial Guinea,24,0,4965,83
2020-09-02,Equatorial Guinea,0,0,4965,83
2020-09-03,Equatorial Guinea,0,0,4965,83
2020-09-04,Equatorial Guinea,7,0,4972,83
2020-09-05,Equatorial Guinea,0,0,4972,83
2020-09-06,Equatorial Guinea,0,0,4972,83
2020-09-07,Equatorial Guinea,13,0,4985,83
2020-09-08,Equatorial Guinea,0,0,4985,83
2020-09-09,Equatorial Guinea,5,0,4990,83
2020-09-10,Equatorial Guinea,0,0,4990,83
2020-09-11,Equatorial Guinea,6,0,4996,83
2020-09-12,Equatorial Guinea,0,0,4996,83
2020-09-13,Equatorial Guinea,0,0,4996,83
2020-09-14,Equatorial Guinea,4,0,5000,83
2020-09-15,Equatorial Guinea,0,0,5000,83
2020-09-16,Equatorial Guinea,0,0,5000,83
2020-09-17,Equatorial Guinea,2,0,5002,83
2020-09-18,Equatorial Guinea,0,0,5002,83
2020-09-19,Equatorial Guinea,0,0,5002,83
2020-09-20,Equatorial Guinea,0,0,5002,83
2020-09-21,Equatorial Guinea,0,0,5002,83
2020-09-22,Equatorial Guinea,16,0,5018,83
2020-09-23,Equatorial Guinea,0,0,5018,83
2020-09-24,Equatorial Guinea,0,0,5018,83
2020-09-25,Equatorial Guinea,0,0,5018,83
2020-09-26,Equatorial Guinea,10,0,5028,83
2020-09-27,Equatorial Guinea,0,0,5028,83
2020-09-28,Equatorial Guinea,0,0,5028,83
2020-09-29,Equatorial Guinea,2,0,5030,83
2020-09-30,Equatorial Guinea,0,0,5030,83
2020-10-01,Equatorial Guinea,15,0,5045,83
2020-10-02,Equatorial Guinea,0,0,5045,83
2020-10-03,Equatorial Guinea,0,0,5045,83
2020-10-04,Equatorial Guinea,0,0,5045,83
2020-10-05,Equatorial Guinea,0,0,5045,83
2020-10-06,Equatorial Guinea,7,0,5052,83
2020-10-07,Equatorial Guinea,0,0,5052,83
2020-10-08,Equatorial Guinea,10,0,5062,83
2020-10-09,Equatorial Guinea,1,0,5063,83
2020-10-10,Equatorial Guinea,0,0,5063,83
2020-10-11,Equatorial Guinea,0,0,5063,83
2020-10-12,Equatorial Guinea,3,0,5066,83
2020-10-13,Equatorial Guinea,0,0,5066,83
2020-10-14,Equatorial Guinea,2,0,5068,83
2020-10-15,Equatorial Guinea,0,0,5068,83
2020-10-16,Equatorial Guinea,0,0,5068,83
2020-10-17,Equatorial Guinea,2,0,5070,83
2020-10-18,Equatorial Guinea,0,0,5070,83
2020-10-19,Equatorial Guinea,0,0,5070,83
2020-10-20,Equatorial Guinea,4,0,5074,83
2020-10-21,Equatorial Guinea,0,0,5074,83
2020-10-22,Equatorial Guinea,0,0,5074,83
2020-10-23,Equatorial Guinea,0,0,5074,83
2020-10-24,Equatorial Guinea,5,0,5079,83
2020-10-25,Equatorial Guinea,0,0,5079,83
2020-10-26,Equatorial Guinea,0,0,5079,83
2020-10-27,Equatorial Guinea,4,0,5083,83
2020-10-28,Equatorial Guinea,0,0,5083,83
2020-10-29,Equatorial Guinea,0,0,5083,83
2020-10-30,Equatorial Guinea,0,0,5083,83
2020-10-31,Equatorial Guinea,5,0,5088,83
2020-11-01,Equatorial Guinea,0,0,5088,83
2020-11-02,Equatorial Guinea,1,0,5089,83
2020-11-03,Equatorial Guinea,0,0,5089,83
2020-11-04,Equatorial Guinea,0,0,5089,83
2020-11-05,Equatorial Guinea,3,2,5092,85
2020-11-06,Equatorial Guinea,0,0,5092,85
2020-11-07,Equatorial Guinea,0,0,5092,85
2020-11-08,Equatorial Guinea,0,0,5092,85
2020-11-09,Equatorial Guinea,0,0,5092,85
2020-11-10,Equatorial Guinea,10,0,5102,85
2020-11-11,Equatorial Guinea,0,0,5102,85
2020-11-12,Equatorial Guinea,2,0,5104,85
2020-11-13,Equatorial Guinea,0,0,5104,85
2020-11-14,Equatorial Guinea,0,0,5104,85
2020-11-15,Equatorial Guinea,0,0,5104,85
2020-11-16,Equatorial Guinea,0,0,5104,85
2020-11-17,Equatorial Guinea,17,0,5121,85
2020-11-18,Equatorial Guinea,0,0,5121,85
2020-11-19,Equatorial Guinea,0,0,5121,85
2020-11-20,Equatorial Guinea,0,0,5121,85
2020-11-21,Equatorial Guinea,9,0,5130,85
2020-11-22,Equatorial Guinea,0,0,5130,85
2020-11-23,Equatorial Guinea,7,0,5137,85
2020-11-24,Equatorial Guinea,0,0,5137,85
2020-11-25,Equatorial Guinea,0,0,5137,85
2020-11-26,Equatorial Guinea,9,0,5146,85
2020-11-27,Equatorial Guinea,0,0,5146,85
2020-11-28,Equatorial Guinea,7,0,5153,85
2020-11-29,Equatorial Guinea,0,0,5153,85
2020-11-30,Equatorial Guinea,0,0,5153,85
2020-12-01,Equatorial Guinea,3,0,5156,85
2020-12-02,Equatorial Guinea,0,0,5156,85
2020-12-03,Equatorial Guinea,3,0,5159,85
2020-12-04,Equatorial Guinea,0,0,5159,85
2020-12-05,Equatorial Guinea,0,0,5159,85
2020-12-06,Equatorial Guinea,0,0,5159,85
2020-12-07,Equatorial Guinea,7,0,5166,85
2020-12-08,Equatorial Guinea,0,0,5166,85
2020-12-09,Equatorial Guinea,17,0,5183,85
2020-12-10,Equatorial Guinea,0,0,5183,85
2020-12-11,Equatorial Guinea,0,0,5183,85
2020-12-12,Equatorial Guinea,2,0,5185,85
2020-12-13,Equatorial Guinea,0,0,5185,85
2020-12-14,Equatorial Guinea,0,0,5185,85
2020-12-15,Equatorial Guinea,10,0,5195,85
2020-12-16,Equatorial Guinea,0,0,5195,85
2020-12-17,Equatorial Guinea,19,0,5214,85
2020-12-18,Equatorial Guinea,0,0,5214,85
2020-12-19,Equatorial Guinea,0,0,5214,85
2020-12-20,Equatorial Guinea,0,0,5214,85
2020-12-21,Equatorial Guinea,17,0,5231,85
2020-12-22,Equatorial Guinea,0,0,5231,85
2020-12-23,Equatorial Guinea,5,0,5236,85
2020-12-24,Equatorial Guinea,0,0,5236,85
2020-12-25,Equatorial Guinea,0,0,5236,85
2020-12-26,Equatorial Guinea,0,0,5236,85
2020-12-27,Equatorial Guinea,12,1,5248,86
2020-12-28,Equatorial Guinea,0,0,5248,86
2020-12-29,Equatorial Guinea,0,0,5248,86
2020-12-30,Equatorial Guinea,16,0,5264,86
2020-12-31,Equatorial Guinea,13,0,5277,86
2021-01-01,Equatorial Guinea,0,0,5277,86
2021-01-02,Equatorial Guinea,0,0,5277,86
2021-01-03,Equatorial Guinea,0,0,5277,86
2021-01-04,Equatorial Guinea,2,0,5279,86
2021-01-05,Equatorial Guinea,0,0,5279,86
2021-01-06,Equatorial Guinea,7,0,5286,86
2021-01-07,Equatorial Guinea,0,0,5286,86
2021-01-08,Equatorial Guinea,3,0,5289,86
2021-01-09,Equatorial Guinea,0,0,5289,86
2021-01-10,Equatorial Guinea,0,0,5289,86
2021-01-11,Equatorial Guinea,7,0,5296,86
2021-01-12,Equatorial Guinea,0,0,5296,86
2021-01-13,Equatorial Guinea,20,0,5316,86
2021-01-14,Equatorial Guinea,0,0,5316,86
2021-01-15,Equatorial Guinea,0,0,5316,86
2021-01-16,Equatorial Guinea,40,0,5356,86
2021-01-17,Equatorial Guinea,0,0,5356,86
2021-01-18,Equatorial Guinea,9,0,5365,86
2021-01-19,Equatorial Guinea,0,0,5365,86
2021-01-20,Equatorial Guinea,0,0,5365,86
2021-01-21,Equatorial Guinea,0,0,5365,86
2021-01-22,Equatorial Guinea,36,0,5401,86
2021-01-23,Equatorial Guinea,0,0,5401,86
2021-01-24,Equatorial Guinea,0,0,5401,86
2021-01-25,Equatorial Guinea,53,0,5454,86
2021-01-26,Equatorial Guinea,0,0,5454,86
2021-01-27,Equatorial Guinea,38,0,5492,86
2021-01-28,Equatorial Guinea,0,0,5492,86
2021-01-29,Equatorial Guinea,24,0,5516,86
2021-01-30,Equatorial Guinea,0,0,5516,86
2021-01-31,Equatorial Guinea,0,0,5516,86
2021-02-01,Equatorial Guinea,18,0,5534,86
2021-02-02,Equatorial Guinea,0,0,5534,86
2021-02-03,Equatorial Guinea,0,0,5534,86
2021-02-04,Equatorial Guinea,0,0,5534,86
2021-02-05,Equatorial Guinea,44,0,5578,86
2021-02-06,Equatorial Guinea,0,0,5578,86
2021-02-07,Equatorial Guinea,0,0,5578,86
2021-02-08,Equatorial Guinea,36,1,5614,87
2021-02-09,Equatorial Guinea,0,0,5614,87
2021-02-10,Equatorial Guinea,44,0,5658,87
2021-02-11,Equatorial Guinea,5,0,5663,87
2021-02-12,Equatorial Guinea,0,0,5663,87
2021-02-13,Equatorial Guinea,31,0,5694,87
2021-02-14,Equatorial Guinea,0,0,5694,87
2021-02-15,Equatorial Guinea,0,0,5694,87
2021-02-16,Equatorial Guinea,0,0,5694,87
2021-02-17,Equatorial Guinea,0,0,5694,87
2021-02-18,Equatorial Guinea,53,1,5747,88
2021-02-19,Equatorial Guinea,0,0,5747,88
2021-02-20,Equatorial Guinea,51,1,5798,89
2021-02-21,Equatorial Guinea,0,0,5798,89
2021-02-22,Equatorial Guinea,0,0,5798,89
2021-02-23,Equatorial Guinea,54,2,5852,91
2021-02-24,Equatorial Guinea,0,0,5852,91
2021-02-25,Equatorial Guinea,0,0,5852,91
2021-02-26,Equatorial Guinea,105,0,5957,91
2021-02-27,Equatorial Guinea,48,0,6005,91
2021-02-28,Equatorial Guinea,0,0,6005,91
2021-03-01,Equatorial Guinea,90,1,6095,92
2021-03-02,Equatorial Guinea,0,0,6095,92
2021-03-03,Equatorial Guinea,115,1,6210,93
2021-03-04,Equatorial Guinea,0,0,6210,93
2021-03-05,Equatorial Guinea,0,0,6210,93
2021-03-06,Equatorial Guinea,119,3,6329,96
2021-03-07,Equatorial Guinea,0,0,6329,96
2021-03-08,Equatorial Guinea,42,0,6371,96
2021-03-09,Equatorial Guinea,0,0,6371,96
2021-03-10,Equatorial Guinea,0,0,6371,96
2021-03-11,Equatorial Guinea,85,2,6456,98
2021-03-12,Equatorial Guinea,0,0,6456,98
2021-03-13,Equatorial Guinea,106,0,6562,98
2021-03-14,Equatorial Guinea,0,0,6562,98
2021-03-15,Equatorial Guinea,0,0,6562,98
2021-03-16,Equatorial Guinea,41,2,6603,100
2021-03-17,Equatorial Guinea,0,0,6603,100
2021-03-18,Equatorial Guinea,63,0,6666,100
2021-03-19,Equatorial Guinea,0,0,6666,100
2021-03-20,Equatorial Guinea,70,0,6736,100
2021-03-21,Equatorial Guinea,0,0,6736,100
2021-03-22,Equatorial Guinea,44,1,6780,101
2021-03-23,Equatorial Guinea,0,0,6780,101
2021-03-24,Equatorial Guinea,71,1,6851,102
2021-03-25,Equatorial Guinea,0,0,6851,102
2021-03-26,Equatorial Guinea,0,0,6851,102
2021-03-27,Equatorial Guinea,51,0,6902,102
2021-03-28,Equatorial Guinea,0,0,6902,102
2021-03-29,Equatorial Guinea,12,0,6914,102
2021-03-30,Equatorial Guinea,0,0,6914,102
2021-03-31,Equatorial Guinea,0,0,6914,102
2021-04-01,Equatorial Guinea,94,1,7008,103
2021-04-02,Equatorial Guinea,0,0,7008,103
2021-04-03,Equatorial Guinea,0,0,7008,103
2021-04-04,Equatorial Guinea,0,0,7008,103
2021-04-05,Equatorial Guinea,51,1,7059,104
2021-04-06,Equatorial Guinea,0,0,7059,104
2021-04-07,Equatorial Guinea,0,0,7059,104
2021-04-08,Equatorial Guinea,0,0,7059,104
2020-03-21,Eritrea,1,0,1,0
2020-03-22,Eritrea,0,0,1,0
2020-03-23,Eritrea,0,0,1,0
2020-03-24,Eritrea,0,0,1,0
2020-03-25,Eritrea,3,0,4,0
2020-03-26,Eritrea,2,0,6,0
2020-03-27,Eritrea,0,0,6,0
2020-03-28,Eritrea,0,0,6,0
2020-03-29,Eritrea,6,0,12,0
2020-03-30,Eritrea,0,0,12,0
2020-03-31,Eritrea,3,0,15,0
2020-04-01,Eritrea,0,0,15,0
2020-04-02,Eritrea,7,0,22,0
2020-04-03,Eritrea,0,0,22,0
2020-04-04,Eritrea,7,0,29,0
2020-04-05,Eritrea,0,0,29,0
2020-04-06,Eritrea,2,0,31,0
2020-04-07,Eritrea,0,0,31,0
2020-04-08,Eritrea,2,0,33,0
2020-04-09,Eritrea,0,0,33,0
2020-04-10,Eritrea,1,0,34,0
2020-04-11,Eritrea,0,0,34,0
2020-04-12,Eritrea,0,0,34,0
2020-04-13,Eritrea,0,0,34,0
2020-04-14,Eritrea,0,0,34,0
2020-04-15,Eritrea,1,0,35,0
2020-04-16,Eritrea,0,0,35,0
2020-04-17,Eritrea,0,0,35,0
2020-04-18,Eritrea,4,0,39,0
2020-04-19,Eritrea,0,0,39,0
2020-04-20,Eritrea,0,0,39,0
2020-04-21,Eritrea,0,0,39,0
2020-04-22,Eritrea,0,0,39,0
2020-04-23,Eritrea,0,0,39,0
2020-04-24,Eritrea,0,0,39,0
2020-04-25,Eritrea,0,0,39,0
2020-04-26,Eritrea,0,0,39,0
2020-04-27,Eritrea,0,0,39,0
2020-04-28,Eritrea,0,0,39,0
2020-04-29,Eritrea,0,0,39,0
2020-04-30,Eritrea,0,0,39,0
2020-05-01,Eritrea,0,0,39,0
2020-05-02,Eritrea,0,0,39,0
2020-05-03,Eritrea,0,0,39,0
2020-05-04,Eritrea,0,0,39,0
2020-05-05,Eritrea,0,0,39,0
2020-05-06,Eritrea,0,0,39,0
2020-05-07,Eritrea,0,0,39,0
2020-05-08,Eritrea,0,0,39,0
2020-05-09,Eritrea,0,0,39,0
2020-05-10,Eritrea,0,0,39,0
2020-05-11,Eritrea,0,0,39,0
2020-05-12,Eritrea,0,0,39,0
2020-05-13,Eritrea,0,0,39,0
2020-05-14,Eritrea,0,0,39,0
2020-05-15,Eritrea,0,0,39,0
2020-05-16,Eritrea,0,0,39,0
2020-05-17,Eritrea,0,0,39,0
2020-05-18,Eritrea,0,0,39,0
2020-05-19,Eritrea,0,0,39,0
2020-05-20,Eritrea,0,0,39,0
2020-05-21,Eritrea,0,0,39,0
2020-05-22,Eritrea,0,0,39,0
2020-05-23,Eritrea,0,0,39,0
2020-05-24,Eritrea,0,0,39,0
2020-05-25,Eritrea,0,0,39,0
2020-05-26,Eritrea,0,0,39,0
2020-05-27,Eritrea,0,0,39,0
2020-05-28,Eritrea,0,0,39,0
2020-05-29,Eritrea,0,0,39,0
2020-05-30,Eritrea,0,0,39,0
2020-05-31,Eritrea,0,0,39,0
2020-06-01,Eritrea,0,0,39,0
2020-06-02,Eritrea,0,0,39,0
2020-06-03,Eritrea,0,0,39,0
2020-06-04,Eritrea,0,0,39,0
2020-06-05,Eritrea,0,0,39,0
2020-06-06,Eritrea,0,0,39,0
2020-06-07,Eritrea,0,0,39,0
2020-06-08,Eritrea,0,0,39,0
2020-06-09,Eritrea,0,0,39,0
2020-06-10,Eritrea,2,0,41,0
2020-06-11,Eritrea,0,0,41,0
2020-06-12,Eritrea,0,0,41,0
2020-06-13,Eritrea,24,0,65,0
2020-06-14,Eritrea,31,0,96,0
2020-06-15,Eritrea,13,0,109,0
2020-06-16,Eritrea,12,0,121,0
2020-06-17,Eritrea,10,0,131,0
2020-06-18,Eritrea,11,0,142,0
2020-06-19,Eritrea,0,0,142,0
2020-06-20,Eritrea,1,0,143,0
2020-06-21,Eritrea,0,0,143,0
2020-06-22,Eritrea,0,0,143,0
2020-06-23,Eritrea,0,0,143,0
2020-06-24,Eritrea,1,0,144,0
2020-06-25,Eritrea,0,0,144,0
2020-06-26,Eritrea,23,0,167,0
2020-06-27,Eritrea,24,0,191,0
2020-06-28,Eritrea,0,0,191,0
2020-06-29,Eritrea,0,0,191,0
2020-06-30,Eritrea,12,0,203,0
2020-07-01,Eritrea,0,0,203,0
2020-07-02,Eritrea,12,0,215,0
2020-07-03,Eritrea,0,0,215,0
2020-07-04,Eritrea,0,0,215,0
2020-07-05,Eritrea,0,0,215,0
2020-07-06,Eritrea,0,0,215,0
2020-07-07,Eritrea,0,0,215,0
2020-07-08,Eritrea,0,0,215,0
2020-07-09,Eritrea,17,0,232,0
2020-07-10,Eritrea,0,0,232,0
2020-07-11,Eritrea,0,0,232,0
2020-07-12,Eritrea,0,0,232,0
2020-07-13,Eritrea,0,0,232,0
2020-07-14,Eritrea,0,0,232,0
2020-07-15,Eritrea,0,0,232,0
2020-07-16,Eritrea,19,0,251,0
2020-07-17,Eritrea,0,0,251,0
2020-07-18,Eritrea,0,0,251,0
2020-07-19,Eritrea,0,0,251,0
2020-07-20,Eritrea,0,0,251,0
2020-07-21,Eritrea,0,0,251,0
2020-07-22,Eritrea,0,0,251,0
2020-07-23,Eritrea,10,0,261,0
2020-07-24,Eritrea,0,0,261,0
2020-07-25,Eritrea,2,0,263,0
2020-07-26,Eritrea,0,0,263,0
2020-07-27,Eritrea,2,0,265,0
2020-07-28,Eritrea,0,0,265,0
2020-07-29,Eritrea,0,0,265,0
2020-07-30,Eritrea,14,0,279,0
2020-07-31,Eritrea,0,0,279,0
2020-08-01,Eritrea,0,0,279,0
2020-08-02,Eritrea,0,0,279,0
2020-08-03,Eritrea,3,0,282,0
2020-08-04,Eritrea,0,0,282,0
2020-08-05,Eritrea,0,0,282,0
2020-08-06,Eritrea,0,0,282,0
2020-08-07,Eritrea,3,0,285,0
2020-08-08,Eritrea,0,0,285,0
2020-08-09,Eritrea,0,0,285,0
2020-08-10,Eritrea,0,0,285,0
2020-08-11,Eritrea,0,0,285,0
2020-08-12,Eritrea,0,0,285,0
2020-08-13,Eritrea,0,0,285,0
2020-08-14,Eritrea,0,0,285,0
2020-08-15,Eritrea,0,0,285,0
2020-08-16,Eritrea,0,0,285,0
2020-08-17,Eritrea,0,0,285,0
2020-08-18,Eritrea,19,0,304,0
2020-08-19,Eritrea,0,0,304,0
2020-08-20,Eritrea,2,0,306,0
2020-08-21,Eritrea,0,0,306,0
2020-08-22,Eritrea,0,0,306,0
2020-08-23,Eritrea,0,0,306,0
2020-08-24,Eritrea,0,0,306,0
2020-08-25,Eritrea,9,0,315,0
2020-08-26,Eritrea,0,0,315,0
2020-08-27,Eritrea,2,0,317,0
2020-08-28,Eritrea,0,0,317,0
2020-08-29,Eritrea,1,0,318,0
2020-08-30,Eritrea,0,0,318,0
2020-08-31,Eritrea,1,0,319,0
2020-09-01,Eritrea,0,0,319,0
2020-09-02,Eritrea,0,0,319,0
2020-09-03,Eritrea,11,0,330,0
2020-09-04,Eritrea,0,0,330,0
2020-09-05,Eritrea,0,0,330,0
2020-09-06,Eritrea,0,0,330,0
2020-09-07,Eritrea,0,0,330,0
2020-09-08,Eritrea,11,0,341,0
2020-09-09,Eritrea,0,0,341,0
2020-09-10,Eritrea,20,0,361,0
2020-09-11,Eritrea,0,0,361,0
2020-09-12,Eritrea,0,0,361,0
2020-09-13,Eritrea,0,0,361,0
2020-09-14,Eritrea,0,0,361,0
2020-09-15,Eritrea,3,0,364,0
2020-09-16,Eritrea,0,0,364,0
2020-09-17,Eritrea,0,0,364,0
2020-09-18,Eritrea,0,0,364,0
2020-09-19,Eritrea,0,0,364,0
2020-09-20,Eritrea,0,0,364,0
2020-09-21,Eritrea,0,0,364,0
2020-09-22,Eritrea,0,0,364,0
2020-09-23,Eritrea,0,0,364,0
2020-09-24,Eritrea,5,0,369,0
2020-09-25,Eritrea,0,0,369,0
2020-09-26,Eritrea,6,0,375,0
2020-09-27,Eritrea,0,0,375,0
2020-09-28,Eritrea,0,0,375,0
2020-09-29,Eritrea,0,0,375,0
2020-09-30,Eritrea,0,0,375,0
2020-10-01,Eritrea,6,0,381,0
2020-10-02,Eritrea,0,0,381,0
2020-10-03,Eritrea,17,0,398,0
2020-10-04,Eritrea,0,0,398,0
2020-10-05,Eritrea,0,0,398,0
2020-10-06,Eritrea,0,0,398,0
2020-10-07,Eritrea,0,0,398,0
2020-10-08,Eritrea,7,0,405,0
2020-10-09,Eritrea,0,0,405,0
2020-10-10,Eritrea,9,0,414,0
2020-10-11,Eritrea,0,0,414,0
2020-10-12,Eritrea,0,0,414,0
2020-10-13,Eritrea,0,0,414,0
2020-10-14,Eritrea,0,0,414,0
2020-10-15,Eritrea,8,0,422,0
2020-10-16,Eritrea,0,0,422,0
2020-10-17,Eritrea,30,0,452,0
2020-10-18,Eritrea,0,0,452,0
2020-10-19,Eritrea,0,0,452,0
2020-10-20,Eritrea,0,0,452,0
2020-10-21,Eritrea,0,0,452,0
2020-10-22,Eritrea,5,0,457,0
2020-10-23,Eritrea,4,0,461,0
2020-10-24,Eritrea,0,0,461,0
2020-10-25,Eritrea,0,0,461,0
2020-10-26,Eritrea,0,0,461,0
2020-10-27,Eritrea,0,0,461,0
2020-10-28,Eritrea,0,0,461,0
2020-10-29,Eritrea,0,0,461,0
2020-10-30,Eritrea,2,0,463,0
2020-10-31,Eritrea,0,0,463,0
2020-11-01,Eritrea,0,0,463,0
2020-11-02,Eritrea,17,0,480,0
2020-11-03,Eritrea,0,0,480,0
2020-11-04,Eritrea,0,0,480,0
2020-11-05,Eritrea,4,0,484,0
2020-11-06,Eritrea,0,0,484,0
2020-11-07,Eritrea,7,0,491,0
2020-11-08,Eritrea,0,0,491,0
2020-11-09,Eritrea,0,0,491,0
2020-11-10,Eritrea,0,0,491,0
2020-11-11,Eritrea,0,0,491,0
2020-11-12,Eritrea,2,0,493,0
2020-11-13,Eritrea,0,0,493,0
2020-11-14,Eritrea,0,0,493,0
2020-11-15,Eritrea,0,0,493,0
2020-11-16,Eritrea,25,0,518,0
2020-11-17,Eritrea,0,0,518,0
2020-11-18,Eritrea,0,0,518,0
2020-11-19,Eritrea,9,0,527,0
2020-11-20,Eritrea,0,0,527,0
2020-11-21,Eritrea,24,0,551,0
2020-11-22,Eritrea,0,0,551,0
2020-11-23,Eritrea,7,0,558,0
2020-11-24,Eritrea,0,0,558,0
2020-11-25,Eritrea,0,0,558,0
2020-11-26,Eritrea,8,0,566,0
2020-11-27,Eritrea,0,0,566,0
2020-11-28,Eritrea,11,0,577,0
2020-11-29,Eritrea,0,0,577,0
2020-11-30,Eritrea,0,0,577,0
2020-12-01,Eritrea,0,0,577,0
2020-12-02,Eritrea,0,0,577,0
2020-12-03,Eritrea,17,0,594,0
2020-12-04,Eritrea,38,0,632,0
2020-12-05,Eritrea,0,0,632,0
2020-12-06,Eritrea,0,0,632,0
2020-12-07,Eritrea,17,0,649,0
2020-12-08,Eritrea,0,0,649,0
2020-12-09,Eritrea,0,0,649,0
2020-12-10,Eritrea,7,0,656,0
2020-12-11,Eritrea,0,0,656,0
2020-12-12,Eritrea,55,0,711,0
2020-12-13,Eritrea,0,0,711,0
2020-12-14,Eritrea,0,0,711,0
2020-12-15,Eritrea,0,0,711,0
2020-12-16,Eritrea,0,0,711,0
2020-12-17,Eritrea,30,0,741,0
2020-12-18,Eritrea,0,0,741,0
2020-12-19,Eritrea,13,0,754,0
2020-12-20,Eritrea,0,0,754,0
2020-12-21,Eritrea,53,0,807,0
2020-12-22,Eritrea,25,1,832,1
2020-12-23,Eritrea,45,0,877,1
2020-12-24,Eritrea,74,0,951,1
2020-12-25,Eritrea,41,0,992,1
2020-12-26,Eritrea,0,0,992,1
2020-12-27,Eritrea,47,0,1039,1
2020-12-28,Eritrea,0,0,1039,1
2020-12-29,Eritrea,181,0,1220,1
2020-12-30,Eritrea,32,0,1252,1
2020-12-31,Eritrea,68,2,1320,3
2021-01-01,Eritrea,0,0,1320,3
2021-01-02,Eritrea,0,0,1320,3
2021-01-03,Eritrea,0,0,1320,3
2021-01-04,Eritrea,43,0,1363,3
2021-01-05,Eritrea,0,0,1363,3
2021-01-06,Eritrea,82,0,1445,3
2021-01-07,Eritrea,0,0,1445,3
2021-01-08,Eritrea,111,3,1556,6
2021-01-09,Eritrea,0,0,1556,6
2021-01-10,Eritrea,0,0,1556,6
2021-01-11,Eritrea,0,0,1556,6
2021-01-12,Eritrea,40,0,1596,6
2021-01-13,Eritrea,0,0,1596,6
2021-01-14,Eritrea,209,0,1805,6
2021-01-15,Eritrea,72,0,1877,6
2021-01-16,Eritrea,0,0,1877,6
2021-01-17,Eritrea,0,0,1877,6
2021-01-18,Eritrea,0,0,1877,6
2021-01-19,Eritrea,0,0,1877,6
2021-01-20,Eritrea,33,0,1910,6
2021-01-21,Eritrea,3,0,1913,6
2021-01-22,Eritrea,27,0,1940,6
2021-01-23,Eritrea,0,0,1940,6
2021-01-24,Eritrea,0,0,1940,6
2021-01-25,Eritrea,10,1,1950,7
2021-01-26,Eritrea,20,0,1970,7
2021-01-27,Eritrea,115,0,2085,7
2021-01-28,Eritrea,0,0,2085,7
2021-01-29,Eritrea,50,0,2135,7
2021-01-30,Eritrea,0,0,2135,7
2021-01-31,Eritrea,0,0,2135,7
2021-02-01,Eritrea,0,0,2135,7
2021-02-02,Eritrea,132,0,2267,7
2021-02-03,Eritrea,42,0,2309,7
2021-02-04,Eritrea,0,0,2309,7
2021-02-05,Eritrea,17,0,2326,7
2021-02-06,Eritrea,0,0,2326,7
2021-02-07,Eritrea,0,0,2326,7
2021-02-08,Eritrea,0,0,2326,7
2021-02-09,Eritrea,75,0,2401,7
2021-02-10,Eritrea,17,0,2418,7
2021-02-11,Eritrea,11,0,2429,7
2021-02-12,Eritrea,0,0,2429,7
2021-02-13,Eritrea,0,0,2429,7
2021-02-14,Eritrea,0,0,2429,7
2021-02-15,Eritrea,137,0,2566,7
2021-02-16,Eritrea,0,0,2566,7
2021-02-17,Eritrea,61,0,2627,7
2021-02-18,Eritrea,48,0,2675,7
2021-02-19,Eritrea,10,0,2685,7
2021-02-20,Eritrea,0,0,2685,7
2021-02-21,Eritrea,0,0,2685,7
2021-02-22,Eritrea,18,0,2703,7
2021-02-23,Eritrea,70,0,2773,7
2021-02-24,Eritrea,16,0,2789,7
2021-02-25,Eritrea,37,0,2826,7
2021-02-26,Eritrea,21,0,2847,7
2021-02-27,Eritrea,0,0,2847,7
2021-02-28,Eritrea,0,0,2847,7
2021-03-01,Eritrea,19,0,2866,7
2021-03-02,Eritrea,18,0,2884,7
2021-03-03,Eritrea,8,0,2892,7
2021-03-04,Eritrea,21,0,2913,7
2021-03-05,Eritrea,9,0,2922,7
2021-03-06,Eritrea,22,0,2944,7
2021-03-07,Eritrea,0,0,2944,7
2021-03-08,Eritrea,0,0,2944,7
2021-03-09,Eritrea,0,0,2944,7
2021-03-10,Eritrea,44,0,2988,7
2021-03-11,Eritrea,21,0,3009,7
2021-03-12,Eritrea,29,0,3038,7
2021-03-13,Eritrea,0,0,3038,7
2021-03-14,Eritrea,0,0,3038,7
2021-03-15,Eritrea,17,0,3055,7
2021-03-16,Eritrea,7,0,3062,7
2021-03-17,Eritrea,16,0,3078,7
2021-03-18,Eritrea,17,0,3095,7
2021-03-19,Eritrea,23,0,3118,7
2021-03-20,Eritrea,0,0,3118,7
2021-03-21,Eritrea,0,0,3118,7
2021-03-22,Eritrea,0,0,3118,7
2021-03-23,Eritrea,0,0,3118,7
2021-03-24,Eritrea,65,1,3183,8
2021-03-25,Eritrea,9,1,3192,9
2021-03-26,Eritrea,16,0,3208,9
2021-03-27,Eritrea,0,0,3208,9
2021-03-28,Eritrea,0,0,3208,9
2021-03-29,Eritrea,43,0,3251,9
2021-03-30,Eritrea,28,0,3279,9
2021-03-31,Eritrea,6,1,3285,10
2021-04-01,Eritrea,23,0,3308,10
2021-04-02,Eritrea,26,0,3334,10
2021-04-03,Eritrea,0,0,3334,10
2021-04-04,Eritrea,0,0,3334,10
2021-04-05,Eritrea,6,0,3340,10
2021-04-06,Eritrea,23,0,3363,10
2021-04-07,Eritrea,11,0,3374,10
2021-04-08,Eritrea,19,0,3393,10
2020-02-27,Estonia,1,0,1,0
2020-02-28,Estonia,0,0,1,0
2020-02-29,Estonia,0,0,1,0
2020-03-01,Estonia,0,0,1,0
2020-03-02,Estonia,0,0,1,0
2020-03-03,Estonia,1,0,2,0
2020-03-04,Estonia,0,0,2,0
2020-03-05,Estonia,1,0,3,0
2020-03-06,Estonia,7,0,10,0
2020-03-07,Estonia,0,0,10,0
2020-03-08,Estonia,0,0,10,0
2020-03-09,Estonia,0,0,10,0
2020-03-10,Estonia,2,0,12,0
2020-03-11,Estonia,4,0,16,0
2020-03-12,Estonia,0,0,16,0
2020-03-13,Estonia,63,0,79,0
2020-03-14,Estonia,36,0,115,0
2020-03-15,Estonia,56,0,171,0
2020-03-16,Estonia,34,0,205,0
2020-03-17,Estonia,20,0,225,0
2020-03-18,Estonia,33,0,258,0
2020-03-19,Estonia,9,0,267,0
2020-03-20,Estonia,16,0,283,0
2020-03-21,Estonia,23,0,306,0
2020-03-22,Estonia,20,0,326,0
2020-03-23,Estonia,26,0,352,0
2020-03-24,Estonia,17,0,369,0
2020-03-25,Estonia,35,1,404,1
2020-03-26,Estonia,134,0,538,1
2020-03-27,Estonia,37,0,575,1
2020-03-28,Estonia,70,0,645,1
2020-03-29,Estonia,34,2,679,3
2020-03-30,Estonia,36,0,715,3
2020-03-31,Estonia,30,1,745,4
2020-04-01,Estonia,34,1,779,5
2020-04-02,Estonia,79,6,858,11
2020-04-03,Estonia,103,1,961,12
2020-04-04,Estonia,78,1,1039,13
2020-04-05,Estonia,58,2,1097,15
2020-04-06,Estonia,11,4,1108,19
2020-04-07,Estonia,41,2,1149,21
2020-04-08,Estonia,36,3,1185,24
2020-04-09,Estonia,22,0,1207,24
2020-04-10,Estonia,51,0,1258,24
2020-04-11,Estonia,46,0,1304,24
2020-04-12,Estonia,5,1,1309,25
2020-04-13,Estonia,23,3,1332,28
2020-04-14,Estonia,41,3,1373,31
2020-04-15,Estonia,27,4,1400,35
2020-04-16,Estonia,34,1,1434,36
2020-04-17,Estonia,25,2,1459,38
2020-04-18,Estonia,53,0,1512,38
2020-04-19,Estonia,16,2,1528,40
2020-04-20,Estonia,7,0,1535,40
2020-04-21,Estonia,17,3,1552,43
2020-04-22,Estonia,7,1,1559,44
2020-04-23,Estonia,33,1,1592,45
2020-04-24,Estonia,13,1,1605,46
2020-04-25,Estonia,30,0,1635,46
2020-04-26,Estonia,8,3,1643,49
2020-04-27,Estonia,4,1,1647,50
2020-04-28,Estonia,13,0,1660,50
2020-04-29,Estonia,6,0,1666,50
2020-04-30,Estonia,23,2,1689,52
2020-05-01,Estonia,5,0,1694,52
2020-05-02,Estonia,5,1,1699,53
2020-05-03,Estonia,1,2,1700,55
2020-05-04,Estonia,3,0,1703,55
2020-05-05,Estonia,8,0,1711,55
2020-05-06,Estonia,2,0,1713,55
2020-05-07,Estonia,7,1,1720,56
2020-05-08,Estonia,5,0,1725,56
2020-05-09,Estonia,8,4,1733,60
2020-05-10,Estonia,6,0,1739,60
2020-05-11,Estonia,2,1,1741,61
2020-05-12,Estonia,5,0,1746,61
2020-05-13,Estonia,5,0,1751,61
2020-05-14,Estonia,7,1,1758,62
2020-05-15,Estonia,8,1,1766,63
2020-05-16,Estonia,4,0,1770,63
2020-05-17,Estonia,4,0,1774,63
2020-05-18,Estonia,10,1,1784,64
2020-05-19,Estonia,7,0,1791,64
2020-05-20,Estonia,3,0,1794,64
2020-05-21,Estonia,6,0,1800,64
2020-05-22,Estonia,7,0,1807,64
2020-05-23,Estonia,14,0,1821,64
2020-05-24,Estonia,2,0,1823,64
2020-05-25,Estonia,1,1,1824,65
2020-05-26,Estonia,10,0,1834,65
2020-05-27,Estonia,6,1,1840,66
2020-05-28,Estonia,11,0,1851,66
2020-05-29,Estonia,8,1,1859,67
2020-05-30,Estonia,6,0,1865,67
2020-05-31,Estonia,4,1,1869,68
2020-06-01,Estonia,1,0,1870,68
2020-06-02,Estonia,0,0,1870,68
2020-06-03,Estonia,10,1,1880,69
2020-06-04,Estonia,10,0,1890,69
2020-06-05,Estonia,20,0,1910,69
2020-06-06,Estonia,21,0,1931,69
2020-06-07,Estonia,8,0,1939,69
2020-06-08,Estonia,1,0,1940,69
2020-06-09,Estonia,7,0,1947,69
2020-06-10,Estonia,11,0,1958,69
2020-06-11,Estonia,7,0,1965,69
2020-06-12,Estonia,5,0,1970,69
2020-06-13,Estonia,3,0,1973,69
2020-06-14,Estonia,0,0,1973,69
2020-06-15,Estonia,1,0,1974,69
2020-06-16,Estonia,1,0,1975,69
2020-06-17,Estonia,2,0,1977,69
2020-06-18,Estonia,0,0,1977,69
2020-06-19,Estonia,2,0,1979,69
2020-06-20,Estonia,2,0,1981,69
2020-06-21,Estonia,0,0,1981,69
2020-06-22,Estonia,0,0,1981,69
2020-06-23,Estonia,1,0,1982,69
2020-06-24,Estonia,1,0,1983,69
2020-06-25,Estonia,1,0,1984,69
2020-06-26,Estonia,2,0,1986,69
2020-06-27,Estonia,0,0,1986,69
2020-06-28,Estonia,1,0,1987,69
2020-06-29,Estonia,0,0,1987,69
2020-06-30,Estonia,2,0,1989,69
2020-07-01,Estonia,0,0,1989,69
2020-07-02,Estonia,1,0,1990,69
2020-07-03,Estonia,1,0,1991,69
2020-07-04,Estonia,2,0,1993,69
2020-07-05,Estonia,0,0,1993,69
2020-07-06,Estonia,1,0,1994,69
2020-07-07,Estonia,1,0,1995,69
2020-07-08,Estonia,8,0,2003,69
2020-07-09,Estonia,8,0,2011,69
2020-07-10,Estonia,2,0,2013,69
2020-07-11,Estonia,1,0,2014,69
2020-07-12,Estonia,0,0,2014,69
2020-07-13,Estonia,0,0,2014,69
2020-07-14,Estonia,1,0,2015,69
2020-07-15,Estonia,1,0,2016,69
2020-07-16,Estonia,0,0,2016,69
2020-07-17,Estonia,4,0,2020,69
2020-07-18,Estonia,1,0,2021,69
2020-07-19,Estonia,0,0,2021,69
2020-07-20,Estonia,0,0,2021,69
2020-07-21,Estonia,1,0,2022,69
2020-07-22,Estonia,3,0,2025,69
2020-07-23,Estonia,2,0,2027,69
2020-07-24,Estonia,1,0,2028,69
2020-07-25,Estonia,5,0,2033,69
2020-07-26,Estonia,1,0,2034,69
2020-07-27,Estonia,0,0,2034,69
2020-07-28,Estonia,4,0,2038,69
2020-07-29,Estonia,4,0,2042,69
2020-07-30,Estonia,9,0,2051,69
2020-07-31,Estonia,13,0,2064,69
2020-08-01,Estonia,8,0,2072,69
2020-08-02,Estonia,7,-6,2079,63
2020-08-03,Estonia,1,0,2080,63
2020-08-04,Estonia,11,0,2091,63
2020-08-05,Estonia,22,0,2113,63
2020-08-06,Estonia,11,0,2124,63
2020-08-07,Estonia,9,0,2133,63
2020-08-08,Estonia,14,0,2147,63
2020-08-09,Estonia,5,0,2152,63
2020-08-10,Estonia,6,0,2158,63
2020-08-11,Estonia,9,0,2167,63
2020-08-12,Estonia,7,0,2174,63
2020-08-13,Estonia,0,0,2174,63
2020-08-14,Estonia,3,0,2177,63
2020-08-15,Estonia,7,0,2184,63
2020-08-16,Estonia,6,0,2190,63
2020-08-17,Estonia,2,0,2192,63
2020-08-18,Estonia,8,0,2200,63
2020-08-19,Estonia,7,0,2207,63
2020-08-20,Estonia,20,0,2227,63
2020-08-21,Estonia,17,0,2244,63
2020-08-22,Estonia,21,0,2265,63
2020-08-23,Estonia,7,0,2272,63
2020-08-24,Estonia,3,1,2275,64
2020-08-25,Estonia,19,0,2294,64
2020-08-26,Estonia,17,0,2311,64
2020-08-27,Estonia,14,0,2325,64
2020-08-28,Estonia,18,0,2343,64
2020-08-29,Estonia,20,0,2363,64
2020-08-30,Estonia,10,0,2373,64
2020-08-31,Estonia,2,0,2375,64
2020-09-01,Estonia,20,0,2395,64
2020-09-02,Estonia,20,0,2415,64
2020-09-03,Estonia,26,0,2441,64
2020-09-04,Estonia,15,0,2456,64
2020-09-05,Estonia,35,0,2491,64
2020-09-06,Estonia,25,0,2516,64
2020-09-07,Estonia,16,0,2532,64
2020-09-08,Estonia,32,0,2564,64
2020-09-09,Estonia,21,0,2585,64
2020-09-10,Estonia,15,0,2600,64
2020-09-11,Estonia,32,0,2632,64
2020-09-12,Estonia,23,0,2655,64
2020-09-13,Estonia,21,0,2676,64
2020-09-14,Estonia,22,0,2698,64
2020-09-15,Estonia,24,0,2722,64
2020-09-16,Estonia,34,0,2756,64
2020-09-17,Estonia,22,0,2778,64
2020-09-18,Estonia,36,0,2814,64
2020-09-19,Estonia,61,0,2875,64
2020-09-20,Estonia,49,0,2924,64
2020-09-21,Estonia,17,0,2941,64
2020-09-22,Estonia,35,0,2976,64
2020-09-23,Estonia,57,0,3033,64
2020-09-24,Estonia,43,0,3076,64
2020-09-25,Estonia,42,0,3118,64
2020-09-26,Estonia,47,0,3165,64
2020-09-27,Estonia,35,0,3200,64
2020-09-28,Estonia,67,0,3267,64
2020-09-29,Estonia,48,0,3315,64
2020-09-30,Estonia,56,0,3371,64
2020-10-01,Estonia,79,1,3450,65
2020-10-02,Estonia,57,1,3507,66
2020-10-03,Estonia,70,1,3577,67
2020-10-04,Estonia,30,0,3607,67
2020-10-05,Estonia,10,0,3617,67
2020-10-06,Estonia,42,0,3659,67
2020-10-07,Estonia,56,0,3715,67
2020-10-08,Estonia,45,0,3760,67
2020-10-09,Estonia,49,1,3809,68
2020-10-10,Estonia,37,0,3846,68
2020-10-11,Estonia,19,0,3865,68
2020-10-12,Estonia,18,0,3883,68
2020-10-13,Estonia,25,0,3908,68
2020-10-14,Estonia,39,0,3947,68
2020-10-15,Estonia,33,0,3980,68
2020-10-16,Estonia,37,0,4017,68
2020-10-17,Estonia,35,0,4052,68
2020-10-18,Estonia,26,0,4078,68
2020-10-19,Estonia,7,0,4085,68
2020-10-20,Estonia,42,3,4127,71
2020-10-21,Estonia,44,0,4171,71
2020-10-22,Estonia,76,0,4247,71
2020-10-23,Estonia,53,2,4300,73
2020-10-24,Estonia,51,0,4351,73
2020-10-25,Estonia,60,0,4411,73
2020-10-26,Estonia,17,0,4428,73
2020-10-27,Estonia,37,0,4465,73
2020-10-28,Estonia,125,0,4590,73
2020-10-29,Estonia,81,0,4671,73
2020-10-30,Estonia,100,0,4771,73
2020-10-31,Estonia,134,0,4905,73
2020-11-01,Estonia,80,0,4985,73
2020-11-02,Estonia,61,0,5046,73
2020-11-03,Estonia,79,0,5125,73
2020-11-04,Estonia,208,0,5333,73
2020-11-05,Estonia,131,0,5464,73
2020-11-06,Estonia,241,0,5705,73
2020-11-07,Estonia,228,0,5933,73
2020-11-08,Estonia,192,2,6125,75
2020-11-09,Estonia,125,1,6250,76
2020-11-10,Estonia,126,0,6376,76
2020-11-11,Estonia,132,0,6508,76
2020-11-12,Estonia,373,0,6881,76
2020-11-13,Estonia,267,4,7148,80
2020-11-14,Estonia,264,0,7412,80
2020-11-15,Estonia,225,1,7637,81
2020-11-16,Estonia,211,0,7848,81
2020-11-17,Estonia,185,3,8033,84
2020-11-18,Estonia,271,1,8304,85
2020-11-19,Estonia,411,1,8715,86
2020-11-20,Estonia,361,1,9076,87
2020-11-21,Estonia,299,0,9375,87
2020-11-22,Estonia,349,1,9724,88
2020-11-23,Estonia,232,4,9956,92
2020-11-24,Estonia,203,2,10159,94
2020-11-25,Estonia,382,3,10541,97
2020-11-26,Estonia,414,2,10955,99
2020-11-27,Estonia,368,5,11323,104
2020-11-28,Estonia,375,5,11698,109
2020-11-29,Estonia,354,3,12052,112
2020-11-30,Estonia,256,6,12308,118
2020-12-01,Estonia,189,3,12497,121
2020-12-02,Estonia,522,1,13019,122
2020-12-03,Estonia,450,1,13469,123
2020-12-04,Estonia,470,2,13939,125
2020-12-05,Estonia,561,1,14500,126
2020-12-06,Estonia,478,5,14978,131
2020-12-07,Estonia,248,3,15226,134
2020-12-08,Estonia,284,3,15510,137
2020-12-09,Estonia,544,2,16054,139
2020-12-10,Estonia,544,2,16598,141
2020-12-11,Estonia,358,1,16956,142
2020-12-12,Estonia,757,6,17713,148
2020-12-13,Estonia,342,1,18055,149
2020-12-14,Estonia,330,5,18385,154
2020-12-15,Estonia,297,3,18682,157
2020-12-16,Estonia,589,3,19271,160
2020-12-17,Estonia,733,4,20004,164
2020-12-18,Estonia,654,4,20658,168
2020-12-19,Estonia,561,2,21219,170
2020-12-20,Estonia,575,4,21794,174
2020-12-21,Estonia,289,7,22083,181
2020-12-22,Estonia,564,6,22647,187
2020-12-23,Estonia,662,5,23309,192
2020-12-24,Estonia,700,3,24009,195
2020-12-25,Estonia,573,7,24582,202
2020-12-26,Estonia,445,2,25027,204
2020-12-27,Estonia,365,0,25392,204
2020-12-28,Estonia,416,9,25808,213
2020-12-29,Estonia,475,8,26283,221
2020-12-30,Estonia,973,5,27256,226
2020-12-31,Estonia,734,3,27990,229
2021-01-01,Estonia,416,5,28406,234
2021-01-02,Estonia,383,7,28789,241
2021-01-03,Estonia,342,3,29131,244
2021-01-04,Estonia,390,7,29521,251
2021-01-05,Estonia,429,7,29950,258
2021-01-06,Estonia,717,3,30667,261
2021-01-07,Estonia,1084,4,31751,265
2021-01-08,Estonia,786,5,32537,270
2021-01-09,Estonia,552,8,33089,278
2021-01-10,Estonia,427,5,33516,283
2021-01-11,Estonia,289,4,33805,287
2021-01-12,Estonia,333,5,34138,292
2021-01-13,Estonia,853,9,34991,301
2021-01-14,Estonia,630,10,35621,311
2021-01-15,Estonia,475,5,36096,316
2021-01-16,Estonia,595,4,36691,320
2021-01-17,Estonia,388,5,37079,325
2021-01-18,Estonia,265,8,37344,333
2021-01-19,Estonia,597,11,37941,344
2021-01-20,Estonia,603,5,38544,349
2021-01-21,Estonia,668,5,39212,354
2021-01-22,Estonia,489,4,39701,358
2021-01-23,Estonia,483,10,40184,368
2021-01-24,Estonia,532,8,40716,376
2021-01-25,Estonia,259,7,40975,383
2021-01-26,Estonia,355,9,41330,392
2021-01-27,Estonia,636,6,41966,398
2021-01-28,Estonia,690,8,42656,406
2021-01-29,Estonia,687,3,43343,409
2021-01-30,Estonia,404,2,43747,411
2021-01-31,Estonia,461,8,44208,419
2021-02-01,Estonia,367,3,44575,422
2021-02-02,Estonia,403,2,44978,424
2021-02-03,Estonia,685,9,45663,433
2021-02-04,Estonia,671,10,46334,443
2021-02-05,Estonia,591,4,46925,447
2021-02-06,Estonia,587,9,47512,456
2021-02-07,Estonia,416,5,47928,461
2021-02-08,Estonia,339,5,48267,466
2021-02-09,Estonia,542,8,48809,474
2021-02-10,Estonia,796,3,49605,477
2021-02-11,Estonia,675,3,50280,480
2021-02-12,Estonia,713,6,50993,486
2021-02-13,Estonia,756,5,51749,491
2021-02-14,Estonia,667,4,52416,495
2021-02-15,Estonia,411,6,52827,501
2021-02-16,Estonia,617,7,53444,508
2021-02-17,Estonia,856,2,54300,510
2021-02-18,Estonia,995,4,55295,514
2021-02-19,Estonia,951,4,56246,518
2021-02-20,Estonia,787,10,57033,528
2021-02-21,Estonia,583,7,57616,535
2021-02-22,Estonia,829,5,58445,540
2021-02-23,Estonia,962,13,59407,553
2021-02-24,Estonia,1068,4,60475,557
2021-02-25,Estonia,1152,10,61627,567
2021-02-26,Estonia,1203,8,62830,575
2021-02-27,Estonia,1569,9,64399,584
2021-02-28,Estonia,1201,5,65600,589
2021-03-01,Estonia,1028,9,66628,598
2021-03-02,Estonia,1111,7,67739,605
2021-03-03,Estonia,1454,10,69193,615
2021-03-04,Estonia,1417,8,70610,623
2021-03-05,Estonia,1534,14,72144,637
2021-03-06,Estonia,1540,7,73684,644
2021-03-07,Estonia,1319,9,75003,653
2021-03-08,Estonia,1180,14,76183,667
2021-03-09,Estonia,1308,2,77491,669
2021-03-10,Estonia,1482,8,78973,677
2021-03-11,Estonia,1956,9,80929,686
2021-03-12,Estonia,1357,9,82286,695
2021-03-13,Estonia,1586,15,83872,710
2021-03-14,Estonia,935,9,84807,719
2021-03-15,Estonia,1279,9,86086,728
2021-03-16,Estonia,1462,11,87548,739
2021-03-17,Estonia,1783,6,89331,745
2021-03-18,Estonia,1700,13,91031,758
2021-03-19,Estonia,1749,11,92780,769
2021-03-20,Estonia,1248,11,94028,780
2021-03-21,Estonia,1373,7,95401,787
2021-03-22,Estonia,993,10,96394,797
2021-03-23,Estonia,1062,12,97456,809
2021-03-24,Estonia,1552,14,99008,823
2021-03-25,Estonia,1429,13,100437,836
2021-03-26,Estonia,1150,11,101587,847
2021-03-27,Estonia,1151,13,102738,860
2021-03-28,Estonia,892,8,103630,868
2021-03-29,Estonia,584,11,104214,879
2021-03-30,Estonia,1202,17,105416,896
2021-03-31,Estonia,1008,6,106424,902
2021-04-01,Estonia,829,6,107253,908
2021-04-02,Estonia,1165,14,108418,922
2021-04-03,Estonia,519,9,108937,931
2021-04-04,Estonia,462,10,109399,941
2021-04-05,Estonia,382,9,109781,950
2021-04-06,Estonia,899,14,110680,964
2021-04-07,Estonia,984,12,111664,976
2021-04-08,Estonia,757,14,112421,990
2020-03-14,Eswatini,1,0,1,0
2020-03-15,Eswatini,0,0,1,0
2020-03-16,Eswatini,0,0,1,0
2020-03-17,Eswatini,0,0,1,0
2020-03-18,Eswatini,0,0,1,0
2020-03-19,Eswatini,0,0,1,0
2020-03-20,Eswatini,0,0,1,0
2020-03-21,Eswatini,0,0,1,0
2020-03-22,Eswatini,3,0,4,0
2020-03-23,Eswatini,0,0,4,0
2020-03-24,Eswatini,0,0,4,0
2020-03-25,Eswatini,0,0,4,0
2020-03-26,Eswatini,2,0,6,0
2020-03-27,Eswatini,3,0,9,0
2020-03-28,Eswatini,0,0,9,0
2020-03-29,Eswatini,0,0,9,0
2020-03-30,Eswatini,0,0,9,0
2020-03-31,Eswatini,0,0,9,0
2020-04-01,Eswatini,0,0,9,0
2020-04-02,Eswatini,0,0,9,0
2020-04-03,Eswatini,0,0,9,0
2020-04-04,Eswatini,0,0,9,0
2020-04-05,Eswatini,0,0,9,0
2020-04-06,Eswatini,1,0,10,0
2020-04-07,Eswatini,0,0,10,0
2020-04-08,Eswatini,2,0,12,0
2020-04-09,Eswatini,0,0,12,0
2020-04-10,Eswatini,0,0,12,0
2020-04-11,Eswatini,0,0,12,0
2020-04-12,Eswatini,2,0,14,0
2020-04-13,Eswatini,1,0,15,0
2020-04-14,Eswatini,0,0,15,0
2020-04-15,Eswatini,0,0,15,0
2020-04-16,Eswatini,1,1,16,1
2020-04-17,Eswatini,0,0,16,1
2020-04-18,Eswatini,6,0,22,1
2020-04-19,Eswatini,0,0,22,1
2020-04-20,Eswatini,2,0,24,1
2020-04-21,Eswatini,7,0,31,1
2020-04-22,Eswatini,0,0,31,1
2020-04-23,Eswatini,0,0,31,1
2020-04-24,Eswatini,5,0,36,1
2020-04-25,Eswatini,20,0,56,1
2020-04-26,Eswatini,3,0,59,1
2020-04-27,Eswatini,6,0,65,1
2020-04-28,Eswatini,6,0,71,1
2020-04-29,Eswatini,20,0,91,1
2020-04-30,Eswatini,9,0,100,1
2020-05-01,Eswatini,6,0,106,1
2020-05-02,Eswatini,2,0,108,1
2020-05-03,Eswatini,4,0,112,1
2020-05-04,Eswatini,4,0,116,1
2020-05-05,Eswatini,3,0,119,1
2020-05-06,Eswatini,4,1,123,2
2020-05-07,Eswatini,30,0,153,2
2020-05-08,Eswatini,6,0,159,2
2020-05-09,Eswatini,4,0,163,2
2020-05-10,Eswatini,9,0,172,2
2020-05-11,Eswatini,3,0,175,2
2020-05-12,Eswatini,9,0,184,2
2020-05-13,Eswatini,3,0,187,2
2020-05-14,Eswatini,0,0,187,2
2020-05-15,Eswatini,3,0,190,2
2020-05-16,Eswatini,12,0,202,2
2020-05-17,Eswatini,1,0,203,2
2020-05-18,Eswatini,2,0,205,2
2020-05-19,Eswatini,3,0,208,2
2020-05-20,Eswatini,9,0,217,2
2020-05-21,Eswatini,3,0,220,2
2020-05-22,Eswatini,5,0,225,2
2020-05-23,Eswatini,13,0,238,2
2020-05-24,Eswatini,12,0,250,2
2020-05-25,Eswatini,6,0,256,2
2020-05-26,Eswatini,5,0,261,2
2020-05-27,Eswatini,11,0,272,2
2020-05-28,Eswatini,7,0,279,2
2020-05-29,Eswatini,0,0,279,2
2020-05-30,Eswatini,4,0,283,2
2020-05-31,Eswatini,2,0,285,2
2020-06-01,Eswatini,8,1,293,3
2020-06-02,Eswatini,1,0,294,3
2020-06-03,Eswatini,1,0,295,3
2020-06-04,Eswatini,5,0,300,3
2020-06-05,Eswatini,5,0,305,3
2020-06-06,Eswatini,17,0,322,3
2020-06-07,Eswatini,11,0,333,3
2020-06-08,Eswatini,7,0,340,3
2020-06-09,Eswatini,31,0,371,3
2020-06-10,Eswatini,27,0,398,3
2020-06-11,Eswatini,51,0,449,3
2020-06-12,Eswatini,23,0,472,3
2020-06-13,Eswatini,14,0,486,3
2020-06-14,Eswatini,4,1,490,4
2020-06-15,Eswatini,16,0,506,4
2020-06-16,Eswatini,14,0,520,4
2020-06-17,Eswatini,43,0,563,4
2020-06-18,Eswatini,23,0,586,4
2020-06-19,Eswatini,37,0,623,4
2020-06-20,Eswatini,4,1,627,5
2020-06-21,Eswatini,8,0,635,5
2020-06-22,Eswatini,8,1,643,6
2020-06-23,Eswatini,31,1,674,7
2020-06-24,Eswatini,16,0,690,7
2020-06-25,Eswatini,16,1,706,8
2020-06-26,Eswatini,22,0,728,8
2020-06-27,Eswatini,17,0,745,8
2020-06-28,Eswatini,36,3,781,11
2020-06-29,Eswatini,14,0,795,11
2020-06-30,Eswatini,17,0,812,11
2020-07-01,Eswatini,28,0,840,11
2020-07-02,Eswatini,33,0,873,11
2020-07-03,Eswatini,36,2,909,13
2020-07-04,Eswatini,45,0,954,13
2020-07-05,Eswatini,34,0,988,13
2020-07-06,Eswatini,23,0,1011,13
2020-07-07,Eswatini,45,1,1056,14
2020-07-08,Eswatini,82,0,1138,14
2020-07-09,Eswatini,75,3,1213,17
2020-07-10,Eswatini,44,1,1257,18
2020-07-11,Eswatini,54,0,1311,18
2020-07-12,Eswatini,40,2,1351,20
2020-07-13,Eswatini,38,0,1389,20
2020-07-14,Eswatini,45,0,1434,20
2020-07-15,Eswatini,55,0,1489,20
2020-07-16,Eswatini,63,1,1552,21
2020-07-17,Eswatini,67,0,1619,21
2020-07-18,Eswatini,110,0,1729,21
2020-07-19,Eswatini,64,0,1793,21
2020-07-20,Eswatini,33,2,1826,23
2020-07-21,Eswatini,68,1,1894,24
2020-07-22,Eswatini,44,1,1938,25
2020-07-23,Eswatini,83,3,2021,28
2020-07-24,Eswatini,52,0,2073,28
2020-07-25,Eswatini,69,0,2142,28
2020-07-26,Eswatini,65,4,2207,32
2020-07-27,Eswatini,109,2,2316,34
2020-07-28,Eswatini,88,5,2404,39
2020-07-29,Eswatini,147,1,2551,40
2020-07-30,Eswatini,26,0,2577,40
2020-07-31,Eswatini,71,1,2648,41
2020-08-01,Eswatini,58,2,2706,43
2020-08-02,Eswatini,69,0,2775,43
2020-08-03,Eswatini,63,2,2838,45
2020-08-04,Eswatini,18,4,2856,49
2020-08-05,Eswatini,53,4,2909,53
2020-08-06,Eswatini,59,2,2968,55
2020-08-07,Eswatini,68,1,3036,56
2020-08-08,Eswatini,92,0,3128,56
2020-08-09,Eswatini,108,2,3236,58
2020-08-10,Eswatini,73,3,3309,61
2020-08-11,Eswatini,101,2,3410,63
2020-08-12,Eswatini,115,0,3525,63
2020-08-13,Eswatini,74,2,3599,65
2020-08-14,Eswatini,71,3,3670,68
2020-08-15,Eswatini,75,1,3745,69
2020-08-16,Eswatini,94,1,3839,70
2020-08-17,Eswatini,55,3,3894,73
2020-08-18,Eswatini,95,3,3989,76
2020-08-19,Eswatini,69,3,4058,79
2020-08-20,Eswatini,52,2,4110,81
2020-08-21,Eswatini,18,0,4128,81
2020-08-22,Eswatini,61,2,4189,83
2020-08-23,Eswatini,36,2,4225,85
2020-08-24,Eswatini,79,0,4304,85
2020-08-25,Eswatini,23,1,4327,86
2020-08-26,Eswatini,60,2,4387,88
2020-08-27,Eswatini,46,1,4433,89
2020-08-28,Eswatini,28,2,4461,91
2020-08-29,Eswatini,49,0,4510,91
2020-08-30,Eswatini,51,0,4561,91
2020-08-31,Eswatini,16,0,4577,91
2020-09-01,Eswatini,41,3,4618,94
2020-09-02,Eswatini,50,0,4668,94
2020-09-03,Eswatini,52,0,4720,94
2020-09-04,Eswatini,60,0,4780,94
2020-09-05,Eswatini,39,0,4819,94
2020-09-06,Eswatini,34,0,4853,94
2020-09-07,Eswatini,31,0,4884,94
2020-09-08,Eswatini,20,2,4904,96
2020-09-09,Eswatini,32,1,4936,97
2020-09-10,Eswatini,58,1,4994,98
2020-09-11,Eswatini,31,0,5025,98
2020-09-12,Eswatini,25,0,5050,98
2020-09-13,Eswatini,25,0,5075,98
2020-09-14,Eswatini,29,3,5104,101
2020-09-15,Eswatini,24,0,5128,101
2020-09-16,Eswatini,27,0,5155,101
2020-09-17,Eswatini,36,2,5191,103
2020-09-18,Eswatini,24,0,5215,103
2020-09-19,Eswatini,30,1,5245,104
2020-09-20,Eswatini,24,0,5269,104
2020-09-21,Eswatini,13,0,5282,104
2020-09-22,Eswatini,25,2,5307,106
2020-09-23,Eswatini,36,2,5343,108
2020-09-24,Eswatini,32,0,5375,108
2020-09-25,Eswatini,24,0,5399,108
2020-09-26,Eswatini,20,0,5419,108
2020-09-27,Eswatini,12,0,5431,108
2020-09-28,Eswatini,21,0,5452,108
2020-09-29,Eswatini,10,0,5462,108
2020-09-30,Eswatini,20,1,5482,109
2020-10-01,Eswatini,18,2,5500,111
2020-10-02,Eswatini,21,0,5521,111
2020-10-03,Eswatini,9,0,5530,111
2020-10-04,Eswatini,39,0,5569,111
2020-10-05,Eswatini,10,1,5579,112
2020-10-06,Eswatini,19,0,5598,112
2020-10-07,Eswatini,19,1,5617,113
2020-10-08,Eswatini,15,0,5632,113
2020-10-09,Eswatini,12,0,5644,113
2020-10-10,Eswatini,16,0,5660,113
2020-10-11,Eswatini,9,0,5669,113
2020-10-12,Eswatini,14,0,5683,113
2020-10-13,Eswatini,13,1,5696,114
2020-10-14,Eswatini,19,0,5715,114
2020-10-15,Eswatini,18,1,5733,115
2020-10-16,Eswatini,13,0,5746,115
2020-10-17,Eswatini,19,0,5765,115
2020-10-18,Eswatini,15,1,5780,116
2020-10-19,Eswatini,8,0,5788,116
2020-10-20,Eswatini,12,0,5800,116
2020-10-21,Eswatini,5,0,5805,116
2020-10-22,Eswatini,9,0,5814,116
2020-10-23,Eswatini,17,0,5831,116
2020-10-24,Eswatini,16,0,5847,116
2020-10-25,Eswatini,7,0,5854,116
2020-10-26,Eswatini,9,0,5863,116
2020-10-27,Eswatini,12,0,5875,116
2020-10-28,Eswatini,11,0,5886,116
2020-10-29,Eswatini,13,1,5899,117
2020-10-30,Eswatini,10,0,5909,117
2020-10-31,Eswatini,8,0,5917,117
2020-11-01,Eswatini,8,0,5925,117
2020-11-02,Eswatini,4,0,5929,117
2020-11-03,Eswatini,13,0,5942,117
2020-11-04,Eswatini,13,0,5955,117
2020-11-05,Eswatini,12,0,5967,117
2020-11-06,Eswatini,9,0,5976,117
2020-11-07,Eswatini,13,0,5989,117
2020-11-08,Eswatini,14,0,6003,117
2020-11-09,Eswatini,10,0,6013,117
2020-11-10,Eswatini,11,0,6024,117
2020-11-11,Eswatini,20,0,6044,117
2020-11-12,Eswatini,16,0,6060,117
2020-11-13,Eswatini,16,1,6076,118
2020-11-14,Eswatini,17,1,6093,119
2020-11-15,Eswatini,2,0,6095,119
2020-11-16,Eswatini,10,0,6105,119
2020-11-17,Eswatini,19,0,6124,119
2020-11-18,Eswatini,20,0,6144,119
2020-11-19,Eswatini,12,0,6156,119
2020-11-20,Eswatini,29,0,6185,119
2020-11-21,Eswatini,20,0,6205,119
2020-11-22,Eswatini,14,1,6219,120
2020-11-23,Eswatini,14,0,6233,120
2020-11-24,Eswatini,14,0,6247,120
2020-11-25,Eswatini,25,0,6272,120
2020-11-26,Eswatini,57,0,6329,120
2020-11-27,Eswatini,33,0,6362,120
2020-11-28,Eswatini,44,1,6406,121
2020-11-29,Eswatini,4,0,6410,121
2020-11-30,Eswatini,9,1,6419,122
2020-12-01,Eswatini,23,0,6442,122
2020-12-02,Eswatini,13,0,6455,122
2020-12-03,Eswatini,19,0,6474,122
2020-12-04,Eswatini,6,0,6480,122
2020-12-05,Eswatini,15,0,6495,122
2020-12-06,Eswatini,6,0,6501,122
2020-12-07,Eswatini,28,1,6529,123
2020-12-08,Eswatini,34,1,6563,124
2020-12-09,Eswatini,49,1,6612,125
2020-12-10,Eswatini,21,1,6633,126
2020-12-11,Eswatini,52,0,6685,126
2020-12-12,Eswatini,29,1,6714,127
2020-12-13,Eswatini,54,0,6768,127
2020-12-14,Eswatini,57,3,6825,130
2020-12-15,Eswatini,87,2,6912,132
2020-12-16,Eswatini,114,3,7026,135
2020-12-17,Eswatini,67,0,7093,135
2020-12-18,Eswatini,109,1,7202,136
2020-12-19,Eswatini,103,1,7305,137
2020-12-20,Eswatini,122,3,7427,140
2020-12-21,Eswatini,135,1,7562,141
2020-12-22,Eswatini,153,1,7715,142
2020-12-23,Eswatini,153,11,7868,153
2020-12-24,Eswatini,164,1,8032,154
2020-12-25,Eswatini,138,0,8170,154
2020-12-26,Eswatini,197,9,8367,163
2020-12-27,Eswatini,117,2,8484,165
2020-12-28,Eswatini,203,2,8687,167
2020-12-29,Eswatini,247,8,8934,175
2020-12-30,Eswatini,212,9,9146,184
2020-12-31,Eswatini,212,21,9358,205
2021-01-01,Eswatini,124,11,9482,216
2021-01-02,Eswatini,229,11,9711,227
2021-01-03,Eswatini,232,4,9943,231
2021-01-04,Eswatini,195,13,10138,244
2021-01-05,Eswatini,200,8,10338,252
2021-01-06,Eswatini,201,9,10539,261
2021-01-07,Eswatini,234,7,10773,268
2021-01-08,Eswatini,202,11,10975,279
2021-01-09,Eswatini,205,12,11180,291
2021-01-10,Eswatini,255,4,11435,295
2021-01-11,Eswatini,276,3,11711,298
2021-01-12,Eswatini,208,21,11919,319
2021-01-13,Eswatini,205,13,12124,332
2021-01-14,Eswatini,203,3,12327,335
2021-01-15,Eswatini,205,8,12532,343
2021-01-16,Eswatini,204,17,12736,360
2021-01-17,Eswatini,208,16,12944,376
2021-01-18,Eswatini,243,8,13187,384
2021-01-19,Eswatini,256,19,13443,403
2021-01-20,Eswatini,346,24,13789,427
2021-01-21,Eswatini,228,14,14017,441
2021-01-22,Eswatini,202,17,14219,458
2021-01-23,Eswatini,111,0,14330,458
2021-01-24,Eswatini,154,21,14484,479
2021-01-25,Eswatini,138,14,14622,493
2021-01-26,Eswatini,208,24,14830,517
2021-01-27,Eswatini,221,5,15051,522
2021-01-28,Eswatini,232,16,15283,538
2021-01-29,Eswatini,188,13,15471,551
2021-01-30,Eswatini,195,11,15666,562
2021-01-31,Eswatini,45,3,15711,565
2021-02-01,Eswatini,93,9,15804,574
2021-02-02,Eswatini,74,9,15878,583
2021-02-03,Eswatini,96,2,15974,585
2021-02-04,Eswatini,71,6,16045,591
2021-02-05,Eswatini,92,9,16137,600
2021-02-06,Eswatini,44,4,16181,604
2021-02-07,Eswatini,23,0,16204,604
2021-02-08,Eswatini,30,3,16234,607
2021-02-09,Eswatini,54,3,16288,610
2021-02-10,Eswatini,53,6,16341,616
2021-02-11,Eswatini,55,3,16396,619
2021-02-12,Eswatini,59,11,16455,630
2021-02-13,Eswatini,33,0,16488,630
2021-02-14,Eswatini,47,0,16535,630
2021-02-15,Eswatini,41,4,16576,634
2021-02-16,Eswatini,30,0,16606,634
2021-02-17,Eswatini,67,3,16673,637
2021-02-18,Eswatini,36,3,16709,640
2021-02-19,Eswatini,33,4,16742,644
2021-02-20,Eswatini,22,1,16764,645
2021-02-21,Eswatini,25,0,16789,645
2021-02-22,Eswatini,18,0,16807,645
2021-02-23,Eswatini,32,2,16839,647
2021-02-24,Eswatini,58,2,16897,649
2021-02-25,Eswatini,49,1,16946,650
2021-02-26,Eswatini,26,0,16972,650
2021-02-27,Eswatini,30,0,17002,650
2021-02-28,Eswatini,12,2,17014,652
2021-03-01,Eswatini,11,0,17025,652
2021-03-02,Eswatini,61,0,17086,652
2021-03-03,Eswatini,17,0,17103,652
2021-03-04,Eswatini,26,2,17129,654
2021-03-05,Eswatini,26,0,17155,654
2021-03-06,Eswatini,18,4,17173,658
2021-03-07,Eswatini,11,0,17184,658
2021-03-08,Eswatini,4,0,17188,658
2021-03-09,Eswatini,3,0,17191,658
2021-03-10,Eswatini,12,0,17203,658
2021-03-11,Eswatini,12,1,17215,659
2021-03-12,Eswatini,10,0,17225,659
2021-03-13,Eswatini,9,2,17234,661
2021-03-14,Eswatini,3,0,17237,661
2021-03-15,Eswatini,2,2,17239,663
2021-03-16,Eswatini,4,0,17243,663
2021-03-17,Eswatini,14,0,17257,663
2021-03-18,Eswatini,10,1,17267,664
2021-03-19,Eswatini,7,0,17274,664
2021-03-20,Eswatini,9,1,17283,665
2021-03-21,Eswatini,3,0,17286,665
2021-03-22,Eswatini,4,0,17290,665
2021-03-23,Eswatini,6,0,17296,665
2021-03-24,Eswatini,5,1,17301,666
2021-03-25,Eswatini,5,0,17306,666
2021-03-26,Eswatini,6,0,17312,666
2021-03-27,Eswatini,6,0,17318,666
2021-03-28,Eswatini,3,1,17321,667
2021-03-29,Eswatini,5,0,17326,667
2021-03-30,Eswatini,7,0,17333,667
2021-03-31,Eswatini,4,0,17337,667
2021-04-01,Eswatini,7,1,17344,668
2021-04-02,Eswatini,3,0,17347,668
2021-04-03,Eswatini,2,0,17349,668
2021-04-04,Eswatini,3,0,17352,668
2021-04-05,Eswatini,2,1,17354,669
2021-04-06,Eswatini,4,0,17358,669
2021-04-07,Eswatini,7,0,17365,669
2021-04-08,Eswatini,2,0,17367,669
2020-03-13,Ethiopia,1,0,1,0
2020-03-14,Ethiopia,0,0,1,0
2020-03-15,Ethiopia,0,0,1,0
2020-03-16,Ethiopia,4,0,5,0
2020-03-17,Ethiopia,0,0,5,0
2020-03-18,Ethiopia,1,0,6,0
2020-03-19,Ethiopia,0,0,6,0
2020-03-20,Ethiopia,3,0,9,0
2020-03-21,Ethiopia,0,0,9,0
2020-03-22,Ethiopia,2,0,11,0
2020-03-23,Ethiopia,0,0,11,0
2020-03-24,Ethiopia,1,0,12,0
2020-03-25,Ethiopia,0,0,12,0
2020-03-26,Ethiopia,0,0,12,0
2020-03-27,Ethiopia,4,0,16,0
2020-03-28,Ethiopia,0,0,16,0
2020-03-29,Ethiopia,5,0,21,0
2020-03-30,Ethiopia,2,0,23,0
2020-03-31,Ethiopia,3,0,26,0
2020-04-01,Ethiopia,3,0,29,0
2020-04-02,Ethiopia,0,0,29,0
2020-04-03,Ethiopia,6,0,35,0
2020-04-04,Ethiopia,3,0,38,0
2020-04-05,Ethiopia,5,2,43,2
2020-04-06,Ethiopia,1,0,44,2
2020-04-07,Ethiopia,8,0,52,2
2020-04-08,Ethiopia,3,0,55,2
2020-04-09,Ethiopia,1,0,56,2
2020-04-10,Ethiopia,9,1,65,3
2020-04-11,Ethiopia,4,0,69,3
2020-04-12,Ethiopia,2,0,71,3
2020-04-13,Ethiopia,3,0,74,3
2020-04-14,Ethiopia,8,0,82,3
2020-04-15,Ethiopia,3,0,85,3
2020-04-16,Ethiopia,7,0,92,3
2020-04-17,Ethiopia,4,0,96,3
2020-04-18,Ethiopia,9,0,105,3
2020-04-19,Ethiopia,3,0,108,3
2020-04-20,Ethiopia,3,0,111,3
2020-04-21,Ethiopia,3,0,114,3
2020-04-22,Ethiopia,2,0,116,3
2020-04-23,Ethiopia,0,0,116,3
2020-04-24,Ethiopia,1,0,117,3
2020-04-25,Ethiopia,5,0,122,3
2020-04-26,Ethiopia,1,0,123,3
2020-04-27,Ethiopia,1,0,124,3
2020-04-28,Ethiopia,2,0,126,3
2020-04-29,Ethiopia,4,0,130,3
2020-04-30,Ethiopia,1,0,131,3
2020-05-01,Ethiopia,2,0,133,3
2020-05-02,Ethiopia,0,0,133,3
2020-05-03,Ethiopia,2,0,135,3
2020-05-04,Ethiopia,5,0,140,3
2020-05-05,Ethiopia,5,1,145,4
2020-05-06,Ethiopia,17,0,162,4
2020-05-07,Ethiopia,29,0,191,4
2020-05-08,Ethiopia,3,0,194,4
2020-05-09,Ethiopia,16,1,210,5
2020-05-10,Ethiopia,29,0,239,5
2020-05-11,Ethiopia,11,0,250,5
2020-05-12,Ethiopia,11,0,261,5
2020-05-13,Ethiopia,2,0,263,5
2020-05-14,Ethiopia,9,0,272,5
2020-05-15,Ethiopia,15,0,287,5
2020-05-16,Ethiopia,19,0,306,5
2020-05-17,Ethiopia,11,0,317,5
2020-05-18,Ethiopia,35,0,352,5
2020-05-19,Ethiopia,13,0,365,5
2020-05-20,Ethiopia,24,0,389,5
2020-05-21,Ethiopia,10,0,399,5
2020-05-22,Ethiopia,34,0,433,5
2020-05-23,Ethiopia,61,0,494,5
2020-05-24,Ethiopia,88,0,582,5
2020-05-25,Ethiopia,73,0,655,5
2020-05-26,Ethiopia,46,1,701,6
2020-05-27,Ethiopia,30,0,731,6
2020-05-28,Ethiopia,100,1,831,7
2020-05-29,Ethiopia,137,1,968,8
2020-05-30,Ethiopia,95,0,1063,8
2020-05-31,Ethiopia,109,3,1172,11
2020-06-01,Ethiopia,85,1,1257,12
2020-06-02,Ethiopia,87,2,1344,14
2020-06-03,Ethiopia,142,3,1486,17
2020-06-04,Ethiopia,150,1,1636,18
2020-06-05,Ethiopia,169,1,1805,19
2020-06-06,Ethiopia,129,1,1934,20
2020-06-07,Ethiopia,86,7,2020,27
2020-06-08,Ethiopia,136,0,2156,27
2020-06-09,Ethiopia,180,5,2336,32
2020-06-10,Ethiopia,170,3,2506,35
2020-06-11,Ethiopia,164,5,2670,40
2020-06-12,Ethiopia,245,7,2915,47
2020-06-13,Ethiopia,251,8,3166,55
2020-06-14,Ethiopia,179,2,3345,57
2020-06-15,Ethiopia,176,3,3521,60
2020-06-16,Ethiopia,109,1,3630,61
2020-06-17,Ethiopia,129,2,3759,63
2020-06-18,Ethiopia,195,2,3954,65
2020-06-19,Ethiopia,116,7,4070,72
2020-06-20,Ethiopia,399,0,4469,72
2020-06-21,Ethiopia,63,2,4532,74
2020-06-22,Ethiopia,131,1,4663,75
2020-06-23,Ethiopia,185,0,4848,75
2020-06-24,Ethiopia,186,3,5034,78
2020-06-25,Ethiopia,141,3,5175,81
2020-06-26,Ethiopia,250,8,5425,89
2020-06-27,Ethiopia,145,5,5570,94
2020-06-28,Ethiopia,119,4,5689,98
2020-06-29,Ethiopia,157,5,5846,103
2020-06-30,Ethiopia,0,0,5846,103
2020-07-01,Ethiopia,0,0,5846,103
2020-07-02,Ethiopia,0,0,5846,103
2020-07-03,Ethiopia,0,0,5846,103
2020-07-04,Ethiopia,0,0,5846,103
2020-07-05,Ethiopia,0,0,5846,103
2020-07-06,Ethiopia,0,0,5846,103
2020-07-07,Ethiopia,0,0,5846,103
2020-07-08,Ethiopia,928,17,6774,120
2020-07-09,Ethiopia,199,0,6973,120
2020-07-10,Ethiopia,147,4,7120,124
2020-07-11,Ethiopia,282,0,7402,124
2020-07-12,Ethiopia,158,3,7560,127
2020-07-13,Ethiopia,206,1,7766,128
2020-07-14,Ethiopia,203,11,7969,139
2020-07-15,Ethiopia,212,7,8181,146
2020-07-16,Ethiopia,294,2,8475,148
2020-07-17,Ethiopia,328,2,8803,150
2020-07-18,Ethiopia,344,13,9147,163
2020-07-19,Ethiopia,356,4,9503,167
2020-07-20,Ethiopia,704,3,10207,170
2020-07-21,Ethiopia,865,10,11072,180
2020-07-22,Ethiopia,452,8,11524,188
2020-07-23,Ethiopia,409,9,11933,197
2020-07-24,Ethiopia,760,3,12693,200
2020-07-25,Ethiopia,555,9,13248,209
2020-07-26,Ethiopia,720,14,13968,223
2020-07-27,Ethiopia,579,5,14547,228
2020-07-28,Ethiopia,653,11,15200,239
2020-07-29,Ethiopia,610,14,15810,253
2020-07-30,Ethiopia,805,10,16615,263
2020-07-31,Ethiopia,915,11,17530,274
2020-08-01,Ethiopia,469,10,17999,284
2020-08-02,Ethiopia,707,26,18706,310
2020-08-03,Ethiopia,583,26,19289,336
2020-08-04,Ethiopia,588,7,19877,343
2020-08-05,Ethiopia,459,13,20336,356
2020-08-06,Ethiopia,564,9,20900,365
2020-08-07,Ethiopia,552,15,21452,380
2020-08-08,Ethiopia,801,10,22253,390
2020-08-09,Ethiopia,565,17,22818,407
2020-08-10,Ethiopia,773,13,23591,420
2020-08-11,Ethiopia,584,20,24175,440
2020-08-12,Ethiopia,943,23,25118,463
2020-08-13,Ethiopia,1086,16,26204,479
2020-08-14,Ethiopia,1038,13,27242,492
2020-08-15,Ethiopia,1652,17,28894,509
2020-08-16,Ethiopia,982,19,29876,528
2020-08-17,Ethiopia,1460,16,31336,544
2020-08-18,Ethiopia,1386,28,32722,572
2020-08-19,Ethiopia,1336,28,34058,600
2020-08-20,Ethiopia,1778,20,35836,620
2020-08-21,Ethiopia,1829,17,37665,637
2020-08-22,Ethiopia,1368,25,39033,662
2020-08-23,Ethiopia,1638,16,40671,678
2020-08-24,Ethiopia,1472,14,42143,692
2020-08-25,Ethiopia,1545,17,43688,709
2020-08-26,Ethiopia,1533,16,45221,725
2020-08-27,Ethiopia,1186,20,46407,745
2020-08-28,Ethiopia,1733,13,48140,758
2020-08-29,Ethiopia,1514,12,49654,770
2020-08-30,Ethiopia,1468,23,51122,793
2020-08-31,Ethiopia,1009,16,52131,809
2020-09-01,Ethiopia,1173,19,53304,828
2020-09-02,Ethiopia,1105,18,54409,846
2020-09-03,Ethiopia,804,10,55213,856
2020-09-04,Ethiopia,1303,24,56516,880
2020-09-05,Ethiopia,950,17,57466,897
2020-09-06,Ethiopia,1206,21,58672,918
2020-09-07,Ethiopia,976,15,59648,933
2020-09-08,Ethiopia,1136,16,60784,949
2020-09-09,Ethiopia,916,17,61700,966
2020-09-10,Ethiopia,878,8,62578,974
2020-09-11,Ethiopia,789,12,63367,986
2020-09-12,Ethiopia,521,10,63888,996
2020-09-13,Ethiopia,413,17,64301,1013
2020-09-14,Ethiopia,485,9,64786,1022
2020-09-15,Ethiopia,700,13,65486,1035
2020-09-16,Ethiopia,738,10,66224,1045
2020-09-17,Ethiopia,689,15,66913,1060
2020-09-18,Ethiopia,602,12,67515,1072
2020-09-19,Ethiopia,616,17,68131,1089
2020-09-20,Ethiopia,689,7,68820,1096
2020-09-21,Ethiopia,889,12,69709,1108
2020-09-22,Ethiopia,713,19,70422,1127
2020-09-23,Ethiopia,661,14,71083,1141
2020-09-24,Ethiopia,604,7,71687,1148
2020-09-25,Ethiopia,486,7,72173,1155
2020-09-26,Ethiopia,527,10,72700,1165
2020-09-27,Ethiopia,632,5,73332,1170
2020-09-28,Ethiopia,612,7,73944,1177
2020-09-29,Ethiopia,640,14,74584,1191
2020-09-30,Ethiopia,784,7,75368,1198
2020-10-01,Ethiopia,730,7,76098,1205
2020-10-02,Ethiopia,890,3,76988,1208
2020-10-03,Ethiopia,872,6,77860,1214
2020-10-04,Ethiopia,959,8,78819,1222
2020-10-05,Ethiopia,618,8,79437,1230
2020-10-06,Ethiopia,566,8,80003,1238
2020-10-07,Ethiopia,892,17,80895,1255
2020-10-08,Ethiopia,902,7,81797,1262
2020-10-09,Ethiopia,865,9,82662,1271
2020-10-10,Ethiopia,767,6,83429,1277
2020-10-11,Ethiopia,866,10,84295,1287
2020-10-12,Ethiopia,841,14,85136,1301
2020-10-13,Ethiopia,582,4,85718,1305
2020-10-14,Ethiopia,712,7,86430,1312
2020-10-15,Ethiopia,739,13,87169,1325
2020-10-16,Ethiopia,665,12,87834,1337
2020-10-17,Ethiopia,600,9,88434,1346
2020-10-18,Ethiopia,703,6,89137,1352
2020-10-19,Ethiopia,723,13,89860,1365
2020-10-20,Ethiopia,630,6,90490,1371
2020-10-21,Ethiopia,628,13,91118,1384
2020-10-22,Ethiopia,575,12,91693,1396
2020-10-23,Ethiopia,536,4,92229,1400
2020-10-24,Ethiopia,629,19,92858,1419
2020-10-25,Ethiopia,485,7,93343,1426
2020-10-26,Ethiopia,364,11,93707,1437
2020-10-27,Ethiopia,511,8,94218,1445
2020-10-28,Ethiopia,602,6,94820,1451
2020-10-29,Ethiopia,481,6,95301,1457
2020-10-30,Ethiopia,488,7,95789,1464
2020-10-31,Ethiopia,380,5,96169,1469
2020-11-01,Ethiopia,414,9,96583,1478
2020-11-02,Ethiopia,359,11,96942,1489
2020-11-03,Ethiopia,560,5,97502,1494
2020-11-04,Ethiopia,379,9,97881,1503
2020-11-05,Ethiopia,510,5,98391,1508
2020-11-06,Ethiopia,355,4,98746,1512
2020-11-07,Ethiopia,455,6,99201,1518
2020-11-08,Ethiopia,474,5,99675,1523
2020-11-09,Ethiopia,307,7,99982,1530
2020-11-10,Ethiopia,345,7,100327,1537
2020-11-11,Ethiopia,400,8,100727,1545
2020-11-12,Ethiopia,521,9,101248,1554
2020-11-13,Ethiopia,509,4,101757,1558
2020-11-14,Ethiopia,564,7,102321,1565
2020-11-15,Ethiopia,399,4,102720,1569
2020-11-16,Ethiopia,336,12,103056,1581
2020-11-17,Ethiopia,339,7,103395,1588
2020-11-18,Ethiopia,533,13,103928,1601
2020-11-19,Ethiopia,499,6,104427,1607
2020-11-20,Ethiopia,452,13,104879,1620
2020-11-21,Ethiopia,473,16,105352,1636
2020-11-22,Ethiopia,433,11,105785,1647
2020-11-23,Ethiopia,418,4,106203,1651
2020-11-24,Ethiopia,388,10,106591,1661
2020-11-25,Ethiopia,518,3,107109,1664
2020-11-26,Ethiopia,560,8,107669,1672
2020-11-27,Ethiopia,769,14,108438,1686
2020-11-28,Ethiopia,492,9,108930,1695
2020-11-29,Ethiopia,604,5,109534,1700
2020-11-30,Ethiopia,540,6,110074,1706
2020-12-01,Ethiopia,480,3,110554,1709
2020-12-02,Ethiopia,430,6,110984,1715
2020-12-03,Ethiopia,595,9,111579,1724
2020-12-04,Ethiopia,512,10,112091,1734
2020-12-05,Ethiopia,649,11,112740,1745
2020-12-06,Ethiopia,555,2,113295,1747
2020-12-07,Ethiopia,440,8,113735,1755
2020-12-08,Ethiopia,531,11,114266,1766
2020-12-09,Ethiopia,568,3,114834,1769
2020-12-10,Ethiopia,526,10,115360,1779
2020-12-11,Ethiopia,422,12,115782,1791
2020-12-12,Ethiopia,515,12,116297,1803
2020-12-13,Ethiopia,472,3,116769,1806
2020-12-14,Ethiopia,473,3,117242,1809
2020-12-15,Ethiopia,300,4,117542,1813
2020-12-16,Ethiopia,464,5,118006,1818
2020-12-17,Ethiopia,475,13,118481,1831
2020-12-18,Ethiopia,544,12,119025,1843
2020-12-19,Ethiopia,469,3,119494,1846
2020-12-20,Ethiopia,457,7,119951,1853
2020-12-21,Ethiopia,397,8,120348,1861
2020-12-22,Ethiopia,290,3,120638,1864
2020-12-23,Ethiopia,351,6,120989,1870
2020-12-24,Ethiopia,410,12,121399,1882
2020-12-25,Ethiopia,481,15,121880,1897
2020-12-26,Ethiopia,533,4,122413,1901
2020-12-27,Ethiopia,451,8,122864,1909
2020-12-28,Ethiopia,281,3,123145,1912
2020-12-29,Ethiopia,243,1,123388,1913
2020-12-30,Ethiopia,468,5,123856,1918
2020-12-31,Ethiopia,408,5,124264,1923
2021-01-01,Ethiopia,388,14,124652,1937
2021-01-02,Ethiopia,397,7,125049,1944
2021-01-03,Ethiopia,573,4,125622,1948
2021-01-04,Ethiopia,297,2,125919,1950
2021-01-05,Ethiopia,322,13,126241,1963
2021-01-06,Ethiopia,545,2,126786,1965
2021-01-07,Ethiopia,441,1,127227,1966
2021-01-08,Ethiopia,345,8,127572,1974
2021-01-09,Ethiopia,220,11,127792,1985
2021-01-10,Ethiopia,524,9,128316,1994
2021-01-11,Ethiopia,300,9,128616,2003
2021-01-12,Ethiopia,376,1,128992,2004
2021-01-13,Ethiopia,463,2,129455,2006
2021-01-14,Ethiopia,467,2,129922,2008
2021-01-15,Ethiopia,404,15,130326,2023
2021-01-16,Ethiopia,446,6,130772,2029
2021-01-17,Ethiopia,423,1,131195,2030
2021-01-18,Ethiopia,351,3,131546,2033
2021-01-19,Ethiopia,181,4,131727,2037
2021-01-20,Ethiopia,307,7,132034,2044
2021-01-21,Ethiopia,292,13,132326,2057
2021-01-22,Ethiopia,555,3,132881,2060
2021-01-23,Ethiopia,417,3,133298,2063
2021-01-24,Ethiopia,469,3,133767,2066
2021-01-25,Ethiopia,365,5,134132,2071
2021-01-26,Ethiopia,437,4,134569,2075
2021-01-27,Ethiopia,476,8,135045,2083
2021-01-28,Ethiopia,549,2,135594,2085
2021-01-29,Ethiopia,771,2,136365,2087
2021-01-30,Ethiopia,656,4,137021,2091
2021-01-31,Ethiopia,629,2,137650,2093
2021-02-01,Ethiopia,734,10,138384,2103
2021-02-02,Ethiopia,477,13,138861,2116
2021-02-03,Ethiopia,547,6,139408,2122
2021-02-04,Ethiopia,749,4,140157,2126
2021-02-05,Ethiopia,726,10,140883,2136
2021-02-06,Ethiopia,570,9,141453,2145
2021-02-07,Ethiopia,885,3,142338,2148
2021-02-08,Ethiopia,656,8,142994,2156
2021-02-09,Ethiopia,572,2,143566,2158
2021-02-10,Ethiopia,683,9,144249,2167
2021-02-11,Ethiopia,613,4,144862,2171
2021-02-12,Ethiopia,686,6,145548,2177
2021-02-13,Ethiopia,156,4,145704,2181
2021-02-14,Ethiopia,1388,13,147092,2194
2021-02-15,Ethiopia,733,15,147825,2209
2021-02-16,Ethiopia,665,14,148490,2223
2021-02-17,Ethiopia,818,14,149308,2237
2021-02-18,Ethiopia,871,12,150179,2249
2021-02-19,Ethiopia,837,10,151016,2259
2021-02-20,Ethiopia,841,12,151857,2271
2021-02-21,Ethiopia,949,8,152806,2279
2021-02-22,Ethiopia,735,14,153541,2293
2021-02-23,Ethiopia,716,12,154257,2305
2021-02-24,Ethiopia,977,11,155234,2316
2021-02-25,Ethiopia,878,5,156112,2321
2021-02-26,Ethiopia,935,19,157047,2340
2021-02-27,Ethiopia,1006,14,158053,2354
2021-02-28,Ethiopia,1019,11,159072,2365
2021-03-01,Ethiopia,900,8,159972,2373
2021-03-02,Ethiopia,841,13,160813,2386
2021-03-03,Ethiopia,1161,5,161974,2391
2021-03-04,Ethiopia,980,3,162954,2394
2021-03-05,Ethiopia,1119,10,164073,2404
2021-03-06,Ethiopia,956,16,165029,2420
2021-03-07,Ethiopia,1109,9,166138,2429
2021-03-08,Ethiopia,995,13,167133,2442
2021-03-09,Ethiopia,1202,9,168335,2451
2021-03-10,Ethiopia,1543,15,169878,2466
2021-03-11,Ethiopia,1332,17,171210,2483
2021-03-12,Ethiopia,1361,27,172571,2510
2021-03-13,Ethiopia,1483,30,174054,2540
2021-03-14,Ethiopia,1413,10,175467,2550
2021-03-15,Ethiopia,1151,5,176618,2555
2021-03-16,Ethiopia,1490,18,178108,2573
2021-03-17,Ethiopia,1704,19,179812,2592
2021-03-18,Ethiopia,2057,10,181869,2602
2021-03-19,Ethiopia,1994,16,183863,2618
2021-03-20,Ethiopia,1778,29,185641,2647
2021-03-21,Ethiopia,1724,12,187365,2659
2021-03-22,Ethiopia,1537,15,188902,2674
2021-03-23,Ethiopia,1692,19,190594,2693
2021-03-24,Ethiopia,1981,25,192575,2718
2021-03-25,Ethiopia,1949,23,194524,2741
2021-03-26,Ethiopia,2097,28,196621,2769
2021-03-27,Ethiopia,2173,15,198794,2784
2021-03-28,Ethiopia,1769,17,200563,2801
2021-03-29,Ethiopia,1982,24,202545,2825
2021-03-30,Ethiopia,1976,16,204521,2841
2021-03-31,Ethiopia,2068,24,206589,2865
2021-04-01,Ethiopia,2372,25,208961,2890
2021-04-02,Ethiopia,2353,25,211314,2915
2021-04-03,Ethiopia,1997,21,213311,2936
2021-04-04,Ethiopia,1878,27,215189,2963
2021-04-05,Ethiopia,2138,37,217327,3000
2021-04-06,Ethiopia,2054,25,219381,3025
2021-04-07,Ethiopia,2163,33,221544,3058
2021-04-08,Ethiopia,2121,20,223665,3078
2020-01-23,Europe,0,0,0,0
2020-01-24,Europe,2,0,2,0
2020-01-25,Europe,1,0,3,0
2020-01-26,Europe,0,0,3,0
2020-01-27,Europe,1,0,4,0
2020-01-28,Europe,4,0,8,0
2020-01-29,Europe,2,0,10,0
2020-01-30,Europe,0,0,10,0
2020-01-31,Europe,7,0,17,0
2020-02-01,Europe,6,0,23,0
2020-02-02,Europe,2,0,25,0
2020-02-03,Europe,8,0,33,0
2020-02-04,Europe,1,0,34,0
2020-02-05,Europe,1,0,35,0
2020-02-06,Europe,0,0,35,0
2020-02-07,Europe,2,0,37,0
2020-02-08,Europe,9,0,46,0
2020-02-09,Europe,3,0,49,0
2020-02-10,Europe,0,0,49,0
2020-02-11,Europe,3,0,52,0
2020-02-12,Europe,1,0,53,0
2020-02-13,Europe,1,0,54,0
2020-02-14,Europe,1,0,55,0
2020-02-15,Europe,1,1,56,1
2020-02-16,Europe,0,0,56,1
2020-02-17,Europe,1,0,57,1
2020-02-18,Europe,0,0,57,1
2020-02-19,Europe,1,0,58,1
2020-02-20,Europe,2,0,60,1
2020-02-21,Europe,18,1,78,2
2020-02-22,Europe,42,1,120,3
2020-02-23,Europe,98,1,218,4
2020-02-24,Europe,76,4,294,8
2020-02-25,Europe,108,3,402,11
2020-02-26,Europe,163,3,565,14
2020-02-27,Europe,265,5,830,19
2020-02-28,Europe,303,4,1133,23
2020-02-29,Europe,373,8,1506,31
2020-03-01,Europe,755,5,2261,36
2020-03-02,Europe,567,19,2828,55
2020-03-03,Europe,688,30,3516,85
2020-03-04,Europe,1012,29,4528,114
2020-03-05,Europe,1432,46,5960,160
2020-03-06,Europe,1772,55,7732,215
2020-03-07,Europe,2158,49,9890,264
2020-03-08,Europe,2535,146,12425,410
2020-03-09,Europe,3142,117,15567,527
2020-03-10,Europe,3391,191,18958,718
2020-03-11,Europe,5463,240,24421,958
2020-03-12,Europe,3928,196,28349,1154
2020-03-13,Europe,11547,381,39896,1535
2020-03-14,Europe,8157,288,48053,1823
2020-03-15,Europe,8841,492,56894,2315
2020-03-16,Europe,10996,501,67890,2816
2020-03-17,Europe,11547,608,79437,3424
2020-03-18,Europe,14047,643,93484,4067
2020-03-19,Europe,19377,852,112861,4919
2020-03-20,Europe,20463,1182,133324,6101
2020-03-21,Europe,21662,1437,154986,7538
2020-03-22,Europe,20309,1317,175295,8855
2020-03-23,Europe,26407,1566,201702,10421
2020-03-24,Europe,24405,1833,226107,12254
2020-03-25,Europe,31019,2236,257126,14490
2020-03-26,Europe,35912,2302,293038,16792
2020-03-27,Europe,36027,2678,329065,19470
2020-03-28,Europe,36795,2776,365860,22246
2020-03-29,Europe,29917,2580,395777,24826
2020-03-30,Europe,32655,3042,428432,27868
2020-03-31,Europe,36809,3265,465241,31133
2020-04-01,Europe,37141,4255,502382,35388
2020-04-02,Europe,36170,3807,538552,39195
2020-04-03,Europe,37653,4235,576205,43430
2020-04-04,Europe,12521,3732,588726,47162
2020-04-05,Europe,26464,3010,615190,50172
2020-04-06,Europe,27402,3551,642592,53723
2020-04-07,Europe,23840,5088,666432,58811
2020-04-08,Europe,34123,3960,700555,62771
2020-04-09,Europe,33364,4788,733919,67559
2020-04-10,Europe,31340,4414,765259,71973
2020-04-11,Europe,27168,3324,792427,75297
2020-04-12,Europe,75042,3200,867469,78497
2020-04-13,Europe,25147,3228,892616,81725
2020-04-14,Europe,37581,3605,930197,85330
2020-04-15,Europe,31933,5021,962130,90351
2020-04-16,Europe,44097,4184,1006227,94535
2020-04-17,Europe,32096,4072,1038323,98607
2020-04-18,Europe,27394,3189,1065717,101796
2020-04-19,Europe,30083,2412,1095800,104208
2020-04-20,Europe,23633,2833,1119433,107041
2020-04-21,Europe,27441,3757,1146874,110798
2020-04-22,Europe,29563,3403,1176437,114201
2020-04-23,Europe,25541,3136,1201978,117337
2020-04-24,Europe,16152,3332,1218130,120669
2020-04-25,Europe,24764,2776,1242894,123445
2020-04-26,Europe,22066,1722,1264960,125167
2020-04-27,Europe,24155,2076,1289115,127243
2020-04-28,Europe,24019,2806,1313134,130049
2020-04-29,Europe,21575,2873,1334709,132922
2020-04-30,Europe,23091,2248,1357800,135170
2020-05-01,Europe,22860,1845,1380660,137015
2020-05-02,Europe,22190,2283,1402850,139298
2020-05-03,Europe,21213,1131,1424063,140429
2020-05-04,Europe,21062,1524,1445125,141953
2020-05-05,Europe,22599,2000,1467724,143953
2020-05-06,Europe,27077,2523,1494801,146476
2020-05-07,Europe,25133,1751,1519934,148227
2020-05-08,Europe,23415,2006,1543349,150233
2020-05-09,Europe,20717,1184,1564066,151417
2020-05-10,Europe,19751,923,1583817,152340
2020-05-11,Europe,23821,1164,1607638,153504
2020-05-12,Europe,22078,1826,1629716,155330
2020-05-13,Europe,20474,1564,1650190,156894
2020-05-14,Europe,20156,1576,1670346,158470
2020-05-15,Europe,20327,1320,1690673,159790
2020-05-16,Europe,17653,1150,1708326,160940
2020-05-17,Europe,16460,979,1724786,161919
2020-05-18,Europe,16899,817,1741685,162736
2020-05-19,Europe,18922,917,1760607,163653
2020-05-20,Europe,18059,1177,1778666,164830
2020-05-21,Europe,17527,960,1796193,165790
2020-05-22,Europe,18853,1610,1815046,167400
2020-05-23,Europe,16629,855,1831675,168255
2020-05-24,Europe,14197,733,1845872,168988
2020-05-25,Europe,14306,-1354,1860178,167634
2020-05-26,Europe,16247,1118,1876425,168752
2020-05-27,Europe,15144,994,1891569,169746
2020-05-28,Europe,20445,909,1912014,170655
2020-05-29,Europe,16602,922,1928616,171577
2020-05-30,Europe,16621,708,1945237,172285
2020-05-31,Europe,14575,398,1959812,172683
2020-06-01,Europe,14689,462,1974501,173145
2020-06-02,Europe,14061,778,1988562,173923
2020-06-03,Europe,11751,798,2000313,174721
2020-06-04,Europe,19768,593,2020081,175314
2020-06-05,Europe,16456,767,2036537,176081
2020-06-06,Europe,15928,573,2052465,176654
2020-06-07,Europe,14767,343,2067232,176997
2020-06-08,Europe,15149,416,2082381,177413
2020-06-09,Europe,15345,726,2097726,178139
2020-06-10,Europe,15528,675,2113254,178814
2020-06-11,Europe,16178,455,2129432,179269
2020-06-12,Europe,17074,538,2146506,179807
2020-06-13,Europe,15731,443,2162237,180250
2020-06-14,Europe,14765,287,2177002,180537
2020-06-15,Europe,14044,329,2191046,180866
2020-06-16,Europe,15884,630,2206930,181496
2020-06-17,Europe,16022,630,2222952,182126
2020-06-18,Europe,17005,511,2239957,182637
2020-06-19,Europe,15816,1611,2255773,184248
2020-06-20,Europe,14616,405,2270389,184653
2020-06-21,Europe,13295,226,2283684,184879
2020-06-22,Europe,13549,232,2297233,185111
2020-06-23,Europe,15074,563,2312307,185674
2020-06-24,Europe,15132,393,2327439,186067
2020-06-25,Europe,14778,372,2342217,186439
2020-06-26,Europe,15625,504,2357842,186943
2020-06-27,Europe,13901,324,2371743,187267
2020-06-28,Europe,11742,252,2383485,187519
2020-06-29,Europe,12950,264,2396435,187783
2020-06-30,Europe,12802,456,2409237,188239
2020-07-01,Europe,13190,495,2422427,188734
2020-07-02,Europe,13533,407,2435960,189141
2020-07-03,Europe,13950,425,2449910,189566
2020-07-04,Europe,12821,330,2462731,189896
2020-07-05,Europe,11793,253,2474524,190149
2020-07-06,Europe,13613,282,2488137,190431
2020-07-07,Europe,11979,469,2500116,190900
2020-07-08,Europe,14144,437,2514260,191337
2020-07-09,Europe,13622,387,2527882,191724
2020-07-10,Europe,14566,388,2542448,192112
2020-07-11,Europe,13741,340,2556189,192452
2020-07-12,Europe,11770,221,2567959,192673
2020-07-13,Europe,14531,242,2582490,192915
2020-07-14,Europe,12813,377,2595303,193292
2020-07-15,Europe,14433,418,2609736,193710
2020-07-16,Europe,15289,373,2625025,194083
2020-07-17,Europe,16202,370,2641227,194453
2020-07-18,Europe,13364,247,2654591,194700
2020-07-19,Europe,11756,187,2666347,194887
2020-07-20,Europe,18002,231,2684349,195118
2020-07-21,Europe,14377,341,2698726,195459
2020-07-22,Europe,15955,349,2714681,195808
2020-07-23,Europe,17553,325,2732234,196133
2020-07-24,Europe,17611,359,2749845,196492
2020-07-25,Europe,13706,263,2763551,196755
2020-07-26,Europe,13048,197,2776599,196952
2020-07-27,Europe,21619,210,2798218,197162
2020-07-28,Europe,15309,328,2813527,197490
2020-07-29,Europe,18376,401,2831903,197891
2020-07-30,Europe,19834,324,2851737,198215
2020-07-31,Europe,19769,363,2871506,198578
2020-08-01,Europe,14374,235,2885880,198813
2020-08-02,Europe,12893,203,2898773,199016
2020-08-03,Europe,24974,263,2923747,199279
2020-08-04,Europe,20538,360,2944285,199639
2020-08-05,Europe,20348,381,2964633,200020
2020-08-06,Europe,21947,327,2986580,200347
2020-08-07,Europe,23706,314,3010286,200661
2020-08-08,Europe,15131,292,3025417,200953
2020-08-09,Europe,13794,203,3039211,201156
2020-08-10,Europe,27638,336,3066849,201492
2020-08-11,Europe,19712,332,3086561,201824
2020-08-12,Europe,23410,348,3109971,202172
2020-08-13,Europe,27407,365,3137378,202537
2020-08-14,Europe,27042,331,3164420,202868
2020-08-15,Europe,19816,448,3184236,203316
2020-08-16,Europe,17038,199,3201274,203515
2020-08-17,Europe,30735,256,3232009,203771
2020-08-18,Europe,22917,356,3254926,204127
2020-08-19,Europe,28057,463,3282983,204590
2020-08-20,Europe,30270,345,3313253,204935
2020-08-21,Europe,32196,320,3345449,205255
2020-08-22,Europe,21417,306,3366866,205561
2020-08-23,Europe,19965,207,3386831,205768
2020-08-24,Europe,36913,277,3423744,206045
2020-08-25,Europe,27052,404,3450796,206449
2020-08-26,Europe,26211,260,3477007,206709
2020-08-27,Europe,39843,380,3516850,207089
2020-08-28,Europe,35272,331,3552122,207420
2020-08-29,Europe,23722,285,3575844,207705
2020-08-30,Europe,21873,205,3597717,207910
2020-08-31,Europe,43032,357,3640749,208267
2020-09-01,Europe,29786,431,3670535,208698
2020-09-02,Europe,35668,404,3706203,209102
2020-09-03,Europe,36956,392,3743159,209494
2020-09-04,Europe,41511,477,3784670,209971
2020-09-05,Europe,29601,335,3814271,210306
2020-09-06,Europe,26454,207,3840725,210513
2020-09-07,Europe,50999,327,3891724,210840
2020-09-08,Europe,37236,472,3928960,211312
2020-09-09,Europe,41150,416,3970110,211728
2020-09-10,Europe,45726,410,4015836,212138
2020-09-11,Europe,49067,417,4064903,212555
2020-09-12,Europe,37884,331,4102787,212886
2020-09-13,Europe,29457,255,4132244,213141
2020-09-14,Europe,55849,370,4188093,213511
2020-09-15,Europe,43770,633,4231863,214144
2020-09-16,Europe,50943,706,4282806,214850
2020-09-17,Europe,55124,607,4337930,215457
2020-09-18,Europe,60955,661,4398885,216118
2020-09-19,Europe,44644,399,4443529,216517
2020-09-20,Europe,38697,288,4482226,216805
2020-09-21,Europe,65880,471,4548106,217276
2020-09-22,Europe,53719,777,4601825,218053
2020-09-23,Europe,61057,685,4662882,218738
2020-09-24,Europe,65364,592,4728246,219330
2020-09-25,Europe,70009,688,4798255,220018
2020-09-26,Europe,51836,567,4850091,220585
2020-09-27,Europe,44788,345,4894879,220930
2020-09-28,Europe,68658,551,4963537,221481
2020-09-29,Europe,48426,626,5011963,222107
2020-09-30,Europe,79394,1014,5091357,223121
2020-10-01,Europe,70380,753,5161737,223874
2020-10-02,Europe,76597,824,5238334,224698
2020-10-03,Europe,71241,577,5309575,225275
2020-10-04,Europe,73537,437,5383112,225712
2020-10-05,Europe,84008,638,5467120,226350
2020-10-06,Europe,84522,1077,5551642,227427
2020-10-07,Europe,98691,904,5650333,228331
2020-10-08,Europe,111313,890,5761646,229221
2020-10-09,Europe,117936,1050,5879582,230271
2020-10-10,Europe,109790,766,5989372,231037
2020-10-11,Europe,87486,623,6076858,231660
2020-10-12,Europe,114751,885,6191609,232545
2020-10-13,Europe,112474,1172,6304083,233717
2020-10-14,Europe,142979,1347,6447062,235064
2020-10-15,Europe,156681,1285,6603743,236349
2020-10-16,Europe,157579,1435,6761322,237784
2020-10-17,Europe,144083,1097,6905405,238881
2020-10-18,Europe,132439,875,7037844,239756
2020-10-19,Europe,165195,1232,7203039,240988
2020-10-20,Europe,160854,1811,7363893,242799
2020-10-21,Europe,200851,1658,7564744,244457
2020-10-22,Europe,215582,1789,7780326,246246
2020-10-23,Europe,235023,1979,8015349,248225
2020-10-24,Europe,205265,1666,8220614,249891
2020-10-25,Europe,153619,1179,8374233,251070
2020-10-26,Europe,284162,1918,8658395,252988
2020-10-27,Europe,230574,2790,8888969,255778
2020-10-28,Europe,257346,2517,9146315,258295
2020-10-29,Europe,284779,2584,9431094,260879
2020-10-30,Europe,300422,3033,9731516,263912
2020-10-31,Europe,230761,2513,9962277,266425
2020-11-01,Europe,218248,1874,10180525,268299
2020-11-02,Europe,346447,2660,10526972,270959
2020-11-03,Europe,277004,4344,10803976,275303
2020-11-04,Europe,228055,4918,11032031,280221
2020-11-05,Europe,316195,3677,11348226,283898
2020-11-06,Europe,321684,4353,11669910,288251
2020-11-07,Europe,300505,3247,11970415,291498
2020-11-08,Europe,219776,2340,12190191,293838
2020-11-09,Europe,244016,3435,12434207,297273
2020-11-10,Europe,250057,5227,12684264,302500
2020-11-11,Europe,297048,5082,12981312,307582
2020-11-12,Europe,294647,4407,13275959,311989
2020-11-13,Europe,286273,4781,13562232,316770
2020-11-14,Europe,242484,3750,13804716,320520
2020-11-15,Europe,200180,2883,14004896,323403
2020-11-16,Europe,235329,4053,14240225,327456
2020-11-17,Europe,274154,5772,14514379,333228
2020-11-18,Europe,263038,5297,14777417,338525
2020-11-19,Europe,269793,4850,15047210,343375
2020-11-20,Europe,267486,5774,15314696,349149
2020-11-21,Europe,220331,3910,15535027,353059
2020-11-22,Europe,172686,3198,15707713,356257
2020-11-23,Europe,192805,4342,15900518,360599
2020-11-24,Europe,225676,6229,16126194,366828
2020-11-25,Europe,237824,5537,16364018,372365
2020-11-26,Europe,237801,5415,16601819,377780
2020-11-27,Europe,233413,5887,16835232,383667
2020-11-28,Europe,193566,4254,17028798,387921
2020-11-29,Europe,150866,3145,17179664,391066
2020-11-30,Europe,164564,4316,17344228,395382
2020-12-01,Europe,200694,6007,17544922,401389
2020-12-02,Europe,210696,5619,17755618,407008
2020-12-03,Europe,224458,5489,17980076,412497
2020-12-04,Europe,214924,5652,18195000,418149
2020-12-05,Europe,200056,4184,18395056,422333
2020-12-06,Europe,162418,3165,18557474,425498
2020-12-07,Europe,151955,3970,18709429,429468
2020-12-08,Europe,198981,5452,18908410,434920
2020-12-09,Europe,212636,5270,19121046,440190
2020-12-10,Europe,238058,5470,19359104,445660
2020-12-11,Europe,231133,5713,19590237,451373
2020-12-12,Europe,201934,4370,19792171,455743
2020-12-13,Europe,169487,3108,19961658,458851
2020-12-14,Europe,158835,4083,20120493,462934
2020-12-15,Europe,213495,6307,20333988,469241
2020-12-16,Europe,241622,5950,20575610,475191
2020-12-17,Europe,254399,5458,20830009,480649
2020-12-18,Europe,244541,5713,21074550,486362
2020-12-19,Europe,202237,4329,21276787,490691
2020-12-20,Europe,169971,2984,21446758,493675
2020-12-21,Europe,187077,4161,21633835,497836
2020-12-22,Europe,236518,6147,21870353,503983
2020-12-23,Europe,248010,5708,22118363,509691
2020-12-24,Europe,249867,4540,22368230,514231
2020-12-25,Europe,180519,3511,22548749,517742
2020-12-26,Europe,139750,2759,22688499,520501
2020-12-27,Europe,135410,2833,22823909,523334
2020-12-28,Europe,172625,4195,22996534,527529
2020-12-29,Europe,244659,6406,23241193,533935
2020-12-30,Europe,296006,6392,23537199,540327
2020-12-31,Europe,269948,5160,23807147,545487
2021-01-01,Europe,209555,3769,24016702,549256
2021-01-02,Europe,159491,2796,24176193,552052
2021-01-03,Europe,168042,2914,24344235,554966
2021-01-04,Europe,203764,4328,24547999,559294
2021-01-05,Europe,275691,6599,24823690,565893
2021-01-06,Europe,269592,5542,25093282,571435
2021-01-07,Europe,320755,5624,25414037,577059
2021-01-08,Europe,274846,6125,25688883,583184
2021-01-09,Europe,227717,4327,25916600,587511
2021-01-10,Europe,182934,3134,26099534,590645
2021-01-11,Europe,212771,4278,26312305,594923
2021-01-12,Europe,237197,6716,26549502,601639
2021-01-13,Europe,262816,6646,26812318,608285
2021-01-14,Europe,257236,6057,27069554,614342
2021-01-15,Europe,245856,5669,27315410,620011
2021-01-16,Europe,185204,4944,27500614,624955
2021-01-17,Europe,155921,3221,27656535,628176
2021-01-18,Europe,209320,3878,27865855,632054
2021-01-19,Europe,202598,7554,28068453,639608
2021-01-20,Europe,248228,7161,28316681,646769
2021-01-21,Europe,225089,6098,28541770,652867
2021-01-22,Europe,230014,6243,28771784,659110
2021-01-23,Europe,169427,4464,28941211,663574
2021-01-24,Europe,139630,3144,29080841,666718
2021-01-25,Europe,194468,4594,29275309,671312
2021-01-26,Europe,179078,6549,29454387,677861
2021-01-27,Europe,216411,6535,29670798,684396
2021-01-28,Europe,210481,6421,29881279,690817
2021-01-29,Europe,203998,5704,30085277,696521
2021-01-30,Europe,155901,4788,30241178,701309
2021-01-31,Europe,115693,2669,30356871,703978
2021-02-01,Europe,170705,4497,30527576,708475
2021-02-02,Europe,159485,6755,30687061,715230
2021-02-03,Europe,186316,5976,30873377,721206
2021-02-04,Europe,159317,4959,31032694,726165
2021-02-05,Europe,196844,5929,31229538,732094
2021-02-06,Europe,130722,3567,31360260,735661
2021-02-07,Europe,109040,2383,31469300,738044
2021-02-08,Europe,125972,3936,31595272,741980
2021-02-09,Europe,129190,5994,31724462,747974
2021-02-10,Europe,156265,5234,31880727,753208
2021-02-11,Europe,154852,4713,32035579,757921
2021-02-12,Europe,148303,4716,32183882,762637
2021-02-13,Europe,121070,3145,32304952,765782
2021-02-14,Europe,93956,2014,32398908,767796
2021-02-15,Europe,102066,3013,32500974,770809
2021-02-16,Europe,123071,4708,32624045,775517
2021-02-17,Europe,148007,4685,32772052,780202
2021-02-18,Europe,154514,3887,32926566,784089
2021-02-19,Europe,155066,4128,33081632,788217
2021-02-20,Europe,128859,2621,33210491,790838
2021-02-21,Europe,111977,1836,33322468,792674
2021-02-22,Europe,103446,2857,33425914,795531
2021-02-23,Europe,134703,4146,33560617,799677
2021-02-24,Europe,171962,3741,33732579,803418
2021-02-25,Europe,170099,3149,33902678,806567
2021-02-26,Europe,165531,3843,34068209,810410
2021-02-27,Europe,145522,2608,34213731,813018
2021-02-28,Europe,118228,1792,34331959,814810
2021-03-01,Europe,101692,2750,34433651,817560
2021-03-02,Europe,68329,3725,34501980,821285
2021-03-03,Europe,175427,4021,34677407,825306
2021-03-04,Europe,175445,3341,34852852,828647
2021-03-05,Europe,175256,3784,35028108,832431
2021-03-06,Europe,155384,2454,35183492,834885
2021-03-07,Europe,128502,1765,35311994,836650
2021-03-08,Europe,101514,2786,35413508,839436
2021-03-09,Europe,151742,3476,35565250,842912
2021-03-10,Europe,194070,3599,35759320,846511
2021-03-11,Europe,185777,3433,35945097,849944
2021-03-12,Europe,191773,3370,36136870,853314
2021-03-13,Europe,183640,2627,36320510,855941
2021-03-14,Europe,147095,2041,36467605,857982
2021-03-15,Europe,122172,2910,36589777,860892
2021-03-16,Europe,186319,3689,36776096,864581
2021-03-17,Europe,207595,3382,36983691,867963
2021-03-18,Europe,231578,3603,37215269,871566
2021-03-19,Europe,215710,3364,37430979,874930
2021-03-20,Europe,194385,2725,37625364,877655
2021-03-21,Europe,161266,2039,37786630,879694
2021-03-22,Europe,152047,3337,37938677,883031
2021-03-23,Europe,179728,3965,38118405,886996
2021-03-24,Europe,256192,3699,38374597,890695
2021-03-25,Europe,252982,4092,38627579,894787
2021-03-26,Europe,239119,4516,38866698,899303
2021-03-27,Europe,218498,2896,39085196,902199
2021-03-28,Europe,163075,2062,39248271,904261
2021-03-29,Europe,139257,2962,39387528,907223
2021-03-30,Europe,204845,3971,39592373,911194
2021-03-31,Europe,255985,4041,39848358,915235
2021-04-01,Europe,251149,3880,40099507,919115
2021-04-02,Europe,216832,3620,40316339,922735
2021-04-03,Europe,153012,3012,40469351,925747
2021-04-04,Europe,199224,2487,40668575,928234
2021-04-05,Europe,107614,2628,40776189,930862
2021-04-06,Europe,131033,3118,40907222,933980
2021-04-07,Europe,162184,4467,41069406,938447
2021-04-08,Europe,282881,4868,41352287,943315
2020-01-23,European Union,0,0,0,0
2020-01-24,European Union,2,0,2,0
2020-01-25,European Union,1,0,3,0
2020-01-26,European Union,0,0,3,0
2020-01-27,European Union,1,0,4,0
2020-01-28,European Union,4,0,8,0
2020-01-29,European Union,2,0,10,0
2020-01-30,European Union,0,0,10,0
2020-01-31,European Union,3,0,13,0
2020-02-01,European Union,6,0,19,0
2020-02-02,European Union,2,0,21,0
2020-02-03,European Union,2,0,23,0
2020-02-04,European Union,1,0,24,0
2020-02-05,European Union,0,0,24,0
2020-02-06,European Union,0,0,24,0
2020-02-07,European Union,2,0,26,0
2020-02-08,European Union,5,0,31,0
2020-02-09,European Union,2,0,33,0
2020-02-10,European Union,0,0,33,0
2020-02-11,European Union,2,0,35,0
2020-02-12,European Union,0,0,35,0
2020-02-13,European Union,0,0,35,0
2020-02-14,European Union,0,0,35,0
2020-02-15,European Union,1,1,36,1
2020-02-16,European Union,0,0,36,1
2020-02-17,European Union,0,0,36,1
2020-02-18,European Union,0,0,36,1
2020-02-19,European Union,0,0,36,1
2020-02-20,European Union,0,0,36,1
2020-02-21,European Union,17,1,53,2
2020-02-22,European Union,42,1,95,3
2020-02-23,European Union,93,1,188,4
2020-02-24,European Union,74,4,262,8
2020-02-25,European Union,103,3,365,11
2020-02-26,European Union,158,3,523,14
2020-02-27,European Union,250,5,773,19
2020-02-28,European Union,284,4,1057,23
2020-02-29,European Union,348,8,1405,31
2020-03-01,European Union,707,5,2112,36
2020-03-02,European Union,494,19,2606,55
2020-03-03,European Union,604,29,3210,84
2020-03-04,European Union,870,29,4080,113
2020-03-05,European Union,1312,45,5392,158
2020-03-06,European Union,1550,54,6942,212
2020-03-07,European Union,2000,48,8942,260
2020-03-08,European Union,2365,145,11307,405
2020-03-09,European Union,2919,116,14226,521
2020-03-10,European Union,2768,185,16994,706
2020-03-11,European Union,4654,238,21648,944
2020-03-12,European Union,3276,193,24924,1137
2020-03-13,European Union,10172,370,35096,1507
2020-03-14,European Union,7411,264,42507,1771
2020-03-15,European Union,7360,477,49867,2248
2020-03-16,European Union,10177,476,60044,2724
2020-03-17,European Union,10001,577,70045,3301
2020-03-18,European Union,12471,598,82516,3899
2020-03-19,European Union,16836,791,99352,4690
2020-03-20,European Union,17491,1132,116843,5822
2020-03-21,European Union,18717,1350,135560,7172
2020-03-22,European Union,17350,1256,152910,8428
2020-03-23,European Union,22263,1459,175173,9887
2020-03-24,European Union,20345,1676,195518,11563
2020-03-25,European Union,26529,2006,222047,13569
2020-03-26,European Union,31125,2082,253172,15651
2020-03-27,European Union,30603,2340,283775,17991
2020-03-28,European Union,31861,2429,315636,20420
2020-03-29,European Union,25311,2314,340947,22734
2020-03-30,European Union,26354,2584,367301,25318
2020-03-31,European Union,30412,2750,397713,28068
2020-04-01,European Union,29750,3494,427463,31562
2020-04-02,European Union,28375,3071,455838,34633
2020-04-03,European Union,30245,3411,486083,38044
2020-04-04,European Union,5976,2857,492059,40901
2020-04-05,European Union,20557,2327,512616,43228
2020-04-06,European Union,19676,2890,532292,46118
2020-04-07,European Union,15528,3877,547820,49995
2020-04-08,European Union,25857,2814,573677,52809
2020-04-09,European Union,24882,3581,598559,56390
2020-04-10,European Union,23224,3188,621783,59578
2020-04-11,European Union,20117,2411,641900,61989
2020-04-12,European Union,67687,2414,709587,64403
2020-04-13,European Union,16719,2421,726306,66824
2020-04-14,European Union,28757,2426,755063,69250
2020-04-15,European Union,21417,4002,776480,73252
2020-04-16,European Union,33026,3035,809506,76287
2020-04-17,European Union,20913,3029,830419,79316
2020-04-18,European Union,15883,1976,846302,81292
2020-04-19,European Union,18387,1876,864689,83168
2020-04-20,European Union,12984,2135,877673,85303
2020-04-21,European Union,15549,2404,893222,87707
2020-04-22,European Union,16915,2423,910137,90130
2020-04-23,European Union,13550,2336,923687,92466
2020-04-24,European Union,3349,2176,927036,94642
2020-04-25,European Union,12813,1857,939849,96499
2020-04-26,European Union,10185,1253,950034,97752
2020-04-27,European Union,11444,1615,961478,99367
2020-04-28,European Union,10929,1684,972407,101051
2020-04-29,European Union,8150,1945,980557,102996
2020-04-30,European Union,8896,1451,989453,104447
2020-05-01,European Union,8524,1005,997977,105452
2020-05-02,European Union,7227,1608,1005204,107060
2020-05-03,European Union,5884,796,1011088,107856
2020-05-04,European Union,5428,1118,1016516,108974
2020-05-05,European Union,7209,1137,1023725,110111
2020-05-06,European Union,10884,1744,1034609,111855
2020-05-07,European Union,8317,1171,1042926,113026
2020-05-08,European Union,7825,1270,1050751,114296
2020-05-09,European Union,5903,753,1056654,115049
2020-05-10,European Union,4795,581,1061449,115630
2020-05-11,European Union,6885,829,1068334,116459
2020-05-12,European Union,6100,1040,1074434,117499
2020-05-13,European Union,5358,985,1079792,118484
2020-05-14,European Union,5800,1090,1085592,119574
2020-05-15,European Union,5362,808,1090954,120382
2020-05-16,European Union,4498,582,1095452,120964
2020-05-17,European Union,3166,781,1098618,121745
2020-05-18,European Union,3915,537,1102533,122282
2020-05-19,European Union,5094,269,1107627,122551
2020-05-20,European Union,4889,677,1112516,123228
2020-05-21,European Union,4329,520,1116845,123748
2020-05-22,European Union,6199,1144,1123044,124892
2020-05-23,European Union,3993,465,1127037,125357
2020-05-24,European Union,2637,171,1129674,125528
2020-05-25,European Union,2392,-1583,1132066,123945
2020-05-26,European Union,4143,773,1136209,124718
2020-05-27,European Union,3390,376,1139599,125094
2020-05-28,European Union,8621,360,1148220,125454
2020-05-29,European Union,4815,389,1153035,125843
2020-05-30,European Union,4933,343,1157968,126186
2020-05-31,European Union,2568,174,1160536,126360
2020-06-01,European Union,2758,180,1163294,126540
2020-06-02,European Union,2109,326,1165403,126866
2020-06-03,European Union,6,345,1165409,127211
2020-06-04,European Union,7729,266,1173138,127477
2020-06-05,European Union,4601,333,1177739,127810
2020-06-06,European Union,4323,202,1182062,128012
2020-06-07,European Union,3244,125,1185306,128137
2020-06-08,European Union,3294,220,1188600,128357
2020-06-09,European Union,3890,315,1192490,128672
2020-06-10,European Union,3986,249,1196476,128921
2020-06-11,European Union,4125,164,1200601,129085
2020-06-12,European Union,4889,187,1205490,129272
2020-06-13,European Union,3881,185,1209371,129457
2020-06-14,European Union,3102,108,1212473,129565
2020-06-15,European Union,2811,126,1215284,129691
2020-06-16,European Union,4328,259,1219612,129950
2020-06-17,European Union,4681,264,1224293,130214
2020-06-18,European Union,5879,212,1230172,130426
2020-06-19,European Union,4260,1304,1234432,131730
2020-06-20,European Union,3778,131,1238210,131861
2020-06-21,European Union,2998,58,1241208,131919
2020-06-22,European Union,3097,85,1244305,132004
2020-06-23,European Union,4685,269,1248990,132273
2020-06-24,European Union,4859,111,1253849,132384
2020-06-25,European Union,4504,140,1258353,132524
2020-06-26,European Union,5653,198,1264006,132722
2020-06-27,European Union,4169,47,1268175,132769
2020-06-28,European Union,2397,63,1270572,132832
2020-06-29,European Union,3568,96,1274140,132928
2020-06-30,European Union,3567,206,1277707,133134
2020-07-01,European Union,4464,140,1282171,133274
2020-07-02,European Union,4274,160,1286445,133434
2020-07-03,European Union,4252,129,1290697,133563
2020-07-04,European Union,3340,81,1294037,133644
2020-07-05,European Union,2484,46,1296521,133690
2020-07-06,European Union,4556,79,1301077,133769
2020-07-07,European Union,3046,142,1304123,133911
2020-07-08,European Union,4384,140,1308507,134051
2020-07-09,European Union,4170,117,1312677,134168
2020-07-10,European Union,4820,110,1317497,134278
2020-07-11,European Union,3623,62,1321120,134340
2020-07-12,European Union,2494,37,1323614,134377
2020-07-13,European Union,5669,77,1329283,134454
2020-07-14,European Union,3409,107,1332692,134561
2020-07-15,European Union,4805,179,1337497,134740
2020-07-16,European Union,5823,115,1343320,134855
2020-07-17,European Union,6187,100,1349507,134955
2020-07-18,European Union,3631,52,1353138,135007
2020-07-19,European Union,2744,35,1355882,135042
2020-07-20,European Union,9702,75,1365584,135117
2020-07-21,European Union,5523,96,1371107,135213
2020-07-22,European Union,6729,105,1377836,135318
2020-07-23,European Union,8183,106,1386019,135424
2020-07-24,European Union,8095,103,1394114,135527
2020-07-25,European Union,4768,51,1398882,135578
2020-07-26,European Union,3729,62,1402611,135640
2020-07-27,European Union,12397,48,1415008,135688
2020-07-28,European Union,6644,107,1421652,135795
2020-07-29,European Union,8975,126,1430627,135921
2020-07-30,European Union,10365,111,1440992,136032
2020-07-31,European Union,10253,104,1451245,136136
2020-08-01,European Union,5316,66,1456561,136202
2020-08-02,European Union,3747,61,1460308,136263
2020-08-03,European Union,16384,121,1476692,136384
2020-08-04,European Union,11892,118,1488584,136502
2020-08-05,European Union,11124,139,1499708,136641
2020-08-06,European Union,12555,110,1512263,136751
2020-08-07,European Union,14254,117,1526517,136868
2020-08-08,European Union,6044,97,1532561,136965
2020-08-09,European Union,5093,64,1537654,137029
2020-08-10,European Union,18801,160,1556455,137189
2020-08-11,European Union,10805,97,1567260,137286
2020-08-12,European Union,13885,140,1581145,137426
2020-08-13,European Union,17805,158,1598950,137584
2020-08-14,European Union,16835,141,1615785,137725
2020-08-15,European Union,10158,254,1625943,137979
2020-08-16,European Union,7950,69,1633893,138048
2020-08-17,European Union,22375,127,1656268,138175
2020-08-18,European Union,13856,156,1670124,138331
2020-08-19,European Union,18319,258,1688443,138589
2020-08-20,European Union,20191,139,1708634,138728
2020-08-21,European Union,22021,160,1730655,138888
2020-08-22,European Union,10747,88,1741402,138976
2020-08-23,European Union,10644,71,1752046,139047
2020-08-24,European Union,27851,138,1779897,139185
2020-08-25,European Union,17727,183,1797624,139368
2020-08-26,European Union,16440,52,1814064,139420
2020-08-27,European Union,29572,155,1843636,139575
2020-08-28,European Union,24860,129,1868496,139704
2020-08-29,European Union,13295,83,1881791,139787
2020-08-30,European Union,11610,67,1893401,139854
2020-08-31,European Union,33225,201,1926626,140055
2020-09-01,European Union,20126,204,1946752,140259
2020-09-02,European Union,24572,186,1971324,140445
2020-09-03,European Union,25617,166,1996941,140611
2020-09-04,European Union,29545,260,2026486,140871
2020-09-05,European Union,17616,112,2044102,140983
2020-09-06,European Union,14459,83,2058561,141066
2020-09-07,European Union,39364,200,2097925,141266
2020-09-08,European Union,25297,219,2123222,141485
2020-09-09,European Union,28377,187,2151599,141672
2020-09-10,European Union,32748,188,2184347,141860
2020-09-11,European Union,34592,221,2218939,142081
2020-09-12,European Union,23628,104,2242567,142185
2020-09-13,European Union,16224,90,2258791,142275
2020-09-14,European Union,43710,233,2302501,142508
2020-09-15,European Union,30212,345,2332713,142853
2020-09-16,European Union,35791,417,2368504,143270
2020-09-17,European Union,39774,333,2408278,143603
2020-09-18,European Union,44975,382,2453253,143985
2020-09-19,European Union,28877,140,2482130,144125
2020-09-20,European Union,23780,128,2505910,144253
2020-09-21,European Union,50187,324,2556097,144577
2020-09-22,European Union,37492,468,2593589,145045
2020-09-23,European Union,42130,383,2635719,145428
2020-09-24,European Union,46217,315,2681936,145743
2020-09-25,European Union,49807,434,2731743,146177
2020-09-26,European Union,32270,246,2764013,146423
2020-09-27,European Union,26727,149,2790740,146572
2020-09-28,European Union,51632,394,2842372,146966
2020-09-29,European Union,27158,278,2869530,147244
2020-09-30,European Union,56856,659,2926386,147903
2020-10-01,European Union,47345,425,2973731,148328
2020-10-02,European Union,51986,469,3025717,148797
2020-10-03,European Union,41593,231,3067310,149028
2020-10-04,European Union,34071,218,3101381,149246
2020-10-05,European Union,52914,423,3154295,149669
2020-10-06,European Union,50772,665,3205067,150334
2020-10-07,European Union,64350,512,3269417,150846
2020-10-08,European Union,72405,484,3341822,151330
2020-10-09,European Union,81277,620,3423099,151950
2020-10-10,European Union,73418,347,3496517,152297
2020-10-11,European Union,53392,297,3549909,152594
2020-10-12,European Union,76393,605,3626302,153199
2020-10-13,European Union,72269,624,3698571,153823
2020-10-14,European Union,96730,801,3795301,154624
2020-10-15,European Union,112837,729,3908138,155353
2020-10-16,European Union,113483,900,4021621,156253
2020-10-17,European Union,102801,514,4124422,156767
2020-10-18,European Union,92208,489,4216630,157256
2020-10-19,European Union,114118,839,4330748,158095
2020-10-20,European Union,111118,1122,4441866,159217
2020-10-21,European Union,141443,1063,4583309,160280
2020-10-22,European Union,161453,1131,4744762,161411
2020-10-23,European Union,177932,1277,4922694,162688
2020-10-24,European Union,153647,993,5076341,163681
2020-10-25,European Union,106554,630,5182895,164311
2020-10-26,European Union,219318,1433,5402213,165744
2020-10-27,European Union,172706,1873,5574919,167617
2020-10-28,European Union,192818,1583,5767737,169200
2020-10-29,European Union,219879,1704,5987616,170904
2020-10-30,European Union,232231,2075,6219847,172979
2020-10-31,European Union,174306,1601,6394153,174580
2020-11-01,European Union,161993,1257,6556146,175837
2020-11-02,European Union,274748,2031,6830894,177868
2020-11-03,European Union,214518,3244,7045412,181112
2020-11-04,European Union,153455,3652,7198867,184764
2020-11-05,European Union,242611,2637,7441478,187401
2020-11-06,European Union,248930,3222,7690408,190623
2020-11-07,European Union,235004,2163,7925412,192786
2020-11-08,European Union,161812,1668,8087224,194454
2020-11-09,European Union,166738,2555,8253962,197009
2020-11-10,European Union,182755,3891,8436717,200900
2020-11-11,European Union,223937,3596,8660654,204496
2020-11-12,European Union,210107,2955,8870761,207451
2020-11-13,European Union,207110,3562,9077871,211013
2020-11-14,European Union,169772,2546,9247643,213559
2020-11-15,European Union,132080,2112,9379723,215671
2020-11-16,European Union,160516,3081,9540239,218752
2020-11-17,European Union,202552,4273,9742791,223025
2020-11-18,European Union,188615,3787,9931406,226812
2020-11-19,European Union,190680,3333,10122086,230145
2020-11-20,European Union,188842,4271,10310928,234416
2020-11-21,European Union,147381,2695,10458309,237111
2020-11-22,European Union,105584,2095,10563893,239206
2020-11-23,European Union,120961,3273,10684854,242479
2020-11-24,European Union,159208,4683,10844062,247162
2020-11-25,European Union,160903,3849,11004965,251011
2020-11-26,European Union,159387,3856,11164352,254867
2020-11-27,European Union,155061,4393,11319413,259260
2020-11-28,European Union,119298,2831,11438711,262091
2020-11-29,European Union,86246,2119,11524957,264210
2020-11-30,European Union,96108,3256,11621065,267466
2020-12-01,European Union,128668,4309,11749733,271775
2020-12-02,European Union,135914,3909,11885647,275684
2020-12-03,European Union,146760,3970,12032407,279654
2020-12-04,European Union,136310,4024,12168717,283678
2020-12-05,European Union,125506,2767,12294223,286445
2020-12-06,European Union,92531,2111,12386754,288556
2020-12-07,European Union,78332,2818,12465086,291374
2020-12-08,European Union,129624,3775,12594710,295149
2020-12-09,European Union,136679,3552,12731389,298701
2020-12-10,European Union,154819,3795,12886208,302496
2020-12-11,European Union,147616,4091,13033824,306587
2020-12-12,European Union,126292,2816,13160116,309403
2020-12-13,European Union,102500,2127,13262616,311530
2020-12-14,European Union,84070,2945,13346686,314475
2020-12-15,European Union,142561,4657,13489247,319132
2020-12-16,European Union,160985,4164,13650232,323296
2020-12-17,European Union,161699,3810,13811931,327106
2020-12-18,European Union,157984,4093,13969915,331199
2020-12-19,European Union,124829,2782,14094744,333981
2020-12-20,European Union,88808,1881,14183552,335862
2020-12-21,European Union,99002,3007,14282554,338869
2020-12-22,European Union,148162,4302,14430716,343171
2020-12-23,European Union,155424,3852,14586140,347023
2020-12-24,European Union,154364,2878,14740504,349901
2020-12-25,European Union,97840,1964,14838344,351865
2020-12-26,European Union,59630,1682,14897974,353547
2020-12-27,European Union,61491,1711,14959465,355258
2020-12-28,European Union,82169,3013,15041634,358271
2020-12-29,European Union,144298,4816,15185932,363087
2020-12-30,European Union,196752,4334,15382684,367421
2020-12-31,European Union,163706,3229,15546390,370650
2021-01-01,European Union,112548,2296,15658938,372946
2021-01-02,European Union,64511,1744,15723449,374690
2021-01-03,European Union,77689,1682,15801138,376372
2021-01-04,European Union,101218,3079,15902356,379451
2021-01-05,European Union,172569,4706,16074925,384157
2021-01-06,European Union,162499,3629,16237424,387786
2021-01-07,European Union,224545,3642,16461969,391428
2021-01-08,European Union,165734,4035,16627703,395463
2021-01-09,European Union,134617,2652,16762320,398115
2021-01-10,European Union,91667,1856,16853987,399971
2021-01-11,European Union,126646,3059,16980633,403030
2021-01-12,European Union,152866,4517,17133499,407547
2021-01-13,European Union,174504,4139,17308003,411686
2021-01-14,European Union,165974,3914,17473977,415600
2021-01-15,European Union,148030,3527,17622007,419127
2021-01-16,European Union,106529,2810,17728536,421937
2021-01-17,European Union,82216,1875,17810752,423812
2021-01-18,European Union,135234,2483,17945986,426295
2021-01-19,European Union,135215,5016,18081201,431311
2021-01-20,European Union,174627,4351,18255828,435662
2021-01-21,European Union,150257,3802,18406085,439464
2021-01-22,European Union,154195,3933,18560280,443397
2021-01-23,European Union,104107,2354,18664387,445751
2021-01-24,European Union,79394,1889,18743781,447640
2021-01-25,European Union,140212,3286,18883993,450926
2021-01-26,European Union,129876,4050,19013869,454976
2021-01-27,European Union,159909,3904,19173778,458880
2021-01-28,European Union,148854,4314,19322632,463194
2021-01-29,European Union,141291,3646,19463923,466840
2021-01-30,European Union,102815,2848,19566738,469688
2021-01-31,European Union,67196,1434,19633934,471122
2021-02-01,European Union,123312,3406,19757246,474528
2021-02-02,European Union,116130,4492,19873376,479020
2021-02-03,European Union,137342,3819,20010718,482839
2021-02-04,European Union,107724,3282,20118442,486121
2021-02-05,European Union,146769,4095,20265211,490216
2021-02-06,European Union,84762,2026,20349973,492242
2021-02-07,European Union,68143,1425,20418116,493667
2021-02-08,European Union,84065,2992,20502181,496659
2021-02-09,European Union,91354,4150,20593535,500809
2021-02-10,European Union,115654,3407,20709189,504216
2021-02-11,European Union,112302,3251,20821491,507467
2021-02-12,European Union,103547,3218,20925038,510685
2021-02-13,European Union,81152,1844,21006190,512529
2021-02-14,European Union,60393,1201,21066583,513730
2021-02-15,European Union,67281,2205,21133864,515935
2021-02-16,European Union,88569,3164,21222433,519099
2021-02-17,European Union,109104,3196,21331537,522295
2021-02-18,European Union,113211,2665,21444748,524960
2021-02-19,European Union,113688,2887,21558436,527847
2021-02-20,European Union,91618,1540,21650054,529387
2021-02-21,European Union,77441,1044,21727495,530431
2021-02-22,European Union,66803,2152,21794298,532583
2021-02-23,European Union,100320,2897,21894618,535480
2021-02-24,European Union,132503,2627,22027121,538107
2021-02-25,European Union,129085,2122,22156206,540229
2021-02-26,European Union,126799,2813,22283005,543042
2021-02-27,European Union,109576,1640,22392581,544682
2021-02-28,European Union,88268,1095,22480849,545777
2021-03-01,European Union,70140,2132,22550989,547909
2021-03-02,European Union,31750,2578,22582739,550487
2021-03-03,European Union,138570,2759,22721309,553246
2021-03-04,European Union,135594,2310,22856903,555556
2021-03-05,European Union,135323,2770,22992226,558326
2021-03-06,European Union,118953,1593,23111179,559919
2021-03-07,European Union,98601,1122,23209780,561041
2021-03-08,European Union,67542,2054,23277322,563095
2021-03-09,European Union,121096,2683,23398418,565778
2021-03-10,European Union,159082,2548,23557500,568326
2021-03-11,European Union,147472,2370,23704972,570696
2021-03-12,European Union,147678,2306,23852650,573002
2021-03-13,European Union,144558,1677,23997208,574679
2021-03-14,European Union,114922,1334,24112130,576013
2021-03-15,European Union,84579,2022,24196709,578035
2021-03-16,European Union,147293,2651,24344002,580686
2021-03-17,European Union,165450,2335,24509452,583021
2021-03-18,European Union,185064,2590,24694516,585611
2021-03-19,European Union,168491,2355,24863007,587966
2021-03-20,European Union,152915,1862,25015922,589828
2021-03-21,European Union,126906,1353,25142828,591181
2021-03-22,European Union,113307,2490,25256135,593671
2021-03-23,European Union,139641,2891,25395776,596562
2021-03-24,European Union,207487,2577,25603263,599139
2021-03-25,European Union,205211,3055,25808474,602194
2021-03-26,European Union,194923,3525,26003397,605719
2021-03-27,European Union,172952,1980,26176349,607699
2021-03-28,European Union,130020,1369,26306369,609068
2021-03-29,European Union,100973,2103,26407342,611171
2021-03-30,European Union,162338,2907,26569680,614078
2021-03-31,European Union,216452,2935,26786132,617013
2021-04-01,European Union,203859,2773,26989991,619786
2021-04-02,European Union,169714,2485,27159705,622271
2021-04-03,European Union,110635,2068,27270340,624339
2021-04-04,European Union,167010,1725,27437350,626064
2021-04-05,European Union,76198,1637,27513548,627701
2021-04-06,European Union,88862,1943,27602410,629644
2021-04-07,European Union,122034,3273,27724444,632917
2021-04-08,European Union,237721,3733,27962165,636650
2020-03-19,Fiji,1,0,1,0
2020-03-20,Fiji,0,0,1,0
2020-03-21,Fiji,0,0,1,0
2020-03-22,Fiji,1,0,2,0
2020-03-23,Fiji,1,0,3,0
2020-03-24,Fiji,1,0,4,0
2020-03-25,Fiji,1,0,5,0
2020-03-26,Fiji,0,0,5,0
2020-03-27,Fiji,0,0,5,0
2020-03-28,Fiji,0,0,5,0
2020-03-29,Fiji,0,0,5,0
2020-03-30,Fiji,0,0,5,0
2020-03-31,Fiji,0,0,5,0
2020-04-01,Fiji,0,0,5,0
2020-04-02,Fiji,2,0,7,0
2020-04-03,Fiji,0,0,7,0
2020-04-04,Fiji,5,0,12,0
2020-04-05,Fiji,0,0,12,0
2020-04-06,Fiji,2,0,14,0
2020-04-07,Fiji,1,0,15,0
2020-04-08,Fiji,0,0,15,0
2020-04-09,Fiji,0,0,15,0
2020-04-10,Fiji,1,0,16,0
2020-04-11,Fiji,0,0,16,0
2020-04-12,Fiji,0,0,16,0
2020-04-13,Fiji,0,0,16,0
2020-04-14,Fiji,0,0,16,0
2020-04-15,Fiji,0,0,16,0
2020-04-16,Fiji,1,0,17,0
2020-04-17,Fiji,0,0,17,0
2020-04-18,Fiji,0,0,17,0
2020-04-19,Fiji,0,0,17,0
2020-04-20,Fiji,1,0,18,0
2020-04-21,Fiji,0,0,18,0
2020-04-22,Fiji,0,0,18,0
2020-04-23,Fiji,0,0,18,0
2020-04-24,Fiji,0,0,18,0
2020-04-25,Fiji,0,0,18,0
2020-04-26,Fiji,0,0,18,0
2020-04-27,Fiji,0,0,18,0
2020-04-28,Fiji,0,0,18,0
2020-04-29,Fiji,0,0,18,0
2020-04-30,Fiji,0,0,18,0
2020-05-01,Fiji,0,0,18,0
2020-05-02,Fiji,0,0,18,0
2020-05-03,Fiji,0,0,18,0
2020-05-04,Fiji,0,0,18,0
2020-05-05,Fiji,0,0,18,0
2020-05-06,Fiji,0,0,18,0
2020-05-07,Fiji,0,0,18,0
2020-05-08,Fiji,0,0,18,0
2020-05-09,Fiji,0,0,18,0
2020-05-10,Fiji,0,0,18,0
2020-05-11,Fiji,0,0,18,0
2020-05-12,Fiji,0,0,18,0
2020-05-13,Fiji,0,0,18,0
2020-05-14,Fiji,0,0,18,0
2020-05-15,Fiji,0,0,18,0
2020-05-16,Fiji,0,0,18,0
2020-05-17,Fiji,0,0,18,0
2020-05-18,Fiji,0,0,18,0
2020-05-19,Fiji,0,0,18,0
2020-05-20,Fiji,0,0,18,0
2020-05-21,Fiji,0,0,18,0
2020-05-22,Fiji,0,0,18,0
2020-05-23,Fiji,0,0,18,0
2020-05-24,Fiji,0,0,18,0
2020-05-25,Fiji,0,0,18,0
2020-05-26,Fiji,0,0,18,0
2020-05-27,Fiji,0,0,18,0
2020-05-28,Fiji,0,0,18,0
2020-05-29,Fiji,0,0,18,0
2020-05-30,Fiji,0,0,18,0
2020-05-31,Fiji,0,0,18,0
2020-06-01,Fiji,0,0,18,0
2020-06-02,Fiji,0,0,18,0
2020-06-03,Fiji,0,0,18,0
2020-06-04,Fiji,0,0,18,0
2020-06-05,Fiji,0,0,18,0
2020-06-06,Fiji,0,0,18,0
2020-06-07,Fiji,0,0,18,0
2020-06-08,Fiji,0,0,18,0
2020-06-09,Fiji,0,0,18,0
2020-06-10,Fiji,0,0,18,0
2020-06-11,Fiji,0,0,18,0
2020-06-12,Fiji,0,0,18,0
2020-06-13,Fiji,0,0,18,0
2020-06-14,Fiji,0,0,18,0
2020-06-15,Fiji,0,0,18,0
2020-06-16,Fiji,0,0,18,0
2020-06-17,Fiji,0,0,18,0
2020-06-18,Fiji,0,0,18,0
2020-06-19,Fiji,0,0,18,0
2020-06-20,Fiji,0,0,18,0
2020-06-21,Fiji,0,0,18,0
2020-06-22,Fiji,0,0,18,0
2020-06-23,Fiji,0,0,18,0
2020-06-24,Fiji,0,0,18,0
2020-06-25,Fiji,0,0,18,0
2020-06-26,Fiji,0,0,18,0
2020-06-27,Fiji,0,0,18,0
2020-06-28,Fiji,0,0,18,0
2020-06-29,Fiji,0,0,18,0
2020-06-30,Fiji,0,0,18,0
2020-07-01,Fiji,0,0,18,0
2020-07-02,Fiji,0,0,18,0
2020-07-03,Fiji,0,0,18,0
2020-07-04,Fiji,0,0,18,0
2020-07-05,Fiji,1,0,19,0
2020-07-06,Fiji,2,0,21,0
2020-07-07,Fiji,0,0,21,0
2020-07-08,Fiji,0,0,21,0
2020-07-09,Fiji,5,0,26,0
2020-07-10,Fiji,0,0,26,0
2020-07-11,Fiji,0,0,26,0
2020-07-12,Fiji,0,0,26,0
2020-07-13,Fiji,0,0,26,0
2020-07-14,Fiji,0,0,26,0
2020-07-15,Fiji,0,0,26,0
2020-07-16,Fiji,0,0,26,0
2020-07-17,Fiji,0,0,26,0
2020-07-18,Fiji,0,0,26,0
2020-07-19,Fiji,1,0,27,0
2020-07-20,Fiji,0,0,27,0
2020-07-21,Fiji,0,0,27,0
2020-07-22,Fiji,0,0,27,0
2020-07-23,Fiji,0,0,27,0
2020-07-24,Fiji,0,0,27,0
2020-07-25,Fiji,0,0,27,0
2020-07-26,Fiji,0,0,27,0
2020-07-27,Fiji,0,0,27,0
2020-07-28,Fiji,0,0,27,0
2020-07-29,Fiji,0,0,27,0
2020-07-30,Fiji,0,0,27,0
2020-07-31,Fiji,0,1,27,1
2020-08-01,Fiji,0,0,27,1
2020-08-02,Fiji,0,0,27,1
2020-08-03,Fiji,0,0,27,1
2020-08-04,Fiji,0,0,27,1
2020-08-05,Fiji,0,0,27,1
2020-08-06,Fiji,0,0,27,1
2020-08-07,Fiji,0,0,27,1
2020-08-08,Fiji,0,0,27,1
2020-08-09,Fiji,0,0,27,1
2020-08-10,Fiji,0,0,27,1
2020-08-11,Fiji,0,0,27,1
2020-08-12,Fiji,0,0,27,1
2020-08-13,Fiji,1,0,28,1
2020-08-14,Fiji,0,0,28,1
2020-08-15,Fiji,0,0,28,1
2020-08-16,Fiji,0,0,28,1
2020-08-17,Fiji,0,0,28,1
2020-08-18,Fiji,0,0,28,1
2020-08-19,Fiji,0,0,28,1
2020-08-20,Fiji,0,0,28,1
2020-08-21,Fiji,0,0,28,1
2020-08-22,Fiji,0,0,28,1
2020-08-23,Fiji,0,0,28,1
2020-08-24,Fiji,0,0,28,1
2020-08-25,Fiji,0,0,28,1
2020-08-26,Fiji,0,0,28,1
2020-08-27,Fiji,0,1,28,2
2020-08-28,Fiji,0,0,28,2
2020-08-29,Fiji,0,0,28,2
2020-08-30,Fiji,0,0,28,2
2020-08-31,Fiji,0,0,28,2
2020-09-01,Fiji,1,0,29,2
2020-09-02,Fiji,0,0,29,2
2020-09-03,Fiji,0,0,29,2
2020-09-04,Fiji,0,0,29,2
2020-09-05,Fiji,2,0,31,2
2020-09-06,Fiji,0,0,31,2
2020-09-07,Fiji,0,0,31,2
2020-09-08,Fiji,0,0,31,2
2020-09-09,Fiji,1,0,32,2
2020-09-10,Fiji,0,0,32,2
2020-09-11,Fiji,0,0,32,2
2020-09-12,Fiji,0,0,32,2
2020-09-13,Fiji,0,0,32,2
2020-09-14,Fiji,0,0,32,2
2020-09-15,Fiji,0,0,32,2
2020-09-16,Fiji,0,0,32,2
2020-09-17,Fiji,0,0,32,2
2020-09-18,Fiji,0,0,32,2
2020-09-19,Fiji,0,0,32,2
2020-09-20,Fiji,0,0,32,2
2020-09-21,Fiji,0,0,32,2
2020-09-22,Fiji,0,0,32,2
2020-09-23,Fiji,0,0,32,2
2020-09-24,Fiji,0,0,32,2
2020-09-25,Fiji,0,0,32,2
2020-09-26,Fiji,0,0,32,2
2020-09-27,Fiji,0,0,32,2
2020-09-28,Fiji,0,0,32,2
2020-09-29,Fiji,0,0,32,2
2020-09-30,Fiji,0,0,32,2
2020-10-01,Fiji,0,0,32,2
2020-10-02,Fiji,0,0,32,2
2020-10-03,Fiji,0,0,32,2
2020-10-04,Fiji,0,0,32,2
2020-10-05,Fiji,0,0,32,2
2020-10-06,Fiji,0,0,32,2
2020-10-07,Fiji,0,0,32,2
2020-10-08,Fiji,0,0,32,2
2020-10-09,Fiji,0,0,32,2
2020-10-10,Fiji,0,0,32,2
2020-10-11,Fiji,0,0,32,2
2020-10-12,Fiji,0,0,32,2
2020-10-13,Fiji,0,0,32,2
2020-10-14,Fiji,0,0,32,2
2020-10-15,Fiji,0,0,32,2
2020-10-16,Fiji,0,0,32,2
2020-10-17,Fiji,0,0,32,2
2020-10-18,Fiji,0,0,32,2
2020-10-19,Fiji,0,0,32,2
2020-10-20,Fiji,0,0,32,2
2020-10-21,Fiji,1,0,33,2
2020-10-22,Fiji,0,0,33,2
2020-10-23,Fiji,0,0,33,2
2020-10-24,Fiji,0,0,33,2
2020-10-25,Fiji,0,0,33,2
2020-10-26,Fiji,0,0,33,2
2020-10-27,Fiji,0,0,33,2
2020-10-28,Fiji,0,0,33,2
2020-10-29,Fiji,1,0,34,2
2020-10-30,Fiji,0,0,34,2
2020-10-31,Fiji,0,0,34,2
2020-11-01,Fiji,0,0,34,2
2020-11-02,Fiji,0,0,34,2
2020-11-03,Fiji,0,0,34,2
2020-11-04,Fiji,0,0,34,2
2020-11-05,Fiji,0,0,34,2
2020-11-06,Fiji,0,0,34,2
2020-11-07,Fiji,0,0,34,2
2020-11-08,Fiji,0,0,34,2
2020-11-09,Fiji,0,0,34,2
2020-11-10,Fiji,0,0,34,2
2020-11-11,Fiji,1,0,35,2
2020-11-12,Fiji,0,0,35,2
2020-11-13,Fiji,0,0,35,2
2020-11-14,Fiji,0,0,35,2
2020-11-15,Fiji,0,0,35,2
2020-11-16,Fiji,0,0,35,2
2020-11-17,Fiji,0,0,35,2
2020-11-18,Fiji,0,0,35,2
2020-11-19,Fiji,0,0,35,2
2020-11-20,Fiji,0,0,35,2
2020-11-21,Fiji,0,0,35,2
2020-11-22,Fiji,0,0,35,2
2020-11-23,Fiji,0,0,35,2
2020-11-24,Fiji,3,0,38,2
2020-11-25,Fiji,0,0,38,2
2020-11-26,Fiji,0,0,38,2
2020-11-27,Fiji,0,0,38,2
2020-11-28,Fiji,0,0,38,2
2020-11-29,Fiji,0,0,38,2
2020-11-30,Fiji,4,0,42,2
2020-12-01,Fiji,0,0,42,2
2020-12-02,Fiji,0,0,42,2
2020-12-03,Fiji,0,0,42,2
2020-12-04,Fiji,2,0,44,2
2020-12-05,Fiji,0,0,44,2
2020-12-06,Fiji,0,0,44,2
2020-12-07,Fiji,0,0,44,2
2020-12-08,Fiji,0,0,44,2
2020-12-09,Fiji,0,0,44,2
2020-12-10,Fiji,0,0,44,2
2020-12-11,Fiji,0,0,44,2
2020-12-12,Fiji,0,0,44,2
2020-12-13,Fiji,2,0,46,2
2020-12-14,Fiji,0,0,46,2
2020-12-15,Fiji,0,0,46,2
2020-12-16,Fiji,0,0,46,2
2020-12-17,Fiji,0,0,46,2
2020-12-18,Fiji,0,0,46,2
2020-12-19,Fiji,0,0,46,2
2020-12-20,Fiji,0,0,46,2
2020-12-21,Fiji,0,0,46,2
2020-12-22,Fiji,0,0,46,2
2020-12-23,Fiji,0,0,46,2
2020-12-24,Fiji,0,0,46,2
2020-12-25,Fiji,0,0,46,2
2020-12-26,Fiji,0,0,46,2
2020-12-27,Fiji,0,0,46,2
2020-12-28,Fiji,0,0,46,2
2020-12-29,Fiji,3,0,49,2
2020-12-30,Fiji,0,0,49,2
2020-12-31,Fiji,0,0,49,2
2021-01-01,Fiji,0,0,49,2
2021-01-02,Fiji,0,0,49,2
2021-01-03,Fiji,0,0,49,2
2021-01-04,Fiji,0,0,49,2
2021-01-05,Fiji,4,0,53,2
2021-01-06,Fiji,0,0,53,2
2021-01-07,Fiji,0,0,53,2
2021-01-08,Fiji,0,0,53,2
2021-01-09,Fiji,0,0,53,2
2021-01-10,Fiji,0,0,53,2
2021-01-11,Fiji,0,0,53,2
2021-01-12,Fiji,0,0,53,2
2021-01-13,Fiji,0,0,53,2
2021-01-14,Fiji,0,0,53,2
2021-01-15,Fiji,0,0,53,2
2021-01-16,Fiji,2,0,55,2
2021-01-17,Fiji,0,0,55,2
2021-01-18,Fiji,0,0,55,2
2021-01-19,Fiji,0,0,55,2
2021-01-20,Fiji,0,0,55,2
2021-01-21,Fiji,0,0,55,2
2021-01-22,Fiji,0,0,55,2
2021-01-23,Fiji,0,0,55,2
2021-01-24,Fiji,0,0,55,2
2021-01-25,Fiji,0,0,55,2
2021-01-26,Fiji,0,0,55,2
2021-01-27,Fiji,0,0,55,2
2021-01-28,Fiji,0,0,55,2
2021-01-29,Fiji,0,0,55,2
2021-01-30,Fiji,0,0,55,2
2021-01-31,Fiji,0,0,55,2
2021-02-01,Fiji,0,0,55,2
2021-02-02,Fiji,0,0,55,2
2021-02-03,Fiji,1,0,56,2
2021-02-04,Fiji,0,0,56,2
2021-02-05,Fiji,0,0,56,2
2021-02-06,Fiji,0,0,56,2
2021-02-07,Fiji,0,0,56,2
2021-02-08,Fiji,0,0,56,2
2021-02-09,Fiji,0,0,56,2
2021-02-10,Fiji,0,0,56,2
2021-02-11,Fiji,0,0,56,2
2021-02-12,Fiji,0,0,56,2
2021-02-13,Fiji,0,0,56,2
2021-02-14,Fiji,0,0,56,2
2021-02-15,Fiji,0,0,56,2
2021-02-16,Fiji,0,0,56,2
2021-02-17,Fiji,0,0,56,2
2021-02-18,Fiji,0,0,56,2
2021-02-19,Fiji,0,0,56,2
2021-02-20,Fiji,0,0,56,2
2021-02-21,Fiji,0,0,56,2
2021-02-22,Fiji,0,0,56,2
2021-02-23,Fiji,0,0,56,2
2021-02-24,Fiji,1,0,57,2
2021-02-25,Fiji,0,0,57,2
2021-02-26,Fiji,2,0,59,2
2021-02-27,Fiji,0,0,59,2
2021-02-28,Fiji,0,0,59,2
2021-03-01,Fiji,0,0,59,2
2021-03-02,Fiji,0,0,59,2
2021-03-03,Fiji,4,0,63,2
2021-03-04,Fiji,0,0,63,2
2021-03-05,Fiji,0,0,63,2
2021-03-06,Fiji,0,0,63,2
2021-03-07,Fiji,0,0,63,2
2021-03-08,Fiji,3,0,66,2
2021-03-09,Fiji,0,0,66,2
2021-03-10,Fiji,0,0,66,2
2021-03-11,Fiji,0,0,66,2
2021-03-12,Fiji,0,0,66,2
2021-03-13,Fiji,0,0,66,2
2021-03-14,Fiji,0,0,66,2
2021-03-15,Fiji,0,0,66,2
2021-03-16,Fiji,0,0,66,2
2021-03-17,Fiji,0,0,66,2
2021-03-18,Fiji,1,0,67,2
2021-03-19,Fiji,0,0,67,2
2021-03-20,Fiji,0,0,67,2
2021-03-21,Fiji,0,0,67,2
2021-03-22,Fiji,0,0,67,2
2021-03-23,Fiji,0,0,67,2
2021-03-24,Fiji,0,0,67,2
2021-03-25,Fiji,0,0,67,2
2021-03-26,Fiji,0,0,67,2
2021-03-27,Fiji,0,0,67,2
2021-03-28,Fiji,0,0,67,2
2021-03-29,Fiji,0,0,67,2
2021-03-30,Fiji,0,0,67,2
2021-03-31,Fiji,0,0,67,2
2021-04-01,Fiji,0,0,67,2
2021-04-02,Fiji,0,0,67,2
2021-04-03,Fiji,0,0,67,2
2021-04-04,Fiji,0,0,67,2
2021-04-05,Fiji,0,0,67,2
2021-04-06,Fiji,0,0,67,2
2021-04-07,Fiji,0,0,67,2
2021-04-08,Fiji,0,0,67,2
2020-01-29,Finland,1,0,1,0
2020-01-30,Finland,0,0,1,0
2020-01-31,Finland,0,0,1,0
2020-02-01,Finland,0,0,1,0
2020-02-02,Finland,0,0,1,0
2020-02-03,Finland,0,0,1,0
2020-02-04,Finland,0,0,1,0
2020-02-05,Finland,0,0,1,0
2020-02-06,Finland,0,0,1,0
2020-02-07,Finland,0,0,1,0
2020-02-08,Finland,0,0,1,0
2020-02-09,Finland,0,0,1,0
2020-02-10,Finland,0,0,1,0
2020-02-11,Finland,0,0,1,0
2020-02-12,Finland,0,0,1,0
2020-02-13,Finland,0,0,1,0
2020-02-14,Finland,0,0,1,0
2020-02-15,Finland,0,0,1,0
2020-02-16,Finland,0,0,1,0
2020-02-17,Finland,0,0,1,0
2020-02-18,Finland,0,0,1,0
2020-02-19,Finland,0,0,1,0
2020-02-20,Finland,0,0,1,0
2020-02-21,Finland,0,0,1,0
2020-02-22,Finland,0,0,1,0
2020-02-23,Finland,0,0,1,0
2020-02-24,Finland,0,0,1,0
2020-02-25,Finland,0,0,1,0
2020-02-26,Finland,1,0,2,0
2020-02-27,Finland,0,0,2,0
2020-02-28,Finland,0,0,2,0
2020-02-29,Finland,1,0,3,0
2020-03-01,Finland,3,0,6,0
2020-03-02,Finland,0,0,6,0
2020-03-03,Finland,0,0,6,0
2020-03-04,Finland,0,0,6,0
2020-03-05,Finland,6,0,12,0
2020-03-06,Finland,3,0,15,0
2020-03-07,Finland,0,0,15,0
2020-03-08,Finland,8,0,23,0
2020-03-09,Finland,7,0,30,0
2020-03-10,Finland,10,0,40,0
2020-03-11,Finland,19,0,59,0
2020-03-12,Finland,0,0,59,0
2020-03-13,Finland,96,0,155,0
2020-03-14,Finland,70,0,225,0
2020-03-15,Finland,19,0,244,0
2020-03-16,Finland,33,0,277,0
2020-03-17,Finland,44,0,321,0
2020-03-18,Finland,15,0,336,0
2020-03-19,Finland,64,0,400,0
2020-03-20,Finland,50,0,450,0
2020-03-21,Finland,73,1,523,1
2020-03-22,Finland,103,0,626,1
2020-03-23,Finland,74,0,700,1
2020-03-24,Finland,92,0,792,1
2020-03-25,Finland,88,2,880,3
2020-03-26,Finland,78,2,958,5
2020-03-27,Finland,83,2,1041,7
2020-03-28,Finland,126,2,1167,9
2020-03-29,Finland,73,2,1240,11
2020-03-30,Finland,112,2,1352,13
2020-03-31,Finland,66,4,1418,17
2020-04-01,Finland,28,0,1446,17
2020-04-02,Finland,72,2,1518,19
2020-04-03,Finland,97,1,1615,20
2020-04-04,Finland,267,5,1882,25
2020-04-05,Finland,45,3,1927,28
2020-04-06,Finland,249,-1,2176,27
2020-04-07,Finland,132,7,2308,34
2020-04-08,Finland,179,6,2487,40
2020-04-09,Finland,118,2,2605,42
2020-04-10,Finland,164,6,2769,48
2020-04-11,Finland,136,1,2905,49
2020-04-12,Finland,69,7,2974,56
2020-04-13,Finland,90,3,3064,59
2020-04-14,Finland,97,5,3161,64
2020-04-15,Finland,76,8,3237,72
2020-04-16,Finland,132,3,3369,75
2020-04-17,Finland,120,7,3489,82
2020-04-18,Finland,192,8,3681,90
2020-04-19,Finland,102,4,3783,94
2020-04-20,Finland,85,4,3868,98
2020-04-21,Finland,146,43,4014,141
2020-04-22,Finland,115,8,4129,149
2020-04-23,Finland,155,23,4284,172
2020-04-24,Finland,111,5,4395,177
2020-04-25,Finland,80,9,4475,186
2020-04-26,Finland,101,4,4576,190
2020-04-27,Finland,119,3,4695,193
2020-04-28,Finland,45,6,4740,199
2020-04-29,Finland,166,7,4906,206
2020-04-30,Finland,89,5,4995,211
2020-05-01,Finland,56,7,5051,218
2020-05-02,Finland,125,2,5176,220
2020-05-03,Finland,78,10,5254,230
2020-05-04,Finland,73,10,5327,240
2020-05-05,Finland,85,6,5412,246
2020-05-06,Finland,161,6,5573,252
2020-05-07,Finland,100,3,5673,255
2020-05-08,Finland,65,5,5738,260
2020-05-09,Finland,142,5,5880,265
2020-05-10,Finland,82,2,5962,267
2020-05-11,Finland,22,4,5984,271
2020-05-12,Finland,19,4,6003,275
2020-05-13,Finland,51,9,6054,284
2020-05-14,Finland,91,3,6145,287
2020-05-15,Finland,83,6,6228,293
2020-05-16,Finland,58,4,6286,297
2020-05-17,Finland,61,1,6347,298
2020-05-18,Finland,33,2,6380,300
2020-05-19,Finland,19,1,6399,301
2020-05-20,Finland,44,3,6443,304
2020-05-21,Finland,50,2,6493,306
2020-05-22,Finland,44,0,6537,306
2020-05-23,Finland,31,0,6568,306
2020-05-24,Finland,11,1,6579,307
2020-05-25,Finland,20,1,6599,308
2020-05-26,Finland,29,4,6628,312
2020-05-27,Finland,64,1,6692,313
2020-05-28,Finland,51,0,6743,313
2020-05-29,Finland,33,1,6776,314
2020-05-30,Finland,50,2,6826,316
2020-05-31,Finland,33,4,6859,320
2020-06-01,Finland,26,-2,6885,318
2020-06-02,Finland,2,2,6887,320
2020-06-03,Finland,24,1,6911,321
2020-06-04,Finland,0,1,6911,322
2020-06-05,Finland,30,0,6941,322
2020-06-06,Finland,23,0,6964,322
2020-06-07,Finland,17,1,6981,323
2020-06-08,Finland,20,0,7001,323
2020-06-09,Finland,24,1,7025,324
2020-06-10,Finland,15,0,7040,324
2020-06-11,Finland,24,1,7064,325
2020-06-12,Finland,9,0,7073,325
2020-06-13,Finland,14,0,7087,325
2020-06-14,Finland,17,1,7104,326
2020-06-15,Finland,4,0,7108,326
2020-06-16,Finland,4,0,7112,326
2020-06-17,Finland,5,0,7117,326
2020-06-18,Finland,2,0,7119,326
2020-06-19,Finland,14,0,7133,326
2020-06-20,Finland,9,0,7142,326
2020-06-21,Finland,1,0,7143,326
2020-06-22,Finland,1,1,7144,327
2020-06-23,Finland,11,0,7155,327
2020-06-24,Finland,12,0,7167,327
2020-06-25,Finland,5,0,7172,327
2020-06-26,Finland,19,1,7191,328
2020-06-27,Finland,7,0,7198,328
2020-06-28,Finland,0,0,7198,328
2020-06-29,Finland,11,0,7209,328
2020-06-30,Finland,5,0,7214,328
2020-07-01,Finland,22,0,7236,328
2020-07-02,Finland,5,0,7241,328
2020-07-03,Finland,1,1,7242,329
2020-07-04,Finland,6,0,7248,329
2020-07-05,Finland,5,0,7253,329
2020-07-06,Finland,4,0,7257,329
2020-07-07,Finland,5,0,7262,329
2020-07-08,Finland,3,0,7265,329
2020-07-09,Finland,8,0,7273,329
2020-07-10,Finland,6,0,7279,329
2020-07-11,Finland,12,0,7291,329
2020-07-12,Finland,3,0,7294,329
2020-07-13,Finland,1,0,7295,329
2020-07-14,Finland,6,0,7301,329
2020-07-15,Finland,-5,-1,7296,328
2020-07-16,Finland,-3,0,7293,328
2020-07-17,Finland,8,0,7301,328
2020-07-18,Finland,17,0,7318,328
2020-07-19,Finland,17,0,7335,328
2020-07-20,Finland,5,0,7340,328
2020-07-21,Finland,11,0,7351,328
2020-07-22,Finland,11,0,7362,328
2020-07-23,Finland,10,0,7372,328
2020-07-24,Finland,8,1,7380,329
2020-07-25,Finland,8,0,7388,329
2020-07-26,Finland,5,0,7393,329
2020-07-27,Finland,5,0,7398,329
2020-07-28,Finland,6,0,7404,329
2020-07-29,Finland,10,0,7414,329
2020-07-30,Finland,9,0,7423,329
2020-07-31,Finland,9,0,7432,329
2020-08-01,Finland,11,0,7443,329
2020-08-02,Finland,10,0,7453,329
2020-08-03,Finland,13,0,7466,329
2020-08-04,Finland,17,2,7483,331
2020-08-05,Finland,29,0,7512,331
2020-08-06,Finland,20,0,7532,331
2020-08-07,Finland,22,0,7554,331
2020-08-08,Finland,14,0,7568,331
2020-08-09,Finland,16,0,7584,331
2020-08-10,Finland,17,2,7601,333
2020-08-11,Finland,22,0,7623,333
2020-08-12,Finland,19,0,7642,333
2020-08-13,Finland,41,0,7683,333
2020-08-14,Finland,17,0,7700,333
2020-08-15,Finland,20,0,7720,333
2020-08-16,Finland,11,0,7731,333
2020-08-17,Finland,21,1,7752,334
2020-08-18,Finland,24,0,7776,334
2020-08-19,Finland,29,0,7805,334
2020-08-20,Finland,37,0,7842,334
2020-08-21,Finland,29,0,7871,334
2020-08-22,Finland,35,0,7906,334
2020-08-23,Finland,14,0,7920,334
2020-08-24,Finland,18,1,7938,335
2020-08-25,Finland,43,0,7981,335
2020-08-26,Finland,21,0,8002,335
2020-08-27,Finland,17,0,8019,335
2020-08-28,Finland,23,0,8042,335
2020-08-29,Finland,7,0,8049,335
2020-08-30,Finland,28,0,8077,335
2020-08-31,Finland,9,1,8086,336
2020-09-01,Finland,56,0,8142,336
2020-09-02,Finland,19,0,8161,336
2020-09-03,Finland,39,0,8200,336
2020-09-04,Finland,25,0,8225,336
2020-09-05,Finland,36,0,8261,336
2020-09-06,Finland,30,0,8291,336
2020-09-07,Finland,36,0,8327,336
2020-09-08,Finland,10,0,8337,336
2020-09-09,Finland,93,1,8430,337
2020-09-10,Finland,39,0,8469,337
2020-09-11,Finland,43,0,8512,337
2020-09-12,Finland,45,0,8557,337
2020-09-13,Finland,23,0,8580,337
2020-09-14,Finland,47,0,8627,337
2020-09-15,Finland,98,2,8725,339
2020-09-16,Finland,25,0,8750,339
2020-09-17,Finland,49,0,8799,339
2020-09-18,Finland,59,0,8858,339
2020-09-19,Finland,64,0,8922,339
2020-09-20,Finland,58,0,8980,339
2020-09-21,Finland,66,2,9046,341
2020-09-22,Finland,149,0,9195,341
2020-09-23,Finland,93,2,9288,343
2020-09-24,Finland,91,0,9379,343
2020-09-25,Finland,105,0,9484,343
2020-09-26,Finland,93,0,9577,343
2020-09-27,Finland,105,0,9682,343
2020-09-28,Finland,61,2,9743,345
2020-09-29,Finland,149,0,9892,345
2020-09-30,Finland,100,-1,9992,344
2020-10-01,Finland,111,0,10103,344
2020-10-02,Finland,141,1,10244,345
2020-10-03,Finland,147,0,10391,345
2020-10-04,Finland,147,0,10538,345
2020-10-05,Finland,164,1,10702,346
2020-10-06,Finland,227,0,10929,346
2020-10-07,Finland,120,0,11049,346
2020-10-08,Finland,296,0,11345,346
2020-10-09,Finland,235,0,11580,346
2020-10-10,Finland,269,0,11849,346
2020-10-11,Finland,149,0,11998,346
2020-10-12,Finland,214,0,12212,346
2020-10-13,Finland,287,0,12499,346
2020-10-14,Finland,204,4,12703,350
2020-10-15,Finland,241,0,12944,350
2020-10-16,Finland,189,1,13133,351
2020-10-17,Finland,160,0,13293,351
2020-10-18,Finland,131,0,13424,351
2020-10-19,Finland,131,0,13555,351
2020-10-20,Finland,294,0,13849,351
2020-10-21,Finland,222,4,14071,355
2020-10-22,Finland,184,0,14255,355
2020-10-23,Finland,219,-2,14474,353
2020-10-24,Finland,178,0,14652,353
2020-10-25,Finland,196,0,14848,353
2020-10-26,Finland,122,1,14970,354
2020-10-27,Finland,193,0,15163,354
2020-10-28,Finland,215,0,15378,354
2020-10-29,Finland,188,0,15566,354
2020-10-30,Finland,344,4,15910,358
2020-10-31,Finland,203,0,16113,358
2020-11-01,Finland,178,0,16291,358
2020-11-02,Finland,109,1,16400,359
2020-11-03,Finland,237,0,16637,359
2020-11-04,Finland,293,2,16930,361
2020-11-05,Finland,189,0,17119,361
2020-11-06,Finland,266,1,17385,362
2020-11-07,Finland,0,0,17385,362
2020-11-08,Finland,412,0,17797,362
2020-11-09,Finland,90,1,17887,363
2020-11-10,Finland,220,0,18107,363
2020-11-11,Finland,238,2,18345,365
2020-11-12,Finland,197,0,18542,365
2020-11-13,Finland,316,4,18858,369
2020-11-14,Finland,244,0,19102,369
2020-11-15,Finland,213,0,19315,369
2020-11-16,Finland,104,2,19419,371
2020-11-17,Finland,228,0,19647,371
2020-11-18,Finland,288,3,19935,374
2020-11-19,Finland,351,0,20286,374
2020-11-20,Finland,461,1,20747,375
2020-11-21,Finland,469,0,21216,375
2020-11-22,Finland,423,0,21639,375
2020-11-23,Finland,297,9,21936,384
2020-11-24,Finland,353,0,22289,384
2020-11-25,Finland,363,4,22652,388
2020-11-26,Finland,496,0,23148,388
2020-11-27,Finland,618,5,23766,393
2020-11-28,Finland,541,0,24307,393
2020-11-29,Finland,322,0,24629,393
2020-11-30,Finland,283,6,24912,399
2020-12-01,Finland,550,0,25462,399
2020-12-02,Finland,420,9,25882,408
2020-12-03,Finland,540,0,26422,408
2020-12-04,Finland,336,0,26758,408
2020-12-05,Finland,460,7,27218,415
2020-12-06,Finland,413,0,27631,415
2020-12-07,Finland,250,9,27881,424
2020-12-08,Finland,361,0,28242,424
2020-12-09,Finland,490,9,28732,433
2020-12-10,Finland,840,9,29572,442
2020-12-11,Finland,501,11,30073,453
2020-12-12,Finland,377,0,30450,453
2020-12-13,Finland,360,0,30810,453
2020-12-14,Finland,300,8,31110,461
2020-12-15,Finland,349,5,31459,466
2020-12-16,Finland,411,6,31870,472
2020-12-17,Finland,358,12,32228,484
2020-12-18,Finland,354,5,32582,489
2020-12-19,Finland,271,0,32853,489
2020-12-20,Finland,309,0,33162,489
2020-12-21,Finland,252,17,33414,506
2020-12-22,Finland,303,5,33717,511
2020-12-23,Finland,367,13,34084,524
2020-12-24,Finland,363,0,34447,524
2020-12-25,Finland,201,0,34648,524
2020-12-26,Finland,173,0,34821,524
2020-12-27,Finland,156,0,34977,524
2020-12-28,Finland,160,22,35137,546
2020-12-29,Finland,283,4,35420,550
2020-12-30,Finland,438,6,35858,556
2020-12-31,Finland,249,5,36107,561
2021-01-01,Finland,296,0,36403,561
2021-01-02,Finland,201,0,36604,561
2021-01-03,Finland,168,0,36772,561
2021-01-04,Finland,147,4,36919,565
2021-01-05,Finland,299,11,37218,576
2021-01-06,Finland,331,0,37549,576
2021-01-07,Finland,223,8,37772,584
2021-01-08,Finland,296,2,38068,586
2021-01-09,Finland,324,0,38392,586
2021-01-10,Finland,198,0,38590,586
2021-01-11,Finland,200,11,38790,597
2021-01-12,Finland,221,5,39011,602
2021-01-13,Finland,324,0,39335,602
2021-01-14,Finland,258,14,39593,616
2021-01-15,Finland,318,2,39911,618
2021-01-16,Finland,190,0,40101,618
2021-01-17,Finland,236,0,40337,618
2021-01-18,Finland,168,0,40505,618
2021-01-19,Finland,217,3,40722,621
2021-01-20,Finland,444,11,41166,632
2021-01-21,Finland,399,0,41565,632
2021-01-22,Finland,350,12,41915,644
2021-01-23,Finland,419,0,42334,644
2021-01-24,Finland,246,0,42580,644
2021-01-25,Finland,192,11,42772,655
2021-01-26,Finland,348,0,43120,655
2021-01-27,Finland,496,5,43616,660
2021-01-28,Finland,423,4,44039,664
2021-01-29,Finland,363,7,44402,671
2021-01-30,Finland,469,0,44871,671
2021-01-31,Finland,367,0,45238,671
2021-02-01,Finland,244,6,45482,677
2021-02-02,Finland,302,7,45784,684
2021-02-03,Finland,265,1,46049,685
2021-02-04,Finland,444,3,46493,688
2021-02-05,Finland,401,0,46894,688
2021-02-06,Finland,368,0,47262,688
2021-02-07,Finland,354,0,47616,688
2021-02-08,Finland,353,0,47969,688
2021-02-09,Finland,438,15,48407,703
2021-02-10,Finland,400,0,48807,703
2021-02-11,Finland,358,5,49165,708
2021-02-12,Finland,407,2,49572,710
2021-02-13,Finland,435,0,50007,710
2021-02-14,Finland,312,0,50319,710
2021-02-15,Finland,343,6,50662,716
2021-02-16,Finland,385,4,51047,720
2021-02-17,Finland,548,3,51595,723
2021-02-18,Finland,614,2,52209,725
2021-02-19,Finland,444,0,52653,725
2021-02-20,Finland,632,1,53285,726
2021-02-21,Finland,457,0,53742,726
2021-02-22,Finland,390,7,54132,733
2021-02-23,Finland,400,1,54532,734
2021-02-24,Finland,590,3,55122,737
2021-02-25,Finland,565,3,55687,740
2021-02-26,Finland,720,2,56407,742
2021-02-27,Finland,645,0,57052,742
2021-02-28,Finland,620,0,57672,742
2021-03-01,Finland,392,8,58064,750
2021-03-02,Finland,581,5,58645,755
2021-03-03,Finland,797,4,59442,759
2021-03-04,Finland,758,5,60200,764
2021-03-05,Finland,704,3,60904,767
2021-03-06,Finland,648,0,61552,767
2021-03-07,Finland,511,0,62063,767
2021-03-08,Finland,459,7,62522,774
2021-03-09,Finland,588,2,63110,776
2021-03-10,Finland,779,0,63889,776
2021-03-11,Finland,720,0,64609,776
2021-03-12,Finland,706,10,65315,786
2021-03-13,Finland,691,0,66006,786
2021-03-14,Finland,863,0,66869,786
2021-03-15,Finland,465,14,67334,800
2021-03-16,Finland,517,1,67851,801
2021-03-17,Finland,842,3,68693,804
2021-03-18,Finland,804,1,69497,805
2021-03-19,Finland,770,0,70267,805
2021-03-20,Finland,856,0,71123,805
2021-03-21,Finland,520,0,71643,805
2021-03-22,Finland,430,3,72073,808
2021-03-23,Finland,640,0,72713,808
2021-03-24,Finland,803,1,73516,809
2021-03-25,Finland,726,6,74242,815
2021-03-26,Finland,512,2,74754,817
2021-03-27,Finland,791,0,75545,817
2021-03-28,Finland,458,0,76003,817
2021-03-29,Finland,422,5,76425,822
2021-03-30,Finland,420,4,76845,826
2021-03-31,Finland,607,18,77452,844
2021-04-01,Finland,654,2,78106,846
2021-04-02,Finland,566,0,78672,846
2021-04-03,Finland,422,0,79094,846
2021-04-04,Finland,302,0,79396,846
2021-04-05,Finland,341,0,79737,846
2021-04-06,Finland,331,14,80068,860
2021-04-07,Finland,348,2,80416,862
2021-04-08,Finland,426,4,80842,866
2020-01-24,France,2,0,2,0
2020-01-25,France,1,0,3,0
2020-01-26,France,0,0,3,0
2020-01-27,France,0,0,3,0
2020-01-28,France,1,0,4,0
2020-01-29,France,1,0,5,0
2020-01-30,France,0,0,5,0
2020-01-31,France,0,0,5,0
2020-02-01,France,1,0,6,0
2020-02-02,France,0,0,6,0
2020-02-03,France,0,0,6,0
2020-02-04,France,0,0,6,0
2020-02-05,France,0,0,6,0
2020-02-06,France,0,0,6,0
2020-02-07,France,0,0,6,0
2020-02-08,France,5,0,11,0
2020-02-09,France,0,0,11,0
2020-02-10,France,0,0,11,0
2020-02-11,France,0,0,11,0
2020-02-12,France,0,0,11,0
2020-02-13,France,0,0,11,0
2020-02-14,France,0,0,11,0
2020-02-15,France,1,1,12,1
2020-02-16,France,0,0,12,1
2020-02-17,France,0,0,12,1
2020-02-18,France,0,0,12,1
2020-02-19,France,0,0,12,1
2020-02-20,France,0,0,12,1
2020-02-21,France,0,0,12,1
2020-02-22,France,0,0,12,1
2020-02-23,France,0,0,12,1
2020-02-24,France,0,0,12,1
2020-02-25,France,2,0,14,1
2020-02-26,France,4,1,18,2
2020-02-27,France,20,0,38,2
2020-02-28,France,19,0,57,2
2020-02-29,France,43,0,100,2
2020-03-01,France,30,0,130,2
2020-03-02,France,61,1,191,3
2020-03-03,France,21,1,212,4
2020-03-04,France,76,0,288,4
2020-03-05,France,138,3,426,7
2020-03-06,France,190,2,616,9
2020-03-07,France,332,7,948,16
2020-03-08,France,177,3,1125,19
2020-03-09,France,286,6,1411,25
2020-03-10,France,372,8,1783,33
2020-03-11,France,510,15,2293,48
2020-03-12,France,0,0,2293,48
2020-03-13,France,1388,31,3681,79
2020-03-14,France,815,12,4496,91
2020-03-15,France,36,0,4532,91
2020-03-16,France,2151,58,6683,149
2020-03-17,France,1032,0,7715,149
2020-03-18,France,1409,0,9124,149
2020-03-19,France,1846,95,10970,244
2020-03-20,France,1788,207,12758,451
2020-03-21,France,1705,112,14463,563
2020-03-22,France,2295,113,16758,676
2020-03-23,France,3365,186,20123,862
2020-03-24,France,2249,240,22372,1102
2020-03-25,France,2962,231,25334,1333
2020-03-26,France,3918,364,29252,1697
2020-03-27,France,3795,299,33047,1996
2020-03-28,France,4645,318,37692,2314
2020-03-29,France,2603,294,40295,2608
2020-03-30,France,4354,418,44649,3026
2020-03-31,France,7629,500,52278,3526
2020-04-01,France,4844,1252,57122,4778
2020-04-02,France,2106,609,59228,5387
2020-04-03,France,5224,1122,64452,6509
2020-04-04,France,-17074,1053,47378,7562
2020-04-05,France,855,519,48233,8081
2020-04-06,France,2654,833,50887,8914
2020-04-07,France,-3491,1416,47396,10330
2020-04-08,France,3855,544,51251,10874
2020-04-09,France,3784,1340,55035,12214
2020-04-10,France,1565,985,56600,13199
2020-04-11,France,1445,636,58045,13835
2020-04-12,France,50746,561,108791,14396
2020-04-13,France,3141,573,111932,14969
2020-04-14,France,17448,743,129380,15712
2020-04-15,France,3208,1438,132588,17150
2020-04-16,France,12578,753,145166,17903
2020-04-17,France,1891,761,147057,18664
2020-04-18,France,3806,641,150863,19305
2020-04-19,France,1092,389,151955,19694
2020-04-20,France,2447,547,154402,20241
2020-04-21,France,2666,528,157068,20769
2020-04-22,France,1800,544,158868,21313
2020-04-23,France,-1710,516,157158,21829
2020-04-24,France,2811,390,159969,22219
2020-04-25,France,1678,369,161647,22588
2020-04-26,France,633,242,162280,22830
2020-04-27,France,3686,437,165966,23267
2020-04-28,France,3132,367,169098,23634
2020-04-29,France,-1455,426,167643,24060
2020-04-30,France,1218,289,168861,24349
2020-05-01,France,526,217,169387,24566
2020-05-02,France,792,197,170179,24763
2020-05-03,France,361,135,170540,24898
2020-05-04,France,562,306,171102,25204
2020-05-05,France,1117,333,172219,25537
2020-05-06,France,4136,275,176355,25812
2020-05-07,France,741,179,177096,25991
2020-05-08,France,531,242,177627,26233
2020-05-09,France,529,80,178156,26313
2020-05-10,France,249,70,178405,26383
2020-05-11,France,314,263,178719,26646
2020-05-12,France,753,348,179472,26994
2020-05-13,France,521,85,179993,27079
2020-05-14,France,642,351,180635,27430
2020-05-15,France,513,102,181148,27532
2020-05-16,France,415,98,181563,27630
2020-05-17,France,140,483,181703,28113
2020-05-18,France,444,129,182147,28242
2020-05-19,France,501,-217,182648,28025
2020-05-20,France,482,111,183130,28136
2020-05-21,France,267,82,183397,28218
2020-05-22,France,756,148,184153,28366
2020-05-23,France,546,86,184699,28452
2020-05-24,France,-439,-80,184260,28372
2020-05-25,France,325,89,184585,28461
2020-05-26,France,255,137,184840,28598
2020-05-27,France,172,1,185012,28599
2020-05-28,France,3343,67,188355,28666
2020-05-29,France,594,51,188949,28717
2020-05-30,France,1795,57,190744,28774
2020-05-31,France,231,31,190975,28805
2020-06-01,France,407,32,191382,28837
2020-06-02,France,-647,106,190735,28943
2020-06-03,France,-3226,81,187509,29024
2020-06-04,France,4360,45,191869,29069
2020-06-05,France,581,45,192450,29114
2020-06-06,France,572,31,193022,29145
2020-06-07,France,341,13,193363,29158
2020-06-08,France,274,55,193637,29213
2020-06-09,France,553,88,194190,29301
2020-06-10,France,625,21,194815,29322
2020-06-11,France,364,27,195179,29349
2020-06-12,France,802,28,195981,29377
2020-06-13,France,497,24,196478,29401
2020-06-14,France,390,10,196868,29411
2020-06-15,France,136,28,197004,29439
2020-06-16,France,663,114,197667,29553
2020-06-17,France,488,25,198155,29578
2020-06-18,France,586,28,198741,29606
2020-06-19,France,787,14,199528,29620
2020-06-20,France,619,18,200147,29638
2020-06-21,France,343,6,200490,29644
2020-06-22,France,142,24,200632,29668
2020-06-23,France,698,54,201330,29722
2020-06-24,France,268,13,201598,29735
2020-06-25,France,255,19,201853,29754
2020-06-26,France,1263,26,203116,29780
2020-06-27,France,448,1,203564,29781
2020-06-28,France,-406,0,203158,29781
2020-06-29,France,645,35,203803,29816
2020-06-30,France,441,30,204244,29846
2020-07-01,France,990,19,205234,29865
2020-07-02,France,539,13,205773,29878
2020-07-03,France,539,18,206312,29896
2020-07-04,France,358,0,206670,29896
2020-07-05,France,11,-1,206681,29895
2020-07-06,France,1018,30,207699,29925
2020-07-07,France,454,11,208153,29936
2020-07-08,France,822,31,208975,29967
2020-07-09,France,444,16,209419,29983
2020-07-10,France,715,26,210134,30009
2020-07-11,France,251,3,210385,30012
2020-07-12,France,16,0,210401,30012
2020-07-13,France,1423,23,211824,30035
2020-07-14,France,62,2,211886,30037
2020-07-15,France,727,88,212613,30125
2020-07-16,France,569,17,213182,30142
2020-07-17,France,829,13,214011,30155
2020-07-18,France,163,3,214174,30158
2020-07-19,France,4,0,214178,30158
2020-07-20,France,1911,24,216089,30182
2020-07-21,France,595,-13,216684,30169
2020-07-22,France,921,6,217605,30175
2020-07-23,France,1236,11,218841,30186
2020-07-24,France,1091,10,219932,30196
2020-07-25,France,88,0,220020,30196
2020-07-26,France,0,0,220020,30196
2020-07-27,France,2488,18,222508,30214
2020-07-28,France,564,13,223072,30227
2020-07-29,France,1470,14,224542,30241
2020-07-30,France,1389,16,225931,30257
2020-07-31,France,1308,11,227239,30268
2020-08-01,France,63,0,227302,30268
2020-08-02,France,3,0,227305,30268
2020-08-03,France,3360,30,230665,30298
2020-08-04,France,971,2,231636,30300
2020-08-05,France,1708,11,233344,30311
2020-08-06,France,1601,4,234945,30315
2020-08-07,France,2387,13,237332,30328
2020-08-08,France,70,1,237402,30329
2020-08-09,France,35,0,237437,30329
2020-08-10,France,4731,15,242168,30344
2020-08-11,France,1414,14,243582,30358
2020-08-12,France,2598,18,246180,30376
2020-08-13,France,2678,17,248858,30393
2020-08-14,France,2923,19,251781,30412
2020-08-15,France,3210,1,254991,30413
2020-08-16,France,3003,1,257994,30414
2020-08-17,France,650,20,258644,30434
2020-08-18,France,2119,22,260763,30456
2020-08-19,France,3772,18,264535,30474
2020-08-20,France,4800,11,269335,30485
2020-08-21,France,5009,24,274344,30509
2020-08-22,France,3474,9,277818,30518
2020-08-23,France,4680,0,282498,30518
2020-08-24,France,1976,16,284474,30534
2020-08-25,France,3616,19,288090,30553
2020-08-26,France,287,0,288377,30553
2020-08-27,France,11203,35,299580,30588
2020-08-28,France,7641,18,307221,30606
2020-08-29,France,5460,6,312681,30612
2020-08-30,France,5366,3,318047,30615
2020-08-31,France,3113,31,321160,30646
2020-09-01,France,5104,27,326264,30673
2020-09-02,France,7113,27,333377,30700
2020-09-03,France,7122,17,340499,30717
2020-09-04,France,8834,-21,349333,30696
2020-09-05,France,8594,12,357927,30708
2020-09-06,France,7016,4,364943,30712
2020-09-07,France,4266,23,369209,30735
2020-09-08,France,6738,38,375947,30773
2020-09-09,France,8619,32,384566,30805
2020-09-10,France,9762,19,394328,30824
2020-09-11,France,9509,82,403837,30906
2020-09-12,France,11337,18,415174,30924
2020-09-13,France,6345,5,421519,30929
2020-09-14,France,6396,34,427915,30963
2020-09-15,France,7826,50,435741,31013
2020-09-16,France,10191,48,445932,31061
2020-09-17,France,10239,47,456171,31108
2020-09-18,France,13233,154,469404,31262
2020-09-19,France,13560,25,482964,31287
2020-09-20,France,10536,11,493500,31298
2020-09-21,France,5539,53,499039,31351
2020-09-22,France,10084,79,509123,31430
2020-09-23,France,13291,48,522414,31478
2020-09-24,France,15850,46,538264,31524
2020-09-25,France,16104,151,554368,31675
2020-09-26,France,14220,39,568588,31714
2020-09-27,France,10635,27,579223,31741
2020-09-28,France,4299,84,583522,31825
2020-09-29,France,8005,73,591527,31898
2020-09-30,France,14366,80,605893,31978
2020-10-01,France,13051,57,618944,32035
2020-10-02,France,12436,136,631380,32171
2020-10-03,France,16488,25,647868,32196
2020-10-04,France,12504,32,660372,32228
2020-10-05,France,5639,71,666011,32299
2020-10-06,France,11310,87,677321,32386
2020-10-07,France,18953,80,696274,32466
2020-10-08,France,17402,73,713676,32539
2020-10-09,France,21088,110,734764,32649
2020-10-10,France,26677,35,761441,32684
2020-10-11,France,15937,46,777378,32730
2020-10-12,France,9212,97,786590,32827
2020-10-13,France,13626,128,800216,32955
2020-10-14,France,23002,106,823218,33061
2020-10-15,France,29757,85,852975,33146
2020-10-16,France,25632,179,878607,33325
2020-10-17,France,32104,73,910711,33398
2020-10-18,France,29837,85,940548,33483
2020-10-19,France,14289,148,954837,33631
2020-10-20,France,20376,281,975213,33912
2020-10-21,France,27422,168,1002635,34080
2020-10-22,France,40813,154,1043448,34234
2020-10-23,France,42837,300,1086285,34534
2020-10-24,France,45265,136,1131550,34670
2020-10-25,France,6616,-21,1138166,34649
2020-10-26,France,73010,389,1211176,35038
2020-10-27,France,34482,529,1245658,35567
2020-10-28,France,37550,259,1283208,35826
2020-10-29,France,46612,232,1329820,36058
2020-10-30,France,49474,547,1379294,36605
2020-10-31,France,35070,222,1414364,36827
2020-11-01,France,46179,231,1460543,37058
2020-11-02,France,106091,428,1566634,37486
2020-11-03,France,72601,1279,1639235,38765
2020-11-04,France,-46076,-31,1593159,38734
2020-11-05,France,57806,354,1650965,39088
2020-11-06,France,60952,829,1711917,39917
2020-11-07,France,86655,303,1798572,40220
2020-11-08,France,38562,270,1837134,40490
2020-11-09,France,21424,560,1858558,41050
2020-11-10,France,22613,1231,1881171,42281
2020-11-11,France,36406,328,1917577,42609
2020-11-12,France,32628,415,1950205,43024
2020-11-13,France,24065,933,1974270,43957
2020-11-14,France,31957,353,2006227,44310
2020-11-15,France,27192,303,2033419,44613
2020-11-16,France,10050,511,2043469,45124
2020-11-17,France,45602,1226,2089071,46350
2020-11-18,France,28897,431,2117968,46781
2020-11-19,France,20736,417,2138704,47198
2020-11-20,France,23264,1141,2161968,48339
2020-11-21,France,17670,252,2179638,48591
2020-11-22,France,13130,214,2192768,48805
2020-11-23,France,5062,506,2197830,49311
2020-11-24,France,9921,1011,2207751,50322
2020-11-25,France,16754,388,2224505,50710
2020-11-26,France,13001,331,2237506,51041
2020-11-27,France,12774,959,2250280,52000
2020-11-28,France,12477,212,2262757,52212
2020-11-29,France,9763,198,2272520,52410
2020-11-30,France,4354,409,2276874,52819
2020-12-01,France,8364,777,2285238,53596
2020-12-02,France,14228,311,2299466,53907
2020-12-03,France,12787,324,2312253,54231
2020-12-04,France,11511,630,2323764,54861
2020-12-05,France,12882,212,2336646,55073
2020-12-06,France,10949,174,2347595,55247
2020-12-07,France,3411,366,2351006,55613
2020-12-08,France,14037,838,2365043,56451
2020-12-09,France,14675,297,2379718,56748
2020-12-10,France,13872,296,2393590,57044
2020-12-11,France,13489,628,2407079,57672
2020-12-12,France,13947,193,2421026,57865
2020-12-13,France,11533,150,2432559,58015
2020-12-14,France,3192,376,2435751,58391
2020-12-15,France,11655,791,2447406,59182
2020-12-16,France,17720,290,2465126,59472
2020-12-17,France,18398,261,2483524,59733
2020-12-18,France,16005,612,2499529,60345
2020-12-19,France,17428,189,2516957,60534
2020-12-20,France,12799,131,2529756,60665
2020-12-21,France,5960,354,2535716,61019
2020-12-22,France,11861,802,2547577,61821
2020-12-23,France,15038,277,2562615,62098
2020-12-24,France,21718,291,2584333,62389
2020-12-25,France,20262,159,2604595,62548
2020-12-26,France,3093,146,2607688,62694
2020-12-27,France,8822,173,2616510,62867
2020-12-28,France,3106,368,2619616,63235
2020-12-29,France,11494,969,2631110,64204
2020-12-30,France,26514,304,2657624,64508
2020-12-31,France,20042,251,2677666,64759
2021-01-01,France,19348,133,2697014,64892
2021-01-02,France,3466,156,2700480,65048
2021-01-03,France,12495,116,2712975,65164
2021-01-04,France,4084,385,2717059,65549
2021-01-05,France,20825,868,2737884,66417
2021-01-06,France,25232,282,2763116,66699
2021-01-07,France,21767,276,2784883,66975
2021-01-08,France,19860,591,2804743,67566
2021-01-09,France,20177,168,2824920,67734
2021-01-10,France,15944,151,2840864,67885
2021-01-11,France,3816,312,2844680,68197
2021-01-12,France,19680,742,2864360,68939
2021-01-13,France,23932,229,2888292,69168
2021-01-14,France,21431,284,2909723,69452
2021-01-15,France,21317,636,2931040,70088
2021-01-16,France,21409,193,2952449,70281
2021-01-17,France,16642,141,2969091,70422
2021-01-18,France,3798,404,2972889,70826
2021-01-19,France,23895,656,2996784,71482
2021-01-20,France,26877,310,3023661,71792
2021-01-21,France,22710,347,3046371,72139
2021-01-22,France,23324,649,3069695,72788
2021-01-23,France,23924,230,3093619,73018
2021-01-24,France,18436,172,3112055,73190
2021-01-25,France,4300,446,3116355,73636
2021-01-26,France,22143,614,3138498,74250
2021-01-27,France,26951,350,3165449,74600
2021-01-28,France,23956,344,3189405,74944
2021-01-29,France,23235,821,3212640,75765
2021-01-30,France,24045,241,3236685,76006
2021-01-31,France,19235,195,3255920,76201
2021-02-01,France,4388,456,3260308,76657
2021-02-02,France,23337,726,3283645,77383
2021-02-03,France,26406,358,3310051,77741
2021-02-04,France,20,0,3310071,77741
2021-02-05,France,45607,1008,3355678,78749
2021-02-06,France,20588,191,3376266,78940
2021-02-07,France,19715,171,3395981,79111
2021-02-08,France,4343,460,3400324,79571
2021-02-09,France,18886,724,3419210,80295
2021-02-10,France,25678,296,3444888,80591
2021-02-11,France,21076,360,3465964,80951
2021-02-12,France,20709,645,3486673,81596
2021-02-13,France,21231,199,3507904,81795
2021-02-14,France,16546,167,3524450,81962
2021-02-15,France,4406,412,3528856,82374
2021-02-16,France,19596,587,3548452,82961
2021-02-17,France,25186,310,3573638,83271
2021-02-18,France,22518,271,3596156,83542
2021-02-19,France,24127,572,3620283,84114
2021-02-20,France,22371,157,3642654,84271
2021-02-21,France,22046,159,3664700,84430
2021-02-22,France,4654,334,3669354,84764
2021-02-23,France,20180,431,3689534,85195
2021-02-24,France,31527,278,3721061,85473
2021-02-25,France,25414,261,3746475,85734
2021-02-26,France,25216,539,3771691,86273
2021-02-27,France,23996,185,3795687,86458
2021-02-28,France,19952,122,3815639,86580
2021-03-01,France,4730,375,3820369,86955
2021-03-02,France,22872,418,3843241,87373
2021-03-03,France,26903,322,3870144,87695
2021-03-04,France,25286,293,3895430,87988
2021-03-05,France,23507,439,3918937,88427
2021-03-06,France,23306,170,3942243,88597
2021-03-07,France,21835,130,3964078,88727
2021-03-08,France,5534,363,3969612,89090
2021-03-09,France,23143,365,3992755,89455
2021-03-10,France,29674,252,4022429,89707
2021-03-11,France,28129,277,4050558,89984
2021-03-12,France,25177,223,4075735,90207
2021-03-13,France,29792,169,4105527,90376
2021-03-14,France,26347,207,4131874,90583
2021-03-15,France,6471,341,4138345,90924
2021-03-16,France,30066,400,4168411,91324
2021-03-17,France,38501,87,4206912,91411
2021-03-18,France,35061,422,4241973,91833
2021-03-19,France,35198,285,4277171,92118
2021-03-20,France,35339,177,4312510,92295
2021-03-21,France,30587,138,4343097,92433
2021-03-22,France,15813,343,4358910,92776
2021-03-23,France,14697,288,4373607,93064
2021-03-24,France,65392,246,4438999,93310
2021-03-25,France,45660,225,4484659,93535
2021-03-26,France,41871,897,4526530,94432
2021-03-27,France,42634,191,4569164,94623
2021-03-28,France,37021,131,4606185,94754
2021-03-29,France,9110,360,4615295,95114
2021-03-30,France,30719,381,4646014,95495
2021-03-31,France,59054,303,4705068,95798
2021-04-01,France,50711,308,4755779,96106
2021-04-02,France,46678,332,4802457,96438
2021-04-03,France,88,1,4802545,96439
2021-04-04,France,80629,369,4883174,96808
2021-04-05,France,10797,197,4893971,97005
2021-04-06,France,8054,426,4902025,97431
2021-04-07,France,960,13,4902985,97444
2021-04-08,France,97170,752,5000155,98196
2020-03-14,Gabon,1,0,1,0
2020-03-15,Gabon,0,0,1,0
2020-03-16,Gabon,0,0,1,0
2020-03-17,Gabon,0,0,1,0
2020-03-18,Gabon,0,0,1,0
2020-03-19,Gabon,0,0,1,0
2020-03-20,Gabon,2,1,3,1
2020-03-21,Gabon,1,0,4,1
2020-03-22,Gabon,1,0,5,1
2020-03-23,Gabon,0,0,5,1
2020-03-24,Gabon,1,0,6,1
2020-03-25,Gabon,0,0,6,1
2020-03-26,Gabon,1,0,7,1
2020-03-27,Gabon,0,0,7,1
2020-03-28,Gabon,0,0,7,1
2020-03-29,Gabon,0,0,7,1
2020-03-30,Gabon,0,0,7,1
2020-03-31,Gabon,9,0,16,1
2020-04-01,Gabon,2,0,18,1
2020-04-02,Gabon,3,0,21,1
2020-04-03,Gabon,0,0,21,1
2020-04-04,Gabon,0,0,21,1
2020-04-05,Gabon,0,0,21,1
2020-04-06,Gabon,3,0,24,1
2020-04-07,Gabon,6,0,30,1
2020-04-08,Gabon,4,0,34,1
2020-04-09,Gabon,10,0,44,1
2020-04-10,Gabon,0,0,44,1
2020-04-11,Gabon,2,0,46,1
2020-04-12,Gabon,3,0,49,1
2020-04-13,Gabon,8,0,57,1
2020-04-14,Gabon,0,0,57,1
2020-04-15,Gabon,23,0,80,1
2020-04-16,Gabon,0,0,80,1
2020-04-17,Gabon,28,0,108,1
2020-04-18,Gabon,0,0,108,1
2020-04-19,Gabon,1,0,109,1
2020-04-20,Gabon,11,0,120,1
2020-04-21,Gabon,36,0,156,1
2020-04-22,Gabon,10,0,166,1
2020-04-23,Gabon,1,1,167,2
2020-04-24,Gabon,5,1,172,3
2020-04-25,Gabon,4,0,176,3
2020-04-26,Gabon,0,0,176,3
2020-04-27,Gabon,35,0,211,3
2020-04-28,Gabon,27,0,238,3
2020-04-29,Gabon,38,0,276,3
2020-04-30,Gabon,0,0,276,3
2020-05-01,Gabon,0,0,276,3
2020-05-02,Gabon,59,2,335,5
2020-05-03,Gabon,0,0,335,5
2020-05-04,Gabon,32,1,367,6
2020-05-05,Gabon,30,0,397,6
2020-05-06,Gabon,0,0,397,6
2020-05-07,Gabon,107,2,504,8
2020-05-08,Gabon,116,0,620,8
2020-05-09,Gabon,41,0,661,8
2020-05-10,Gabon,0,0,661,8
2020-05-11,Gabon,141,1,802,9
2020-05-12,Gabon,61,0,863,9
2020-05-13,Gabon,141,0,1004,9
2020-05-14,Gabon,100,1,1104,10
2020-05-15,Gabon,105,0,1209,10
2020-05-16,Gabon,111,1,1320,11
2020-05-17,Gabon,0,0,1320,11
2020-05-18,Gabon,112,0,1432,11
2020-05-19,Gabon,70,1,1502,12
2020-05-20,Gabon,65,0,1567,12
2020-05-21,Gabon,0,0,1567,12
2020-05-22,Gabon,161,0,1728,12
2020-05-23,Gabon,206,0,1934,12
2020-05-24,Gabon,0,0,1934,12
2020-05-25,Gabon,201,2,2135,14
2020-05-26,Gabon,103,0,2238,14
2020-05-27,Gabon,81,0,2319,14
2020-05-28,Gabon,112,0,2431,14
2020-05-29,Gabon,182,1,2613,15
2020-05-30,Gabon,42,2,2655,17
2020-05-31,Gabon,0,0,2655,17
2020-06-01,Gabon,0,0,2655,17
2020-06-02,Gabon,148,3,2803,20
2020-06-03,Gabon,99,0,2902,20
2020-06-04,Gabon,53,1,2955,21
2020-06-05,Gabon,146,0,3101,21
2020-06-06,Gabon,0,0,3101,21
2020-06-07,Gabon,0,0,3101,21
2020-06-08,Gabon,0,0,3101,21
2020-06-09,Gabon,146,0,3247,21
2020-06-10,Gabon,128,1,3375,22
2020-06-11,Gabon,88,1,3463,23
2020-06-12,Gabon,0,0,3463,23
2020-06-13,Gabon,0,0,3463,23
2020-06-14,Gabon,0,0,3463,23
2020-06-15,Gabon,570,4,4033,27
2020-06-16,Gabon,81,2,4114,29
2020-06-17,Gabon,115,1,4229,30
2020-06-18,Gabon,111,2,4340,32
2020-06-19,Gabon,88,2,4428,34
2020-06-20,Gabon,0,0,4428,34
2020-06-21,Gabon,0,0,4428,34
2020-06-22,Gabon,311,5,4739,39
2020-06-23,Gabon,110,0,4849,39
2020-06-24,Gabon,107,0,4956,39
2020-06-25,Gabon,131,1,5087,40
2020-06-26,Gabon,122,0,5209,40
2020-06-27,Gabon,0,0,5209,40
2020-06-28,Gabon,0,0,5209,40
2020-06-29,Gabon,185,2,5394,42
2020-06-30,Gabon,0,0,5394,42
2020-07-01,Gabon,119,0,5513,42
2020-07-02,Gabon,0,0,5513,42
2020-07-03,Gabon,107,2,5620,44
2020-07-04,Gabon,0,0,5620,44
2020-07-05,Gabon,0,0,5620,44
2020-07-06,Gabon,123,2,5743,46
2020-07-07,Gabon,0,0,5743,46
2020-07-08,Gabon,128,0,5871,46
2020-07-09,Gabon,0,0,5871,46
2020-07-10,Gabon,71,0,5942,46
2020-07-11,Gabon,0,0,5942,46
2020-07-12,Gabon,0,0,5942,46
2020-07-13,Gabon,84,0,6026,46
2020-07-14,Gabon,0,0,6026,46
2020-07-15,Gabon,95,0,6121,46
2020-07-16,Gabon,0,0,6121,46
2020-07-17,Gabon,194,0,6315,46
2020-07-18,Gabon,0,0,6315,46
2020-07-19,Gabon,0,0,6315,46
2020-07-20,Gabon,118,0,6433,46
2020-07-21,Gabon,0,0,6433,46
2020-07-22,Gabon,155,1,6588,47
2020-07-23,Gabon,0,0,6588,47
2020-07-24,Gabon,396,2,6984,49
2020-07-25,Gabon,0,0,6984,49
2020-07-26,Gabon,0,0,6984,49
2020-07-27,Gabon,205,0,7189,49
2020-07-28,Gabon,0,0,7189,49
2020-07-29,Gabon,163,0,7352,49
2020-07-30,Gabon,0,0,7352,49
2020-07-31,Gabon,0,0,7352,49
2020-08-01,Gabon,179,1,7531,50
2020-08-02,Gabon,0,0,7531,50
2020-08-03,Gabon,115,1,7646,51
2020-08-04,Gabon,0,0,7646,51
2020-08-05,Gabon,141,0,7787,51
2020-08-06,Gabon,0,0,7787,51
2020-08-07,Gabon,136,0,7923,51
2020-08-08,Gabon,0,0,7923,51
2020-08-09,Gabon,0,0,7923,51
2020-08-10,Gabon,83,0,8006,51
2020-08-11,Gabon,0,0,8006,51
2020-08-12,Gabon,71,0,8077,51
2020-08-13,Gabon,0,0,8077,51
2020-08-14,Gabon,148,0,8225,51
2020-08-15,Gabon,0,0,8225,51
2020-08-16,Gabon,0,0,8225,51
2020-08-17,Gabon,45,2,8270,53
2020-08-18,Gabon,0,0,8270,53
2020-08-19,Gabon,49,0,8319,53
2020-08-20,Gabon,0,0,8319,53
2020-08-21,Gabon,69,0,8388,53
2020-08-22,Gabon,0,0,8388,53
2020-08-23,Gabon,0,0,8388,53
2020-08-24,Gabon,21,0,8409,53
2020-08-25,Gabon,0,0,8409,53
2020-08-26,Gabon,59,0,8468,53
2020-08-27,Gabon,0,0,8468,53
2020-08-28,Gabon,37,0,8505,53
2020-08-29,Gabon,0,0,8505,53
2020-08-30,Gabon,0,0,8505,53
2020-08-31,Gabon,28,0,8533,53
2020-09-01,Gabon,0,0,8533,53
2020-09-02,Gabon,5,0,8538,53
2020-09-03,Gabon,0,0,8538,53
2020-09-04,Gabon,63,0,8601,53
2020-09-05,Gabon,0,0,8601,53
2020-09-06,Gabon,0,0,8601,53
2020-09-07,Gabon,7,0,8608,53
2020-09-08,Gabon,0,0,8608,53
2020-09-09,Gabon,13,0,8621,53
2020-09-10,Gabon,0,0,8621,53
2020-09-11,Gabon,22,0,8643,53
2020-09-12,Gabon,0,0,8643,53
2020-09-13,Gabon,0,0,8643,53
2020-09-14,Gabon,11,0,8654,53
2020-09-15,Gabon,0,0,8654,53
2020-09-16,Gabon,24,0,8678,53
2020-09-17,Gabon,0,0,8678,53
2020-09-18,Gabon,18,0,8696,53
2020-09-19,Gabon,0,0,8696,53
2020-09-20,Gabon,0,0,8696,53
2020-09-21,Gabon,8,1,8704,54
2020-09-22,Gabon,0,0,8704,54
2020-09-23,Gabon,12,0,8716,54
2020-09-24,Gabon,0,0,8716,54
2020-09-25,Gabon,12,0,8728,54
2020-09-26,Gabon,0,0,8728,54
2020-09-27,Gabon,0,0,8728,54
2020-09-28,Gabon,0,0,8728,54
2020-09-29,Gabon,24,0,8752,54
2020-09-30,Gabon,14,0,8766,54
2020-10-01,Gabon,0,0,8766,54
2020-10-02,Gabon,31,0,8797,54
2020-10-03,Gabon,0,0,8797,54
2020-10-04,Gabon,0,0,8797,54
2020-10-05,Gabon,11,0,8808,54
2020-10-06,Gabon,0,0,8808,54
2020-10-07,Gabon,7,0,8815,54
2020-10-08,Gabon,0,0,8815,54
2020-10-09,Gabon,20,0,8835,54
2020-10-10,Gabon,0,0,8835,54
2020-10-11,Gabon,0,0,8835,54
2020-10-12,Gabon,25,0,8860,54
2020-10-13,Gabon,0,0,8860,54
2020-10-14,Gabon,9,0,8869,54
2020-10-15,Gabon,0,0,8869,54
2020-10-16,Gabon,12,0,8881,54
2020-10-17,Gabon,0,0,8881,54
2020-10-18,Gabon,0,0,8881,54
2020-10-19,Gabon,3,0,8884,54
2020-10-20,Gabon,0,0,8884,54
2020-10-21,Gabon,17,0,8901,54
2020-10-22,Gabon,0,0,8901,54
2020-10-23,Gabon,18,0,8919,54
2020-10-24,Gabon,0,0,8919,54
2020-10-25,Gabon,0,0,8919,54
2020-10-26,Gabon,18,0,8937,54
2020-10-27,Gabon,0,0,8937,54
2020-10-28,Gabon,20,1,8957,55
2020-10-29,Gabon,0,0,8957,55
2020-10-30,Gabon,11,0,8968,55
2020-10-31,Gabon,0,0,8968,55
2020-11-01,Gabon,0,0,8968,55
2020-11-02,Gabon,16,0,8984,55
2020-11-03,Gabon,0,0,8984,55
2020-11-04,Gabon,21,0,9005,55
2020-11-05,Gabon,0,0,9005,55
2020-11-06,Gabon,17,0,9022,55
2020-11-07,Gabon,0,0,9022,55
2020-11-08,Gabon,0,0,9022,55
2020-11-09,Gabon,7,2,9029,57
2020-11-10,Gabon,0,0,9029,57
2020-11-11,Gabon,19,0,9048,57
2020-11-12,Gabon,0,0,9048,57
2020-11-13,Gabon,14,1,9062,58
2020-11-14,Gabon,0,0,9062,58
2020-11-15,Gabon,0,0,9062,58
2020-11-16,Gabon,22,0,9084,58
2020-11-17,Gabon,0,0,9084,58
2020-11-18,Gabon,0,0,9084,58
2020-11-19,Gabon,32,1,9116,59
2020-11-20,Gabon,15,0,9131,59
2020-11-21,Gabon,0,0,9131,59
2020-11-22,Gabon,0,0,9131,59
2020-11-23,Gabon,19,0,9150,59
2020-11-24,Gabon,0,0,9150,59
2020-11-25,Gabon,23,0,9173,59
2020-11-26,Gabon,0,0,9173,59
2020-11-27,Gabon,18,0,9191,59
2020-11-28,Gabon,0,0,9191,59
2020-11-29,Gabon,0,0,9191,59
2020-11-30,Gabon,23,1,9214,60
2020-12-01,Gabon,0,0,9214,60
2020-12-02,Gabon,25,0,9239,60
2020-12-03,Gabon,0,0,9239,60
2020-12-04,Gabon,15,0,9254,60
2020-12-05,Gabon,0,0,9254,60
2020-12-06,Gabon,0,0,9254,60
2020-12-07,Gabon,24,0,9278,60
2020-12-08,Gabon,0,0,9278,60
2020-12-09,Gabon,22,2,9300,62
2020-12-10,Gabon,0,0,9300,62
2020-12-11,Gabon,30,1,9330,63
2020-12-12,Gabon,0,0,9330,63
2020-12-13,Gabon,0,0,9330,63
2020-12-14,Gabon,21,0,9351,63
2020-12-15,Gabon,0,0,9351,63
2020-12-16,Gabon,22,0,9373,63
2020-12-17,Gabon,0,0,9373,63
2020-12-18,Gabon,27,1,9400,64
2020-12-19,Gabon,0,0,9400,64
2020-12-20,Gabon,0,0,9400,64
2020-12-21,Gabon,20,0,9420,64
2020-12-22,Gabon,0,0,9420,64
2020-12-23,Gabon,49,0,9469,64
2020-12-24,Gabon,0,0,9469,64
2020-12-25,Gabon,28,0,9497,64
2020-12-26,Gabon,0,0,9497,64
2020-12-27,Gabon,0,0,9497,64
2020-12-28,Gabon,13,0,9510,64
2020-12-29,Gabon,0,0,9510,64
2020-12-30,Gabon,61,0,9571,64
2020-12-31,Gabon,0,0,9571,64
2021-01-01,Gabon,0,0,9571,64
2021-01-02,Gabon,0,0,9571,64
2021-01-03,Gabon,0,0,9571,64
2021-01-04,Gabon,34,2,9605,66
2021-01-05,Gabon,0,0,9605,66
2021-01-06,Gabon,36,0,9641,66
2021-01-07,Gabon,0,0,9641,66
2021-01-08,Gabon,53,0,9694,66
2021-01-09,Gabon,0,0,9694,66
2021-01-10,Gabon,0,0,9694,66
2021-01-11,Gabon,46,0,9740,66
2021-01-12,Gabon,0,0,9740,66
2021-01-13,Gabon,79,0,9819,66
2021-01-14,Gabon,0,0,9819,66
2021-01-15,Gabon,80,0,9899,66
2021-01-16,Gabon,0,0,9899,66
2021-01-17,Gabon,0,0,9899,66
2021-01-18,Gabon,120,0,10019,66
2021-01-19,Gabon,0,0,10019,66
2021-01-20,Gabon,101,0,10120,66
2021-01-21,Gabon,0,0,10120,66
2021-01-22,Gabon,158,1,10278,67
2021-01-23,Gabon,0,0,10278,67
2021-01-24,Gabon,0,0,10278,67
2021-01-25,Gabon,133,0,10411,67
2021-01-26,Gabon,0,0,10411,67
2021-01-27,Gabon,125,1,10536,68
2021-01-28,Gabon,0,0,10536,68
2021-01-29,Gabon,212,0,10748,68
2021-01-30,Gabon,0,0,10748,68
2021-01-31,Gabon,0,0,10748,68
2021-02-01,Gabon,204,0,10952,68
2021-02-02,Gabon,0,0,10952,68
2021-02-03,Gabon,177,2,11129,70
2021-02-04,Gabon,0,0,11129,70
2021-02-05,Gabon,328,1,11457,71
2021-02-06,Gabon,0,0,11457,71
2021-02-07,Gabon,0,0,11457,71
2021-02-08,Gabon,379,0,11836,71
2021-02-09,Gabon,0,0,11836,71
2021-02-10,Gabon,335,0,12171,71
2021-02-11,Gabon,0,0,12171,71
2021-02-12,Gabon,406,2,12577,73
2021-02-13,Gabon,0,0,12577,73
2021-02-14,Gabon,0,0,12577,73
2021-02-15,Gabon,288,2,12865,75
2021-02-16,Gabon,0,0,12865,75
2021-02-17,Gabon,242,0,13107,75
2021-02-18,Gabon,0,0,13107,75
2021-02-19,Gabon,446,0,13553,75
2021-02-20,Gabon,0,0,13553,75
2021-02-21,Gabon,0,0,13553,75
2021-02-22,Gabon,331,1,13884,76
2021-02-23,Gabon,0,0,13884,76
2021-02-24,Gabon,350,4,14234,80
2021-02-25,Gabon,0,0,14234,80
2021-02-26,Gabon,330,3,14564,83
2021-02-27,Gabon,0,0,14564,83
2021-02-28,Gabon,0,0,14564,83
2021-03-01,Gabon,285,4,14849,87
2021-03-02,Gabon,0,0,14849,87
2021-03-03,Gabon,405,1,15254,88
2021-03-04,Gabon,0,0,15254,88
2021-03-05,Gabon,0,0,15254,88
2021-03-06,Gabon,371,2,15625,90
2021-03-07,Gabon,0,0,15625,90
2021-03-08,Gabon,390,1,16015,91
2021-03-09,Gabon,0,0,16015,91
2021-03-10,Gabon,298,2,16313,93
2021-03-11,Gabon,0,0,16313,93
2021-03-12,Gabon,347,3,16660,96
2021-03-13,Gabon,0,0,16660,96
2021-03-14,Gabon,0,0,16660,96
2021-03-15,Gabon,285,5,16945,101
2021-03-16,Gabon,0,0,16945,101
2021-03-17,Gabon,352,4,17297,105
2021-03-18,Gabon,0,0,17297,105
2021-03-19,Gabon,414,1,17711,106
2021-03-20,Gabon,0,0,17711,106
2021-03-21,Gabon,0,0,17711,106
2021-03-22,Gabon,367,2,18078,108
2021-03-23,Gabon,0,0,18078,108
2021-03-24,Gabon,348,1,18426,109
2021-03-25,Gabon,0,0,18426,109
2021-03-26,Gabon,0,0,18426,109
2021-03-27,Gabon,351,2,18777,111
2021-03-28,Gabon,0,0,18777,111
2021-03-29,Gabon,363,3,19140,114
2021-03-30,Gabon,0,0,19140,114
2021-03-31,Gabon,410,4,19550,118
2021-04-01,Gabon,0,0,19550,118
2021-04-02,Gabon,313,1,19863,119
2021-04-03,Gabon,0,0,19863,119
2021-04-04,Gabon,0,0,19863,119
2021-04-05,Gabon,0,0,19863,119
2021-04-06,Gabon,0,0,19863,119
2021-04-07,Gabon,402,5,20265,124
2021-04-08,Gabon,0,0,20265,124
2020-03-17,Gambia,1,0,1,0
2020-03-18,Gambia,0,0,1,0
2020-03-19,Gambia,0,0,1,0
2020-03-20,Gambia,0,0,1,0
2020-03-21,Gambia,0,0,1,0
2020-03-22,Gambia,0,0,1,0
2020-03-23,Gambia,1,1,2,1
2020-03-24,Gambia,1,0,3,1
2020-03-25,Gambia,0,0,3,1
2020-03-26,Gambia,0,0,3,1
2020-03-27,Gambia,0,0,3,1
2020-03-28,Gambia,0,0,3,1
2020-03-29,Gambia,1,0,4,1
2020-03-30,Gambia,0,0,4,1
2020-03-31,Gambia,0,0,4,1
2020-04-01,Gambia,0,0,4,1
2020-04-02,Gambia,0,0,4,1
2020-04-03,Gambia,0,0,4,1
2020-04-04,Gambia,0,0,4,1
2020-04-05,Gambia,0,0,4,1
2020-04-06,Gambia,0,0,4,1
2020-04-07,Gambia,0,0,4,1
2020-04-08,Gambia,0,0,4,1
2020-04-09,Gambia,0,0,4,1
2020-04-10,Gambia,0,0,4,1
2020-04-11,Gambia,5,0,9,1
2020-04-12,Gambia,0,0,9,1
2020-04-13,Gambia,0,0,9,1
2020-04-14,Gambia,0,0,9,1
2020-04-15,Gambia,0,0,9,1
2020-04-16,Gambia,0,0,9,1
2020-04-17,Gambia,0,0,9,1
2020-04-18,Gambia,0,0,9,1
2020-04-19,Gambia,1,0,10,1
2020-04-20,Gambia,0,0,10,1
2020-04-21,Gambia,0,0,10,1
2020-04-22,Gambia,0,0,10,1
2020-04-23,Gambia,0,0,10,1
2020-04-24,Gambia,0,0,10,1
2020-04-25,Gambia,0,0,10,1
2020-04-26,Gambia,0,0,10,1
2020-04-27,Gambia,0,0,10,1
2020-04-28,Gambia,0,0,10,1
2020-04-29,Gambia,0,0,10,1
2020-04-30,Gambia,1,0,11,1
2020-05-01,Gambia,1,0,12,1
2020-05-02,Gambia,5,0,17,1
2020-05-03,Gambia,0,0,17,1
2020-05-04,Gambia,0,0,17,1
2020-05-05,Gambia,0,0,17,1
2020-05-06,Gambia,0,0,17,1
2020-05-07,Gambia,1,0,18,1
2020-05-08,Gambia,2,0,20,1
2020-05-09,Gambia,0,0,20,1
2020-05-10,Gambia,0,0,20,1
2020-05-11,Gambia,2,0,22,1
2020-05-12,Gambia,0,0,22,1
2020-05-13,Gambia,1,0,23,1
2020-05-14,Gambia,0,0,23,1
2020-05-15,Gambia,0,0,23,1
2020-05-16,Gambia,0,0,23,1
2020-05-17,Gambia,0,0,23,1
2020-05-18,Gambia,1,0,24,1
2020-05-19,Gambia,0,0,24,1
2020-05-20,Gambia,0,0,24,1
2020-05-21,Gambia,0,0,24,1
2020-05-22,Gambia,1,0,25,1
2020-05-23,Gambia,0,0,25,1
2020-05-24,Gambia,0,0,25,1
2020-05-25,Gambia,0,0,25,1
2020-05-26,Gambia,0,0,25,1
2020-05-27,Gambia,0,0,25,1
2020-05-28,Gambia,0,0,25,1
2020-05-29,Gambia,0,0,25,1
2020-05-30,Gambia,0,0,25,1
2020-05-31,Gambia,0,0,25,1
2020-06-01,Gambia,0,0,25,1
2020-06-02,Gambia,0,0,25,1
2020-06-03,Gambia,1,0,26,1
2020-06-04,Gambia,0,0,26,1
2020-06-05,Gambia,0,0,26,1
2020-06-06,Gambia,0,0,26,1
2020-06-07,Gambia,0,0,26,1
2020-06-08,Gambia,2,0,28,1
2020-06-09,Gambia,0,0,28,1
2020-06-10,Gambia,0,0,28,1
2020-06-11,Gambia,0,0,28,1
2020-06-12,Gambia,0,0,28,1
2020-06-13,Gambia,0,0,28,1
2020-06-14,Gambia,0,0,28,1
2020-06-15,Gambia,2,0,30,1
2020-06-16,Gambia,4,0,34,1
2020-06-17,Gambia,0,0,34,1
2020-06-18,Gambia,2,0,36,1
2020-06-19,Gambia,0,0,36,1
2020-06-20,Gambia,1,1,37,2
2020-06-21,Gambia,0,0,37,2
2020-06-22,Gambia,4,0,41,2
2020-06-23,Gambia,1,0,42,2
2020-06-24,Gambia,0,0,42,2
2020-06-25,Gambia,1,0,43,2
2020-06-26,Gambia,0,0,43,2
2020-06-27,Gambia,1,0,44,2
2020-06-28,Gambia,1,0,45,2
2020-06-29,Gambia,2,0,47,2
2020-06-30,Gambia,2,0,49,2
2020-07-01,Gambia,0,0,49,2
2020-07-02,Gambia,6,0,55,2
2020-07-03,Gambia,0,0,55,2
2020-07-04,Gambia,2,0,57,2
2020-07-05,Gambia,0,0,57,2
2020-07-06,Gambia,4,1,61,3
2020-07-07,Gambia,0,0,61,3
2020-07-08,Gambia,0,0,61,3
2020-07-09,Gambia,2,0,63,3
2020-07-10,Gambia,1,0,64,3
2020-07-11,Gambia,0,0,64,3
2020-07-12,Gambia,0,0,64,3
2020-07-13,Gambia,0,0,64,3
2020-07-14,Gambia,0,0,64,3
2020-07-15,Gambia,0,0,64,3
2020-07-16,Gambia,14,0,78,3
2020-07-17,Gambia,0,0,78,3
2020-07-18,Gambia,15,1,93,4
2020-07-19,Gambia,0,0,93,4
2020-07-20,Gambia,19,0,112,4
2020-07-21,Gambia,0,0,112,4
2020-07-22,Gambia,34,1,146,5
2020-07-23,Gambia,24,0,170,5
2020-07-24,Gambia,46,1,216,6
2020-07-25,Gambia,61,0,277,6
2020-07-26,Gambia,0,0,277,6
2020-07-27,Gambia,49,2,326,8
2020-07-28,Gambia,0,0,326,8
2020-07-29,Gambia,0,0,326,8
2020-07-30,Gambia,77,0,403,8
2020-07-31,Gambia,95,1,498,9
2020-08-01,Gambia,0,0,498,9
2020-08-02,Gambia,0,0,498,9
2020-08-03,Gambia,0,0,498,9
2020-08-04,Gambia,173,5,671,14
2020-08-05,Gambia,128,2,799,16
2020-08-06,Gambia,136,0,935,16
2020-08-07,Gambia,155,3,1090,19
2020-08-08,Gambia,0,0,1090,19
2020-08-09,Gambia,145,4,1235,23
2020-08-10,Gambia,0,0,1235,23
2020-08-11,Gambia,111,9,1346,32
2020-08-12,Gambia,131,1,1477,33
2020-08-13,Gambia,79,10,1556,43
2020-08-14,Gambia,67,7,1623,50
2020-08-15,Gambia,66,4,1689,54
2020-08-16,Gambia,183,9,1872,63
2020-08-17,Gambia,0,0,1872,63
2020-08-18,Gambia,244,0,2116,63
2020-08-19,Gambia,172,14,2288,77
2020-08-20,Gambia,113,4,2401,81
2020-08-21,Gambia,36,3,2437,84
2020-08-22,Gambia,0,0,2437,84
2020-08-23,Gambia,248,3,2685,87
2020-08-24,Gambia,-100,0,2585,87
2020-08-25,Gambia,101,3,2686,90
2020-08-26,Gambia,22,3,2708,93
2020-08-27,Gambia,35,0,2743,93
2020-08-28,Gambia,54,3,2797,96
2020-08-29,Gambia,98,0,2895,96
2020-08-30,Gambia,68,0,2963,96
2020-08-31,Gambia,0,0,2963,96
2020-09-01,Gambia,66,0,3029,96
2020-09-02,Gambia,38,1,3067,97
2020-09-03,Gambia,34,2,3101,99
2020-09-04,Gambia,19,0,3120,99
2020-09-05,Gambia,30,0,3150,99
2020-09-06,Gambia,47,0,3197,99
2020-09-07,Gambia,0,0,3197,99
2020-09-08,Gambia,78,0,3275,99
2020-09-09,Gambia,18,0,3293,99
2020-09-10,Gambia,37,1,3330,100
2020-09-11,Gambia,32,0,3362,100
2020-09-12,Gambia,14,2,3376,102
2020-09-13,Gambia,29,1,3405,103
2020-09-14,Gambia,0,0,3405,103
2020-09-15,Gambia,23,2,3428,105
2020-09-16,Gambia,12,2,3440,107
2020-09-17,Gambia,33,0,3473,107
2020-09-18,Gambia,12,1,3485,108
2020-09-19,Gambia,19,0,3504,108
2020-09-20,Gambia,22,0,3526,108
2020-09-21,Gambia,0,0,3526,108
2020-09-22,Gambia,14,2,3540,110
2020-09-23,Gambia,2,0,3542,110
2020-09-24,Gambia,10,0,3552,110
2020-09-25,Gambia,3,0,3555,110
2020-09-26,Gambia,0,0,3555,110
2020-09-27,Gambia,14,1,3569,111
2020-09-28,Gambia,0,0,3569,111
2020-09-29,Gambia,10,1,3579,112
2020-09-30,Gambia,0,0,3579,112
2020-10-01,Gambia,5,1,3584,113
2020-10-02,Gambia,1,2,3585,115
2020-10-03,Gambia,5,0,3590,115
2020-10-04,Gambia,4,0,3594,115
2020-10-05,Gambia,0,0,3594,115
2020-10-06,Gambia,19,2,3613,117
2020-10-07,Gambia,0,0,3613,117
2020-10-08,Gambia,4,0,3617,117
2020-10-09,Gambia,4,0,3621,117
2020-10-10,Gambia,7,0,3628,117
2020-10-11,Gambia,4,0,3632,117
2020-10-12,Gambia,4,1,3636,118
2020-10-13,Gambia,0,0,3636,118
2020-10-14,Gambia,6,0,3642,118
2020-10-15,Gambia,2,0,3644,118
2020-10-16,Gambia,5,0,3649,118
2020-10-17,Gambia,0,0,3649,118
2020-10-18,Gambia,0,0,3649,118
2020-10-19,Gambia,0,0,3649,118
2020-10-20,Gambia,6,0,3655,118
2020-10-21,Gambia,2,0,3657,118
2020-10-22,Gambia,2,1,3659,119
2020-10-23,Gambia,0,0,3659,119
2020-10-24,Gambia,0,0,3659,119
2020-10-25,Gambia,1,0,3660,119
2020-10-26,Gambia,5,0,3665,119
2020-10-27,Gambia,1,0,3666,119
2020-10-28,Gambia,0,0,3666,119
2020-10-29,Gambia,0,0,3666,119
2020-10-30,Gambia,4,0,3670,119
2020-10-31,Gambia,2,0,3672,119
2020-11-01,Gambia,0,0,3672,119
2020-11-02,Gambia,0,0,3672,119
2020-11-03,Gambia,7,1,3679,120
2020-11-04,Gambia,1,0,3680,120
2020-11-05,Gambia,1,0,3681,120
2020-11-06,Gambia,3,1,3684,121
2020-11-07,Gambia,0,0,3684,121
2020-11-08,Gambia,0,0,3684,121
2020-11-09,Gambia,12,1,3696,122
2020-11-10,Gambia,0,0,3696,122
2020-11-11,Gambia,1,0,3697,122
2020-11-12,Gambia,0,0,3697,122
2020-11-13,Gambia,1,0,3698,122
2020-11-14,Gambia,4,0,3702,122
2020-11-15,Gambia,0,0,3702,122
2020-11-16,Gambia,3,0,3705,122
2020-11-17,Gambia,0,0,3705,122
2020-11-18,Gambia,0,0,3705,122
2020-11-19,Gambia,0,0,3705,122
2020-11-20,Gambia,1,0,3706,122
2020-11-21,Gambia,20,1,3726,123
2020-11-22,Gambia,0,0,3726,123
2020-11-23,Gambia,0,0,3726,123
2020-11-24,Gambia,0,0,3726,123
2020-11-25,Gambia,1,0,3727,123
2020-11-26,Gambia,1,0,3728,123
2020-11-27,Gambia,3,0,3731,123
2020-11-28,Gambia,0,0,3731,123
2020-11-29,Gambia,3,0,3734,123
2020-11-30,Gambia,8,0,3742,123
2020-12-01,Gambia,1,0,3743,123
2020-12-02,Gambia,22,0,3765,123
2020-12-03,Gambia,2,0,3767,123
2020-12-04,Gambia,1,0,3768,123
2020-12-05,Gambia,2,0,3770,123
2020-12-06,Gambia,0,0,3770,123
2020-12-07,Gambia,0,0,3770,123
2020-12-08,Gambia,6,0,3776,123
2020-12-09,Gambia,0,0,3776,123
2020-12-10,Gambia,1,0,3777,123
2020-12-11,Gambia,2,0,3779,123
2020-12-12,Gambia,0,0,3779,123
2020-12-13,Gambia,3,0,3782,123
2020-12-14,Gambia,0,0,3782,123
2020-12-15,Gambia,3,0,3785,123
2020-12-16,Gambia,1,0,3786,123
2020-12-17,Gambia,0,0,3786,123
2020-12-18,Gambia,0,0,3786,123
2020-12-19,Gambia,0,0,3786,123
2020-12-20,Gambia,0,0,3786,123
2020-12-21,Gambia,0,0,3786,123
2020-12-22,Gambia,5,0,3791,123
2020-12-23,Gambia,0,0,3791,123
2020-12-24,Gambia,0,0,3791,123
2020-12-25,Gambia,0,0,3791,123
2020-12-26,Gambia,0,0,3791,123
2020-12-27,Gambia,2,0,3793,123
2020-12-28,Gambia,0,0,3793,123
2020-12-29,Gambia,4,1,3797,124
2020-12-30,Gambia,0,0,3797,124
2020-12-31,Gambia,0,0,3797,124
2021-01-01,Gambia,3,0,3800,124
2021-01-02,Gambia,0,0,3800,124
2021-01-03,Gambia,0,0,3800,124
2021-01-04,Gambia,0,0,3800,124
2021-01-05,Gambia,12,1,3812,125
2021-01-06,Gambia,0,0,3812,125
2021-01-07,Gambia,21,0,3833,125
2021-01-08,Gambia,5,0,3838,125
2021-01-09,Gambia,3,0,3841,125
2021-01-10,Gambia,16,0,3857,125
2021-01-11,Gambia,0,0,3857,125
2021-01-12,Gambia,19,0,3876,125
2021-01-13,Gambia,9,0,3885,125
2021-01-14,Gambia,8,1,3893,126
2021-01-15,Gambia,4,1,3897,127
2021-01-16,Gambia,0,0,3897,127
2021-01-17,Gambia,13,0,3910,127
2021-01-18,Gambia,23,1,3933,128
2021-01-19,Gambia,5,0,3938,128
2021-01-20,Gambia,0,0,3938,128
2021-01-21,Gambia,12,0,3950,128
2021-01-22,Gambia,8,0,3958,128
2021-01-23,Gambia,0,0,3958,128
2021-01-24,Gambia,14,0,3972,128
2021-01-25,Gambia,36,0,4008,128
2021-01-26,Gambia,4,0,4012,128
2021-01-27,Gambia,7,0,4019,128
2021-01-28,Gambia,0,0,4019,128
2021-01-29,Gambia,0,0,4019,128
2021-01-30,Gambia,71,0,4090,128
2021-01-31,Gambia,0,0,4090,128
2021-02-01,Gambia,49,3,4139,131
2021-02-02,Gambia,0,0,4139,131
2021-02-03,Gambia,45,1,4184,132
2021-02-04,Gambia,0,0,4184,132
2021-02-05,Gambia,0,0,4184,132
2021-02-06,Gambia,53,2,4237,134
2021-02-07,Gambia,0,0,4237,134
2021-02-08,Gambia,65,1,4302,135
2021-02-09,Gambia,0,0,4302,135
2021-02-10,Gambia,0,0,4302,135
2021-02-11,Gambia,0,0,4302,135
2021-02-12,Gambia,0,0,4302,135
2021-02-13,Gambia,0,0,4302,135
2021-02-14,Gambia,112,3,4414,138
2021-02-15,Gambia,0,0,4414,138
2021-02-16,Gambia,55,0,4469,138
2021-02-17,Gambia,0,0,4469,138
2021-02-18,Gambia,41,1,4510,139
2021-02-19,Gambia,33,4,4543,143
2021-02-20,Gambia,11,1,4554,144
2021-02-21,Gambia,0,0,4554,144
2021-02-22,Gambia,0,0,4554,144
2021-02-23,Gambia,58,2,4612,146
2021-02-24,Gambia,28,1,4640,147
2021-02-25,Gambia,31,0,4671,147
2021-02-26,Gambia,20,1,4691,148
2021-02-27,Gambia,0,0,4691,148
2021-02-28,Gambia,21,2,4712,150
2021-03-01,Gambia,0,0,4712,150
2021-03-02,Gambia,0,0,4712,150
2021-03-03,Gambia,23,1,4735,151
2021-03-04,Gambia,24,1,4759,152
2021-03-05,Gambia,0,0,4759,152
2021-03-06,Gambia,0,0,4759,152
2021-03-07,Gambia,0,0,4759,152
2021-03-08,Gambia,33,1,4792,153
2021-03-09,Gambia,0,0,4792,153
2021-03-10,Gambia,0,0,4792,153
2021-03-11,Gambia,0,0,4792,153
2021-03-12,Gambia,147,0,4939,153
2021-03-13,Gambia,46,0,4985,153
2021-03-14,Gambia,0,0,4985,153
2021-03-15,Gambia,34,0,5019,153
2021-03-16,Gambia,0,0,5019,153
2021-03-17,Gambia,66,5,5085,158
2021-03-18,Gambia,37,2,5122,160
2021-03-19,Gambia,31,0,5153,160
2021-03-20,Gambia,0,0,5153,160
2021-03-21,Gambia,102,1,5255,161
2021-03-22,Gambia,0,0,5255,161
2021-03-23,Gambia,0,0,5255,161
2021-03-24,Gambia,48,0,5303,161
2021-03-25,Gambia,0,0,5303,161
2021-03-26,Gambia,62,2,5365,163
2021-03-27,Gambia,0,0,5365,163
2021-03-28,Gambia,36,0,5401,163
2021-03-29,Gambia,19,1,5420,164
2021-03-30,Gambia,27,1,5447,165
2021-03-31,Gambia,12,0,5459,165
2021-04-01,Gambia,0,0,5459,165
2021-04-02,Gambia,0,0,5459,165
2021-04-03,Gambia,46,1,5505,166
2021-04-04,Gambia,0,0,5505,166
2021-04-05,Gambia,0,0,5505,166
2021-04-06,Gambia,59,0,5564,166
2021-04-07,Gambia,0,0,5564,166
2021-04-08,Gambia,0,0,5564,166
2020-02-26,Georgia,1,0,1,0
2020-02-27,Georgia,0,0,1,0
2020-02-28,Georgia,0,0,1,0
2020-02-29,Georgia,0,0,1,0
2020-03-01,Georgia,2,0,3,0
2020-03-02,Georgia,0,0,3,0
2020-03-03,Georgia,0,0,3,0
2020-03-04,Georgia,0,0,3,0
2020-03-05,Georgia,1,0,4,0
2020-03-06,Georgia,0,0,4,0
2020-03-07,Georgia,0,0,4,0
2020-03-08,Georgia,9,0,13,0
2020-03-09,Georgia,2,0,15,0
2020-03-10,Georgia,0,0,15,0
2020-03-11,Georgia,9,0,24,0
2020-03-12,Georgia,0,0,24,0
2020-03-13,Georgia,1,0,25,0
2020-03-14,Georgia,5,0,30,0
2020-03-15,Georgia,3,0,33,0
2020-03-16,Georgia,0,0,33,0
2020-03-17,Georgia,1,0,34,0
2020-03-18,Georgia,4,0,38,0
2020-03-19,Georgia,2,0,40,0
2020-03-20,Georgia,3,0,43,0
2020-03-21,Georgia,6,0,49,0
2020-03-22,Georgia,5,0,54,0
2020-03-23,Georgia,7,0,61,0
2020-03-24,Georgia,9,0,70,0
2020-03-25,Georgia,5,0,75,0
2020-03-26,Georgia,4,0,79,0
2020-03-27,Georgia,4,0,83,0
2020-03-28,Georgia,7,0,90,0
2020-03-29,Georgia,1,0,91,0
2020-03-30,Georgia,12,0,103,0
2020-03-31,Georgia,7,0,110,0
2020-04-01,Georgia,7,0,117,0
2020-04-02,Georgia,17,0,134,0
2020-04-03,Georgia,21,0,155,0
2020-04-04,Georgia,7,1,162,1
2020-04-05,Georgia,12,1,174,2
2020-04-06,Georgia,14,0,188,2
2020-04-07,Georgia,8,1,196,3
2020-04-08,Georgia,15,0,211,3
2020-04-09,Georgia,7,0,218,3
2020-04-10,Georgia,16,0,234,3
2020-04-11,Georgia,8,0,242,3
2020-04-12,Georgia,15,0,257,3
2020-04-13,Georgia,15,0,272,3
2020-04-14,Georgia,28,0,300,3
2020-04-15,Georgia,6,0,306,3
2020-04-16,Georgia,42,0,348,3
2020-04-17,Georgia,22,0,370,3
2020-04-18,Georgia,18,1,388,4
2020-04-19,Georgia,6,0,394,4
2020-04-20,Georgia,8,0,402,4
2020-04-21,Georgia,6,0,408,4
2020-04-22,Georgia,8,1,416,5
2020-04-23,Georgia,9,0,425,5
2020-04-24,Georgia,19,0,444,5
2020-04-25,Georgia,12,0,456,5
2020-04-26,Georgia,30,1,486,6
2020-04-27,Georgia,11,0,497,6
2020-04-28,Georgia,14,0,511,6
2020-04-29,Georgia,6,0,517,6
2020-04-30,Georgia,22,0,539,6
2020-05-01,Georgia,27,1,566,7
2020-05-02,Georgia,16,1,582,8
2020-05-03,Georgia,7,1,589,9
2020-05-04,Georgia,4,0,593,9
2020-05-05,Georgia,11,0,604,9
2020-05-06,Georgia,6,0,610,9
2020-05-07,Georgia,5,0,615,9
2020-05-08,Georgia,8,1,623,10
2020-05-09,Georgia,3,0,626,10
2020-05-10,Georgia,9,0,635,10
2020-05-11,Georgia,3,1,638,11
2020-05-12,Georgia,4,0,642,11
2020-05-13,Georgia,5,0,647,11
2020-05-14,Georgia,20,1,667,12
2020-05-15,Georgia,4,0,671,12
2020-05-16,Georgia,12,0,683,12
2020-05-17,Georgia,12,0,695,12
2020-05-18,Georgia,6,0,701,12
2020-05-19,Georgia,6,0,707,12
2020-05-20,Georgia,6,0,713,12
2020-05-21,Georgia,8,0,721,12
2020-05-22,Georgia,2,0,723,12
2020-05-23,Georgia,5,0,728,12
2020-05-24,Georgia,2,0,730,12
2020-05-25,Georgia,1,0,731,12
2020-05-26,Georgia,1,0,732,12
2020-05-27,Georgia,3,0,735,12
2020-05-28,Georgia,3,0,738,12
2020-05-29,Georgia,8,0,746,12
2020-05-30,Georgia,11,0,757,12
2020-05-31,Georgia,26,0,783,12
2020-06-01,Georgia,11,0,794,12
2020-06-02,Georgia,2,1,796,13
2020-06-03,Georgia,4,0,800,13
2020-06-04,Georgia,1,0,801,13
2020-06-05,Georgia,4,0,805,13
2020-06-06,Georgia,3,0,808,13
2020-06-07,Georgia,1,0,809,13
2020-06-08,Georgia,3,0,812,13
2020-06-09,Georgia,6,0,818,13
2020-06-10,Georgia,9,0,827,13
2020-06-11,Georgia,4,0,831,13
2020-06-12,Georgia,12,0,843,13
2020-06-13,Georgia,8,1,851,14
2020-06-14,Georgia,13,0,864,14
2020-06-15,Georgia,15,0,879,14
2020-06-16,Georgia,0,0,879,14
2020-06-17,Georgia,9,0,888,14
2020-06-18,Georgia,5,0,893,14
2020-06-19,Georgia,3,0,896,14
2020-06-20,Georgia,2,0,898,14
2020-06-21,Georgia,8,0,906,14
2020-06-22,Georgia,2,0,908,14
2020-06-23,Georgia,3,0,911,14
2020-06-24,Georgia,3,0,914,14
2020-06-25,Georgia,3,0,917,14
2020-06-26,Georgia,2,0,919,14
2020-06-27,Georgia,2,0,921,14
2020-06-28,Georgia,3,1,924,15
2020-06-29,Georgia,2,0,926,15
2020-06-30,Georgia,2,0,928,15
2020-07-01,Georgia,3,0,931,15
2020-07-02,Georgia,8,0,939,15
2020-07-03,Georgia,4,0,943,15
2020-07-04,Georgia,5,0,948,15
2020-07-05,Georgia,3,0,951,15
2020-07-06,Georgia,2,0,953,15
2020-07-07,Georgia,5,0,958,15
2020-07-08,Georgia,5,0,963,15
2020-07-09,Georgia,5,0,968,15
2020-07-10,Georgia,5,0,973,15
2020-07-11,Georgia,8,0,981,15
2020-07-12,Georgia,5,0,986,15
2020-07-13,Georgia,9,0,995,15
2020-07-14,Georgia,4,0,999,15
2020-07-15,Georgia,5,0,1004,15
2020-07-16,Georgia,2,0,1006,15
2020-07-17,Georgia,4,0,1010,15
2020-07-18,Georgia,8,0,1018,15
2020-07-19,Georgia,10,0,1028,15
2020-07-20,Georgia,11,1,1039,16
2020-07-21,Georgia,10,0,1049,16
2020-07-22,Georgia,24,0,1073,16
2020-07-23,Georgia,12,0,1085,16
2020-07-24,Georgia,19,0,1104,16
2020-07-25,Georgia,13,0,1117,16
2020-07-26,Georgia,14,0,1131,16
2020-07-27,Georgia,6,0,1137,16
2020-07-28,Georgia,8,0,1145,16
2020-07-29,Georgia,10,1,1155,17
2020-07-30,Georgia,5,0,1160,17
2020-07-31,Georgia,8,0,1168,17
2020-08-01,Georgia,3,0,1171,17
2020-08-02,Georgia,6,0,1177,17
2020-08-03,Georgia,2,0,1179,17
2020-08-04,Georgia,3,0,1182,17
2020-08-05,Georgia,15,0,1197,17
2020-08-06,Georgia,9,0,1206,17
2020-08-07,Georgia,7,0,1213,17
2020-08-08,Georgia,3,0,1216,17
2020-08-09,Georgia,9,0,1225,17
2020-08-10,Georgia,25,0,1250,17
2020-08-11,Georgia,14,0,1264,17
2020-08-12,Georgia,14,0,1278,17
2020-08-13,Georgia,5,0,1283,17
2020-08-14,Georgia,23,0,1306,17
2020-08-15,Georgia,15,0,1321,17
2020-08-16,Georgia,15,0,1336,17
2020-08-17,Georgia,5,0,1341,17
2020-08-18,Georgia,10,0,1351,17
2020-08-19,Georgia,10,0,1361,17
2020-08-20,Georgia,9,0,1370,17
2020-08-21,Georgia,15,0,1385,17
2020-08-22,Georgia,9,0,1394,17
2020-08-23,Georgia,17,0,1411,17
2020-08-24,Georgia,10,1,1421,18
2020-08-25,Georgia,8,1,1429,19
2020-08-26,Georgia,7,0,1436,19
2020-08-27,Georgia,11,0,1447,19
2020-08-28,Georgia,8,0,1455,19
2020-08-29,Georgia,7,0,1462,19
2020-08-30,Georgia,7,0,1469,19
2020-08-31,Georgia,18,0,1487,19
2020-09-01,Georgia,23,0,1510,19
2020-09-02,Georgia,38,0,1548,19
2020-09-03,Georgia,20,0,1568,19
2020-09-04,Georgia,28,0,1596,19
2020-09-05,Georgia,25,0,1621,19
2020-09-06,Georgia,29,0,1650,19
2020-09-07,Georgia,34,0,1684,19
2020-09-08,Georgia,45,0,1729,19
2020-09-09,Georgia,44,0,1773,19
2020-09-10,Georgia,57,0,1830,19
2020-09-11,Georgia,87,0,1917,19
2020-09-12,Georgia,158,0,2075,19
2020-09-13,Georgia,152,0,2227,19
2020-09-14,Georgia,165,0,2392,19
2020-09-15,Georgia,170,0,2562,19
2020-09-16,Georgia,196,0,2758,19
2020-09-17,Georgia,179,0,2937,19
2020-09-18,Georgia,182,0,3119,19
2020-09-19,Georgia,187,0,3306,19
2020-09-20,Georgia,196,0,3502,19
2020-09-21,Georgia,193,1,3695,20
2020-09-22,Georgia,218,3,3913,23
2020-09-23,Georgia,227,2,4140,25
2020-09-24,Georgia,259,1,4399,26
2020-09-25,Georgia,265,1,4664,27
2020-09-26,Georgia,296,1,4960,28
2020-09-27,Georgia,294,0,5254,28
2020-09-28,Georgia,298,4,5552,32
2020-09-29,Georgia,314,4,5866,36
2020-09-30,Georgia,326,3,6192,39
2020-10-01,Georgia,448,2,6640,41
2020-10-02,Georgia,453,5,7093,46
2020-10-03,Georgia,471,2,7564,48
2020-10-04,Georgia,554,2,8118,50
2020-10-05,Georgia,578,4,8696,54
2020-10-06,Georgia,549,4,9245,58
2020-10-07,Georgia,508,5,9753,63
2020-10-08,Georgia,472,3,10225,66
2020-10-09,Georgia,527,6,10752,72
2020-10-10,Georgia,519,6,11271,78
2020-10-11,Georgia,523,7,11794,85
2020-10-12,Georgia,478,8,12272,93
2020-10-13,Georgia,569,9,12841,102
2020-10-14,Georgia,680,7,13521,109
2020-10-15,Georgia,919,4,14440,113
2020-10-16,Georgia,887,11,15327,124
2020-10-17,Georgia,958,4,16285,128
2020-10-18,Georgia,1192,8,17477,136
2020-10-19,Georgia,1186,7,18663,143
2020-10-20,Georgia,1194,15,19857,158
2020-10-21,Georgia,1351,14,21208,172
2020-10-22,Georgia,1595,6,22803,178
2020-10-23,Georgia,1759,5,24562,183
2020-10-24,Georgia,1941,10,26503,193
2020-10-25,Georgia,1928,8,28431,201
2020-10-26,Georgia,1872,14,30303,215
2020-10-27,Georgia,1824,23,32127,238
2020-10-28,Georgia,1731,15,33858,253
2020-10-29,Georgia,1709,20,35567,273
2020-10-30,Georgia,1696,12,37263,285
2020-10-31,Georgia,1673,22,38936,307
2020-11-01,Georgia,1791,28,40727,335
2020-11-02,Georgia,1852,7,42579,342
2020-11-03,Georgia,1943,20,44522,362
2020-11-04,Georgia,2295,19,46817,381
2020-11-05,Georgia,2401,20,49218,401
2020-11-06,Georgia,2775,22,51993,423
2020-11-07,Georgia,2859,18,54852,441
2020-11-08,Georgia,2901,34,57753,475
2020-11-09,Georgia,2927,24,60680,499
2020-11-10,Georgia,2970,22,63650,521
2020-11-11,Georgia,2911,45,66561,566
2020-11-12,Georgia,3120,33,69681,599
2020-11-13,Georgia,3473,37,73154,636
2020-11-14,Georgia,3504,33,76658,669
2020-11-15,Georgia,3020,34,79678,703
2020-11-16,Georgia,3157,30,82835,733
2020-11-17,Georgia,3117,45,85952,778
2020-11-18,Georgia,3443,37,89395,815
2020-11-19,Georgia,3697,38,93092,853
2020-11-20,Georgia,3768,41,96860,894
2020-11-21,Georgia,3824,33,100684,927
2020-11-22,Georgia,4048,49,104732,976
2020-11-23,Georgia,3958,36,108690,1012
2020-11-24,Georgia,3128,39,111818,1051
2020-11-25,Georgia,3071,34,114889,1085
2020-11-26,Georgia,3801,39,118690,1124
2020-11-27,Georgia,4780,37,123470,1161
2020-11-28,Georgia,4472,34,127942,1195
2020-11-29,Georgia,4426,35,132368,1230
2020-11-30,Georgia,3216,37,135584,1267
2020-12-01,Georgia,3759,36,139343,1303
2020-12-02,Georgia,4033,39,143376,1342
2020-12-03,Georgia,4260,45,147636,1387
2020-12-04,Georgia,5068,38,152704,1425
2020-12-05,Georgia,5450,37,158154,1462
2020-12-06,Georgia,4321,42,162475,1504
2020-12-07,Georgia,2501,36,164976,1540
2020-12-08,Georgia,4673,36,169649,1576
2020-12-09,Georgia,4734,38,174383,1614
2020-12-10,Georgia,4570,43,178953,1657
2020-12-11,Georgia,4146,37,183099,1694
2020-12-12,Georgia,3907,50,187006,1744
2020-12-13,Georgia,2720,46,189726,1790
2020-12-14,Georgia,1337,49,191063,1839
2020-12-15,Georgia,3837,44,194900,1883
2020-12-16,Georgia,3487,39,198387,1922
2020-12-17,Georgia,2981,31,201368,1953
2020-12-18,Georgia,2635,49,204003,2002
2020-12-19,Georgia,2904,53,206907,2055
2020-12-20,Georgia,1731,39,208638,2094
2020-12-21,Georgia,824,46,209462,2140
2020-12-22,Georgia,3064,42,212526,2182
2020-12-23,Georgia,2345,51,214871,2233
2020-12-24,Georgia,1972,43,216843,2276
2020-12-25,Georgia,1881,37,218724,2313
2020-12-26,Georgia,1784,39,220508,2352
2020-12-27,Georgia,1097,25,221605,2377
2020-12-28,Georgia,538,41,222143,2418
2020-12-29,Georgia,2012,25,224155,2443
2020-12-30,Georgia,1738,38,225893,2481
2020-12-31,Georgia,1527,24,227420,2505
2021-01-01,Georgia,990,23,228410,2528
2021-01-02,Georgia,342,44,228752,2572
2021-01-03,Georgia,417,31,229169,2603
2021-01-04,Georgia,594,25,229763,2628
2021-01-05,Georgia,2316,18,232079,2646
2021-01-06,Georgia,1800,20,233879,2666
2021-01-07,Georgia,1612,28,235491,2694
2021-01-08,Georgia,537,34,236028,2728
2021-01-09,Georgia,2058,22,238086,2750
2021-01-10,Georgia,1143,23,239229,2773
2021-01-11,Georgia,551,23,239780,2796
2021-01-12,Georgia,1857,24,241637,2820
2021-01-13,Georgia,1618,26,243255,2846
2021-01-14,Georgia,1357,21,244612,2867
2021-01-15,Georgia,1177,26,245789,2893
2021-01-16,Georgia,1236,23,247025,2916
2021-01-17,Georgia,780,17,247805,2933
2021-01-18,Georgia,110,25,247915,2958
2021-01-19,Georgia,1550,15,249465,2973
2021-01-20,Georgia,469,14,249934,2987
2021-01-21,Georgia,1137,11,251071,2998
2021-01-22,Georgia,903,24,251974,3022
2021-01-23,Georgia,998,16,252972,3038
2021-01-24,Georgia,546,17,253518,3055
2021-01-25,Georgia,298,16,253816,3071
2021-01-26,Georgia,1006,25,254822,3096
2021-01-27,Georgia,742,12,255564,3108
2021-01-28,Georgia,723,19,256287,3127
2021-01-29,Georgia,669,21,256956,3148
2021-01-30,Georgia,676,11,257632,3159
2021-01-31,Georgia,479,19,258111,3178
2021-02-01,Georgia,240,16,258351,3194
2021-02-02,Georgia,858,14,259209,3208
2021-02-03,Georgia,688,13,259897,3221
2021-02-04,Georgia,583,19,260480,3240
2021-02-05,Georgia,538,18,261018,3258
2021-02-06,Georgia,602,11,261620,3269
2021-02-07,Georgia,404,14,262024,3283
2021-02-08,Georgia,204,15,262228,3298
2021-02-09,Georgia,829,8,263057,3306
2021-02-10,Georgia,544,5,263601,3311
2021-02-11,Georgia,557,10,264158,3321
2021-02-12,Georgia,507,15,264665,3336
2021-02-13,Georgia,535,7,265200,3343
2021-02-14,Georgia,357,9,265557,3352
2021-02-15,Georgia,165,11,265722,3363
2021-02-16,Georgia,740,14,266462,3377
2021-02-17,Georgia,486,13,266948,3390
2021-02-18,Georgia,365,9,267313,3399
2021-02-19,Georgia,388,7,267701,3406
2021-02-20,Georgia,396,19,268097,3425
2021-02-21,Georgia,258,10,268355,3435
2021-02-22,Georgia,147,12,268502,3447
2021-02-23,Georgia,493,10,268995,3457
2021-02-24,Georgia,443,6,269438,3463
2021-02-25,Georgia,362,12,269800,3475
2021-02-26,Georgia,337,10,270137,3485
2021-02-27,Georgia,373,14,270510,3499
2021-02-28,Georgia,248,11,270758,3510
2021-03-01,Georgia,160,10,270918,3520
2021-03-02,Georgia,461,12,271379,3532
2021-03-03,Georgia,360,9,271739,3541
2021-03-04,Georgia,133,12,271872,3553
2021-03-05,Georgia,390,10,272262,3563
2021-03-06,Georgia,355,4,272617,3567
2021-03-07,Georgia,234,9,272851,3576
2021-03-08,Georgia,147,15,272998,3591
2021-03-09,Georgia,139,10,273137,3601
2021-03-10,Georgia,513,12,273650,3613
2021-03-11,Georgia,395,9,274045,3622
2021-03-12,Georgia,332,12,274377,3634
2021-03-13,Georgia,344,9,274721,3643
2021-03-14,Georgia,268,5,274989,3648
2021-03-15,Georgia,159,2,275148,3650
2021-03-16,Georgia,537,8,275685,3658
2021-03-17,Georgia,382,7,276067,3665
2021-03-18,Georgia,369,9,276436,3674
2021-03-19,Georgia,360,9,276796,3683
2021-03-20,Georgia,422,8,277218,3691
2021-03-21,Georgia,262,9,277480,3700
2021-03-22,Georgia,170,10,277650,3710
2021-03-23,Georgia,528,4,278178,3714
2021-03-24,Georgia,450,8,278628,3722
2021-03-25,Georgia,399,10,279027,3732
2021-03-26,Georgia,419,6,279446,3738
2021-03-27,Georgia,490,8,279936,3746
2021-03-28,Georgia,365,5,280301,3751
2021-03-29,Georgia,171,14,280472,3765
2021-03-30,Georgia,673,8,281145,3773
2021-03-31,Georgia,616,5,281761,3778
2021-04-01,Georgia,499,7,282260,3785
2021-04-02,Georgia,529,13,282789,3798
2021-04-03,Georgia,580,6,283369,3804
2021-04-04,Georgia,464,7,283833,3811
2021-04-05,Georgia,228,11,284061,3822
2021-04-06,Georgia,897,10,284958,3832
2021-04-07,Georgia,687,8,285645,3840
2021-04-08,Georgia,761,9,286406,3849
2020-01-27,Germany,1,0,1,0
2020-01-28,Germany,3,0,4,0
2020-01-29,Germany,0,0,4,0
2020-01-30,Germany,0,0,4,0
2020-01-31,Germany,1,0,5,0
2020-02-01,Germany,3,0,8,0
2020-02-02,Germany,2,0,10,0
2020-02-03,Germany,2,0,12,0
2020-02-04,Germany,0,0,12,0
2020-02-05,Germany,0,0,12,0
2020-02-06,Germany,0,0,12,0
2020-02-07,Germany,1,0,13,0
2020-02-08,Germany,0,0,13,0
2020-02-09,Germany,1,0,14,0
2020-02-10,Germany,0,0,14,0
2020-02-11,Germany,2,0,16,0
2020-02-12,Germany,0,0,16,0
2020-02-13,Germany,0,0,16,0
2020-02-14,Germany,0,0,16,0
2020-02-15,Germany,0,0,16,0
2020-02-16,Germany,0,0,16,0
2020-02-17,Germany,0,0,16,0
2020-02-18,Germany,0,0,16,0
2020-02-19,Germany,0,0,16,0
2020-02-20,Germany,0,0,16,0
2020-02-21,Germany,0,0,16,0
2020-02-22,Germany,0,0,16,0
2020-02-23,Germany,0,0,16,0
2020-02-24,Germany,0,0,16,0
2020-02-25,Germany,1,0,17,0
2020-02-26,Germany,10,0,27,0
2020-02-27,Germany,19,0,46,0
2020-02-28,Germany,2,0,48,0
2020-02-29,Germany,31,0,79,0
2020-03-01,Germany,51,0,130,0
2020-03-02,Germany,29,0,159,0
2020-03-03,Germany,37,0,196,0
2020-03-04,Germany,66,0,262,0
2020-03-05,Germany,220,0,482,0
2020-03-06,Germany,188,0,670,0
2020-03-07,Germany,129,0,799,0
2020-03-08,Germany,241,0,1040,0
2020-03-09,Germany,136,2,1176,2
2020-03-10,Germany,281,0,1457,2
2020-03-11,Germany,451,1,1908,3
2020-03-12,Germany,170,0,2078,3
2020-03-13,Germany,1597,4,3675,7
2020-03-14,Germany,910,2,4585,9
2020-03-15,Germany,1210,2,5795,11
2020-03-16,Germany,1477,6,7272,17
2020-03-17,Germany,1985,7,9257,24
2020-03-18,Germany,3070,4,12327,28
2020-03-19,Germany,2993,16,15320,44
2020-03-20,Germany,4528,23,19848,67
2020-03-21,Germany,2365,17,22213,84
2020-03-22,Germany,2660,10,24873,94
2020-03-23,Germany,4183,29,29056,123
2020-03-24,Germany,3930,34,32986,157
2020-03-25,Germany,4337,49,37323,206
2020-03-26,Germany,6615,61,43938,267
2020-03-27,Germany,6933,75,50871,342
2020-03-28,Germany,6824,91,57695,433
2020-03-29,Germany,4400,100,62095,533
2020-03-30,Germany,4790,112,66885,645
2020-03-31,Germany,4923,130,71808,775
2020-04-01,Germany,6064,145,77872,920
2020-04-02,Germany,6922,187,84794,1107
2020-04-03,Germany,6365,168,91159,1275
2020-04-04,Germany,4933,169,96092,1444
2020-04-05,Germany,4031,140,100123,1584
2020-04-06,Germany,3251,226,103374,1810
2020-04-07,Germany,4289,206,107663,2016
2020-04-08,Germany,5633,333,113296,2349
2020-04-09,Germany,4885,258,118181,2607
2020-04-10,Germany,3990,160,122171,2767
2020-04-11,Germany,2737,-31,124908,2736
2020-04-12,Germany,2946,286,127854,3022
2020-04-13,Germany,2218,172,130072,3194
2020-04-14,Germany,1287,100,131359,3294
2020-04-15,Germany,3394,510,134753,3804
2020-04-16,Germany,2945,248,137698,4052
2020-04-17,Germany,3699,300,141397,4352
2020-04-18,Germany,1945,107,143342,4459
2020-04-19,Germany,1842,127,145184,4586
2020-04-20,Germany,1881,276,147065,4862
2020-04-21,Germany,1226,171,148291,5033
2020-04-22,Germany,2357,246,150648,5279
2020-04-23,Germany,2481,296,153129,5575
2020-04-24,Germany,1870,185,154999,5760
2020-04-25,Germany,1514,117,156513,5877
2020-04-26,Germany,1257,99,157770,5976
2020-04-27,Germany,988,150,158758,6126
2020-04-28,Germany,1154,188,159912,6314
2020-04-29,Germany,1627,153,161539,6467
2020-04-30,Germany,1470,156,163009,6623
2020-05-01,Germany,1068,113,164077,6736
2020-05-02,Germany,890,76,164967,6812
2020-05-03,Germany,697,54,165664,6866
2020-05-04,Germany,488,127,166152,6993
2020-05-05,Germany,855,0,167007,6993
2020-05-06,Germany,1155,282,168162,7275
2020-05-07,Germany,1268,117,169430,7392
2020-05-08,Germany,1158,118,170588,7510
2020-05-09,Germany,736,39,171324,7549
2020-05-10,Germany,555,20,171879,7569
2020-05-11,Germany,697,92,172576,7661
2020-05-12,Germany,595,77,173171,7738
2020-05-13,Germany,927,123,174098,7861
2020-05-14,Germany,380,23,174478,7884
2020-05-15,Germany,755,13,175233,7897
2020-05-16,Germany,519,41,175752,7938
2020-05-17,Germany,617,24,176369,7962
2020-05-18,Germany,182,41,176551,8003
2020-05-19,Germany,1227,78,177778,8081
2020-05-20,Germany,695,63,178473,8144
2020-05-21,Germany,548,59,179021,8203
2020-05-22,Germany,689,25,179710,8228
2020-05-23,Germany,276,33,179986,8261
2020-05-24,Germany,342,22,180328,8283
2020-05-25,Germany,272,26,180600,8309
2020-05-26,Germany,600,63,181200,8372
2020-05-27,Germany,324,56,181524,8428
2020-05-28,Germany,672,42,182196,8470
2020-05-29,Germany,726,34,182922,8504
2020-05-30,Germany,267,26,183189,8530
2020-05-31,Germany,221,10,183410,8540
2020-06-01,Germany,184,15,183594,8555
2020-06-02,Germany,285,8,183879,8563
2020-06-03,Germany,242,39,184121,8602
2020-06-04,Germany,351,33,184472,8635
2020-06-05,Germany,452,23,184924,8658
2020-06-06,Germany,526,15,185450,8673
2020-06-07,Germany,300,12,185750,8685
2020-06-08,Germany,359,10,186109,8695
2020-06-09,Germany,397,41,186506,8736
2020-06-10,Germany,16,16,186522,8752
2020-06-11,Germany,169,20,186691,8772
2020-06-12,Germany,535,11,187226,8783
2020-06-13,Germany,41,10,187267,8793
2020-06-14,Germany,251,8,187518,8801
2020-06-15,Germany,164,6,187682,8807
2020-06-16,Germany,570,13,188252,8820
2020-06-17,Germany,352,31,188604,8851
2020-06-18,Germany,1213,24,189817,8875
2020-06-19,Germany,482,12,190299,8887
2020-06-20,Germany,371,8,190670,8895
2020-06-21,Germany,602,0,191272,8895
2020-06-22,Germany,496,4,191768,8899
2020-06-23,Germany,712,15,192480,8914
2020-06-24,Germany,391,14,192871,8928
2020-06-25,Germany,500,12,193371,8940
2020-06-26,Germany,665,25,194036,8965
2020-06-27,Germany,422,3,194458,8968
2020-06-28,Germany,235,0,194693,8968
2020-06-29,Germany,349,8,195042,8976
2020-06-30,Germany,376,14,195418,8990
2020-07-01,Germany,475,5,195893,8995
2020-07-02,Germany,477,11,196370,9006
2020-07-03,Germany,410,4,196780,9010
2020-07-04,Germany,418,10,197198,9020
2020-07-05,Germany,325,3,197523,9023
2020-07-06,Germany,541,-1,198064,9022
2020-07-07,Germany,279,10,198343,9032
2020-07-08,Germany,356,14,198699,9046
2020-07-09,Germany,302,11,199001,9057
2020-07-10,Germany,331,6,199332,9063
2020-07-11,Germany,377,7,199709,9070
2020-07-12,Germany,210,1,199919,9071
2020-07-13,Germany,261,3,200180,9074
2020-07-14,Germany,276,4,200456,9078
2020-07-15,Germany,434,2,200890,9080
2020-07-16,Germany,560,7,201450,9087
2020-07-17,Germany,595,1,202045,9088
2020-07-18,Germany,381,3,202426,9091
2020-07-19,Germany,309,1,202735,9092
2020-07-20,Germany,590,2,203325,9094
2020-07-21,Germany,392,5,203717,9099
2020-07-22,Germany,559,3,204276,9102
2020-07-23,Germany,605,8,204881,9110
2020-07-24,Germany,742,10,205623,9120
2020-07-25,Germany,655,4,206278,9124
2020-07-26,Germany,389,0,206667,9124
2020-07-27,Germany,445,1,207112,9125
2020-07-28,Germany,595,6,207707,9131
2020-07-29,Germany,839,4,208546,9135
2020-07-30,Germany,989,9,209535,9144
2020-07-31,Germany,864,3,210399,9147
2020-08-01,Germany,606,7,211005,9154
2020-08-02,Germany,215,0,211220,9154
2020-08-03,Germany,891,0,212111,9154
2020-08-04,Germany,717,9,212828,9163
2020-08-05,Germany,1285,16,214113,9179
2020-08-06,Germany,926,2,215039,9181
2020-08-07,Germany,1157,14,216196,9195
2020-08-08,Germany,707,6,216903,9201
2020-08-09,Germany,385,1,217288,9202
2020-08-10,Germany,1220,1,218508,9203
2020-08-11,Germany,1032,5,219540,9208
2020-08-12,Germany,1319,5,220859,9213
2020-08-13,Germany,1422,4,222281,9217
2020-08-14,Germany,1510,13,223791,9230
2020-08-15,Germany,697,5,224488,9235
2020-08-16,Germany,519,0,225007,9235
2020-08-17,Germany,1693,1,226700,9236
2020-08-18,Germany,1420,5,228120,9241
2020-08-19,Germany,1586,8,229706,9249
2020-08-20,Germany,1586,14,231292,9263
2020-08-21,Germany,1737,3,233029,9266
2020-08-22,Germany,832,6,233861,9272
2020-08-23,Germany,633,3,234494,9275
2020-08-24,Germany,1628,1,236122,9276
2020-08-25,Germany,1461,5,237583,9281
2020-08-26,Germany,1427,4,239010,9285
2020-08-27,Germany,1561,5,240571,9290
2020-08-28,Germany,1555,0,242126,9290
2020-08-29,Germany,709,9,242835,9299
2020-08-30,Germany,470,1,243305,9300
2020-08-31,Germany,1497,3,244802,9303
2020-09-01,Germany,1213,4,246015,9307
2020-09-02,Germany,1396,15,247411,9322
2020-09-03,Germany,1429,0,248840,9322
2020-09-04,Germany,1443,5,250283,9327
2020-09-05,Germany,775,2,251058,9329
2020-09-06,Germany,670,1,251728,9330
2020-09-07,Germany,1898,1,253626,9331
2020-09-08,Germany,1331,5,254957,9336
2020-09-09,Germany,1476,6,256433,9342
2020-09-10,Germany,1716,3,258149,9345
2020-09-11,Germany,1586,3,259735,9348
2020-09-12,Germany,1082,4,260817,9352
2020-09-13,Germany,920,2,261737,9354
2020-09-14,Germany,1485,2,263222,9356
2020-09-15,Germany,1792,11,265014,9367
2020-09-16,Germany,1855,6,266869,9373
2020-09-17,Germany,2179,3,269048,9376
2020-09-18,Germany,2199,10,271247,9386
2020-09-19,Germany,1685,2,272932,9388
2020-09-20,Germany,1033,2,273965,9390
2020-09-21,Germany,1595,0,275560,9390
2020-09-22,Germany,1852,15,277412,9405
2020-09-23,Germany,1613,18,279025,9423
2020-09-24,Germany,2321,13,281346,9436
2020-09-25,Germany,2366,15,283712,9451
2020-09-26,Germany,1314,8,285026,9459
2020-09-27,Germany,1313,5,286339,9464
2020-09-28,Germany,2292,4,288631,9468
2020-09-29,Germany,1840,15,290471,9483
2020-09-30,Germany,2442,12,292913,9495
2020-10-01,Germany,2626,14,295539,9509
2020-10-02,Germany,2835,9,298374,9518
2020-10-03,Germany,1653,13,300027,9531
2020-10-04,Germany,1546,2,301573,9533
2020-10-05,Germany,3100,21,304673,9554
2020-10-06,Germany,2454,12,307127,9566
2020-10-07,Germany,4010,16,311137,9582
2020-10-08,Germany,4804,12,315941,9594
2020-10-09,Germany,4554,5,320495,9599
2020-10-10,Germany,2968,21,323463,9620
2020-10-11,Germany,2846,6,326309,9626
2020-10-12,Germany,6541,14,332850,9640
2020-10-13,Germany,4464,42,337314,9682
2020-10-14,Germany,7173,34,344487,9716
2020-10-15,Germany,7620,23,352107,9739
2020-10-16,Germany,7695,34,359802,9773
2020-10-17,Germany,4862,12,364664,9785
2020-10-18,Germany,4007,13,368671,9798
2020-10-19,Germany,8397,44,377068,9842
2020-10-20,Germany,8523,40,385591,9882
2020-10-21,Germany,12331,29,397922,9911
2020-10-22,Germany,5952,49,403874,9960
2020-10-23,Germany,13476,18,417350,9978
2020-10-24,Germany,10458,57,427808,10035
2020-10-25,Germany,9890,27,437698,10062
2020-10-26,Germany,12560,29,450258,10091
2020-10-27,Germany,13161,30,463419,10121
2020-10-28,Germany,16202,97,479621,10218
2020-10-29,Germany,18733,87,498354,10305
2020-10-30,Germany,19382,86,517736,10391
2020-10-31,Germany,14054,92,531790,10483
2020-11-01,Germany,12556,30,544346,10513
2020-11-02,Germany,25252,156,569598,10669
2020-11-03,Germany,7533,48,577131,10717
2020-11-04,Germany,31480,232,608611,10949
2020-11-05,Germany,22561,161,631172,11110
2020-11-06,Germany,22820,130,653992,11240
2020-11-07,Germany,14122,66,668114,11306
2020-11-08,Germany,14510,66,682624,11372
2020-11-09,Germany,6522,36,689146,11408
2020-11-10,Germany,26547,373,715693,11781
2020-11-11,Germany,22401,213,738094,11994
2020-11-12,Germany,24738,222,762832,12216
2020-11-13,Germany,22261,188,785093,12404
2020-11-14,Germany,14640,107,799733,12511
2020-11-15,Germany,3213,62,802946,12573
2020-11-16,Germany,14580,260,817526,12833
2020-11-17,Germany,26231,305,843757,13138
2020-11-18,Germany,23727,252,867484,13390
2020-11-19,Germany,24041,272,891525,13662
2020-11-20,Germany,22593,256,914118,13918
2020-11-21,Germany,13872,143,927990,14061
2020-11-22,Germany,4377,98,932367,14159
2020-11-23,Germany,14455,301,946822,14460
2020-11-24,Germany,16370,372,963192,14832
2020-11-25,Germany,32687,378,995879,15210
2020-11-26,Germany,21951,430,1017830,15640
2020-11-27,Germany,20819,371,1038649,16011
2020-11-28,Germany,13845,170,1052494,16181
2020-11-29,Germany,3197,125,1055691,16306
2020-11-30,Germany,14221,388,1069912,16694
2020-12-01,Germany,24766,483,1094678,17177
2020-12-02,Germany,23275,482,1117953,17659
2020-12-03,Germany,23591,438,1141544,18097
2020-12-04,Germany,15970,480,1157514,18577
2020-12-05,Germany,26126,262,1183640,18839
2020-12-06,Germany,10910,150,1194550,18989
2020-12-07,Germany,5456,445,1200006,19434
2020-12-08,Germany,29263,568,1229269,20002
2020-12-09,Germany,25089,458,1254358,20460
2020-12-10,Germany,32734,604,1287092,21064
2020-12-11,Germany,27217,503,1314309,21567
2020-12-12,Germany,21792,333,1336101,21900
2020-12-13,Germany,14709,206,1350810,22106
2020-12-14,Germany,6451,528,1357261,22634
2020-12-15,Germany,33825,910,1391086,23544
2020-12-16,Germany,32744,729,1423830,24273
2020-12-17,Germany,30179,754,1454009,25027
2020-12-18,Germany,32830,727,1486839,25754
2020-12-19,Germany,21679,417,1508518,26171
2020-12-20,Germany,6444,229,1514962,26400
2020-12-21,Germany,19256,710,1534218,27110
2020-12-22,Germany,36153,986,1570371,28096
2020-12-23,Germany,33758,813,1604129,28909
2020-12-24,Germany,26467,421,1630596,29330
2020-12-25,Germany,2140,250,1632736,29580
2020-12-26,Germany,13504,366,1646240,29946
2020-12-27,Germany,12399,351,1658639,30297
2020-12-28,Germany,14004,848,1672643,31145
2020-12-29,Germany,19466,1122,1692109,32267
2020-12-30,Germany,49044,963,1741153,33230
2020-12-31,Germany,19367,561,1760520,33791
2021-01-01,Germany,2117,354,1762637,34145
2021-01-02,Germany,10903,335,1773540,34480
2021-01-03,Germany,10356,311,1783896,34791
2021-01-04,Germany,12320,957,1796216,35748
2021-01-05,Germany,18349,1009,1814565,36757
2021-01-06,Germany,26663,1078,1841228,37835
2021-01-07,Germany,45333,1152,1886561,38987
2021-01-08,Germany,19077,1035,1905638,40022
2021-01-09,Germany,22824,575,1928462,40597
2021-01-10,Germany,948,339,1929410,40936
2021-01-11,Germany,11706,863,1941116,41799
2021-01-12,Germany,27210,1090,1968326,42889
2021-01-13,Germany,25566,1207,1993892,44096
2021-01-14,Germany,21343,1111,2015235,45207
2021-01-15,Germany,8593,498,2023828,45705
2021-01-16,Germany,14817,759,2038645,46464
2021-01-17,Germany,11484,437,2050129,46901
2021-01-18,Germany,9253,362,2059382,47263
2021-01-19,Germany,12233,1734,2071615,48997
2021-01-20,Germany,29003,1013,2100618,50010
2021-01-21,Germany,8277,866,2108895,50876
2021-01-22,Germany,16366,837,2125261,51713
2021-01-23,Germany,12430,160,2137691,51873
2021-01-24,Germany,10078,423,2147769,52296
2021-01-25,Germany,6887,831,2154656,53127
2021-01-26,Germany,9387,492,2164043,53619
2021-01-27,Germany,15636,879,2179679,54498
2021-01-28,Germany,14883,1385,2194562,55883
2021-01-29,Germany,12831,403,2207393,56286
2021-01-30,Germany,17518,819,2224911,57105
2021-01-31,Germany,748,58,2225659,57163
2021-02-01,Germany,6668,896,2232327,58059
2021-02-02,Germany,7690,933,2240017,58992
2021-02-03,Germany,12487,784,2252504,59776
2021-02-04,Germany,13032,858,2265536,60634
2021-02-05,Germany,10835,690,2276371,61324
2021-02-06,Germany,8632,227,2285003,61551
2021-02-07,Germany,6670,157,2291673,61708
2021-02-08,Germany,4650,483,2296323,62191
2021-02-09,Germany,5728,815,2302051,63006
2021-02-10,Germany,9246,666,2311297,63672
2021-02-11,Germany,9928,552,2321225,64224
2021-02-12,Germany,9197,547,2330422,64771
2021-02-13,Germany,6484,219,2336906,64990
2021-02-14,Germany,4838,117,2341744,65107
2021-02-15,Germany,5132,181,2346876,65288
2021-02-16,Germany,5890,541,2352766,65829
2021-02-17,Germany,9598,903,2362364,66732
2021-02-18,Germany,9845,513,2372209,67245
2021-02-19,Germany,9050,496,2381259,67741
2021-02-20,Germany,7162,142,2388421,67883
2021-02-21,Germany,6094,63,2394515,67946
2021-02-22,Germany,4984,417,2399499,68363
2021-02-23,Germany,5764,422,2405263,68785
2021-02-24,Germany,10774,385,2416037,69170
2021-02-25,Germany,11032,173,2427069,69343
2021-02-26,Germany,9437,596,2436506,69939
2021-02-27,Germany,7671,153,2444177,70092
2021-02-28,Germany,6118,60,2450295,70152
2021-03-01,Germany,5274,362,2455569,70514
2021-03-02,Germany,6492,412,2462061,70926
2021-03-03,Germany,10852,359,2472913,71285
2021-03-04,Germany,11393,269,2484306,71554
2021-03-05,Germany,9581,298,2493887,71852
2021-03-06,Germany,8264,99,2502151,71951
2021-03-07,Germany,6504,33,2508655,71984
2021-03-08,Germany,5129,252,2513784,72236
2021-03-09,Germany,6834,298,2520618,72534
2021-03-10,Germany,21163,324,2541781,72858
2021-03-11,Germany,4745,262,2546526,73120
2021-03-12,Germany,12770,228,2559296,73348
2021-03-13,Germany,10568,21,2569864,73369
2021-03-14,Germany,8978,94,2578842,73463
2021-03-15,Germany,6543,238,2585385,73701
2021-03-16,Germany,17679,251,2603064,73952
2021-03-17,Germany,7705,91,2610769,74043
2021-03-18,Germany,28489,359,2639258,74402
2021-03-19,Germany,15476,206,2654734,74608
2021-03-20,Germany,14499,98,2669233,74706
2021-03-21,Germany,768,50,2670001,74756
2021-03-22,Germany,8261,253,2678262,75009
2021-03-23,Germany,20969,246,2699231,75255
2021-03-24,Germany,23757,229,2722988,75484
2021-03-25,Germany,21620,185,2744608,75669
2021-03-26,Germany,20689,159,2765297,75828
2021-03-27,Germany,17628,87,2782925,75915
2021-03-28,Germany,1727,44,2784652,75959
2021-03-29,Germany,10297,180,2794949,76139
2021-03-30,Germany,23681,250,2818630,76389
2021-03-31,Germany,25014,200,2843644,76589
2021-04-01,Germany,22679,234,2866323,76823
2021-04-02,Germany,16033,117,2882356,76940
2021-04-03,Germany,3673,70,2886029,77010
2021-04-04,Germany,10300,50,2896329,77060
2021-04-05,Germany,5980,76,2902309,77136
2021-04-06,Germany,7593,109,2909902,77245
2021-04-07,Germany,30377,510,2940279,77755
2021-04-08,Germany,26510,294,2966789,78049
2020-03-14,Ghana,3,0,3,0
2020-03-15,Ghana,3,0,6,0
2020-03-16,Ghana,0,0,6,0
2020-03-17,Ghana,1,0,7,0
2020-03-18,Ghana,0,0,7,0
2020-03-19,Ghana,4,0,11,0
2020-03-20,Ghana,5,0,16,0
2020-03-21,Ghana,3,1,19,1
2020-03-22,Ghana,4,0,23,1
2020-03-23,Ghana,4,1,27,2
2020-03-24,Ghana,26,0,53,2
2020-03-25,Ghana,40,2,93,4
2020-03-26,Ghana,39,0,132,4
2020-03-27,Ghana,5,0,137,4
2020-03-28,Ghana,4,1,141,5
2020-03-29,Ghana,11,0,152,5
2020-03-30,Ghana,0,0,152,5
2020-03-31,Ghana,9,0,161,5
2020-04-01,Ghana,34,0,195,5
2020-04-02,Ghana,9,0,204,5
2020-04-03,Ghana,1,0,205,5
2020-04-04,Ghana,0,0,205,5
2020-04-05,Ghana,9,0,214,5
2020-04-06,Ghana,0,0,214,5
2020-04-07,Ghana,73,0,287,5
2020-04-08,Ghana,26,1,313,6
2020-04-09,Ghana,65,0,378,6
2020-04-10,Ghana,0,0,378,6
2020-04-11,Ghana,30,2,408,8
2020-04-12,Ghana,158,0,566,8
2020-04-13,Ghana,0,0,566,8
2020-04-14,Ghana,70,0,636,8
2020-04-15,Ghana,0,0,636,8
2020-04-16,Ghana,5,0,641,8
2020-04-17,Ghana,0,0,641,8
2020-04-18,Ghana,193,1,834,9
2020-04-19,Ghana,208,0,1042,9
2020-04-20,Ghana,0,0,1042,9
2020-04-21,Ghana,0,0,1042,9
2020-04-22,Ghana,112,0,1154,9
2020-04-23,Ghana,0,0,1154,9
2020-04-24,Ghana,125,1,1279,10
2020-04-25,Ghana,0,0,1279,10
2020-04-26,Ghana,271,1,1550,11
2020-04-27,Ghana,0,0,1550,11
2020-04-28,Ghana,121,5,1671,16
2020-04-29,Ghana,0,0,1671,16
2020-04-30,Ghana,403,1,2074,17
2020-05-01,Ghana,0,0,2074,17
2020-05-02,Ghana,95,1,2169,18
2020-05-03,Ghana,0,0,2169,18
2020-05-04,Ghana,550,0,2719,18
2020-05-05,Ghana,0,0,2719,18
2020-05-06,Ghana,372,0,3091,18
2020-05-07,Ghana,0,0,3091,18
2020-05-08,Ghana,921,0,4012,18
2020-05-09,Ghana,251,4,4263,22
2020-05-10,Ghana,0,0,4263,22
2020-05-11,Ghana,437,0,4700,22
2020-05-12,Ghana,427,0,5127,22
2020-05-13,Ghana,281,2,5408,24
2020-05-14,Ghana,122,0,5530,24
2020-05-15,Ghana,108,4,5638,28
2020-05-16,Ghana,97,1,5735,29
2020-05-17,Ghana,0,0,5735,29
2020-05-18,Ghana,0,0,5735,29
2020-05-19,Ghana,361,2,6096,31
2020-05-20,Ghana,173,0,6269,31
2020-05-21,Ghana,0,0,6269,31
2020-05-22,Ghana,217,0,6486,31
2020-05-23,Ghana,131,0,6617,31
2020-05-24,Ghana,66,1,6683,32
2020-05-25,Ghana,125,0,6808,32
2020-05-26,Ghana,309,2,7117,34
2020-05-27,Ghana,186,0,7303,34
2020-05-28,Ghana,0,0,7303,34
2020-05-29,Ghana,313,0,7616,34
2020-05-30,Ghana,152,1,7768,35
2020-05-31,Ghana,302,1,8070,36
2020-06-01,Ghana,0,0,8070,36
2020-06-02,Ghana,227,2,8297,38
2020-06-03,Ghana,251,0,8548,38
2020-06-04,Ghana,337,0,8885,38
2020-06-05,Ghana,283,4,9168,42
2020-06-06,Ghana,294,2,9462,44
2020-06-07,Ghana,176,0,9638,44
2020-06-08,Ghana,272,4,9910,48
2020-06-09,Ghana,291,0,10201,48
2020-06-10,Ghana,0,0,10201,48
2020-06-11,Ghana,157,0,10358,48
2020-06-12,Ghana,498,0,10856,48
2020-06-13,Ghana,262,0,11118,48
2020-06-14,Ghana,846,6,11964,54
2020-06-15,Ghana,0,0,11964,54
2020-06-16,Ghana,229,4,12193,58
2020-06-17,Ghana,397,8,12590,66
2020-06-18,Ghana,339,0,12929,66
2020-06-19,Ghana,274,4,13203,70
2020-06-20,Ghana,514,15,13717,85
2020-06-21,Ghana,437,0,14154,85
2020-06-22,Ghana,0,0,14154,85
2020-06-23,Ghana,414,10,14568,95
2020-06-24,Ghana,445,0,15013,95
2020-06-25,Ghana,460,0,15473,95
2020-06-26,Ghana,361,8,15834,103
2020-06-27,Ghana,597,0,16431,103
2020-06-28,Ghana,311,9,16742,112
2020-06-29,Ghana,609,0,17351,112
2020-06-30,Ghana,390,0,17741,112
2020-07-01,Ghana,393,5,18134,117
2020-07-02,Ghana,0,0,18134,117
2020-07-03,Ghana,1254,0,19388,117
2020-07-04,Ghana,0,0,19388,117
2020-07-05,Ghana,697,5,20085,122
2020-07-06,Ghana,992,7,21077,129
2020-07-07,Ghana,891,0,21968,129
2020-07-08,Ghana,854,0,22822,129
2020-07-09,Ghana,641,0,23463,129
2020-07-10,Ghana,371,6,23834,135
2020-07-11,Ghana,414,0,24248,135
2020-07-12,Ghana,270,4,24518,139
2020-07-13,Ghana,470,0,24988,139
2020-07-14,Ghana,0,0,24988,139
2020-07-15,Ghana,442,0,25430,139
2020-07-16,Ghana,695,0,26125,139
2020-07-17,Ghana,447,5,26572,144
2020-07-18,Ghana,488,1,27060,145
2020-07-19,Ghana,607,3,27667,148
2020-07-20,Ghana,763,5,28430,153
2020-07-21,Ghana,559,0,28989,153
2020-07-22,Ghana,683,0,29672,153
2020-07-23,Ghana,0,0,29672,153
2020-07-24,Ghana,1385,8,31057,161
2020-07-25,Ghana,794,0,31851,161
2020-07-26,Ghana,1118,7,32969,168
2020-07-27,Ghana,655,0,33624,168
2020-07-28,Ghana,782,0,34406,168
2020-07-29,Ghana,736,7,35142,175
2020-07-30,Ghana,0,0,35142,175
2020-07-31,Ghana,359,7,35501,182
2020-08-01,Ghana,1513,0,37014,182
2020-08-02,Ghana,0,0,37014,182
2020-08-03,Ghana,798,9,37812,191
2020-08-04,Ghana,0,0,37812,191
2020-08-05,Ghana,1263,8,39075,199
2020-08-06,Ghana,567,0,39642,199
2020-08-07,Ghana,455,7,40097,206
2020-08-08,Ghana,436,0,40533,206
2020-08-09,Ghana,470,9,41003,215
2020-08-10,Ghana,209,0,41212,215
2020-08-11,Ghana,192,0,41404,215
2020-08-12,Ghana,168,8,41572,223
2020-08-13,Ghana,153,0,41725,223
2020-08-14,Ghana,122,0,41847,223
2020-08-15,Ghana,363,8,42210,231
2020-08-16,Ghana,322,0,42532,231
2020-08-17,Ghana,121,8,42653,239
2020-08-18,Ghana,340,9,42993,248
2020-08-19,Ghana,101,8,43094,256
2020-08-20,Ghana,166,5,43260,261
2020-08-21,Ghana,65,0,43325,261
2020-08-22,Ghana,0,0,43325,261
2020-08-23,Ghana,180,0,43505,261
2020-08-24,Ghana,117,2,43622,263
2020-08-25,Ghana,95,7,43717,270
2020-08-26,Ghana,52,0,43769,270
2020-08-27,Ghana,72,0,43841,270
2020-08-28,Ghana,108,0,43949,270
2020-08-29,Ghana,169,0,44118,270
2020-08-30,Ghana,87,6,44205,276
2020-08-31,Ghana,93,0,44298,276
2020-09-01,Ghana,162,0,44460,276
2020-09-02,Ghana,198,0,44658,276
2020-09-03,Ghana,55,4,44713,280
2020-09-04,Ghana,64,3,44777,283
2020-09-05,Ghana,0,0,44777,283
2020-09-06,Ghana,0,0,44777,283
2020-09-07,Ghana,92,0,44869,283
2020-09-08,Ghana,143,0,45012,283
2020-09-09,Ghana,301,0,45313,283
2020-09-10,Ghana,0,0,45313,283
2020-09-11,Ghana,75,2,45388,285
2020-09-12,Ghana,46,1,45434,286
2020-09-13,Ghana,0,0,45434,286
2020-09-14,Ghana,167,8,45601,294
2020-09-15,Ghana,54,0,45655,294
2020-09-16,Ghana,0,0,45655,294
2020-09-17,Ghana,59,0,45714,294
2020-09-18,Ghana,46,1,45760,295
2020-09-19,Ghana,117,2,45877,297
2020-09-20,Ghana,127,0,46004,297
2020-09-21,Ghana,58,0,46062,297
2020-09-22,Ghana,0,0,46062,297
2020-09-23,Ghana,91,2,46153,299
2020-09-24,Ghana,69,0,46222,299
2020-09-25,Ghana,0,0,46222,299
2020-09-26,Ghana,0,0,46222,299
2020-09-27,Ghana,165,0,46387,299
2020-09-28,Ghana,57,0,46444,299
2020-09-29,Ghana,38,2,46482,301
2020-09-30,Ghana,144,0,46626,301
2020-10-01,Ghana,30,0,46656,301
2020-10-02,Ghana,38,0,46694,301
2020-10-03,Ghana,109,2,46803,303
2020-10-04,Ghana,26,0,46829,303
2020-10-05,Ghana,0,0,46829,303
2020-10-06,Ghana,0,0,46829,303
2020-10-07,Ghana,0,0,46829,303
2020-10-08,Ghana,118,3,46947,306
2020-10-09,Ghana,40,0,46987,306
2020-10-10,Ghana,18,0,47005,306
2020-10-11,Ghana,0,0,47005,306
2020-10-12,Ghana,25,2,47030,308
2020-10-13,Ghana,96,2,47126,310
2020-10-14,Ghana,0,0,47126,310
2020-10-15,Ghana,47,0,47173,310
2020-10-16,Ghana,0,0,47173,310
2020-10-17,Ghana,59,0,47232,310
2020-10-18,Ghana,78,0,47310,310
2020-10-19,Ghana,62,0,47372,310
2020-10-20,Ghana,89,2,47461,312
2020-10-21,Ghana,0,0,47461,312
2020-10-22,Ghana,77,0,47538,312
2020-10-23,Ghana,63,2,47601,314
2020-10-24,Ghana,89,2,47690,316
2020-10-25,Ghana,0,0,47690,316
2020-10-26,Ghana,85,0,47775,316
2020-10-27,Ghana,0,0,47775,316
2020-10-28,Ghana,0,0,47775,316
2020-10-29,Ghana,280,4,48055,320
2020-10-30,Ghana,0,0,48055,320
2020-10-31,Ghana,0,0,48055,320
2020-11-01,Ghana,69,0,48124,320
2020-11-02,Ghana,76,0,48200,320
2020-11-03,Ghana,0,0,48200,320
2020-11-04,Ghana,443,0,48643,320
2020-11-05,Ghana,145,0,48788,320
2020-11-06,Ghana,0,0,48788,320
2020-11-07,Ghana,116,0,48904,320
2020-11-08,Ghana,198,0,49102,320
2020-11-09,Ghana,100,0,49202,320
2020-11-10,Ghana,100,0,49302,320
2020-11-11,Ghana,0,0,49302,320
2020-11-12,Ghana,655,0,49957,320
2020-11-13,Ghana,61,0,50018,320
2020-11-14,Ghana,0,0,50018,320
2020-11-15,Ghana,105,2,50123,322
2020-11-16,Ghana,253,1,50376,323
2020-11-17,Ghana,0,0,50376,323
2020-11-18,Ghana,81,0,50457,323
2020-11-19,Ghana,174,0,50631,323
2020-11-20,Ghana,0,0,50631,323
2020-11-21,Ghana,86,0,50717,323
2020-11-22,Ghana,157,0,50874,323
2020-11-23,Ghana,67,0,50941,323
2020-11-24,Ghana,243,0,51184,323
2020-11-25,Ghana,41,0,51225,323
2020-11-26,Ghana,0,0,51225,323
2020-11-27,Ghana,0,0,51225,323
2020-11-28,Ghana,154,0,51379,323
2020-11-29,Ghana,190,0,51569,323
2020-11-30,Ghana,98,0,51667,323
2020-12-01,Ghana,0,0,51667,323
2020-12-02,Ghana,0,0,51667,323
2020-12-03,Ghana,0,0,51667,323
2020-12-04,Ghana,429,2,52096,325
2020-12-05,Ghana,0,0,52096,325
2020-12-06,Ghana,178,0,52274,325
2020-12-07,Ghana,0,0,52274,325
2020-12-08,Ghana,226,1,52500,326
2020-12-09,Ghana,122,0,52622,326
2020-12-10,Ghana,116,0,52738,326
2020-12-11,Ghana,0,0,52738,326
2020-12-12,Ghana,195,1,52933,327
2020-12-13,Ghana,0,0,52933,327
2020-12-14,Ghana,81,0,53014,327
2020-12-15,Ghana,256,0,53270,327
2020-12-16,Ghana,116,0,53386,327
2020-12-17,Ghana,167,4,53553,331
2020-12-18,Ghana,100,0,53653,331
2020-12-19,Ghana,0,0,53653,331
2020-12-20,Ghana,0,0,53653,331
2020-12-21,Ghana,301,2,53954,333
2020-12-22,Ghana,0,0,53954,333
2020-12-23,Ghana,89,0,54043,333
2020-12-24,Ghana,0,0,54043,333
2020-12-25,Ghana,0,0,54043,333
2020-12-26,Ghana,243,0,54286,333
2020-12-27,Ghana,115,0,54401,333
2020-12-28,Ghana,102,0,54503,333
2020-12-29,Ghana,178,2,54681,335
2020-12-30,Ghana,90,0,54771,335
2020-12-31,Ghana,0,0,54771,335
2021-01-01,Ghana,159,0,54930,335
2021-01-02,Ghana,134,0,55064,335
2021-01-03,Ghana,104,0,55168,335
2021-01-04,Ghana,0,0,55168,335
2021-01-05,Ghana,0,0,55168,335
2021-01-06,Ghana,0,0,55168,335
2021-01-07,Ghana,293,1,55461,336
2021-01-08,Ghana,0,0,55461,336
2021-01-09,Ghana,311,0,55772,336
2021-01-10,Ghana,0,0,55772,336
2021-01-11,Ghana,458,2,56230,338
2021-01-12,Ghana,191,0,56421,338
2021-01-13,Ghana,560,3,56981,341
2021-01-14,Ghana,0,0,56981,341
2021-01-15,Ghana,0,0,56981,341
2021-01-16,Ghana,0,0,56981,341
2021-01-17,Ghana,733,5,57714,346
2021-01-18,Ghana,351,6,58065,352
2021-01-19,Ghana,366,6,58431,358
2021-01-20,Ghana,0,0,58431,358
2021-01-21,Ghana,1049,3,59480,361
2021-01-22,Ghana,0,0,59480,361
2021-01-23,Ghana,635,0,60115,361
2021-01-24,Ghana,679,6,60794,367
2021-01-25,Ghana,1341,5,62135,372
2021-01-26,Ghana,0,0,62135,372
2021-01-27,Ghana,616,5,62751,377
2021-01-28,Ghana,1132,13,63883,390
2021-01-29,Ghana,0,0,63883,390
2021-01-30,Ghana,1544,15,65427,405
2021-01-31,Ghana,1583,11,67010,416
2021-02-01,Ghana,0,0,67010,416
2021-02-02,Ghana,772,8,67782,424
2021-02-03,Ghana,777,9,68559,433
2021-02-04,Ghana,696,7,69255,440
2021-02-05,Ghana,791,9,70046,449
2021-02-06,Ghana,0,0,70046,449
2021-02-07,Ghana,722,8,70768,457
2021-02-08,Ghana,1560,15,72328,472
2021-02-09,Ghana,675,10,73003,482
2021-02-10,Ghana,0,0,73003,482
2021-02-11,Ghana,554,12,73557,494
2021-02-12,Ghana,790,11,74347,505
2021-02-13,Ghana,1489,28,75836,533
2021-02-14,Ghana,0,0,75836,533
2021-02-15,Ghana,656,9,76492,542
2021-02-16,Ghana,554,13,77046,555
2021-02-17,Ghana,1225,10,78271,565
2021-02-18,Ghana,418,3,78689,568
2021-02-19,Ghana,476,0,79165,568
2021-02-20,Ghana,490,4,79655,572
2021-02-21,Ghana,598,5,80253,577
2021-02-22,Ghana,506,5,80759,582
2021-02-23,Ghana,0,0,80759,582
2021-02-24,Ghana,486,2,81245,584
2021-02-25,Ghana,428,4,81673,588
2021-02-26,Ghana,913,6,82586,594
2021-02-27,Ghana,0,0,82586,594
2021-02-28,Ghana,1437,13,84023,607
2021-03-01,Ghana,0,0,84023,607
2021-03-02,Ghana,0,0,84023,607
2021-03-03,Ghana,326,4,84349,611
2021-03-04,Ghana,890,18,85239,629
2021-03-05,Ghana,0,0,85239,629
2021-03-06,Ghana,853,11,86092,640
2021-03-07,Ghana,373,7,86465,647
2021-03-08,Ghana,0,0,86465,647
2021-03-09,Ghana,272,9,86737,656
2021-03-10,Ghana,0,0,86737,656
2021-03-11,Ghana,0,0,86737,656
2021-03-12,Ghana,0,0,86737,656
2021-03-13,Ghana,743,23,87480,679
2021-03-14,Ghana,282,6,87762,685
2021-03-15,Ghana,223,6,87985,691
2021-03-16,Ghana,243,7,88228,698
2021-03-17,Ghana,193,7,88421,705
2021-03-18,Ghana,0,0,88421,705
2021-03-19,Ghana,587,8,89008,713
2021-03-20,Ghana,268,3,89276,716
2021-03-21,Ghana,406,9,89682,725
2021-03-22,Ghana,0,0,89682,725
2021-03-23,Ghana,211,9,89893,734
2021-03-24,Ghana,0,0,89893,734
2021-03-25,Ghana,106,3,89999,737
2021-03-26,Ghana,288,3,90287,740
2021-03-27,Ghana,0,0,90287,740
2021-03-28,Ghana,0,0,90287,740
2021-03-29,Ghana,0,0,90287,740
2021-03-30,Ghana,0,0,90287,740
2021-03-31,Ghana,296,3,90583,743
2021-04-01,Ghana,0,0,90583,743
2021-04-02,Ghana,91,1,90674,744
2021-04-03,Ghana,0,0,90674,744
2021-04-04,Ghana,108,4,90782,748
2021-04-05,Ghana,118,4,90900,752
2021-04-06,Ghana,46,0,90946,752
2021-04-07,Ghana,63,0,91009,752
2021-04-08,Ghana,100,0,91109,752
2020-02-26,Greece,1,0,1,0
2020-02-27,Greece,2,0,3,0
2020-02-28,Greece,1,0,4,0
2020-02-29,Greece,0,0,4,0
2020-03-01,Greece,3,0,7,0
2020-03-02,Greece,0,0,7,0
2020-03-03,Greece,0,0,7,0
2020-03-04,Greece,2,0,9,0
2020-03-05,Greece,22,0,31,0
2020-03-06,Greece,14,0,45,0
2020-03-07,Greece,1,0,46,0
2020-03-08,Greece,27,0,73,0
2020-03-09,Greece,0,0,73,0
2020-03-10,Greece,16,0,89,0
2020-03-11,Greece,10,1,99,1
2020-03-12,Greece,0,0,99,1
2020-03-13,Greece,91,0,190,1
2020-03-14,Greece,38,2,228,3
2020-03-15,Greece,103,1,331,4
2020-03-16,Greece,0,0,331,4
2020-03-17,Greece,56,1,387,5
2020-03-18,Greece,31,0,418,5
2020-03-19,Greece,0,1,418,6
2020-03-20,Greece,77,0,495,6
2020-03-21,Greece,35,7,530,13
2020-03-22,Greece,94,2,624,15
2020-03-23,Greece,71,2,695,17
2020-03-24,Greece,48,3,743,20
2020-03-25,Greece,78,2,821,22
2020-03-26,Greece,71,4,892,26
2020-03-27,Greece,74,2,966,28
2020-03-28,Greece,95,4,1061,32
2020-03-29,Greece,95,6,1156,38
2020-03-30,Greece,56,5,1212,43
2020-03-31,Greece,102,6,1314,49
2020-04-01,Greece,101,1,1415,50
2020-04-02,Greece,129,3,1544,53
2020-04-03,Greece,69,10,1613,63
2020-04-04,Greece,60,5,1673,68
2020-04-05,Greece,62,5,1735,73
2020-04-06,Greece,20,6,1755,79
2020-04-07,Greece,77,2,1832,81
2020-04-08,Greece,52,2,1884,83
2020-04-09,Greece,71,4,1955,87
2020-04-10,Greece,56,5,2011,92
2020-04-11,Greece,70,1,2081,93
2020-04-12,Greece,33,5,2114,98
2020-04-13,Greece,31,1,2145,99
2020-04-14,Greece,25,2,2170,101
2020-04-15,Greece,22,1,2192,102
2020-04-16,Greece,15,3,2207,105
2020-04-17,Greece,17,3,2224,108
2020-04-18,Greece,11,2,2235,110
2020-04-19,Greece,0,3,2235,113
2020-04-20,Greece,10,3,2245,116
2020-04-21,Greece,156,5,2401,121
2020-04-22,Greece,7,0,2408,121
2020-04-23,Greece,55,4,2463,125
2020-04-24,Greece,27,5,2490,130
2020-04-25,Greece,16,0,2506,130
2020-04-26,Greece,11,4,2517,134
2020-04-27,Greece,17,2,2534,136
2020-04-28,Greece,32,2,2566,138
2020-04-29,Greece,10,1,2576,139
2020-04-30,Greece,15,1,2591,140
2020-05-01,Greece,21,0,2612,140
2020-05-02,Greece,8,3,2620,143
2020-05-03,Greece,6,1,2626,144
2020-05-04,Greece,6,2,2632,146
2020-05-05,Greece,10,0,2642,146
2020-05-06,Greece,21,1,2663,147
2020-05-07,Greece,15,1,2678,148
2020-05-08,Greece,13,2,2691,150
2020-05-09,Greece,19,1,2710,151
2020-05-10,Greece,6,0,2716,151
2020-05-11,Greece,10,0,2726,151
2020-05-12,Greece,18,1,2744,152
2020-05-13,Greece,16,3,2760,155
2020-05-14,Greece,10,1,2770,156
2020-05-15,Greece,40,4,2810,160
2020-05-16,Greece,9,2,2819,162
2020-05-17,Greece,15,1,2834,163
2020-05-18,Greece,2,2,2836,165
2020-05-19,Greece,4,0,2840,165
2020-05-20,Greece,10,1,2850,166
2020-05-21,Greece,3,2,2853,168
2020-05-22,Greece,21,1,2874,169
2020-05-23,Greece,2,2,2876,171
2020-05-24,Greece,2,0,2878,171
2020-05-25,Greece,4,1,2882,172
2020-05-26,Greece,10,1,2892,173
2020-05-27,Greece,11,0,2903,173
2020-05-28,Greece,3,2,2906,175
2020-05-29,Greece,3,0,2909,175
2020-05-30,Greece,6,0,2915,175
2020-05-31,Greece,2,0,2917,175
2020-06-01,Greece,1,4,2918,179
2020-06-02,Greece,19,0,2937,179
2020-06-03,Greece,0,0,2937,179
2020-06-04,Greece,15,1,2952,180
2020-06-05,Greece,15,0,2967,180
2020-06-06,Greece,13,0,2980,180
2020-06-07,Greece,17,0,2997,180
2020-06-08,Greece,52,2,3049,182
2020-06-09,Greece,9,1,3058,183
2020-06-10,Greece,10,0,3068,183
2020-06-11,Greece,20,0,3088,183
2020-06-12,Greece,20,0,3108,183
2020-06-13,Greece,4,0,3112,183
2020-06-14,Greece,9,0,3121,183
2020-06-15,Greece,13,1,3134,184
2020-06-16,Greece,14,1,3148,185
2020-06-17,Greece,55,2,3203,187
2020-06-18,Greece,24,1,3227,188
2020-06-19,Greece,10,1,3237,189
2020-06-20,Greece,19,1,3256,190
2020-06-21,Greece,10,0,3266,190
2020-06-22,Greece,21,0,3287,190
2020-06-23,Greece,15,0,3302,190
2020-06-24,Greece,8,0,3310,190
2020-06-25,Greece,11,1,3321,191
2020-06-26,Greece,22,0,3343,191
2020-06-27,Greece,23,0,3366,191
2020-06-28,Greece,10,0,3376,191
2020-06-29,Greece,14,0,3390,191
2020-06-30,Greece,19,1,3409,192
2020-07-01,Greece,23,0,3432,192
2020-07-02,Greece,26,0,3458,192
2020-07-03,Greece,28,0,3486,192
2020-07-04,Greece,25,0,3511,192
2020-07-05,Greece,8,0,3519,192
2020-07-06,Greece,43,0,3562,192
2020-07-07,Greece,27,1,3589,193
2020-07-08,Greece,33,0,3622,193
2020-07-09,Greece,50,0,3672,193
2020-07-10,Greece,60,0,3732,193
2020-07-11,Greece,40,0,3772,193
2020-07-12,Greece,31,0,3803,193
2020-07-13,Greece,23,0,3826,193
2020-07-14,Greece,57,0,3883,193
2020-07-15,Greece,27,0,3910,193
2020-07-16,Greece,29,0,3939,193
2020-07-17,Greece,25,1,3964,194
2020-07-18,Greece,19,0,3983,194
2020-07-19,Greece,24,0,4007,194
2020-07-20,Greece,5,1,4012,195
2020-07-21,Greece,36,2,4048,197
2020-07-22,Greece,29,3,4077,200
2020-07-23,Greece,33,1,4110,201
2020-07-24,Greece,25,0,4135,201
2020-07-25,Greece,31,0,4166,201
2020-07-26,Greece,27,1,4193,202
2020-07-27,Greece,34,0,4227,202
2020-07-28,Greece,52,1,4279,203
2020-07-29,Greece,57,0,4336,203
2020-07-30,Greece,65,0,4401,203
2020-07-31,Greece,76,3,4477,206
2020-08-01,Greece,110,0,4587,206
2020-08-02,Greece,75,2,4662,208
2020-08-03,Greece,75,1,4737,209
2020-08-04,Greece,118,0,4855,209
2020-08-05,Greece,119,1,4974,210
2020-08-06,Greece,149,0,5123,210
2020-08-07,Greece,147,0,5270,210
2020-08-08,Greece,151,1,5421,211
2020-08-09,Greece,202,1,5623,212
2020-08-10,Greece,126,1,5749,213
2020-08-11,Greece,193,1,5942,214
2020-08-12,Greece,235,2,6177,216
2020-08-13,Greece,204,5,6381,221
2020-08-14,Greece,251,2,6632,223
2020-08-15,Greece,226,3,6858,226
2020-08-16,Greece,217,2,7075,228
2020-08-17,Greece,147,2,7222,230
2020-08-18,Greece,250,2,7472,232
2020-08-19,Greece,212,3,7684,235
2020-08-20,Greece,250,0,7934,235
2020-08-21,Greece,204,3,8138,238
2020-08-22,Greece,243,2,8381,240
2020-08-23,Greece,283,2,8664,242
2020-08-24,Greece,155,0,8819,242
2020-08-25,Greece,168,1,8987,243
2020-08-26,Greece,293,5,9280,248
2020-08-27,Greece,251,6,9531,254
2020-08-28,Greece,269,5,9800,259
2020-08-29,Greece,177,1,9977,260
2020-08-30,Greece,157,2,10134,262
2020-08-31,Greece,183,4,10317,266
2020-09-01,Greece,207,5,10524,271
2020-09-02,Greece,233,2,10757,273
2020-09-03,Greece,241,5,10998,278
2020-09-04,Greece,202,1,11200,279
2020-09-05,Greece,186,1,11386,280
2020-09-06,Greece,138,4,11524,284
2020-09-07,Greece,139,5,11663,289
2020-09-08,Greece,169,1,11832,290
2020-09-09,Greece,248,3,12080,293
2020-09-10,Greece,372,4,12452,297
2020-09-11,Greece,282,3,12734,300
2020-09-12,Greece,302,2,13036,302
2020-09-13,Greece,204,3,13240,305
2020-09-14,Greece,180,5,13420,310
2020-09-15,Greece,310,3,13730,313
2020-09-16,Greece,311,3,14041,316
2020-09-17,Greece,359,9,14400,325
2020-09-18,Greece,338,2,14738,327
2020-09-19,Greece,240,4,14978,331
2020-09-20,Greece,164,7,15142,338
2020-09-21,Greece,453,6,15595,344
2020-09-22,Greece,333,8,15928,352
2020-09-23,Greece,358,5,16286,357
2020-09-24,Greece,341,9,16627,366
2020-09-25,Greece,286,3,16913,369
2020-09-26,Greece,315,7,17228,376
2020-09-27,Greece,216,3,17444,379
2020-09-28,Greece,263,4,17707,383
2020-09-29,Greece,416,5,18123,388
2020-09-30,Greece,352,3,18475,391
2020-10-01,Greece,411,2,18886,393
2020-10-02,Greece,460,5,19346,398
2020-10-03,Greece,267,7,19613,405
2020-10-04,Greece,229,4,19842,409
2020-10-05,Greece,300,8,20142,417
2020-10-06,Greece,399,3,20541,420
2020-10-07,Greece,406,4,20947,424
2020-10-08,Greece,434,6,21381,430
2020-10-09,Greece,391,1,21772,431
2020-10-10,Greece,306,5,22078,436
2020-10-11,Greece,280,13,22358,449
2020-10-12,Greece,294,7,22652,456
2020-10-13,Greece,408,6,23060,462
2020-10-14,Greece,435,7,23495,469
2020-10-15,Greece,452,13,23947,482
2020-10-16,Greece,503,8,24450,490
2020-10-17,Greece,482,10,24932,500
2020-10-18,Greece,438,9,25370,509
2020-10-19,Greece,432,11,25802,520
2020-10-20,Greece,667,8,26469,528
2020-10-21,Greece,865,6,27334,534
2020-10-22,Greece,882,15,28216,549
2020-10-23,Greece,841,10,29057,559
2020-10-24,Greece,935,5,29992,564
2020-10-25,Greece,790,10,30782,574
2020-10-26,Greece,714,7,31496,581
2020-10-27,Greece,1256,12,32752,593
2020-10-28,Greece,1547,10,34299,603
2020-10-29,Greece,1211,12,35510,615
2020-10-30,Greece,1686,5,37196,620
2020-10-31,Greece,2055,6,39251,626
2020-11-01,Greece,1678,9,40929,635
2020-11-02,Greece,1151,7,42080,642
2020-11-03,Greece,2166,13,44246,655
2020-11-04,Greece,2646,18,46892,673
2020-11-05,Greece,2915,29,49807,702
2020-11-06,Greece,2447,13,52254,715
2020-11-07,Greece,2555,34,54809,749
2020-11-08,Greece,1889,35,56698,784
2020-11-09,Greece,1489,41,58187,825
2020-11-10,Greece,2383,41,60570,866
2020-11-11,Greece,2751,43,63321,909
2020-11-12,Greece,3316,50,66637,959
2020-11-13,Greece,3038,38,69675,997
2020-11-14,Greece,2835,38,72510,1035
2020-11-15,Greece,1695,71,74205,1106
2020-11-16,Greece,2198,59,76403,1165
2020-11-17,Greece,2422,63,78825,1228
2020-11-18,Greece,3209,60,82034,1288
2020-11-19,Greece,3227,59,85261,1347
2020-11-20,Greece,2551,72,87812,1419
2020-11-21,Greece,2309,108,90121,1527
2020-11-22,Greece,1498,103,91619,1630
2020-11-23,Greece,1387,84,93006,1714
2020-11-24,Greece,2131,101,95137,1815
2020-11-25,Greece,2151,87,97288,1902
2020-11-26,Greece,2018,99,99306,2001
2020-11-27,Greece,1981,101,101287,2102
2020-11-28,Greece,1747,121,103034,2223
2020-11-29,Greece,1193,98,104227,2321
2020-11-30,Greece,1044,85,105271,2406
2020-12-01,Greece,2199,111,107470,2517
2020-12-02,Greece,2185,89,109655,2606
2020-12-03,Greece,1882,100,111537,2706
2020-12-04,Greece,1648,98,113185,2804
2020-12-05,Greece,1383,98,114568,2902
2020-12-06,Greece,903,101,115471,3003
2020-12-07,Greece,1250,89,116721,3092
2020-12-08,Greece,1324,102,118045,3194
2020-12-09,Greece,1675,95,119720,3289
2020-12-10,Greece,1533,81,121253,3370
2020-12-11,Greece,1395,102,122648,3472
2020-12-12,Greece,1194,68,123842,3540
2020-12-13,Greece,692,85,124534,3625
2020-12-14,Greece,639,62,125173,3687
2020-12-15,Greece,1199,98,126372,3785
2020-12-16,Greece,1185,85,127557,3870
2020-12-17,Greece,1153,78,128710,3948
2020-12-18,Greece,874,96,129584,4044
2020-12-19,Greece,901,58,130485,4102
2020-12-20,Greece,587,70,131072,4172
2020-12-21,Greece,525,85,131597,4257
2020-12-22,Greece,833,83,132430,4340
2020-12-23,Greece,935,62,133365,4402
2020-12-24,Greece,870,55,134235,4457
2020-12-25,Greece,617,50,134852,4507
2020-12-26,Greece,262,46,135114,4553
2020-12-27,Greece,342,53,135456,4606
2020-12-28,Greece,475,66,135931,4672
2020-12-29,Greece,1045,58,136976,4730
2020-12-30,Greece,942,58,137918,4788
2020-12-31,Greece,932,50,138850,4838
2021-01-01,Greece,597,43,139447,4881
2021-01-02,Greece,262,40,139709,4921
2021-01-03,Greece,390,36,140099,4957
2021-01-04,Greece,427,54,140526,5011
2021-01-05,Greece,927,40,141453,5051
2021-01-06,Greece,814,48,142267,5099
2021-01-07,Greece,510,47,142777,5146
2021-01-08,Greece,717,49,143494,5195
2021-01-09,Greece,799,32,144293,5227
2021-01-10,Greece,445,36,144738,5263
2021-01-11,Greece,441,39,145179,5302
2021-01-12,Greece,841,27,146020,5329
2021-01-13,Greece,668,25,146688,5354
2021-01-14,Greece,595,33,147283,5387
2021-01-15,Greece,577,34,147860,5421
2021-01-16,Greece,510,20,148370,5441
2021-01-17,Greece,237,28,148607,5469
2021-01-18,Greece,318,19,148925,5488
2021-01-19,Greece,537,30,149462,5518
2021-01-20,Greece,511,27,149973,5545
2021-01-21,Greece,506,25,150479,5570
2021-01-22,Greece,562,28,151041,5598
2021-01-23,Greece,605,24,151646,5622
2021-01-24,Greece,334,24,151980,5646
2021-01-25,Greece,432,25,152412,5671
2021-01-26,Greece,814,21,153226,5692
2021-01-27,Greece,857,32,154083,5724
2021-01-28,Greece,713,18,154796,5742
2021-01-29,Greece,882,22,155678,5764
2021-01-30,Greece,795,15,156473,5779
2021-01-31,Greece,484,17,156957,5796
2021-02-01,Greece,538,33,157495,5829
2021-02-02,Greece,1221,22,158716,5851
2021-02-03,Greece,1150,27,159866,5878
2021-02-04,Greece,1069,25,160935,5903
2021-02-05,Greece,1172,19,162107,5922
2021-02-06,Greece,1106,29,163213,5951
2021-02-07,Greece,733,21,163946,5972
2021-02-08,Greece,629,25,164575,5997
2021-02-09,Greece,1492,20,166067,6017
2021-02-10,Greece,1482,17,167549,6034
2021-02-11,Greece,1323,22,168872,6056
2021-02-12,Greece,1372,21,170244,6077
2021-02-13,Greece,1222,26,171466,6103
2021-02-14,Greece,662,23,172128,6126
2021-02-15,Greece,696,26,172824,6152
2021-02-16,Greece,1081,29,173905,6181
2021-02-17,Greece,754,13,174659,6194
2021-02-18,Greece,1400,27,176059,6221
2021-02-19,Greece,1435,28,177494,6249
2021-02-20,Greece,1424,23,178918,6272
2021-02-21,Greece,884,25,179802,6297
2021-02-22,Greece,870,24,180672,6321
2021-02-23,Greece,2111,22,182783,6343
2021-02-24,Greece,1903,28,184686,6371
2021-02-25,Greece,1783,39,186469,6410
2021-02-26,Greece,1732,29,188201,6439
2021-02-27,Greece,1630,29,189831,6468
2021-02-28,Greece,1269,36,191100,6504
2021-03-01,Greece,1170,30,192270,6534
2021-03-02,Greece,2312,23,194582,6557
2021-03-03,Greece,2697,40,197279,6597
2021-03-04,Greece,2217,35,199496,6632
2021-03-05,Greece,2181,32,201677,6664
2021-03-06,Greece,2301,41,203978,6705
2021-03-07,Greece,1142,53,205120,6758
2021-03-08,Greece,1161,39,206281,6797
2021-03-09,Greece,3181,46,209462,6843
2021-03-10,Greece,2629,43,212091,6886
2021-03-11,Greece,2570,51,214661,6937
2021-03-12,Greece,2357,49,217018,6986
2021-03-13,Greece,2503,52,219521,7038
2021-03-14,Greece,1626,53,221147,7091
2021-03-15,Greece,1134,46,222281,7137
2021-03-16,Greece,1508,59,223789,7196
2021-03-17,Greece,3458,56,227247,7252
2021-03-18,Greece,3070,45,230317,7297
2021-03-19,Greece,2762,64,233079,7361
2021-03-20,Greece,2532,60,235611,7421
2021-03-21,Greece,1514,41,237125,7462
2021-03-22,Greece,1705,69,238830,7531
2021-03-23,Greece,3517,51,242347,7582
2021-03-24,Greece,3058,67,245405,7649
2021-03-25,Greece,2587,52,247992,7701
2021-03-26,Greece,1466,53,249458,7754
2021-03-27,Greece,3132,72,252590,7826
2021-03-28,Greece,1441,54,254031,7880
2021-03-29,Greece,1724,65,255755,7945
2021-03-30,Greece,4322,72,260077,8017
2021-03-31,Greece,3612,76,263689,8093
2021-04-01,Greece,3483,67,267172,8160
2021-04-02,Greece,3058,72,270230,8232
2021-04-03,Greece,3229,70,273459,8302
2021-04-04,Greece,1955,78,275414,8380
2021-04-05,Greece,1863,73,277277,8453
2021-04-06,Greece,4293,79,281570,8532
2021-04-07,Greece,3445,75,285015,8607
2021-04-08,Greece,3215,73,288230,8680
2020-03-22,Grenada,1,0,1,0
2020-03-23,Grenada,0,0,1,0
2020-03-24,Grenada,0,0,1,0
2020-03-25,Grenada,0,0,1,0
2020-03-26,Grenada,6,0,7,0
2020-03-27,Grenada,0,0,7,0
2020-03-28,Grenada,0,0,7,0
2020-03-29,Grenada,2,0,9,0
2020-03-30,Grenada,0,0,9,0
2020-03-31,Grenada,0,0,9,0
2020-04-01,Grenada,0,0,9,0
2020-04-02,Grenada,1,0,10,0
2020-04-03,Grenada,2,0,12,0
2020-04-04,Grenada,0,0,12,0
2020-04-05,Grenada,0,0,12,0
2020-04-06,Grenada,0,0,12,0
2020-04-07,Grenada,0,0,12,0
2020-04-08,Grenada,0,0,12,0
2020-04-09,Grenada,0,0,12,0
2020-04-10,Grenada,2,0,14,0
2020-04-11,Grenada,0,0,14,0
2020-04-12,Grenada,0,0,14,0
2020-04-13,Grenada,0,0,14,0
2020-04-14,Grenada,0,0,14,0
2020-04-15,Grenada,0,0,14,0
2020-04-16,Grenada,0,0,14,0
2020-04-17,Grenada,0,0,14,0
2020-04-18,Grenada,0,0,14,0
2020-04-19,Grenada,0,0,14,0
2020-04-20,Grenada,0,0,14,0
2020-04-21,Grenada,0,0,14,0
2020-04-22,Grenada,1,0,15,0
2020-04-23,Grenada,0,0,15,0
2020-04-24,Grenada,0,0,15,0
2020-04-25,Grenada,3,0,18,0
2020-04-26,Grenada,0,0,18,0
2020-04-27,Grenada,0,0,18,0
2020-04-28,Grenada,1,0,19,0
2020-04-29,Grenada,1,0,20,0
2020-04-30,Grenada,0,0,20,0
2020-05-01,Grenada,0,0,20,0
2020-05-02,Grenada,1,0,21,0
2020-05-03,Grenada,0,0,21,0
2020-05-04,Grenada,0,0,21,0
2020-05-05,Grenada,0,0,21,0
2020-05-06,Grenada,0,0,21,0
2020-05-07,Grenada,0,0,21,0
2020-05-08,Grenada,0,0,21,0
2020-05-09,Grenada,0,0,21,0
2020-05-10,Grenada,0,0,21,0
2020-05-11,Grenada,0,0,21,0
2020-05-12,Grenada,0,0,21,0
2020-05-13,Grenada,0,0,21,0
2020-05-14,Grenada,0,0,21,0
2020-05-15,Grenada,1,0,22,0
2020-05-16,Grenada,0,0,22,0
2020-05-17,Grenada,0,0,22,0
2020-05-18,Grenada,0,0,22,0
2020-05-19,Grenada,0,0,22,0
2020-05-20,Grenada,0,0,22,0
2020-05-21,Grenada,0,0,22,0
2020-05-22,Grenada,0,0,22,0
2020-05-23,Grenada,0,0,22,0
2020-05-24,Grenada,0,0,22,0
2020-05-25,Grenada,1,0,23,0
2020-05-26,Grenada,0,0,23,0
2020-05-27,Grenada,0,0,23,0
2020-05-28,Grenada,0,0,23,0
2020-05-29,Grenada,0,0,23,0
2020-05-30,Grenada,0,0,23,0
2020-05-31,Grenada,0,0,23,0
2020-06-01,Grenada,0,0,23,0
2020-06-02,Grenada,0,0,23,0
2020-06-03,Grenada,0,0,23,0
2020-06-04,Grenada,0,0,23,0
2020-06-05,Grenada,0,0,23,0
2020-06-06,Grenada,0,0,23,0
2020-06-07,Grenada,0,0,23,0
2020-06-08,Grenada,0,0,23,0
2020-06-09,Grenada,0,0,23,0
2020-06-10,Grenada,0,0,23,0
2020-06-11,Grenada,0,0,23,0
2020-06-12,Grenada,0,0,23,0
2020-06-13,Grenada,0,0,23,0
2020-06-14,Grenada,0,0,23,0
2020-06-15,Grenada,0,0,23,0
2020-06-16,Grenada,0,0,23,0
2020-06-17,Grenada,0,0,23,0
2020-06-18,Grenada,0,0,23,0
2020-06-19,Grenada,0,0,23,0
2020-06-20,Grenada,0,0,23,0
2020-06-21,Grenada,0,0,23,0
2020-06-22,Grenada,0,0,23,0
2020-06-23,Grenada,0,0,23,0
2020-06-24,Grenada,0,0,23,0
2020-06-25,Grenada,0,0,23,0
2020-06-26,Grenada,0,0,23,0
2020-06-27,Grenada,0,0,23,0
2020-06-28,Grenada,0,0,23,0
2020-06-29,Grenada,0,0,23,0
2020-06-30,Grenada,0,0,23,0
2020-07-01,Grenada,0,0,23,0
2020-07-02,Grenada,0,0,23,0
2020-07-03,Grenada,0,0,23,0
2020-07-04,Grenada,0,0,23,0
2020-07-05,Grenada,0,0,23,0
2020-07-06,Grenada,0,0,23,0
2020-07-07,Grenada,0,0,23,0
2020-07-08,Grenada,0,0,23,0
2020-07-09,Grenada,0,0,23,0
2020-07-10,Grenada,0,0,23,0
2020-07-11,Grenada,0,0,23,0
2020-07-12,Grenada,0,0,23,0
2020-07-13,Grenada,0,0,23,0
2020-07-14,Grenada,0,0,23,0
2020-07-15,Grenada,0,0,23,0
2020-07-16,Grenada,0,0,23,0
2020-07-17,Grenada,0,0,23,0
2020-07-18,Grenada,0,0,23,0
2020-07-19,Grenada,0,0,23,0
2020-07-20,Grenada,0,0,23,0
2020-07-21,Grenada,0,0,23,0
2020-07-22,Grenada,0,0,23,0
2020-07-23,Grenada,0,0,23,0
2020-07-24,Grenada,0,0,23,0
2020-07-25,Grenada,0,0,23,0
2020-07-26,Grenada,0,0,23,0
2020-07-27,Grenada,0,0,23,0
2020-07-28,Grenada,0,0,23,0
2020-07-29,Grenada,0,0,23,0
2020-07-30,Grenada,1,0,24,0
2020-07-31,Grenada,0,0,24,0
2020-08-01,Grenada,0,0,24,0
2020-08-02,Grenada,0,0,24,0
2020-08-03,Grenada,0,0,24,0
2020-08-04,Grenada,0,0,24,0
2020-08-05,Grenada,0,0,24,0
2020-08-06,Grenada,0,0,24,0
2020-08-07,Grenada,0,0,24,0
2020-08-08,Grenada,0,0,24,0
2020-08-09,Grenada,0,0,24,0
2020-08-10,Grenada,0,0,24,0
2020-08-11,Grenada,0,0,24,0
2020-08-12,Grenada,0,0,24,0
2020-08-13,Grenada,0,0,24,0
2020-08-14,Grenada,0,0,24,0
2020-08-15,Grenada,0,0,24,0
2020-08-16,Grenada,0,0,24,0
2020-08-17,Grenada,0,0,24,0
2020-08-18,Grenada,0,0,24,0
2020-08-19,Grenada,0,0,24,0
2020-08-20,Grenada,0,0,24,0
2020-08-21,Grenada,0,0,24,0
2020-08-22,Grenada,0,0,24,0
2020-08-23,Grenada,0,0,24,0
2020-08-24,Grenada,0,0,24,0
2020-08-25,Grenada,0,0,24,0
2020-08-26,Grenada,0,0,24,0
2020-08-27,Grenada,0,0,24,0
2020-08-28,Grenada,0,0,24,0
2020-08-29,Grenada,0,0,24,0
2020-08-30,Grenada,0,0,24,0
2020-08-31,Grenada,0,0,24,0
2020-09-01,Grenada,0,0,24,0
2020-09-02,Grenada,0,0,24,0
2020-09-03,Grenada,0,0,24,0
2020-09-04,Grenada,0,0,24,0
2020-09-05,Grenada,0,0,24,0
2020-09-06,Grenada,0,0,24,0
2020-09-07,Grenada,0,0,24,0
2020-09-08,Grenada,0,0,24,0
2020-09-09,Grenada,0,0,24,0
2020-09-10,Grenada,0,0,24,0
2020-09-11,Grenada,0,0,24,0
2020-09-12,Grenada,0,0,24,0
2020-09-13,Grenada,0,0,24,0
2020-09-14,Grenada,0,0,24,0
2020-09-15,Grenada,0,0,24,0
2020-09-16,Grenada,0,0,24,0
2020-09-17,Grenada,0,0,24,0
2020-09-18,Grenada,0,0,24,0
2020-09-19,Grenada,0,0,24,0
2020-09-20,Grenada,0,0,24,0
2020-09-21,Grenada,0,0,24,0
2020-09-22,Grenada,0,0,24,0
2020-09-23,Grenada,0,0,24,0
2020-09-24,Grenada,0,0,24,0
2020-09-25,Grenada,0,0,24,0
2020-09-26,Grenada,0,0,24,0
2020-09-27,Grenada,0,0,24,0
2020-09-28,Grenada,0,0,24,0
2020-09-29,Grenada,0,0,24,0
2020-09-30,Grenada,0,0,24,0
2020-10-01,Grenada,0,0,24,0
2020-10-02,Grenada,0,0,24,0
2020-10-03,Grenada,0,0,24,0
2020-10-04,Grenada,0,0,24,0
2020-10-05,Grenada,0,0,24,0
2020-10-06,Grenada,0,0,24,0
2020-10-07,Grenada,0,0,24,0
2020-10-08,Grenada,0,0,24,0
2020-10-09,Grenada,0,0,24,0
2020-10-10,Grenada,0,0,24,0
2020-10-11,Grenada,0,0,24,0
2020-10-12,Grenada,1,0,25,0
2020-10-13,Grenada,0,0,25,0
2020-10-14,Grenada,0,0,25,0
2020-10-15,Grenada,0,0,25,0
2020-10-16,Grenada,0,0,25,0
2020-10-17,Grenada,2,0,27,0
2020-10-18,Grenada,0,0,27,0
2020-10-19,Grenada,0,0,27,0
2020-10-20,Grenada,0,0,27,0
2020-10-21,Grenada,0,0,27,0
2020-10-22,Grenada,0,0,27,0
2020-10-23,Grenada,0,0,27,0
2020-10-24,Grenada,1,0,28,0
2020-10-25,Grenada,0,0,28,0
2020-10-26,Grenada,0,0,28,0
2020-10-27,Grenada,0,0,28,0
2020-10-28,Grenada,0,0,28,0
2020-10-29,Grenada,0,0,28,0
2020-10-30,Grenada,0,0,28,0
2020-10-31,Grenada,0,0,28,0
2020-11-01,Grenada,0,0,28,0
2020-11-02,Grenada,1,0,29,0
2020-11-03,Grenada,0,0,29,0
2020-11-04,Grenada,1,0,30,0
2020-11-05,Grenada,0,0,30,0
2020-11-06,Grenada,0,0,30,0
2020-11-07,Grenada,0,0,30,0
2020-11-08,Grenada,2,0,32,0
2020-11-09,Grenada,0,0,32,0
2020-11-10,Grenada,0,0,32,0
2020-11-11,Grenada,0,0,32,0
2020-11-12,Grenada,0,0,32,0
2020-11-13,Grenada,0,0,32,0
2020-11-14,Grenada,0,0,32,0
2020-11-15,Grenada,0,0,32,0
2020-11-16,Grenada,1,0,33,0
2020-11-17,Grenada,0,0,33,0
2020-11-18,Grenada,3,0,36,0
2020-11-19,Grenada,0,0,36,0
2020-11-20,Grenada,5,0,41,0
2020-11-21,Grenada,0,0,41,0
2020-11-22,Grenada,0,0,41,0
2020-11-23,Grenada,0,0,41,0
2020-11-24,Grenada,0,0,41,0
2020-11-25,Grenada,0,0,41,0
2020-11-26,Grenada,0,0,41,0
2020-11-27,Grenada,0,0,41,0
2020-11-28,Grenada,0,0,41,0
2020-11-29,Grenada,0,0,41,0
2020-11-30,Grenada,0,0,41,0
2020-12-01,Grenada,0,0,41,0
2020-12-02,Grenada,0,0,41,0
2020-12-03,Grenada,0,0,41,0
2020-12-04,Grenada,0,0,41,0
2020-12-05,Grenada,0,0,41,0
2020-12-06,Grenada,0,0,41,0
2020-12-07,Grenada,2,0,43,0
2020-12-08,Grenada,0,0,43,0
2020-12-09,Grenada,0,0,43,0
2020-12-10,Grenada,0,0,43,0
2020-12-11,Grenada,0,0,43,0
2020-12-12,Grenada,0,0,43,0
2020-12-13,Grenada,26,0,69,0
2020-12-14,Grenada,0,0,69,0
2020-12-15,Grenada,0,0,69,0
2020-12-16,Grenada,16,0,85,0
2020-12-17,Grenada,0,0,85,0
2020-12-18,Grenada,9,0,94,0
2020-12-19,Grenada,0,0,94,0
2020-12-20,Grenada,9,0,103,0
2020-12-21,Grenada,0,0,103,0
2020-12-22,Grenada,0,0,103,0
2020-12-23,Grenada,2,0,105,0
2020-12-24,Grenada,0,0,105,0
2020-12-25,Grenada,7,0,112,0
2020-12-26,Grenada,0,0,112,0
2020-12-27,Grenada,0,0,112,0
2020-12-28,Grenada,12,0,124,0
2020-12-29,Grenada,3,0,127,0
2020-12-30,Grenada,0,0,127,0
2020-12-31,Grenada,0,0,127,0
2021-01-01,Grenada,0,0,127,0
2021-01-02,Grenada,0,0,127,0
2021-01-03,Grenada,0,1,127,1
2021-01-04,Grenada,0,0,127,1
2021-01-05,Grenada,0,0,127,1
2021-01-06,Grenada,0,0,127,1
2021-01-07,Grenada,0,0,127,1
2021-01-08,Grenada,0,0,127,1
2021-01-09,Grenada,0,0,127,1
2021-01-10,Grenada,0,0,127,1
2021-01-11,Grenada,5,0,132,1
2021-01-12,Grenada,0,0,132,1
2021-01-13,Grenada,0,0,132,1
2021-01-14,Grenada,0,0,132,1
2021-01-15,Grenada,7,0,139,1
2021-01-16,Grenada,0,0,139,1
2021-01-17,Grenada,0,0,139,1
2021-01-18,Grenada,0,0,139,1
2021-01-19,Grenada,0,0,139,1
2021-01-20,Grenada,0,0,139,1
2021-01-21,Grenada,0,0,139,1
2021-01-22,Grenada,0,0,139,1
2021-01-23,Grenada,8,0,147,1
2021-01-24,Grenada,0,0,147,1
2021-01-25,Grenada,1,0,148,1
2021-01-26,Grenada,0,0,148,1
2021-01-27,Grenada,0,0,148,1
2021-01-28,Grenada,0,0,148,1
2021-01-29,Grenada,0,0,148,1
2021-01-30,Grenada,0,0,148,1
2021-01-31,Grenada,0,0,148,1
2021-02-01,Grenada,0,0,148,1
2021-02-02,Grenada,0,0,148,1
2021-02-03,Grenada,0,0,148,1
2021-02-04,Grenada,0,0,148,1
2021-02-05,Grenada,0,0,148,1
2021-02-06,Grenada,0,0,148,1
2021-02-07,Grenada,0,0,148,1
2021-02-08,Grenada,0,0,148,1
2021-02-09,Grenada,0,0,148,1
2021-02-10,Grenada,0,0,148,1
2021-02-11,Grenada,0,0,148,1
2021-02-12,Grenada,0,0,148,1
2021-02-13,Grenada,0,0,148,1
2021-02-14,Grenada,0,0,148,1
2021-02-15,Grenada,0,0,148,1
2021-02-16,Grenada,0,0,148,1
2021-02-17,Grenada,0,0,148,1
2021-02-18,Grenada,0,0,148,1
2021-02-19,Grenada,0,0,148,1
2021-02-20,Grenada,0,0,148,1
2021-02-21,Grenada,0,0,148,1
2021-02-22,Grenada,0,0,148,1
2021-02-23,Grenada,0,0,148,1
2021-02-24,Grenada,0,0,148,1
2021-02-25,Grenada,0,0,148,1
2021-02-26,Grenada,0,0,148,1
2021-02-27,Grenada,0,0,148,1
2021-02-28,Grenada,0,0,148,1
2021-03-01,Grenada,0,0,148,1
2021-03-02,Grenada,0,0,148,1
2021-03-03,Grenada,0,0,148,1
2021-03-04,Grenada,0,0,148,1
2021-03-05,Grenada,0,0,148,1
2021-03-06,Grenada,0,0,148,1
2021-03-07,Grenada,0,0,148,1
2021-03-08,Grenada,0,0,148,1
2021-03-09,Grenada,0,0,148,1
2021-03-10,Grenada,0,0,148,1
2021-03-11,Grenada,0,0,148,1
2021-03-12,Grenada,0,0,148,1
2021-03-13,Grenada,0,0,148,1
2021-03-14,Grenada,0,0,148,1
2021-03-15,Grenada,6,0,154,1
2021-03-16,Grenada,0,0,154,1
2021-03-17,Grenada,0,0,154,1
2021-03-18,Grenada,0,0,154,1
2021-03-19,Grenada,0,0,154,1
2021-03-20,Grenada,0,0,154,1
2021-03-21,Grenada,0,0,154,1
2021-03-22,Grenada,0,0,154,1
2021-03-23,Grenada,0,0,154,1
2021-03-24,Grenada,0,0,154,1
2021-03-25,Grenada,0,0,154,1
2021-03-26,Grenada,1,0,155,1
2021-03-27,Grenada,0,0,155,1
2021-03-28,Grenada,0,0,155,1
2021-03-29,Grenada,0,0,155,1
2021-03-30,Grenada,0,0,155,1
2021-03-31,Grenada,0,0,155,1
2021-04-01,Grenada,0,0,155,1
2021-04-02,Grenada,0,0,155,1
2021-04-03,Grenada,0,0,155,1
2021-04-04,Grenada,0,0,155,1
2021-04-05,Grenada,0,0,155,1
2021-04-06,Grenada,0,0,155,1
2021-04-07,Grenada,0,0,155,1
2021-04-08,Grenada,0,0,155,1
2020-03-14,Guatemala,1,0,1,0
2020-03-15,Guatemala,0,0,1,0
2020-03-16,Guatemala,1,1,2,1
2020-03-17,Guatemala,4,0,6,1
2020-03-18,Guatemala,0,0,6,1
2020-03-19,Guatemala,3,0,9,1
2020-03-20,Guatemala,3,0,12,1
2020-03-21,Guatemala,5,0,17,1
2020-03-22,Guatemala,2,0,19,1
2020-03-23,Guatemala,1,0,20,1
2020-03-24,Guatemala,1,0,21,1
2020-03-25,Guatemala,3,0,24,1
2020-03-26,Guatemala,1,0,25,1
2020-03-27,Guatemala,3,0,28,1
2020-03-28,Guatemala,6,0,34,1
2020-03-29,Guatemala,0,0,34,1
2020-03-30,Guatemala,2,0,36,1
2020-03-31,Guatemala,2,0,38,1
2020-04-01,Guatemala,1,0,39,1
2020-04-02,Guatemala,8,0,47,1
2020-04-03,Guatemala,3,0,50,1
2020-04-04,Guatemala,11,1,61,2
2020-04-05,Guatemala,0,0,61,2
2020-04-06,Guatemala,9,1,70,3
2020-04-07,Guatemala,7,0,77,3
2020-04-08,Guatemala,10,0,87,3
2020-04-09,Guatemala,8,0,95,3
2020-04-10,Guatemala,31,0,126,3
2020-04-11,Guatemala,11,0,137,3
2020-04-12,Guatemala,18,2,155,5
2020-04-13,Guatemala,1,0,156,5
2020-04-14,Guatemala,11,0,167,5
2020-04-15,Guatemala,13,0,180,5
2020-04-16,Guatemala,16,0,196,5
2020-04-17,Guatemala,18,2,214,7
2020-04-18,Guatemala,21,0,235,7
2020-04-19,Guatemala,22,0,257,7
2020-04-20,Guatemala,32,0,289,7
2020-04-21,Guatemala,5,0,294,7
2020-04-22,Guatemala,22,1,316,8
2020-04-23,Guatemala,68,3,384,11
2020-04-24,Guatemala,46,0,430,11
2020-04-25,Guatemala,43,2,473,13
2020-04-26,Guatemala,27,2,500,15
2020-04-27,Guatemala,30,0,530,15
2020-04-28,Guatemala,0,0,530,15
2020-04-29,Guatemala,27,1,557,16
2020-04-30,Guatemala,42,0,599,16
2020-05-01,Guatemala,45,0,644,16
2020-05-02,Guatemala,44,1,688,17
2020-05-03,Guatemala,15,0,703,17
2020-05-04,Guatemala,27,2,730,19
2020-05-05,Guatemala,33,0,763,19
2020-05-06,Guatemala,35,2,798,21
2020-05-07,Guatemala,34,2,832,23
2020-05-08,Guatemala,68,1,900,24
2020-05-09,Guatemala,67,0,967,24
2020-05-10,Guatemala,85,2,1052,26
2020-05-11,Guatemala,62,0,1114,26
2020-05-12,Guatemala,85,1,1199,27
2020-05-13,Guatemala,143,2,1342,29
2020-05-14,Guatemala,176,0,1518,29
2020-05-15,Guatemala,125,1,1643,30
2020-05-16,Guatemala,120,3,1763,33
2020-05-17,Guatemala,0,0,1763,33
2020-05-18,Guatemala,149,2,1912,35
2020-05-19,Guatemala,221,8,2133,43
2020-05-20,Guatemala,132,2,2265,45
2020-05-21,Guatemala,247,3,2512,48
2020-05-22,Guatemala,231,3,2743,51
2020-05-23,Guatemala,311,4,3054,55
2020-05-24,Guatemala,370,3,3424,58
2020-05-25,Guatemala,336,1,3760,59
2020-05-26,Guatemala,194,4,3954,63
2020-05-27,Guatemala,191,5,4145,68
2020-05-28,Guatemala,203,12,4348,80
2020-05-29,Guatemala,259,10,4607,90
2020-05-30,Guatemala,132,12,4739,102
2020-05-31,Guatemala,348,6,5087,108
2020-06-01,Guatemala,249,8,5336,116
2020-06-02,Guatemala,250,7,5586,123
2020-06-03,Guatemala,174,20,5760,143
2020-06-04,Guatemala,394,15,6154,158
2020-06-05,Guatemala,331,58,6485,216
2020-06-06,Guatemala,307,14,6792,230
2020-06-07,Guatemala,263,22,7055,252
2020-06-08,Guatemala,447,15,7502,267
2020-06-09,Guatemala,364,22,7866,289
2020-06-10,Guatemala,355,27,8221,316
2020-06-11,Guatemala,340,18,8561,334
2020-06-12,Guatemala,421,17,8982,351
2020-06-13,Guatemala,509,16,9491,367
2020-06-14,Guatemala,354,17,9845,384
2020-06-15,Guatemala,427,15,10272,399
2020-06-16,Guatemala,434,19,10706,418
2020-06-17,Guatemala,545,14,11251,432
2020-06-18,Guatemala,617,17,11868,449
2020-06-19,Guatemala,641,34,12509,483
2020-06-20,Guatemala,246,31,12755,514
2020-06-21,Guatemala,390,17,13145,531
2020-06-22,Guatemala,624,16,13769,547
2020-06-23,Guatemala,771,35,14540,582
2020-06-24,Guatemala,279,19,14819,601
2020-06-25,Guatemala,800,22,15619,623
2020-06-26,Guatemala,209,49,15828,672
2020-06-27,Guatemala,569,34,16397,706
2020-06-28,Guatemala,533,21,16930,727
2020-06-29,Guatemala,479,19,17409,746
2020-06-30,Guatemala,687,27,18096,773
2020-07-01,Guatemala,915,44,19011,817
2020-07-02,Guatemala,1061,26,20072,843
2020-07-03,Guatemala,1221,37,21293,880
2020-07-04,Guatemala,1208,40,22501,920
2020-07-05,Guatemala,747,27,23248,947
2020-07-06,Guatemala,724,34,23972,981
2020-07-07,Guatemala,815,23,24787,1004
2020-07-08,Guatemala,624,49,25411,1053
2020-07-09,Guatemala,1247,39,26658,1092
2020-07-10,Guatemala,961,47,27619,1139
2020-07-11,Guatemala,979,33,28598,1172
2020-07-12,Guatemala,757,47,29355,1219
2020-07-13,Guatemala,387,25,29742,1244
2020-07-14,Guatemala,1130,58,30872,1302
2020-07-15,Guatemala,1202,48,32074,1350
2020-07-16,Guatemala,865,54,32939,1404
2020-07-17,Guatemala,870,39,33809,1443
2020-07-18,Guatemala,4233,6,38042,1449
2020-07-19,Guatemala,635,36,38677,1485
2020-07-20,Guatemala,362,17,39039,1502
2020-07-21,Guatemala,1190,29,40229,1531
2020-07-22,Guatemala,906,42,41135,1573
2020-07-23,Guatemala,1057,59,42192,1632
2020-07-24,Guatemala,1091,37,43283,1669
2020-07-25,Guatemala,1209,30,44492,1699
2020-07-26,Guatemala,561,35,45053,1734
2020-07-27,Guatemala,256,27,45309,1761
2020-07-28,Guatemala,1142,21,46451,1782
2020-07-29,Guatemala,1154,53,47605,1835
2020-07-30,Guatemala,1221,32,48826,1867
2020-07-31,Guatemala,963,57,49789,1924
2020-08-01,Guatemala,1190,35,50979,1959
2020-08-02,Guatemala,327,36,51306,1995
2020-08-03,Guatemala,236,18,51542,2013
2020-08-04,Guatemala,823,24,52365,2037
2020-08-05,Guatemala,1144,35,53509,2072
2020-08-06,Guatemala,830,47,54339,2119
2020-08-07,Guatemala,931,49,55270,2168
2020-08-08,Guatemala,919,29,56189,2197
2020-08-09,Guatemala,416,14,56605,2211
2020-08-10,Guatemala,382,11,56987,2222
2020-08-11,Guatemala,979,11,57966,2233
2020-08-12,Guatemala,1123,34,59089,2267
2020-08-13,Guatemala,1195,29,60284,2296
2020-08-14,Guatemala,1144,45,61428,2341
2020-08-15,Guatemala,885,14,62313,2355
2020-08-16,Guatemala,249,24,62562,2379
2020-08-17,Guatemala,382,10,62944,2389
2020-08-18,Guatemala,903,30,63847,2419
2020-08-19,Guatemala,1034,48,64881,2467
2020-08-20,Guatemala,1102,39,65983,2506
2020-08-21,Guatemala,958,26,66941,2532
2020-08-22,Guatemala,915,48,67856,2580
2020-08-23,Guatemala,332,14,68188,2594
2020-08-24,Guatemala,345,17,68533,2611
2020-08-25,Guatemala,1118,19,69651,2630
2020-08-26,Guatemala,1063,32,70714,2662
2020-08-27,Guatemala,1142,23,71856,2685
2020-08-28,Guatemala,1065,24,72921,2709
2020-08-29,Guatemala,758,19,73679,2728
2020-08-30,Guatemala,233,12,73912,2740
2020-08-31,Guatemala,162,20,74074,2760
2020-09-01,Guatemala,819,18,74893,2778
2020-09-02,Guatemala,751,12,75644,2790
2020-09-03,Guatemala,714,14,76358,2804
2020-09-04,Guatemala,682,21,77040,2825
2020-09-05,Guatemala,441,20,77481,2845
2020-09-06,Guatemala,202,7,77683,2852
2020-09-07,Guatemala,145,10,77828,2862
2020-09-08,Guatemala,893,28,78721,2890
2020-09-09,Guatemala,901,7,79622,2897
2020-09-10,Guatemala,684,21,80306,2918
2020-09-11,Guatemala,703,11,81009,2929
2020-09-12,Guatemala,649,20,81658,2949
2020-09-13,Guatemala,251,8,81909,2957
2020-09-14,Guatemala,263,15,82172,2972
2020-09-15,Guatemala,512,12,82684,2984
2020-09-16,Guatemala,240,25,82924,3009
2020-09-17,Guatemala,740,27,83664,3036
2020-09-18,Guatemala,680,40,84344,3076
2020-09-19,Guatemala,808,29,85152,3105
2020-09-20,Guatemala,292,14,85444,3119
2020-09-21,Guatemala,237,5,85681,3124
2020-09-22,Guatemala,942,13,86623,3137
2020-09-23,Guatemala,819,17,87442,3154
2020-09-24,Guatemala,491,16,87933,3170
2020-09-25,Guatemala,945,16,88878,3186
2020-09-26,Guatemala,824,27,89702,3213
2020-09-27,Guatemala,390,16,90092,3229
2020-09-28,Guatemala,171,5,90263,3234
2020-09-29,Guatemala,705,4,90968,3238
2020-09-30,Guatemala,778,8,91746,3246
2020-10-01,Guatemala,663,15,92409,3261
2020-10-02,Guatemala,681,6,93090,3267
2020-10-03,Guatemala,658,18,93748,3285
2020-10-04,Guatemala,215,8,93963,3293
2020-10-05,Guatemala,219,9,94182,3302
2020-10-06,Guatemala,688,8,94870,3310
2020-10-07,Guatemala,834,25,95704,3335
2020-10-08,Guatemala,776,12,96480,3347
2020-10-09,Guatemala,455,9,96935,3356
2020-10-10,Guatemala,609,9,97544,3365
2020-10-11,Guatemala,171,19,97715,3384
2020-10-12,Guatemala,111,3,97826,3387
2020-10-13,Guatemala,554,23,98380,3410
2020-10-14,Guatemala,714,20,99094,3430
2020-10-15,Guatemala,671,23,99765,3453
2020-10-16,Guatemala,666,25,100431,3478
2020-10-17,Guatemala,597,37,101028,3515
2020-10-18,Guatemala,332,15,101360,3530
2020-10-19,Guatemala,239,11,101599,3541
2020-10-20,Guatemala,620,5,102219,3546
2020-10-21,Guatemala,196,21,102415,3567
2020-10-22,Guatemala,757,13,103172,3580
2020-10-23,Guatemala,730,14,103902,3594
2020-10-24,Guatemala,730,15,104632,3609
2020-10-25,Guatemala,155,35,104787,3644
2020-10-26,Guatemala,107,7,104894,3651
2020-10-27,Guatemala,677,14,105571,3665
2020-10-28,Guatemala,749,17,106320,3682
2020-10-29,Guatemala,470,22,106790,3704
2020-10-30,Guatemala,549,10,107339,3714
2020-10-31,Guatemala,600,15,107939,3729
2020-11-01,Guatemala,165,9,108104,3738
2020-11-02,Guatemala,0,0,108104,3738
2020-11-03,Guatemala,379,10,108483,3748
2020-11-04,Guatemala,664,4,109147,3752
2020-11-05,Guatemala,702,14,109849,3766
2020-11-06,Guatemala,653,28,110502,3794
2020-11-07,Guatemala,548,17,111050,3811
2020-11-08,Guatemala,212,10,111262,3821
2020-11-09,Guatemala,98,2,111360,3823
2020-11-10,Guatemala,769,9,112129,3832
2020-11-11,Guatemala,682,13,112811,3845
2020-11-12,Guatemala,732,13,113543,3858
2020-11-13,Guatemala,580,22,114123,3880
2020-11-14,Guatemala,596,40,114719,3920
2020-11-15,Guatemala,166,12,114885,3932
2020-11-16,Guatemala,147,6,115032,3938
2020-11-17,Guatemala,698,9,115730,3947
2020-11-18,Guatemala,651,61,116381,4008
2020-11-19,Guatemala,685,42,117066,4050
2020-11-20,Guatemala,691,17,117757,4067
2020-11-21,Guatemala,660,7,118417,4074
2020-11-22,Guatemala,212,2,118629,4076
2020-11-23,Guatemala,93,16,118722,4092
2020-11-24,Guatemala,627,7,119349,4099
2020-11-25,Guatemala,640,8,119989,4107
2020-11-26,Guatemala,696,26,120685,4133
2020-11-27,Guatemala,447,8,121132,4141
2020-11-28,Guatemala,666,20,121798,4161
2020-11-29,Guatemala,173,5,121971,4166
2020-11-30,Guatemala,91,5,122062,4171
2020-12-01,Guatemala,712,7,122774,4178
2020-12-02,Guatemala,686,13,123460,4191
2020-12-03,Guatemala,593,18,124053,4209
2020-12-04,Guatemala,752,15,124805,4224
2020-12-05,Guatemala,547,15,125352,4239
2020-12-06,Guatemala,198,11,125550,4250
2020-12-07,Guatemala,124,24,125674,4274
2020-12-08,Guatemala,799,12,126473,4286
2020-12-09,Guatemala,654,25,127127,4311
2020-12-10,Guatemala,659,34,127786,4345
2020-12-11,Guatemala,755,31,128541,4376
2020-12-12,Guatemala,558,29,129099,4405
2020-12-13,Guatemala,183,18,129282,4423
2020-12-14,Guatemala,123,22,129405,4445
2020-12-15,Guatemala,677,31,130082,4476
2020-12-16,Guatemala,746,34,130828,4510
2020-12-17,Guatemala,607,41,131435,4551
2020-12-18,Guatemala,627,38,132062,4589
2020-12-19,Guatemala,533,35,132595,4624
2020-12-20,Guatemala,170,32,132765,4656
2020-12-21,Guatemala,102,32,132867,4688
2020-12-22,Guatemala,734,30,133601,4718
2020-12-23,Guatemala,655,21,134256,4739
2020-12-24,Guatemala,638,10,134894,4749
2020-12-25,Guatemala,186,8,135080,4757
2020-12-26,Guatemala,91,6,135171,4763
2020-12-27,Guatemala,138,5,135309,4768
2020-12-28,Guatemala,132,5,135441,4773
2020-12-29,Guatemala,846,8,136287,4781
2020-12-30,Guatemala,879,22,137166,4803
2020-12-31,Guatemala,846,10,138012,4813
2021-01-01,Guatemala,224,7,138236,4820
2021-01-02,Guatemala,80,7,138316,4827
2021-01-03,Guatemala,159,6,138475,4833
2021-01-04,Guatemala,181,2,138656,4835
2021-01-05,Guatemala,763,24,139419,4859
2021-01-06,Guatemala,783,40,140202,4899
2021-01-07,Guatemala,872,29,141074,4928
2021-01-08,Guatemala,990,44,142064,4972
2021-01-09,Guatemala,1063,27,143127,4999
2021-01-10,Guatemala,116,26,143243,5025
2021-01-11,Guatemala,0,0,143243,5025
2021-01-12,Guatemala,1739,55,144982,5080
2021-01-13,Guatemala,1004,37,145986,5117
2021-01-14,Guatemala,951,34,146937,5151
2021-01-15,Guatemala,623,26,147560,5177
2021-01-16,Guatemala,1038,43,148598,5220
2021-01-17,Guatemala,290,34,148888,5254
2021-01-18,Guatemala,258,24,149146,5278
2021-01-19,Guatemala,1131,35,150277,5313
2021-01-20,Guatemala,1047,30,151324,5343
2021-01-21,Guatemala,1071,46,152395,5389
2021-01-22,Guatemala,561,31,152956,5420
2021-01-23,Guatemala,934,36,153890,5456
2021-01-24,Guatemala,322,9,154212,5465
2021-01-25,Guatemala,218,4,154430,5469
2021-01-26,Guatemala,1029,17,155459,5486
2021-01-27,Guatemala,1038,27,156497,5513
2021-01-28,Guatemala,1098,30,157595,5543
2021-01-29,Guatemala,741,39,158336,5582
2021-01-30,Guatemala,782,36,159118,5618
2021-01-31,Guatemala,386,25,159504,5643
2021-02-01,Guatemala,128,30,159632,5673
2021-02-02,Guatemala,667,36,160299,5709
2021-02-03,Guatemala,667,27,160966,5736
2021-02-04,Guatemala,699,49,161665,5785
2021-02-05,Guatemala,630,31,162295,5816
2021-02-06,Guatemala,642,38,162937,5854
2021-02-07,Guatemala,200,30,163137,5884
2021-02-08,Guatemala,110,38,163247,5922
2021-02-09,Guatemala,746,33,163993,5955
2021-02-10,Guatemala,753,34,164746,5989
2021-02-11,Guatemala,786,34,165532,6023
2021-02-12,Guatemala,751,34,166283,6057
2021-02-13,Guatemala,788,37,167071,6094
2021-02-14,Guatemala,208,30,167279,6124
2021-02-15,Guatemala,104,26,167383,6150
2021-02-16,Guatemala,720,8,168103,6158
2021-02-17,Guatemala,777,6,168880,6164
2021-02-18,Guatemala,730,22,169610,6186
2021-02-19,Guatemala,665,34,170275,6220
2021-02-20,Guatemala,656,29,170931,6249
2021-02-21,Guatemala,239,33,171170,6282
2021-02-22,Guatemala,119,24,171289,6306
2021-02-23,Guatemala,783,9,172072,6315
2021-02-24,Guatemala,692,12,172764,6327
2021-02-25,Guatemala,378,7,173142,6334
2021-02-26,Guatemala,672,14,173814,6348
2021-02-27,Guatemala,521,26,174335,6374
2021-02-28,Guatemala,207,19,174542,6393
2021-03-01,Guatemala,111,9,174653,6402
2021-03-02,Guatemala,758,10,175411,6412
2021-03-03,Guatemala,839,15,176250,6427
2021-03-04,Guatemala,626,8,176876,6435
2021-03-05,Guatemala,840,20,177716,6455
2021-03-06,Guatemala,621,12,178337,6467
2021-03-07,Guatemala,223,6,178560,6473
2021-03-08,Guatemala,210,6,178770,6479
2021-03-09,Guatemala,793,14,179563,6493
2021-03-10,Guatemala,830,29,180393,6522
2021-03-11,Guatemala,750,9,181143,6531
2021-03-12,Guatemala,831,15,181974,6546
2021-03-13,Guatemala,705,25,182679,6571
2021-03-14,Guatemala,202,-3,182881,6568
2021-03-15,Guatemala,133,10,183014,6578
2021-03-16,Guatemala,971,21,183985,6599
2021-03-17,Guatemala,949,20,184934,6619
2021-03-18,Guatemala,898,20,185832,6639
2021-03-19,Guatemala,908,24,186740,6663
2021-03-20,Guatemala,919,22,187659,6685
2021-03-21,Guatemala,252,15,187911,6700
2021-03-22,Guatemala,208,10,188119,6710
2021-03-23,Guatemala,948,20,189067,6730
2021-03-24,Guatemala,1141,19,190208,6749
2021-03-25,Guatemala,999,16,191207,6765
2021-03-26,Guatemala,926,10,192133,6775
2021-03-27,Guatemala,917,19,193050,6794
2021-03-28,Guatemala,327,8,193377,6802
2021-03-29,Guatemala,179,7,193556,6809
2021-03-30,Guatemala,278,14,193834,6823
2021-03-31,Guatemala,0,17,193834,6840
2021-04-01,Guatemala,922,20,194756,6860
2021-04-02,Guatemala,280,15,195036,6875
2021-04-03,Guatemala,203,9,195239,6884
2021-04-04,Guatemala,232,7,195471,6891
2021-04-05,Guatemala,209,3,195680,6894
2021-04-06,Guatemala,1340,9,197020,6903
2021-04-07,Guatemala,1354,25,198374,6928
2021-04-08,Guatemala,1590,27,199964,6955
2020-03-13,Guinea,1,0,1,0
2020-03-14,Guinea,0,0,1,0
2020-03-15,Guinea,0,0,1,0
2020-03-16,Guinea,0,0,1,0
2020-03-17,Guinea,0,0,1,0
2020-03-18,Guinea,0,0,1,0
2020-03-19,Guinea,0,0,1,0
2020-03-20,Guinea,0,0,1,0
2020-03-21,Guinea,1,0,2,0
2020-03-22,Guinea,0,0,2,0
2020-03-23,Guinea,2,0,4,0
2020-03-24,Guinea,0,0,4,0
2020-03-25,Guinea,0,0,4,0
2020-03-26,Guinea,0,0,4,0
2020-03-27,Guinea,4,0,8,0
2020-03-28,Guinea,0,0,8,0
2020-03-29,Guinea,8,0,16,0
2020-03-30,Guinea,6,0,22,0
2020-03-31,Guinea,0,0,22,0
2020-04-01,Guinea,8,0,30,0
2020-04-02,Guinea,22,0,52,0
2020-04-03,Guinea,21,0,73,0
2020-04-04,Guinea,38,0,111,0
2020-04-05,Guinea,10,0,121,0
2020-04-06,Guinea,7,0,128,0
2020-04-07,Guinea,16,0,144,0
2020-04-08,Guinea,20,0,164,0
2020-04-09,Guinea,30,0,194,0
2020-04-10,Guinea,18,0,212,0
2020-04-11,Guinea,38,0,250,0
2020-04-12,Guinea,0,0,250,0
2020-04-13,Guinea,69,0,319,0
2020-04-14,Guinea,44,0,363,0
2020-04-15,Guinea,41,1,404,1
2020-04-16,Guinea,34,0,438,1
2020-04-17,Guinea,39,2,477,3
2020-04-18,Guinea,41,0,518,3
2020-04-19,Guinea,61,2,579,5
2020-04-20,Guinea,43,0,622,5
2020-04-21,Guinea,66,1,688,6
2020-04-22,Guinea,73,0,761,6
2020-04-23,Guinea,101,0,862,6
2020-04-24,Guinea,92,0,954,6
2020-04-25,Guinea,42,1,996,7
2020-04-26,Guinea,0,0,996,7
2020-04-27,Guinea,167,0,1163,7
2020-04-28,Guinea,77,0,1240,7
2020-04-29,Guinea,111,0,1351,7
2020-04-30,Guinea,144,0,1495,7
2020-05-01,Guinea,42,0,1537,7
2020-05-02,Guinea,49,0,1586,7
2020-05-03,Guinea,0,0,1586,7
2020-05-04,Guinea,124,2,1710,9
2020-05-05,Guinea,101,1,1811,10
2020-05-06,Guinea,45,1,1856,11
2020-05-07,Guinea,71,0,1927,11
2020-05-08,Guinea,82,0,2009,11
2020-05-09,Guinea,33,0,2042,11
2020-05-10,Guinea,104,0,2146,11
2020-05-11,Guinea,0,0,2146,11
2020-05-12,Guinea,152,0,2298,11
2020-05-13,Guinea,76,3,2374,14
2020-05-14,Guinea,99,1,2473,15
2020-05-15,Guinea,0,0,2473,15
2020-05-16,Guinea,185,1,2658,16
2020-05-17,Guinea,0,0,2658,16
2020-05-18,Guinea,138,0,2796,16
2020-05-19,Guinea,67,2,2863,18
2020-05-20,Guinea,0,0,2863,18
2020-05-21,Guinea,204,0,3067,18
2020-05-22,Guinea,0,1,3067,19
2020-05-23,Guinea,109,1,3176,20
2020-05-24,Guinea,99,0,3275,20
2020-05-25,Guinea,0,0,3275,20
2020-05-26,Guinea,0,0,3275,20
2020-05-27,Guinea,0,0,3275,20
2020-05-28,Guinea,278,2,3553,22
2020-05-29,Guinea,103,0,3656,22
2020-05-30,Guinea,50,1,3706,23
2020-05-31,Guinea,0,0,3706,23
2020-06-01,Guinea,138,0,3844,23
2020-06-02,Guinea,42,0,3886,23
2020-06-03,Guinea,47,0,3933,23
2020-06-04,Guinea,58,0,3991,23
2020-06-05,Guinea,69,0,4060,23
2020-06-06,Guinea,57,0,4117,23
2020-06-07,Guinea,0,0,4117,23
2020-06-08,Guinea,99,0,4216,23
2020-06-09,Guinea,42,0,4258,23
2020-06-10,Guinea,0,0,4258,23
2020-06-11,Guinea,114,0,4372,23
2020-06-12,Guinea,54,1,4426,24
2020-06-13,Guinea,58,1,4484,25
2020-06-14,Guinea,48,0,4532,25
2020-06-15,Guinea,40,1,4572,26
2020-06-16,Guinea,67,0,4639,26
2020-06-17,Guinea,29,0,4668,26
2020-06-18,Guinea,173,0,4841,26
2020-06-19,Guinea,63,1,4904,27
2020-06-20,Guinea,56,0,4960,27
2020-06-21,Guinea,28,0,4988,27
2020-06-22,Guinea,0,0,4988,27
2020-06-23,Guinea,52,1,5040,28
2020-06-24,Guinea,134,1,5174,29
2020-06-25,Guinea,0,0,5174,29
2020-06-26,Guinea,86,0,5260,29
2020-06-27,Guinea,31,1,5291,30
2020-06-28,Guinea,51,1,5342,31
2020-06-29,Guinea,9,0,5351,31
2020-06-30,Guinea,40,2,5391,33
2020-07-01,Guinea,13,0,5404,33
2020-07-02,Guinea,46,0,5450,33
2020-07-03,Guinea,71,0,5521,33
2020-07-04,Guinea,49,1,5570,34
2020-07-05,Guinea,40,0,5610,34
2020-07-06,Guinea,0,0,5610,34
2020-07-07,Guinea,26,0,5636,34
2020-07-08,Guinea,61,0,5697,34
2020-07-09,Guinea,184,2,5881,36
2020-07-10,Guinea,88,1,5969,37
2020-07-11,Guinea,75,0,6044,37
2020-07-12,Guinea,97,0,6141,37
2020-07-13,Guinea,0,0,6141,37
2020-07-14,Guinea,59,1,6200,38
2020-07-15,Guinea,76,0,6276,38
2020-07-16,Guinea,83,1,6359,39
2020-07-17,Guinea,71,0,6430,39
2020-07-18,Guinea,61,0,6491,39
2020-07-19,Guinea,53,0,6544,39
2020-07-20,Guinea,46,1,6590,40
2020-07-21,Guinea,62,1,6652,41
2020-07-22,Guinea,95,0,6747,41
2020-07-23,Guinea,59,1,6806,42
2020-07-24,Guinea,61,0,6867,42
2020-07-25,Guinea,60,0,6927,42
2020-07-26,Guinea,81,1,7008,43
2020-07-27,Guinea,47,2,7055,45
2020-07-28,Guinea,71,1,7126,46
2020-07-29,Guinea,57,0,7183,46
2020-07-30,Guinea,59,0,7242,46
2020-07-31,Guinea,66,0,7308,46
2020-08-01,Guinea,0,0,7308,46
2020-08-02,Guinea,9,0,7317,46
2020-08-03,Guinea,47,0,7364,46
2020-08-04,Guinea,125,2,7489,48
2020-08-05,Guinea,86,1,7575,49
2020-08-06,Guinea,89,0,7664,49
2020-08-07,Guinea,113,1,7777,50
2020-08-08,Guinea,98,0,7875,50
2020-08-09,Guinea,55,0,7930,50
2020-08-10,Guinea,0,0,7930,50
2020-08-11,Guinea,88,0,8018,50
2020-08-12,Guinea,98,0,8116,50
2020-08-13,Guinea,82,0,8198,50
2020-08-14,Guinea,62,0,8260,50
2020-08-15,Guinea,83,0,8343,50
2020-08-16,Guinea,139,1,8482,51
2020-08-17,Guinea,138,0,8620,51
2020-08-18,Guinea,95,1,8715,52
2020-08-19,Guinea,77,1,8792,53
2020-08-20,Guinea,84,0,8876,53
2020-08-21,Guinea,56,0,8932,53
2020-08-22,Guinea,0,0,8932,53
2020-08-23,Guinea,35,0,8967,53
2020-08-24,Guinea,109,2,9076,55
2020-08-25,Guinea,52,2,9128,57
2020-08-26,Guinea,39,0,9167,57
2020-08-27,Guinea,46,1,9213,58
2020-08-28,Guinea,38,1,9251,59
2020-08-29,Guinea,0,0,9251,59
2020-08-30,Guinea,120,0,9371,59
2020-08-31,Guinea,38,0,9409,59
2020-09-01,Guinea,70,0,9479,59
2020-09-02,Guinea,0,0,9479,59
2020-09-03,Guinea,100,2,9579,61
2020-09-04,Guinea,70,0,9649,61
2020-09-05,Guinea,0,0,9649,61
2020-09-06,Guinea,149,0,9798,61
2020-09-07,Guinea,18,1,9816,62
2020-09-08,Guinea,32,1,9848,63
2020-09-09,Guinea,37,0,9885,63
2020-09-10,Guinea,61,0,9946,63
2020-09-11,Guinea,33,0,9979,63
2020-09-12,Guinea,41,0,10020,63
2020-09-13,Guinea,25,0,10045,63
2020-09-14,Guinea,16,0,10061,63
2020-09-15,Guinea,50,0,10111,63
2020-09-16,Guinea,43,0,10154,63
2020-09-17,Guinea,0,0,10154,63
2020-09-18,Guinea,77,0,10231,63
2020-09-19,Guinea,55,0,10286,63
2020-09-20,Guinea,39,1,10325,64
2020-09-21,Guinea,19,1,10344,65
2020-09-22,Guinea,43,0,10387,65
2020-09-23,Guinea,47,0,10434,65
2020-09-24,Guinea,0,0,10434,65
2020-09-25,Guinea,44,0,10478,65
2020-09-26,Guinea,34,0,10512,65
2020-09-27,Guinea,68,1,10580,66
2020-09-28,Guinea,18,0,10598,66
2020-09-29,Guinea,36,0,10634,66
2020-09-30,Guinea,18,0,10652,66
2020-10-01,Guinea,0,0,10652,66
2020-10-02,Guinea,83,0,10735,66
2020-10-03,Guinea,0,0,10735,66
2020-10-04,Guinea,19,0,10754,66
2020-10-05,Guinea,46,1,10800,67
2020-10-06,Guinea,63,1,10863,68
2020-10-07,Guinea,0,0,10863,68
2020-10-08,Guinea,38,0,10901,68
2020-10-09,Guinea,53,0,10954,68
2020-10-10,Guinea,42,1,10996,69
2020-10-11,Guinea,26,0,11022,69
2020-10-12,Guinea,40,1,11062,70
2020-10-13,Guinea,72,0,11134,70
2020-10-14,Guinea,54,0,11188,70
2020-10-15,Guinea,67,0,11255,70
2020-10-16,Guinea,107,0,11362,70
2020-10-17,Guinea,116,0,11478,70
2020-10-18,Guinea,40,0,11518,70
2020-10-19,Guinea,0,0,11518,70
2020-10-20,Guinea,20,0,11538,70
2020-10-21,Guinea,61,0,11599,70
2020-10-22,Guinea,36,1,11635,71
2020-10-23,Guinea,0,0,11635,71
2020-10-24,Guinea,0,0,11635,71
2020-10-25,Guinea,0,0,11635,71
2020-10-26,Guinea,0,0,11635,71
2020-10-27,Guinea,184,0,11819,71
2020-10-28,Guinea,0,0,11819,71
2020-10-29,Guinea,201,0,12020,71
2020-10-30,Guinea,52,1,12072,72
2020-10-31,Guinea,0,0,12072,72
2020-11-01,Guinea,123,1,12195,73
2020-11-02,Guinea,18,0,12213,73
2020-11-03,Guinea,0,0,12213,73
2020-11-04,Guinea,118,0,12331,73
2020-11-05,Guinea,32,0,12363,73
2020-11-06,Guinea,0,0,12363,73
2020-11-07,Guinea,37,0,12400,73
2020-11-08,Guinea,14,1,12414,74
2020-11-09,Guinea,45,0,12459,74
2020-11-10,Guinea,25,0,12484,74
2020-11-11,Guinea,32,0,12516,74
2020-11-12,Guinea,21,0,12537,74
2020-11-13,Guinea,0,0,12537,74
2020-11-14,Guinea,48,0,12585,74
2020-11-15,Guinea,26,1,12611,75
2020-11-16,Guinea,13,0,12624,75
2020-11-17,Guinea,30,0,12654,75
2020-11-18,Guinea,59,0,12713,75
2020-11-19,Guinea,0,0,12713,75
2020-11-20,Guinea,30,0,12743,75
2020-11-21,Guinea,55,0,12798,75
2020-11-22,Guinea,28,0,12826,75
2020-11-23,Guinea,15,0,12841,75
2020-11-24,Guinea,22,0,12863,75
2020-11-25,Guinea,66,1,12929,76
2020-11-26,Guinea,20,0,12949,76
2020-11-27,Guinea,90,0,13039,76
2020-11-28,Guinea,0,0,13039,76
2020-11-29,Guinea,0,0,13039,76
2020-11-30,Guinea,80,0,13119,76
2020-12-01,Guinea,0,0,13119,76
2020-12-02,Guinea,24,0,13143,76
2020-12-03,Guinea,24,0,13167,76
2020-12-04,Guinea,19,0,13186,76
2020-12-05,Guinea,47,0,13233,76
2020-12-06,Guinea,0,0,13233,76
2020-12-07,Guinea,31,3,13264,79
2020-12-08,Guinea,0,0,13264,79
2020-12-09,Guinea,61,0,13325,79
2020-12-10,Guinea,43,0,13368,79
2020-12-11,Guinea,30,0,13398,79
2020-12-12,Guinea,22,0,13420,79
2020-12-13,Guinea,0,0,13420,79
2020-12-14,Guinea,37,1,13457,80
2020-12-15,Guinea,0,0,13457,80
2020-12-16,Guinea,17,0,13474,80
2020-12-17,Guinea,11,0,13485,80
2020-12-18,Guinea,26,0,13511,80
2020-12-19,Guinea,21,0,13532,80
2020-12-20,Guinea,13,0,13545,80
2020-12-21,Guinea,33,0,13578,80
2020-12-22,Guinea,0,0,13578,80
2020-12-23,Guinea,20,0,13598,80
2020-12-24,Guinea,32,0,13630,80
2020-12-25,Guinea,16,0,13646,80
2020-12-26,Guinea,0,0,13646,80
2020-12-27,Guinea,28,0,13674,80
2020-12-28,Guinea,14,0,13688,80
2020-12-29,Guinea,0,0,13688,80
2020-12-30,Guinea,19,0,13707,80
2020-12-31,Guinea,15,1,13722,81
2021-01-01,Guinea,16,0,13738,81
2021-01-02,Guinea,46,0,13784,81
2021-01-03,Guinea,0,0,13784,81
2021-01-04,Guinea,15,0,13799,81
2021-01-05,Guinea,46,0,13845,81
2021-01-06,Guinea,0,0,13845,81
2021-01-07,Guinea,59,0,13904,81
2021-01-08,Guinea,0,0,13904,81
2021-01-09,Guinea,38,0,13942,81
2021-01-10,Guinea,0,0,13942,81
2021-01-11,Guinea,38,0,13980,81
2021-01-12,Guinea,45,0,14025,81
2021-01-13,Guinea,26,0,14051,81
2021-01-14,Guinea,0,0,14051,81
2021-01-15,Guinea,14,0,14065,81
2021-01-16,Guinea,33,0,14098,81
2021-01-17,Guinea,16,0,14114,81
2021-01-18,Guinea,51,0,14165,81
2021-01-19,Guinea,42,0,14207,81
2021-01-20,Guinea,0,0,14207,81
2021-01-21,Guinea,29,0,14236,81
2021-01-22,Guinea,26,0,14262,81
2021-01-23,Guinea,38,0,14300,81
2021-01-24,Guinea,19,0,14319,81
2021-01-25,Guinea,56,0,14375,81
2021-01-26,Guinea,4,1,14379,82
2021-01-27,Guinea,56,0,14435,82
2021-01-28,Guinea,0,0,14435,82
2021-01-29,Guinea,16,0,14451,82
2021-01-30,Guinea,24,0,14475,82
2021-01-31,Guinea,71,0,14546,82
2021-02-01,Guinea,9,1,14555,83
2021-02-02,Guinea,0,0,14555,83
2021-02-03,Guinea,0,0,14555,83
2021-02-04,Guinea,74,1,14629,84
2021-02-05,Guinea,0,0,14629,84
2021-02-06,Guinea,36,0,14665,84
2021-02-07,Guinea,22,0,14687,84
2021-02-08,Guinea,77,0,14764,84
2021-02-09,Guinea,27,0,14791,84
2021-02-10,Guinea,0,0,14791,84
2021-02-11,Guinea,69,0,14860,84
2021-02-12,Guinea,0,0,14860,84
2021-02-13,Guinea,35,0,14895,84
2021-02-14,Guinea,72,1,14967,85
2021-02-15,Guinea,0,0,14967,85
2021-02-16,Guinea,53,0,15020,85
2021-02-17,Guinea,68,0,15088,85
2021-02-18,Guinea,66,0,15154,85
2021-02-19,Guinea,62,1,15216,86
2021-02-20,Guinea,179,0,15395,86
2021-02-21,Guinea,0,0,15395,86
2021-02-22,Guinea,32,0,15427,86
2021-02-23,Guinea,60,1,15487,87
2021-02-24,Guinea,193,1,15680,88
2021-02-25,Guinea,109,0,15789,88
2021-02-26,Guinea,105,1,15894,89
2021-02-27,Guinea,0,0,15894,89
2021-02-28,Guinea,98,0,15992,89
2021-03-01,Guinea,13,0,16005,89
2021-03-02,Guinea,76,2,16081,91
2021-03-03,Guinea,210,1,16291,92
2021-03-04,Guinea,129,1,16420,93
2021-03-05,Guinea,0,0,16420,93
2021-03-06,Guinea,120,0,16540,93
2021-03-07,Guinea,130,2,16670,95
2021-03-08,Guinea,242,2,16912,97
2021-03-09,Guinea,0,0,16912,97
2021-03-10,Guinea,296,4,17208,101
2021-03-11,Guinea,164,0,17372,101
2021-03-12,Guinea,220,1,17592,102
2021-03-13,Guinea,0,0,17592,102
2021-03-14,Guinea,150,0,17742,102
2021-03-15,Guinea,109,1,17851,103
2021-03-16,Guinea,131,1,17982,104
2021-03-17,Guinea,303,2,18285,106
2021-03-18,Guinea,0,0,18285,106
2021-03-19,Guinea,277,2,18562,108
2021-03-20,Guinea,0,0,18562,108
2021-03-21,Guinea,315,3,18877,111
2021-03-22,Guinea,68,2,18945,113
2021-03-23,Guinea,0,0,18945,113
2021-03-24,Guinea,139,0,19084,113
2021-03-25,Guinea,148,0,19232,113
2021-03-26,Guinea,171,3,19403,116
2021-03-27,Guinea,98,0,19501,116
2021-03-28,Guinea,169,4,19670,120
2021-03-29,Guinea,103,3,19773,123
2021-03-30,Guinea,20,2,19793,125
2021-03-31,Guinea,115,0,19908,125
2021-04-01,Guinea,175,2,20083,127
2021-04-02,Guinea,145,1,20228,128
2021-04-03,Guinea,91,1,20319,129
2021-04-04,Guinea,86,1,20405,130
2021-04-05,Guinea,101,0,20506,130
2021-04-06,Guinea,4,0,20510,130
2021-04-07,Guinea,44,1,20554,131
2021-04-08,Guinea,0,0,20554,131
2020-03-25,Guinea-Bissau,2,0,2,0
2020-03-26,Guinea-Bissau,0,0,2,0
2020-03-27,Guinea-Bissau,0,0,2,0
2020-03-28,Guinea-Bissau,0,0,2,0
2020-03-29,Guinea-Bissau,0,0,2,0
2020-03-30,Guinea-Bissau,6,0,8,0
2020-03-31,Guinea-Bissau,0,0,8,0
2020-04-01,Guinea-Bissau,1,0,9,0
2020-04-02,Guinea-Bissau,0,0,9,0
2020-04-03,Guinea-Bissau,6,0,15,0
2020-04-04,Guinea-Bissau,3,0,18,0
2020-04-05,Guinea-Bissau,0,0,18,0
2020-04-06,Guinea-Bissau,0,0,18,0
2020-04-07,Guinea-Bissau,15,0,33,0
2020-04-08,Guinea-Bissau,0,0,33,0
2020-04-09,Guinea-Bissau,3,0,36,0
2020-04-10,Guinea-Bissau,0,0,36,0
2020-04-11,Guinea-Bissau,2,0,38,0
2020-04-12,Guinea-Bissau,0,0,38,0
2020-04-13,Guinea-Bissau,0,0,38,0
2020-04-14,Guinea-Bissau,0,0,38,0
2020-04-15,Guinea-Bissau,5,0,43,0
2020-04-16,Guinea-Bissau,0,0,43,0
2020-04-17,Guinea-Bissau,0,0,43,0
2020-04-18,Guinea-Bissau,3,0,46,0
2020-04-19,Guinea-Bissau,4,0,50,0
2020-04-20,Guinea-Bissau,0,0,50,0
2020-04-21,Guinea-Bissau,0,0,50,0
2020-04-22,Guinea-Bissau,0,0,50,0
2020-04-23,Guinea-Bissau,0,0,50,0
2020-04-24,Guinea-Bissau,2,0,52,0
2020-04-25,Guinea-Bissau,0,0,52,0
2020-04-26,Guinea-Bissau,1,1,53,1
2020-04-27,Guinea-Bissau,20,0,73,1
2020-04-28,Guinea-Bissau,0,0,73,1
2020-04-29,Guinea-Bissau,132,0,205,1
2020-04-30,Guinea-Bissau,0,0,205,1
2020-05-01,Guinea-Bissau,52,0,257,1
2020-05-02,Guinea-Bissau,0,0,257,1
2020-05-03,Guinea-Bissau,0,0,257,1
2020-05-04,Guinea-Bissau,156,0,413,1
2020-05-05,Guinea-Bissau,0,0,413,1
2020-05-06,Guinea-Bissau,62,1,475,2
2020-05-07,Guinea-Bissau,89,0,564,2
2020-05-08,Guinea-Bissau,30,0,594,2
2020-05-09,Guinea-Bissau,47,1,641,3
2020-05-10,Guinea-Bissau,85,0,726,3
2020-05-11,Guinea-Bissau,35,0,761,3
2020-05-12,Guinea-Bissau,59,0,820,3
2020-05-13,Guinea-Bissau,16,0,836,3
2020-05-14,Guinea-Bissau,77,0,913,3
2020-05-15,Guinea-Bissau,0,0,913,3
2020-05-16,Guinea-Bissau,56,1,969,4
2020-05-17,Guinea-Bissau,21,0,990,4
2020-05-18,Guinea-Bissau,42,0,1032,4
2020-05-19,Guinea-Bissau,6,2,1038,6
2020-05-20,Guinea-Bissau,51,0,1089,6
2020-05-21,Guinea-Bissau,20,0,1109,6
2020-05-22,Guinea-Bissau,5,0,1114,6
2020-05-23,Guinea-Bissau,0,0,1114,6
2020-05-24,Guinea-Bissau,0,0,1114,6
2020-05-25,Guinea-Bissau,64,1,1178,7
2020-05-26,Guinea-Bissau,0,0,1178,7
2020-05-27,Guinea-Bissau,17,0,1195,7
2020-05-28,Guinea-Bissau,0,1,1195,8
2020-05-29,Guinea-Bissau,61,0,1256,8
2020-05-30,Guinea-Bissau,0,0,1256,8
2020-05-31,Guinea-Bissau,0,0,1256,8
2020-06-01,Guinea-Bissau,83,0,1339,8
2020-06-02,Guinea-Bissau,0,0,1339,8
2020-06-03,Guinea-Bissau,0,0,1339,8
2020-06-04,Guinea-Bissau,0,0,1339,8
2020-06-05,Guinea-Bissau,29,4,1368,12
2020-06-06,Guinea-Bissau,0,0,1368,12
2020-06-07,Guinea-Bissau,0,0,1368,12
2020-06-08,Guinea-Bissau,21,0,1389,12
2020-06-09,Guinea-Bissau,0,0,1389,12
2020-06-10,Guinea-Bissau,0,0,1389,12
2020-06-11,Guinea-Bissau,0,0,1389,12
2020-06-12,Guinea-Bissau,71,3,1460,15
2020-06-13,Guinea-Bissau,0,0,1460,15
2020-06-14,Guinea-Bissau,0,0,1460,15
2020-06-15,Guinea-Bissau,32,0,1492,15
2020-06-16,Guinea-Bissau,0,0,1492,15
2020-06-17,Guinea-Bissau,0,0,1492,15
2020-06-18,Guinea-Bissau,0,0,1492,15
2020-06-19,Guinea-Bissau,49,2,1541,17
2020-06-20,Guinea-Bissau,0,0,1541,17
2020-06-21,Guinea-Bissau,0,0,1541,17
2020-06-22,Guinea-Bissau,15,2,1556,19
2020-06-23,Guinea-Bissau,0,0,1556,19
2020-06-24,Guinea-Bissau,0,0,1556,19
2020-06-25,Guinea-Bissau,0,0,1556,19
2020-06-26,Guinea-Bissau,58,3,1614,22
2020-06-27,Guinea-Bissau,0,0,1614,22
2020-06-28,Guinea-Bissau,0,0,1614,22
2020-06-29,Guinea-Bissau,40,2,1654,24
2020-06-30,Guinea-Bissau,0,0,1654,24
2020-07-01,Guinea-Bissau,0,0,1654,24
2020-07-02,Guinea-Bissau,0,0,1654,24
2020-07-03,Guinea-Bissau,111,1,1765,25
2020-07-04,Guinea-Bissau,0,0,1765,25
2020-07-05,Guinea-Bissau,0,0,1765,25
2020-07-06,Guinea-Bissau,25,0,1790,25
2020-07-07,Guinea-Bissau,0,0,1790,25
2020-07-08,Guinea-Bissau,0,0,1790,25
2020-07-09,Guinea-Bissau,0,0,1790,25
2020-07-10,Guinea-Bissau,52,1,1842,26
2020-07-11,Guinea-Bissau,0,0,1842,26
2020-07-12,Guinea-Bissau,0,0,1842,26
2020-07-13,Guinea-Bissau,0,0,1842,26
2020-07-14,Guinea-Bissau,0,0,1842,26
2020-07-15,Guinea-Bissau,0,0,1842,26
2020-07-16,Guinea-Bissau,60,0,1902,26
2020-07-17,Guinea-Bissau,25,0,1927,26
2020-07-18,Guinea-Bissau,22,0,1949,26
2020-07-19,Guinea-Bissau,0,0,1949,26
2020-07-20,Guinea-Bissau,0,0,1949,26
2020-07-21,Guinea-Bissau,5,0,1954,26
2020-07-22,Guinea-Bissau,0,0,1954,26
2020-07-23,Guinea-Bissau,0,0,1954,26
2020-07-24,Guinea-Bissau,0,0,1954,26
2020-07-25,Guinea-Bissau,0,0,1954,26
2020-07-26,Guinea-Bissau,0,0,1954,26
2020-07-27,Guinea-Bissau,0,0,1954,26
2020-07-28,Guinea-Bissau,0,0,1954,26
2020-07-29,Guinea-Bissau,0,0,1954,26
2020-07-30,Guinea-Bissau,27,0,1981,26
2020-07-31,Guinea-Bissau,0,0,1981,26
2020-08-01,Guinea-Bissau,0,1,1981,27
2020-08-02,Guinea-Bissau,0,0,1981,27
2020-08-03,Guinea-Bissau,0,0,1981,27
2020-08-04,Guinea-Bissau,0,0,1981,27
2020-08-05,Guinea-Bissau,51,0,2032,27
2020-08-06,Guinea-Bissau,0,0,2032,27
2020-08-07,Guinea-Bissau,0,0,2032,27
2020-08-08,Guinea-Bissau,20,2,2052,29
2020-08-09,Guinea-Bissau,0,0,2052,29
2020-08-10,Guinea-Bissau,0,0,2052,29
2020-08-11,Guinea-Bissau,36,0,2088,29
2020-08-12,Guinea-Bissau,0,0,2088,29
2020-08-13,Guinea-Bissau,0,0,2088,29
2020-08-14,Guinea-Bissau,0,0,2088,29
2020-08-15,Guinea-Bissau,29,4,2117,33
2020-08-16,Guinea-Bissau,0,0,2117,33
2020-08-17,Guinea-Bissau,0,0,2117,33
2020-08-18,Guinea-Bissau,0,0,2117,33
2020-08-19,Guinea-Bissau,0,0,2117,33
2020-08-20,Guinea-Bissau,32,0,2149,33
2020-08-21,Guinea-Bissau,0,0,2149,33
2020-08-22,Guinea-Bissau,0,0,2149,33
2020-08-23,Guinea-Bissau,0,0,2149,33
2020-08-24,Guinea-Bissau,0,0,2149,33
2020-08-25,Guinea-Bissau,0,0,2149,33
2020-08-26,Guinea-Bissau,56,1,2205,34
2020-08-27,Guinea-Bissau,0,0,2205,34
2020-08-28,Guinea-Bissau,0,0,2205,34
2020-08-29,Guinea-Bissau,0,0,2205,34
2020-08-30,Guinea-Bissau,0,0,2205,34
2020-08-31,Guinea-Bissau,0,0,2205,34
2020-09-01,Guinea-Bissau,0,0,2205,34
2020-09-02,Guinea-Bissau,0,0,2205,34
2020-09-03,Guinea-Bissau,0,0,2205,34
2020-09-04,Guinea-Bissau,40,4,2245,38
2020-09-05,Guinea-Bissau,0,0,2245,38
2020-09-06,Guinea-Bissau,0,0,2245,38
2020-09-07,Guinea-Bissau,0,0,2245,38
2020-09-08,Guinea-Bissau,0,0,2245,38
2020-09-09,Guinea-Bissau,0,0,2245,38
2020-09-10,Guinea-Bissau,30,1,2275,39
2020-09-11,Guinea-Bissau,0,0,2275,39
2020-09-12,Guinea-Bissau,0,0,2275,39
2020-09-13,Guinea-Bissau,0,0,2275,39
2020-09-14,Guinea-Bissau,0,0,2275,39
2020-09-15,Guinea-Bissau,0,0,2275,39
2020-09-16,Guinea-Bissau,0,0,2275,39
2020-09-17,Guinea-Bissau,0,0,2275,39
2020-09-18,Guinea-Bissau,28,0,2303,39
2020-09-19,Guinea-Bissau,0,0,2303,39
2020-09-20,Guinea-Bissau,0,0,2303,39
2020-09-21,Guinea-Bissau,0,0,2303,39
2020-09-22,Guinea-Bissau,21,0,2324,39
2020-09-23,Guinea-Bissau,0,0,2324,39
2020-09-24,Guinea-Bissau,0,0,2324,39
2020-09-25,Guinea-Bissau,0,0,2324,39
2020-09-26,Guinea-Bissau,0,0,2324,39
2020-09-27,Guinea-Bissau,0,0,2324,39
2020-09-28,Guinea-Bissau,0,0,2324,39
2020-09-29,Guinea-Bissau,0,0,2324,39
2020-09-30,Guinea-Bissau,0,0,2324,39
2020-10-01,Guinea-Bissau,0,0,2324,39
2020-10-02,Guinea-Bissau,38,0,2362,39
2020-10-03,Guinea-Bissau,0,0,2362,39
2020-10-04,Guinea-Bissau,0,0,2362,39
2020-10-05,Guinea-Bissau,23,1,2385,40
2020-10-06,Guinea-Bissau,0,0,2385,40
2020-10-07,Guinea-Bissau,0,0,2385,40
2020-10-08,Guinea-Bissau,0,0,2385,40
2020-10-09,Guinea-Bissau,0,0,2385,40
2020-10-10,Guinea-Bissau,0,0,2385,40
2020-10-11,Guinea-Bissau,0,0,2385,40
2020-10-12,Guinea-Bissau,4,1,2389,41
2020-10-13,Guinea-Bissau,0,0,2389,41
2020-10-14,Guinea-Bissau,0,0,2389,41
2020-10-15,Guinea-Bissau,0,0,2389,41
2020-10-16,Guinea-Bissau,0,0,2389,41
2020-10-17,Guinea-Bissau,0,0,2389,41
2020-10-18,Guinea-Bissau,0,0,2389,41
2020-10-19,Guinea-Bissau,14,0,2403,41
2020-10-20,Guinea-Bissau,0,0,2403,41
2020-10-21,Guinea-Bissau,0,0,2403,41
2020-10-22,Guinea-Bissau,0,0,2403,41
2020-10-23,Guinea-Bissau,0,0,2403,41
2020-10-24,Guinea-Bissau,0,0,2403,41
2020-10-25,Guinea-Bissau,0,0,2403,41
2020-10-26,Guinea-Bissau,0,0,2403,41
2020-10-27,Guinea-Bissau,0,0,2403,41
2020-10-28,Guinea-Bissau,0,0,2403,41
2020-10-29,Guinea-Bissau,0,0,2403,41
2020-10-30,Guinea-Bissau,0,0,2403,41
2020-10-31,Guinea-Bissau,10,0,2413,41
2020-11-01,Guinea-Bissau,0,0,2413,41
2020-11-02,Guinea-Bissau,0,0,2413,41
2020-11-03,Guinea-Bissau,0,0,2413,41
2020-11-04,Guinea-Bissau,1,1,2414,42
2020-11-05,Guinea-Bissau,0,0,2414,42
2020-11-06,Guinea-Bissau,0,0,2414,42
2020-11-07,Guinea-Bissau,0,0,2414,42
2020-11-08,Guinea-Bissau,0,0,2414,42
2020-11-09,Guinea-Bissau,5,1,2419,43
2020-11-10,Guinea-Bissau,0,0,2419,43
2020-11-11,Guinea-Bissau,0,0,2419,43
2020-11-12,Guinea-Bissau,0,0,2419,43
2020-11-13,Guinea-Bissau,0,0,2419,43
2020-11-14,Guinea-Bissau,0,0,2419,43
2020-11-15,Guinea-Bissau,0,0,2419,43
2020-11-16,Guinea-Bissau,0,0,2419,43
2020-11-17,Guinea-Bissau,0,0,2419,43
2020-11-18,Guinea-Bissau,2,0,2421,43
2020-11-19,Guinea-Bissau,0,0,2421,43
2020-11-20,Guinea-Bissau,0,0,2421,43
2020-11-21,Guinea-Bissau,0,0,2421,43
2020-11-22,Guinea-Bissau,0,0,2421,43
2020-11-23,Guinea-Bissau,1,0,2422,43
2020-11-24,Guinea-Bissau,0,0,2422,43
2020-11-25,Guinea-Bissau,0,0,2422,43
2020-11-26,Guinea-Bissau,0,0,2422,43
2020-11-27,Guinea-Bissau,0,0,2422,43
2020-11-28,Guinea-Bissau,0,0,2422,43
2020-11-29,Guinea-Bissau,0,0,2422,43
2020-11-30,Guinea-Bissau,19,1,2441,44
2020-12-01,Guinea-Bissau,0,0,2441,44
2020-12-02,Guinea-Bissau,0,0,2441,44
2020-12-03,Guinea-Bissau,0,0,2441,44
2020-12-04,Guinea-Bissau,0,0,2441,44
2020-12-05,Guinea-Bissau,0,0,2441,44
2020-12-06,Guinea-Bissau,0,0,2441,44
2020-12-07,Guinea-Bissau,3,0,2444,44
2020-12-08,Guinea-Bissau,0,0,2444,44
2020-12-09,Guinea-Bissau,0,0,2444,44
2020-12-10,Guinea-Bissau,0,0,2444,44
2020-12-11,Guinea-Bissau,0,0,2444,44
2020-12-12,Guinea-Bissau,0,0,2444,44
2020-12-13,Guinea-Bissau,0,0,2444,44
2020-12-14,Guinea-Bissau,0,0,2444,44
2020-12-15,Guinea-Bissau,3,0,2447,44
2020-12-16,Guinea-Bissau,0,0,2447,44
2020-12-17,Guinea-Bissau,0,0,2447,44
2020-12-18,Guinea-Bissau,0,0,2447,44
2020-12-19,Guinea-Bissau,0,0,2447,44
2020-12-20,Guinea-Bissau,0,0,2447,44
2020-12-21,Guinea-Bissau,0,0,2447,44
2020-12-22,Guinea-Bissau,0,1,2447,45
2020-12-23,Guinea-Bissau,0,0,2447,45
2020-12-24,Guinea-Bissau,0,0,2447,45
2020-12-25,Guinea-Bissau,0,0,2447,45
2020-12-26,Guinea-Bissau,0,0,2447,45
2020-12-27,Guinea-Bissau,0,0,2447,45
2020-12-28,Guinea-Bissau,0,0,2447,45
2020-12-29,Guinea-Bissau,5,0,2452,45
2020-12-30,Guinea-Bissau,0,0,2452,45
2020-12-31,Guinea-Bissau,0,0,2452,45
2021-01-01,Guinea-Bissau,0,0,2452,45
2021-01-02,Guinea-Bissau,0,0,2452,45
2021-01-03,Guinea-Bissau,3,0,2455,45
2021-01-04,Guinea-Bissau,0,0,2455,45
2021-01-05,Guinea-Bissau,0,0,2455,45
2021-01-06,Guinea-Bissau,0,0,2455,45
2021-01-07,Guinea-Bissau,0,0,2455,45
2021-01-08,Guinea-Bissau,0,0,2455,45
2021-01-09,Guinea-Bissau,0,0,2455,45
2021-01-10,Guinea-Bissau,23,0,2478,45
2021-01-11,Guinea-Bissau,0,0,2478,45
2021-01-12,Guinea-Bissau,0,0,2478,45
2021-01-13,Guinea-Bissau,0,0,2478,45
2021-01-14,Guinea-Bissau,0,0,2478,45
2021-01-15,Guinea-Bissau,0,0,2478,45
2021-01-16,Guinea-Bissau,0,0,2478,45
2021-01-17,Guinea-Bissau,31,0,2509,45
2021-01-18,Guinea-Bissau,0,0,2509,45
2021-01-19,Guinea-Bissau,1,0,2510,45
2021-01-20,Guinea-Bissau,0,0,2510,45
2021-01-21,Guinea-Bissau,0,0,2510,45
2021-01-22,Guinea-Bissau,0,0,2510,45
2021-01-23,Guinea-Bissau,0,0,2510,45
2021-01-24,Guinea-Bissau,22,0,2532,45
2021-01-25,Guinea-Bissau,0,0,2532,45
2021-01-26,Guinea-Bissau,0,0,2532,45
2021-01-27,Guinea-Bissau,0,0,2532,45
2021-01-28,Guinea-Bissau,0,0,2532,45
2021-01-29,Guinea-Bissau,0,0,2532,45
2021-01-30,Guinea-Bissau,0,0,2532,45
2021-01-31,Guinea-Bissau,102,0,2634,45
2021-02-01,Guinea-Bissau,0,0,2634,45
2021-02-02,Guinea-Bissau,0,0,2634,45
2021-02-03,Guinea-Bissau,28,0,2662,45
2021-02-04,Guinea-Bissau,0,1,2662,46
2021-02-05,Guinea-Bissau,90,0,2752,46
2021-02-06,Guinea-Bissau,20,0,2772,46
2021-02-07,Guinea-Bissau,8,0,2780,46
2021-02-08,Guinea-Bissau,0,0,2780,46
2021-02-09,Guinea-Bissau,30,0,2810,46
2021-02-10,Guinea-Bissau,16,0,2826,46
2021-02-11,Guinea-Bissau,22,0,2848,46
2021-02-12,Guinea-Bissau,21,0,2869,46
2021-02-13,Guinea-Bissau,16,0,2885,46
2021-02-14,Guinea-Bissau,39,0,2924,46
2021-02-15,Guinea-Bissau,0,0,2924,46
2021-02-16,Guinea-Bissau,26,0,2950,46
2021-02-17,Guinea-Bissau,49,0,2999,46
2021-02-18,Guinea-Bissau,26,0,3025,46
2021-02-19,Guinea-Bissau,39,0,3064,46
2021-02-20,Guinea-Bissau,27,0,3091,46
2021-02-21,Guinea-Bissau,24,1,3115,47
2021-02-22,Guinea-Bissau,0,0,3115,47
2021-02-23,Guinea-Bissau,41,0,3156,47
2021-02-24,Guinea-Bissau,15,1,3171,48
2021-02-25,Guinea-Bissau,44,0,3215,48
2021-02-26,Guinea-Bissau,26,0,3241,48
2021-02-27,Guinea-Bissau,6,0,3247,48
2021-02-28,Guinea-Bissau,15,0,3262,48
2021-03-01,Guinea-Bissau,0,0,3262,48
2021-03-02,Guinea-Bissau,9,0,3271,48
2021-03-03,Guinea-Bissau,11,0,3282,48
2021-03-04,Guinea-Bissau,19,1,3301,49
2021-03-05,Guinea-Bissau,2,0,3303,49
2021-03-06,Guinea-Bissau,9,0,3312,49
2021-03-07,Guinea-Bissau,0,0,3312,49
2021-03-08,Guinea-Bissau,0,0,3312,49
2021-03-09,Guinea-Bissau,7,0,3319,49
2021-03-10,Guinea-Bissau,8,2,3327,51
2021-03-11,Guinea-Bissau,53,0,3380,51
2021-03-12,Guinea-Bissau,18,1,3398,52
2021-03-13,Guinea-Bissau,38,0,3436,52
2021-03-14,Guinea-Bissau,11,0,3447,52
2021-03-15,Guinea-Bissau,0,0,3447,52
2021-03-16,Guinea-Bissau,22,0,3469,52
2021-03-17,Guinea-Bissau,19,2,3488,54
2021-03-18,Guinea-Bissau,30,0,3518,54
2021-03-19,Guinea-Bissau,18,1,3536,55
2021-03-20,Guinea-Bissau,22,0,3558,55
2021-03-21,Guinea-Bissau,10,0,3568,55
2021-03-22,Guinea-Bissau,0,0,3568,55
2021-03-23,Guinea-Bissau,18,1,3586,56
2021-03-24,Guinea-Bissau,5,0,3591,56
2021-03-25,Guinea-Bissau,16,5,3607,61
2021-03-26,Guinea-Bissau,8,0,3615,61
2021-03-27,Guinea-Bissau,15,0,3630,61
2021-03-28,Guinea-Bissau,4,0,3634,61
2021-03-29,Guinea-Bissau,0,0,3634,61
2021-03-30,Guinea-Bissau,13,0,3647,61
2021-03-31,Guinea-Bissau,3,2,3650,63
2021-04-01,Guinea-Bissau,11,0,3661,63
2021-04-02,Guinea-Bissau,0,2,3661,65
2021-04-03,Guinea-Bissau,0,0,3661,65
2021-04-04,Guinea-Bissau,1,1,3662,66
2021-04-05,Guinea-Bissau,0,0,3662,66
2021-04-06,Guinea-Bissau,0,0,3662,66
2021-04-07,Guinea-Bissau,1,0,3663,66
2021-04-08,Guinea-Bissau,1,0,3664,66
2020-03-12,Guyana,1,1,1,1
2020-03-13,Guyana,0,0,1,1
2020-03-14,Guyana,0,0,1,1
2020-03-15,Guyana,3,0,4,1
2020-03-16,Guyana,0,0,4,1
2020-03-17,Guyana,3,0,7,1
2020-03-18,Guyana,0,0,7,1
2020-03-19,Guyana,0,0,7,1
2020-03-20,Guyana,0,0,7,1
2020-03-21,Guyana,0,0,7,1
2020-03-22,Guyana,12,0,19,1
2020-03-23,Guyana,1,0,20,1
2020-03-24,Guyana,-15,0,5,1
2020-03-25,Guyana,0,0,5,1
2020-03-26,Guyana,0,0,5,1
2020-03-27,Guyana,0,0,5,1
2020-03-28,Guyana,3,0,8,1
2020-03-29,Guyana,0,0,8,1
2020-03-30,Guyana,0,0,8,1
2020-03-31,Guyana,4,1,12,2
2020-04-01,Guyana,7,0,19,2
2020-04-02,Guyana,0,2,19,4
2020-04-03,Guyana,4,0,23,4
2020-04-04,Guyana,0,0,23,4
2020-04-05,Guyana,1,0,24,4
2020-04-06,Guyana,7,0,31,4
2020-04-07,Guyana,2,1,33,5
2020-04-08,Guyana,4,1,37,6
2020-04-09,Guyana,0,0,37,6
2020-04-10,Guyana,0,0,37,6
2020-04-11,Guyana,8,0,45,6
2020-04-12,Guyana,0,0,45,6
2020-04-13,Guyana,0,0,45,6
2020-04-14,Guyana,2,0,47,6
2020-04-15,Guyana,8,0,55,6
2020-04-16,Guyana,0,0,55,6
2020-04-17,Guyana,8,0,63,6
2020-04-18,Guyana,0,0,63,6
2020-04-19,Guyana,2,1,65,7
2020-04-20,Guyana,0,0,65,7
2020-04-21,Guyana,1,0,66,7
2020-04-22,Guyana,1,0,67,7
2020-04-23,Guyana,3,0,70,7
2020-04-24,Guyana,3,0,73,7
2020-04-25,Guyana,0,0,73,7
2020-04-26,Guyana,1,1,74,8
2020-04-27,Guyana,0,0,74,8
2020-04-28,Guyana,0,0,74,8
2020-04-29,Guyana,4,0,78,8
2020-04-30,Guyana,4,1,82,9
2020-05-01,Guyana,0,0,82,9
2020-05-02,Guyana,0,0,82,9
2020-05-03,Guyana,0,0,82,9
2020-05-04,Guyana,10,0,92,9
2020-05-05,Guyana,1,1,93,10
2020-05-06,Guyana,0,0,93,10
2020-05-07,Guyana,0,0,93,10
2020-05-08,Guyana,1,0,94,10
2020-05-09,Guyana,0,0,94,10
2020-05-10,Guyana,10,0,104,10
2020-05-11,Guyana,5,0,109,10
2020-05-12,Guyana,4,0,113,10
2020-05-13,Guyana,0,0,113,10
2020-05-14,Guyana,0,0,113,10
2020-05-15,Guyana,3,0,116,10
2020-05-16,Guyana,1,0,117,10
2020-05-17,Guyana,0,0,117,10
2020-05-18,Guyana,7,0,124,10
2020-05-19,Guyana,1,0,125,10
2020-05-20,Guyana,0,0,125,10
2020-05-21,Guyana,2,0,127,10
2020-05-22,Guyana,0,0,127,10
2020-05-23,Guyana,0,0,127,10
2020-05-24,Guyana,8,0,135,10
2020-05-25,Guyana,2,1,137,11
2020-05-26,Guyana,2,0,139,11
2020-05-27,Guyana,0,0,139,11
2020-05-28,Guyana,11,0,150,11
2020-05-29,Guyana,0,0,150,11
2020-05-30,Guyana,2,1,152,12
2020-05-31,Guyana,1,0,153,12
2020-06-01,Guyana,0,0,153,12
2020-06-02,Guyana,0,0,153,12
2020-06-03,Guyana,0,0,153,12
2020-06-04,Guyana,0,0,153,12
2020-06-05,Guyana,0,0,153,12
2020-06-06,Guyana,1,0,154,12
2020-06-07,Guyana,0,0,154,12
2020-06-08,Guyana,0,0,154,12
2020-06-09,Guyana,2,0,156,12
2020-06-10,Guyana,0,0,156,12
2020-06-11,Guyana,2,0,158,12
2020-06-12,Guyana,1,0,159,12
2020-06-13,Guyana,0,0,159,12
2020-06-14,Guyana,0,0,159,12
2020-06-15,Guyana,0,0,159,12
2020-06-16,Guyana,12,0,171,12
2020-06-17,Guyana,0,0,171,12
2020-06-18,Guyana,12,0,183,12
2020-06-19,Guyana,0,0,183,12
2020-06-20,Guyana,0,0,183,12
2020-06-21,Guyana,1,0,184,12
2020-06-22,Guyana,21,0,205,12
2020-06-23,Guyana,1,0,206,12
2020-06-24,Guyana,3,0,209,12
2020-06-25,Guyana,6,0,215,12
2020-06-26,Guyana,0,0,215,12
2020-06-27,Guyana,15,0,230,12
2020-06-28,Guyana,0,0,230,12
2020-06-29,Guyana,5,0,235,12
2020-06-30,Guyana,10,0,245,12
2020-07-01,Guyana,3,1,248,13
2020-07-02,Guyana,2,1,250,14
2020-07-03,Guyana,6,0,256,14
2020-07-04,Guyana,16,0,272,14
2020-07-05,Guyana,1,1,273,15
2020-07-06,Guyana,0,0,273,15
2020-07-07,Guyana,11,1,284,16
2020-07-08,Guyana,0,0,284,16
2020-07-09,Guyana,2,0,286,16
2020-07-10,Guyana,4,0,290,16
2020-07-11,Guyana,1,1,291,17
2020-07-12,Guyana,6,0,297,17
2020-07-13,Guyana,3,0,300,17
2020-07-14,Guyana,8,0,308,17
2020-07-15,Guyana,5,1,313,18
2020-07-16,Guyana,2,1,315,19
2020-07-17,Guyana,5,0,320,19
2020-07-18,Guyana,7,0,327,19
2020-07-19,Guyana,9,0,336,19
2020-07-20,Guyana,1,0,337,19
2020-07-21,Guyana,2,0,339,19
2020-07-22,Guyana,11,0,350,19
2020-07-23,Guyana,1,0,351,19
2020-07-24,Guyana,1,1,352,20
2020-07-25,Guyana,8,0,360,20
2020-07-26,Guyana,10,0,370,20
2020-07-27,Guyana,19,0,389,20
2020-07-28,Guyana,7,0,396,20
2020-07-29,Guyana,2,0,398,20
2020-07-30,Guyana,3,0,401,20
2020-07-31,Guyana,12,0,413,20
2020-08-01,Guyana,17,0,430,20
2020-08-02,Guyana,44,1,474,21
2020-08-03,Guyana,0,0,474,21
2020-08-04,Guyana,23,1,497,22
2020-08-05,Guyana,12,0,509,22
2020-08-06,Guyana,29,0,538,22
2020-08-07,Guyana,0,0,538,22
2020-08-08,Guyana,16,0,554,22
2020-08-09,Guyana,14,0,568,22
2020-08-10,Guyana,0,0,568,22
2020-08-11,Guyana,34,0,602,22
2020-08-12,Guyana,21,0,623,22
2020-08-13,Guyana,8,0,631,22
2020-08-14,Guyana,18,0,649,22
2020-08-15,Guyana,25,0,674,22
2020-08-16,Guyana,35,1,709,23
2020-08-17,Guyana,0,0,709,23
2020-08-18,Guyana,28,2,737,25
2020-08-19,Guyana,39,2,776,27
2020-08-20,Guyana,70,2,846,29
2020-08-21,Guyana,35,1,881,30
2020-08-22,Guyana,44,1,925,31
2020-08-23,Guyana,30,0,955,31
2020-08-24,Guyana,74,0,1029,31
2020-08-25,Guyana,31,0,1060,31
2020-08-26,Guyana,33,0,1093,31
2020-08-27,Guyana,47,1,1140,32
2020-08-28,Guyana,40,3,1180,35
2020-08-29,Guyana,4,0,1184,35
2020-08-30,Guyana,50,1,1234,36
2020-08-31,Guyana,72,3,1306,39
2020-09-01,Guyana,67,2,1373,41
2020-09-02,Guyana,9,0,1382,41
2020-09-03,Guyana,19,3,1401,44
2020-09-04,Guyana,0,0,1401,44
2020-09-05,Guyana,58,2,1459,46
2020-09-06,Guyana,9,0,1468,46
2020-09-07,Guyana,92,1,1560,47
2020-09-08,Guyana,53,1,1613,48
2020-09-09,Guyana,90,0,1703,48
2020-09-10,Guyana,47,1,1750,49
2020-09-11,Guyana,13,3,1763,52
2020-09-12,Guyana,49,2,1812,54
2020-09-13,Guyana,41,2,1853,56
2020-09-14,Guyana,31,0,1884,56
2020-09-15,Guyana,74,2,1958,58
2020-09-16,Guyana,0,0,1958,58
2020-09-17,Guyana,69,2,2027,60
2020-09-18,Guyana,75,2,2102,62
2020-09-19,Guyana,66,2,2168,64
2020-09-20,Guyana,101,0,2269,64
2020-09-21,Guyana,133,1,2402,65
2020-09-22,Guyana,35,2,2437,67
2020-09-23,Guyana,98,2,2535,69
2020-09-24,Guyana,44,2,2579,71
2020-09-25,Guyana,130,2,2709,73
2020-09-26,Guyana,16,1,2725,74
2020-09-27,Guyana,47,2,2772,76
2020-09-28,Guyana,15,2,2787,78
2020-09-29,Guyana,59,0,2846,78
2020-09-30,Guyana,48,2,2894,80
2020-10-01,Guyana,35,2,2929,82
2020-10-02,Guyana,39,3,2968,85
2020-10-03,Guyana,0,0,2968,85
2020-10-04,Guyana,125,2,3093,87
2020-10-05,Guyana,95,3,3188,90
2020-10-06,Guyana,0,2,3188,92
2020-10-07,Guyana,104,3,3292,95
2020-10-08,Guyana,37,3,3329,98
2020-10-09,Guyana,29,2,3358,100
2020-10-10,Guyana,47,2,3405,102
2020-10-11,Guyana,64,1,3469,103
2020-10-12,Guyana,52,1,3521,104
2020-10-13,Guyana,44,2,3565,106
2020-10-14,Guyana,24,0,3589,106
2020-10-15,Guyana,31,1,3620,107
2020-10-16,Guyana,52,0,3672,107
2020-10-17,Guyana,38,2,3710,109
2020-10-18,Guyana,24,0,3734,109
2020-10-19,Guyana,31,2,3765,111
2020-10-20,Guyana,31,3,3796,114
2020-10-21,Guyana,54,2,3850,116
2020-10-22,Guyana,27,1,3877,117
2020-10-23,Guyana,83,0,3960,117
2020-10-24,Guyana,34,0,3994,117
2020-10-25,Guyana,29,2,4023,119
2020-10-26,Guyana,3,0,4026,119
2020-10-27,Guyana,35,0,4061,119
2020-10-28,Guyana,13,4,4074,123
2020-10-29,Guyana,24,0,4098,123
2020-10-30,Guyana,45,1,4143,124
2020-10-31,Guyana,19,0,4162,124
2020-11-01,Guyana,46,2,4208,126
2020-11-02,Guyana,30,2,4238,128
2020-11-03,Guyana,7,0,4245,128
2020-11-04,Guyana,79,2,4324,130
2020-11-05,Guyana,69,0,4393,130
2020-11-06,Guyana,64,3,4457,133
2020-11-07,Guyana,27,1,4484,134
2020-11-08,Guyana,30,0,4514,134
2020-11-09,Guyana,10,1,4524,135
2020-11-10,Guyana,6,0,4530,135
2020-11-11,Guyana,88,2,4618,137
2020-11-12,Guyana,44,1,4662,138
2020-11-13,Guyana,62,0,4724,138
2020-11-14,Guyana,70,0,4794,138
2020-11-15,Guyana,29,1,4823,139
2020-11-16,Guyana,51,0,4874,139
2020-11-17,Guyana,16,1,4890,140
2020-11-18,Guyana,24,2,4914,142
2020-11-19,Guyana,62,1,4976,143
2020-11-20,Guyana,29,0,5005,143
2020-11-21,Guyana,88,0,5093,143
2020-11-22,Guyana,40,0,5133,143
2020-11-23,Guyana,21,3,5154,146
2020-11-24,Guyana,35,1,5189,147
2020-11-25,Guyana,47,0,5236,147
2020-11-26,Guyana,40,2,5276,149
2020-11-27,Guyana,34,0,5310,149
2020-11-28,Guyana,28,0,5338,149
2020-11-29,Guyana,38,1,5376,150
2020-11-30,Guyana,30,1,5406,151
2020-12-01,Guyana,17,0,5423,151
2020-12-02,Guyana,26,0,5449,151
2020-12-03,Guyana,79,0,5528,151
2020-12-04,Guyana,73,0,5601,151
2020-12-05,Guyana,36,0,5637,151
2020-12-06,Guyana,28,2,5665,153
2020-12-07,Guyana,32,1,5697,154
2020-12-08,Guyana,3,0,5700,154
2020-12-09,Guyana,32,0,5732,154
2020-12-10,Guyana,79,0,5811,154
2020-12-11,Guyana,28,0,5839,154
2020-12-12,Guyana,40,0,5879,154
2020-12-13,Guyana,41,1,5920,155
2020-12-14,Guyana,23,1,5943,156
2020-12-15,Guyana,30,0,5973,156
2020-12-16,Guyana,43,2,6016,158
2020-12-17,Guyana,26,0,6042,158
2020-12-18,Guyana,34,1,6076,159
2020-12-19,Guyana,29,0,6105,159
2020-12-20,Guyana,20,0,6125,159
2020-12-21,Guyana,46,0,6171,159
2020-12-22,Guyana,45,1,6216,160
2020-12-23,Guyana,42,2,6258,162
2020-12-24,Guyana,8,0,6266,162
2020-12-25,Guyana,23,0,6289,162
2020-12-26,Guyana,0,0,6289,162
2020-12-27,Guyana,4,2,6293,164
2020-12-28,Guyana,5,0,6298,164
2020-12-29,Guyana,3,0,6301,164
2020-12-30,Guyana,18,0,6319,164
2020-12-31,Guyana,13,0,6332,164
2021-01-01,Guyana,16,0,6348,164
2021-01-02,Guyana,3,0,6351,164
2021-01-03,Guyana,7,0,6358,164
2021-01-04,Guyana,21,2,6379,166
2021-01-05,Guyana,28,0,6407,166
2021-01-06,Guyana,0,0,6407,166
2021-01-07,Guyana,62,1,6469,167
2021-01-08,Guyana,0,0,6469,167
2021-01-09,Guyana,72,0,6541,167
2021-01-10,Guyana,33,2,6574,169
2021-01-11,Guyana,14,1,6588,170
2021-01-12,Guyana,65,0,6653,170
2021-01-13,Guyana,43,0,6696,170
2021-01-14,Guyana,49,0,6745,170
2021-01-15,Guyana,60,0,6805,170
2021-01-16,Guyana,46,0,6851,170
2021-01-17,Guyana,57,0,6908,170
2021-01-18,Guyana,23,0,6931,170
2021-01-19,Guyana,19,0,6950,170
2021-01-20,Guyana,65,0,7015,170
2021-01-21,Guyana,52,0,7067,170
2021-01-22,Guyana,76,0,7143,170
2021-01-23,Guyana,79,0,7222,170
2021-01-24,Guyana,76,2,7298,172
2021-01-25,Guyana,19,0,7317,172
2021-01-26,Guyana,29,0,7346,172
2021-01-27,Guyana,34,2,7380,174
2021-01-28,Guyana,90,1,7470,175
2021-01-29,Guyana,58,0,7528,175
2021-01-30,Guyana,53,1,7581,176
2021-01-31,Guyana,60,0,7641,176
2021-02-01,Guyana,13,1,7654,177
2021-02-02,Guyana,24,0,7678,177
2021-02-03,Guyana,36,0,7714,177
2021-02-04,Guyana,66,0,7780,177
2021-02-05,Guyana,107,2,7887,179
2021-02-06,Guyana,52,1,7939,180
2021-02-07,Guyana,43,0,7982,180
2021-02-08,Guyana,41,1,8023,181
2021-02-09,Guyana,18,0,8041,181
2021-02-10,Guyana,51,1,8092,182
2021-02-11,Guyana,43,2,8135,184
2021-02-12,Guyana,46,2,8181,186
2021-02-13,Guyana,26,0,8207,186
2021-02-14,Guyana,24,0,8231,186
2021-02-15,Guyana,1,0,8232,186
2021-02-16,Guyana,30,2,8262,188
2021-02-17,Guyana,51,1,8313,189
2021-02-18,Guyana,25,0,8338,189
2021-02-19,Guyana,19,0,8357,189
2021-02-20,Guyana,42,0,8399,189
2021-02-21,Guyana,21,0,8420,189
2021-02-22,Guyana,7,0,8427,189
2021-02-23,Guyana,25,1,8452,190
2021-02-24,Guyana,5,2,8457,192
2021-02-25,Guyana,28,3,8485,195
2021-02-26,Guyana,28,0,8513,195
2021-02-27,Guyana,37,0,8550,195
2021-02-28,Guyana,35,0,8585,195
2021-03-01,Guyana,10,2,8595,197
2021-03-02,Guyana,31,0,8626,197
2021-03-03,Guyana,22,2,8648,199
2021-03-04,Guyana,51,0,8699,199
2021-03-05,Guyana,30,1,8729,200
2021-03-06,Guyana,43,0,8772,200
2021-03-07,Guyana,35,1,8807,201
2021-03-08,Guyana,7,2,8814,203
2021-03-09,Guyana,33,1,8847,204
2021-03-10,Guyana,81,1,8928,205
2021-03-11,Guyana,65,1,8993,206
2021-03-12,Guyana,76,0,9069,206
2021-03-13,Guyana,52,0,9121,206
2021-03-14,Guyana,39,1,9160,207
2021-03-15,Guyana,27,0,9187,207
2021-03-16,Guyana,51,1,9238,208
2021-03-17,Guyana,84,1,9322,209
2021-03-18,Guyana,120,3,9442,212
2021-03-19,Guyana,44,0,9486,212
2021-03-20,Guyana,99,2,9585,214
2021-03-21,Guyana,64,1,9649,215
2021-03-22,Guyana,19,1,9668,216
2021-03-23,Guyana,64,2,9732,218
2021-03-24,Guyana,88,2,9820,220
2021-03-25,Guyana,78,3,9898,223
2021-03-26,Guyana,109,2,10007,225
2021-03-27,Guyana,65,0,10072,225
2021-03-28,Guyana,96,2,10168,227
2021-03-29,Guyana,14,2,10182,229
2021-03-30,Guyana,10,2,10192,231
2021-03-31,Guyana,57,0,10249,231
2021-04-01,Guyana,126,2,10375,233
2021-04-02,Guyana,71,2,10446,235
2021-04-03,Guyana,94,2,10540,237
2021-04-04,Guyana,40,6,10580,243
2021-04-05,Guyana,26,3,10606,246
2021-04-06,Guyana,31,1,10637,247
2021-04-07,Guyana,81,3,10718,250
2021-04-08,Guyana,135,2,10853,252
2020-03-20,Haiti,2,0,2,0
2020-03-21,Haiti,0,0,2,0
2020-03-22,Haiti,0,0,2,0
2020-03-23,Haiti,0,0,2,0
2020-03-24,Haiti,5,0,7,0
2020-03-25,Haiti,0,0,7,0
2020-03-26,Haiti,1,0,8,0
2020-03-27,Haiti,0,0,8,0
2020-03-28,Haiti,0,0,8,0
2020-03-29,Haiti,0,0,8,0
2020-03-30,Haiti,7,0,15,0
2020-03-31,Haiti,0,0,15,0
2020-04-01,Haiti,0,0,15,0
2020-04-02,Haiti,1,0,16,0
2020-04-03,Haiti,0,0,16,0
2020-04-04,Haiti,2,0,18,0
2020-04-05,Haiti,0,0,18,0
2020-04-06,Haiti,3,0,21,0
2020-04-07,Haiti,3,1,24,1
2020-04-08,Haiti,1,0,25,1
2020-04-09,Haiti,2,0,27,1
2020-04-10,Haiti,3,1,30,2
2020-04-11,Haiti,0,0,30,2
2020-04-12,Haiti,1,0,31,2
2020-04-13,Haiti,0,0,31,2
2020-04-14,Haiti,9,1,40,3
2020-04-15,Haiti,0,0,40,3
2020-04-16,Haiti,1,0,41,3
2020-04-17,Haiti,0,0,41,3
2020-04-18,Haiti,2,0,43,3
2020-04-19,Haiti,1,0,44,3
2020-04-20,Haiti,0,0,44,3
2020-04-21,Haiti,3,0,47,3
2020-04-22,Haiti,10,0,57,3
2020-04-23,Haiti,1,1,58,4
2020-04-24,Haiti,4,-1,62,3
2020-04-25,Haiti,10,2,72,5
2020-04-26,Haiti,0,1,72,6
2020-04-27,Haiti,0,0,72,6
2020-04-28,Haiti,2,0,74,6
2020-04-29,Haiti,2,0,76,6
2020-04-30,Haiti,0,0,76,6
2020-05-01,Haiti,0,1,76,7
2020-05-02,Haiti,5,1,81,8
2020-05-03,Haiti,4,0,85,8
2020-05-04,Haiti,0,0,85,8
2020-05-05,Haiti,3,1,88,9
2020-05-06,Haiti,12,2,100,11
2020-05-07,Haiti,1,1,101,12
2020-05-08,Haiti,7,0,108,12
2020-05-09,Haiti,21,0,129,12
2020-05-10,Haiti,17,0,146,12
2020-05-11,Haiti,5,0,151,12
2020-05-12,Haiti,21,1,172,13
2020-05-13,Haiti,37,3,209,16
2020-05-14,Haiti,10,2,219,18
2020-05-15,Haiti,15,0,234,18
2020-05-16,Haiti,39,2,273,20
2020-05-17,Haiti,37,0,310,20
2020-05-18,Haiti,48,0,358,20
2020-05-19,Haiti,98,0,456,20
2020-05-20,Haiti,77,1,533,21
2020-05-21,Haiti,63,1,596,22
2020-05-22,Haiti,67,0,663,22
2020-05-23,Haiti,71,3,734,25
2020-05-24,Haiti,78,0,812,25
2020-05-25,Haiti,53,1,865,26
2020-05-26,Haiti,93,1,958,27
2020-05-27,Haiti,105,4,1063,31
2020-05-28,Haiti,111,2,1174,33
2020-05-29,Haiti,146,1,1320,34
2020-05-30,Haiti,123,1,1443,35
2020-05-31,Haiti,141,0,1584,35
2020-06-01,Haiti,281,6,1865,41
2020-06-02,Haiti,259,3,2124,44
2020-06-03,Haiti,102,1,2226,45
2020-06-04,Haiti,281,3,2507,48
2020-06-05,Haiti,97,2,2604,50
2020-06-06,Haiti,36,0,2640,50
2020-06-07,Haiti,284,0,2924,50
2020-06-08,Haiti,148,0,3072,50
2020-06-09,Haiti,262,1,3334,51
2020-06-10,Haiti,204,3,3538,54
2020-06-11,Haiti,124,2,3662,56
2020-06-12,Haiti,134,2,3796,58
2020-06-13,Haiti,145,6,3941,64
2020-06-14,Haiti,0,0,3941,64
2020-06-15,Haiti,224,6,4165,70
2020-06-16,Haiti,144,3,4309,73
2020-06-17,Haiti,132,3,4441,76
2020-06-18,Haiti,106,4,4547,80
2020-06-19,Haiti,141,2,4688,82
2020-06-20,Haiti,228,2,4916,84
2020-06-21,Haiti,64,3,4980,87
2020-06-22,Haiti,97,1,5077,88
2020-06-23,Haiti,134,0,5211,88
2020-06-24,Haiti,5,0,5216,88
2020-06-25,Haiti,108,1,5324,89
2020-06-26,Haiti,105,3,5429,92
2020-06-27,Haiti,114,4,5543,96
2020-06-28,Haiti,179,2,5722,98
2020-06-29,Haiti,0,0,5722,98
2020-06-30,Haiti,125,6,5847,104
2020-07-01,Haiti,86,1,5933,105
2020-07-02,Haiti,42,0,5975,105
2020-07-03,Haiti,65,2,6040,107
2020-07-04,Haiti,61,3,6101,110
2020-07-05,Haiti,129,0,6230,110
2020-07-06,Haiti,64,3,6294,113
2020-07-07,Haiti,39,0,6333,113
2020-07-08,Haiti,38,0,6371,113
2020-07-09,Haiti,61,4,6432,117
2020-07-10,Haiti,54,6,6486,123
2020-07-11,Haiti,96,7,6582,130
2020-07-12,Haiti,35,5,6617,135
2020-07-13,Haiti,73,4,6690,139
2020-07-14,Haiti,37,0,6727,139
2020-07-15,Haiti,0,2,6727,141
2020-07-16,Haiti,104,2,6831,143
2020-07-17,Haiti,71,2,6902,145
2020-07-18,Haiti,46,0,6948,145
2020-07-19,Haiti,27,1,6975,146
2020-07-20,Haiti,78,0,7053,146
2020-07-21,Haiti,10,0,7063,146
2020-07-22,Haiti,37,5,7100,151
2020-07-23,Haiti,46,3,7146,154
2020-07-24,Haiti,21,0,7167,154
2020-07-25,Haiti,30,0,7197,154
2020-07-26,Haiti,63,2,7260,156
2020-07-27,Haiti,37,1,7297,157
2020-07-28,Haiti,18,0,7315,157
2020-07-29,Haiti,25,1,7340,158
2020-07-30,Haiti,31,0,7371,158
2020-07-31,Haiti,7,1,7378,159
2020-08-01,Haiti,34,2,7412,161
2020-08-02,Haiti,12,0,7424,161
2020-08-03,Haiti,44,4,7468,165
2020-08-04,Haiti,8,0,7476,165
2020-08-05,Haiti,35,1,7511,166
2020-08-06,Haiti,21,5,7532,171
2020-08-07,Haiti,12,0,7544,171
2020-08-08,Haiti,38,0,7582,171
2020-08-09,Haiti,17,6,7599,177
2020-08-10,Haiti,12,5,7611,182
2020-08-11,Haiti,23,1,7634,183
2020-08-12,Haiti,15,0,7649,183
2020-08-13,Haiti,94,4,7743,187
2020-08-14,Haiti,38,5,7781,192
2020-08-15,Haiti,29,0,7810,192
2020-08-16,Haiti,21,4,7831,196
2020-08-17,Haiti,48,0,7879,196
2020-08-18,Haiti,18,0,7897,196
2020-08-19,Haiti,24,0,7921,196
2020-08-20,Haiti,28,0,7949,196
2020-08-21,Haiti,48,0,7997,196
2020-08-22,Haiti,19,0,8016,196
2020-08-23,Haiti,34,0,8050,196
2020-08-24,Haiti,32,0,8082,196
2020-08-25,Haiti,28,0,8110,196
2020-08-26,Haiti,2,0,8112,196
2020-08-27,Haiti,10,1,8122,197
2020-08-28,Haiti,29,3,8151,200
2020-08-29,Haiti,10,1,8161,201
2020-08-30,Haiti,13,0,8174,201
2020-08-31,Haiti,35,0,8209,201
2020-09-01,Haiti,15,0,8224,201
2020-09-02,Haiti,0,0,8224,201
2020-09-03,Haiti,34,5,8258,206
2020-09-04,Haiti,0,0,8258,206
2020-09-05,Haiti,68,6,8326,212
2020-09-06,Haiti,0,0,8326,212
2020-09-07,Haiti,34,2,8360,214
2020-09-08,Haiti,0,0,8360,214
2020-09-09,Haiti,2,0,8362,214
2020-09-10,Haiti,14,0,8376,214
2020-09-11,Haiti,53,1,8429,215
2020-09-12,Haiti,28,1,8457,216
2020-09-13,Haiti,0,0,8457,216
2020-09-14,Haiti,21,3,8478,219
2020-09-15,Haiti,15,0,8493,219
2020-09-16,Haiti,6,0,8499,219
2020-09-17,Haiti,31,1,8530,220
2020-09-18,Haiti,26,0,8556,220
2020-09-19,Haiti,0,0,8556,220
2020-09-20,Haiti,44,1,8600,221
2020-09-21,Haiti,0,0,8600,221
2020-09-22,Haiti,24,0,8624,221
2020-09-23,Haiti,0,0,8624,221
2020-09-24,Haiti,22,4,8646,225
2020-09-25,Haiti,0,0,8646,225
2020-09-26,Haiti,38,2,8684,227
2020-09-27,Haiti,0,0,8684,227
2020-09-28,Haiti,39,0,8723,227
2020-09-29,Haiti,17,0,8740,227
2020-09-30,Haiti,0,0,8740,227
2020-10-01,Haiti,26,2,8766,229
2020-10-02,Haiti,0,0,8766,229
2020-10-03,Haiti,26,0,8792,229
2020-10-04,Haiti,0,0,8792,229
2020-10-05,Haiti,27,0,8819,229
2020-10-06,Haiti,0,0,8819,229
2020-10-07,Haiti,0,0,8819,229
2020-10-08,Haiti,19,0,8838,229
2020-10-09,Haiti,16,1,8854,230
2020-10-10,Haiti,0,0,8854,230
2020-10-11,Haiti,6,0,8860,230
2020-10-12,Haiti,22,0,8882,230
2020-10-13,Haiti,0,0,8882,230
2020-10-14,Haiti,5,0,8887,230
2020-10-15,Haiti,21,1,8908,231
2020-10-16,Haiti,0,0,8908,231
2020-10-17,Haiti,17,0,8925,231
2020-10-18,Haiti,0,0,8925,231
2020-10-19,Haiti,0,0,8925,231
2020-10-20,Haiti,0,0,8925,231
2020-10-21,Haiti,51,0,8976,231
2020-10-22,Haiti,3,0,8979,231
2020-10-23,Haiti,0,0,8979,231
2020-10-24,Haiti,20,0,8999,231
2020-10-25,Haiti,16,0,9015,231
2020-10-26,Haiti,11,1,9026,232
2020-10-27,Haiti,0,0,9026,232
2020-10-28,Haiti,0,0,9026,232
2020-10-29,Haiti,20,0,9046,232
2020-10-30,Haiti,8,0,9054,232
2020-10-31,Haiti,0,0,9054,232
2020-11-01,Haiti,0,0,9054,232
2020-11-02,Haiti,0,0,9054,232
2020-11-03,Haiti,0,0,9054,232
2020-11-04,Haiti,0,0,9054,232
2020-11-05,Haiti,46,0,9100,232
2020-11-06,Haiti,9,0,9109,232
2020-11-07,Haiti,0,0,9109,232
2020-11-08,Haiti,18,0,9127,232
2020-11-09,Haiti,0,0,9127,232
2020-11-10,Haiti,0,0,9127,232
2020-11-11,Haiti,10,0,9137,232
2020-11-12,Haiti,15,0,9152,232
2020-11-13,Haiti,0,0,9152,232
2020-11-14,Haiti,16,0,9168,232
2020-11-15,Haiti,0,0,9168,232
2020-11-16,Haiti,11,0,9179,232
2020-11-17,Haiti,9,0,9188,232
2020-11-18,Haiti,3,0,9191,232
2020-11-19,Haiti,0,0,9191,232
2020-11-20,Haiti,17,0,9208,232
2020-11-21,Haiti,3,0,9211,232
2020-11-22,Haiti,3,0,9214,232
2020-11-23,Haiti,0,0,9214,232
2020-11-24,Haiti,10,0,9224,232
2020-11-25,Haiti,5,0,9229,232
2020-11-26,Haiti,19,0,9248,232
2020-11-27,Haiti,8,0,9256,232
2020-11-28,Haiti,8,0,9264,232
2020-11-29,Haiti,0,0,9264,232
2020-11-30,Haiti,8,0,9272,232
2020-12-01,Haiti,22,1,9294,233
2020-12-02,Haiti,2,0,9296,233
2020-12-03,Haiti,7,0,9303,233
2020-12-04,Haiti,10,0,9313,233
2020-12-05,Haiti,34,0,9347,233
2020-12-06,Haiti,23,0,9370,233
2020-12-07,Haiti,0,0,9370,233
2020-12-08,Haiti,29,0,9399,233
2020-12-09,Haiti,0,0,9399,233
2020-12-10,Haiti,35,0,9434,233
2020-12-11,Haiti,0,0,9434,233
2020-12-12,Haiti,31,0,9465,233
2020-12-13,Haiti,26,0,9491,233
2020-12-14,Haiti,18,1,9509,234
2020-12-15,Haiti,56,0,9565,234
2020-12-16,Haiti,32,0,9597,234
2020-12-17,Haiti,0,0,9597,234
2020-12-18,Haiti,30,0,9627,234
2020-12-19,Haiti,21,0,9648,234
2020-12-20,Haiti,26,0,9674,234
2020-12-21,Haiti,0,0,9674,234
2020-12-22,Haiti,97,0,9771,234
2020-12-23,Haiti,34,1,9805,235
2020-12-24,Haiti,41,0,9846,235
2020-12-25,Haiti,0,0,9846,235
2020-12-26,Haiti,0,0,9846,235
2020-12-27,Haiti,0,0,9846,235
2020-12-28,Haiti,112,1,9958,236
2020-12-29,Haiti,0,0,9958,236
2020-12-30,Haiti,41,0,9999,236
2020-12-31,Haiti,0,0,9999,236
2021-01-01,Haiti,16,0,10015,236
2021-01-02,Haiti,0,0,10015,236
2021-01-03,Haiti,62,0,10077,236
2021-01-04,Haiti,50,0,10127,236
2021-01-05,Haiti,0,0,10127,236
2021-01-06,Haiti,0,0,10127,236
2021-01-07,Haiti,0,0,10127,236
2021-01-08,Haiti,76,0,10203,236
2021-01-09,Haiti,38,1,10241,237
2021-01-10,Haiti,0,0,10241,237
2021-01-11,Haiti,31,1,10272,238
2021-01-12,Haiti,0,0,10272,238
2021-01-13,Haiti,114,0,10386,238
2021-01-14,Haiti,29,0,10415,238
2021-01-15,Haiti,154,0,10569,238
2021-01-16,Haiti,66,0,10635,238
2021-01-17,Haiti,146,2,10781,240
2021-01-18,Haiti,0,0,10781,240
2021-01-19,Haiti,71,0,10852,240
2021-01-20,Haiti,55,0,10907,240
2021-01-21,Haiti,56,0,10963,240
2021-01-22,Haiti,0,0,10963,240
2021-01-23,Haiti,72,3,11035,243
2021-01-24,Haiti,64,0,11099,243
2021-01-25,Haiti,0,0,11099,243
2021-01-26,Haiti,187,0,11286,243
2021-01-27,Haiti,0,0,11286,243
2021-01-28,Haiti,0,0,11286,243
2021-01-29,Haiti,116,1,11402,244
2021-01-30,Haiti,58,1,11460,245
2021-01-31,Haiti,73,0,11533,245
2021-02-01,Haiti,0,0,11533,245
2021-02-02,Haiti,57,0,11590,245
2021-02-03,Haiti,82,0,11672,245
2021-02-04,Haiti,20,0,11692,245
2021-02-05,Haiti,0,0,11692,245
2021-02-06,Haiti,66,0,11758,245
2021-02-07,Haiti,48,1,11806,246
2021-02-08,Haiti,0,0,11806,246
2021-02-09,Haiti,102,0,11908,246
2021-02-10,Haiti,61,0,11969,246
2021-02-11,Haiti,22,0,11991,246
2021-02-12,Haiti,25,0,12016,246
2021-02-13,Haiti,0,0,12016,246
2021-02-14,Haiti,127,1,12143,247
2021-02-15,Haiti,0,0,12143,247
2021-02-16,Haiti,49,0,12192,247
2021-02-17,Haiti,14,0,12206,247
2021-02-18,Haiti,0,0,12206,247
2021-02-19,Haiti,0,0,12206,247
2021-02-20,Haiti,48,0,12254,247
2021-02-21,Haiti,20,0,12274,247
2021-02-22,Haiti,35,0,12309,247
2021-02-23,Haiti,0,0,12309,247
2021-02-24,Haiti,43,0,12352,247
2021-02-25,Haiti,0,0,12352,247
2021-02-26,Haiti,0,0,12352,247
2021-02-27,Haiti,78,3,12430,250
2021-02-28,Haiti,0,0,12430,250
2021-03-01,Haiti,18,0,12448,250
2021-03-02,Haiti,45,0,12493,250
2021-03-03,Haiti,38,0,12531,250
2021-03-04,Haiti,5,0,12536,250
2021-03-05,Haiti,0,0,12536,250
2021-03-06,Haiti,0,1,12536,251
2021-03-07,Haiti,0,0,12536,251
2021-03-08,Haiti,0,0,12536,251
2021-03-09,Haiti,0,0,12536,251
2021-03-10,Haiti,58,0,12594,251
2021-03-11,Haiti,0,0,12594,251
2021-03-12,Haiti,38,0,12632,251
2021-03-13,Haiti,0,-1,12632,250
2021-03-14,Haiti,0,0,12632,250
2021-03-15,Haiti,0,0,12632,250
2021-03-16,Haiti,32,0,12664,250
2021-03-17,Haiti,5,0,12669,250
2021-03-18,Haiti,17,1,12686,251
2021-03-19,Haiti,2,0,12688,251
2021-03-20,Haiti,12,0,12700,251
2021-03-21,Haiti,14,0,12714,251
2021-03-22,Haiti,0,0,12714,251
2021-03-23,Haiti,8,0,12722,251
2021-03-24,Haiti,10,0,12732,251
2021-03-25,Haiti,0,0,12732,251
2021-03-26,Haiti,4,0,12736,251
2021-03-27,Haiti,0,0,12736,251
2021-03-28,Haiti,0,1,12736,252
2021-03-29,Haiti,0,0,12736,252
2021-03-30,Haiti,22,-1,12758,251
2021-03-31,Haiti,0,1,12758,252
2021-04-01,Haiti,4,0,12762,252
2021-04-02,Haiti,26,0,12788,252
2021-04-03,Haiti,0,0,12788,252
2021-04-04,Haiti,0,0,12788,252
2021-04-05,Haiti,0,0,12788,252
2021-04-06,Haiti,15,0,12803,252
2021-04-07,Haiti,0,0,12803,252
2021-04-08,Haiti,0,0,12803,252
2020-03-11,Honduras,2,0,2,0
2020-03-12,Honduras,0,0,2,0
2020-03-13,Honduras,0,0,2,0
2020-03-14,Honduras,0,0,2,0
2020-03-15,Honduras,1,0,3,0
2020-03-16,Honduras,3,0,6,0
2020-03-17,Honduras,2,0,8,0
2020-03-18,Honduras,1,0,9,0
2020-03-19,Honduras,3,0,12,0
2020-03-20,Honduras,12,0,24,0
2020-03-21,Honduras,0,0,24,0
2020-03-22,Honduras,2,0,26,0
2020-03-23,Honduras,4,0,30,0
2020-03-24,Honduras,0,0,30,0
2020-03-25,Honduras,6,0,36,0
2020-03-26,Honduras,16,1,52,1
2020-03-27,Honduras,16,0,68,1
2020-03-28,Honduras,27,0,95,1
2020-03-29,Honduras,15,2,110,3
2020-03-30,Honduras,29,4,139,7
2020-03-31,Honduras,2,0,141,7
2020-04-01,Honduras,31,3,172,10
2020-04-02,Honduras,47,4,219,14
2020-04-03,Honduras,3,1,222,15
2020-04-04,Honduras,42,0,264,15
2020-04-05,Honduras,4,7,268,22
2020-04-06,Honduras,30,0,298,22
2020-04-07,Honduras,7,0,305,22
2020-04-08,Honduras,7,0,312,22
2020-04-09,Honduras,31,1,343,23
2020-04-10,Honduras,39,0,382,23
2020-04-11,Honduras,10,1,392,24
2020-04-12,Honduras,1,1,393,25
2020-04-13,Honduras,4,0,397,25
2020-04-14,Honduras,10,1,407,26
2020-04-15,Honduras,12,5,419,31
2020-04-16,Honduras,7,4,426,35
2020-04-17,Honduras,16,6,442,41
2020-04-18,Honduras,15,5,457,46
2020-04-19,Honduras,15,0,472,46
2020-04-20,Honduras,5,0,477,46
2020-04-21,Honduras,17,0,494,46
2020-04-22,Honduras,16,0,510,46
2020-04-23,Honduras,9,1,519,47
2020-04-24,Honduras,72,8,591,55
2020-04-25,Honduras,36,4,627,59
2020-04-26,Honduras,0,0,627,59
2020-04-27,Honduras,34,2,661,61
2020-04-28,Honduras,41,3,702,64
2020-04-29,Honduras,36,2,738,66
2020-04-30,Honduras,33,5,771,71
2020-05-01,Honduras,33,4,804,75
2020-05-02,Honduras,206,1,1010,76
2020-05-03,Honduras,45,6,1055,82
2020-05-04,Honduras,123,1,1178,83
2020-05-05,Honduras,92,10,1270,93
2020-05-06,Honduras,191,6,1461,99
2020-05-07,Honduras,224,6,1685,105
2020-05-08,Honduras,86,2,1771,107
2020-05-09,Honduras,59,1,1830,108
2020-05-10,Honduras,142,0,1972,108
2020-05-11,Honduras,128,8,2100,116
2020-05-12,Honduras,-20,5,2080,121
2020-05-13,Honduras,175,2,2255,123
2020-05-14,Honduras,63,10,2318,133
2020-05-15,Honduras,142,1,2460,134
2020-05-16,Honduras,105,4,2565,138
2020-05-17,Honduras,81,4,2646,142
2020-05-18,Honduras,152,4,2798,146
2020-05-19,Honduras,157,1,2955,147
2020-05-20,Honduras,0,0,2955,147
2020-05-21,Honduras,249,9,3204,156
2020-05-22,Honduras,273,11,3477,167
2020-05-23,Honduras,0,0,3477,167
2020-05-24,Honduras,473,13,3950,180
2020-05-25,Honduras,239,2,4189,182
2020-05-26,Honduras,212,6,4401,188
2020-05-27,Honduras,239,6,4640,194
2020-05-28,Honduras,112,2,4752,196
2020-05-29,Honduras,0,0,4752,196
2020-05-30,Honduras,342,5,5094,201
2020-05-31,Honduras,108,11,5202,212
2020-06-01,Honduras,160,5,5362,217
2020-06-02,Honduras,165,8,5527,225
2020-06-03,Honduras,163,9,5690,234
2020-06-04,Honduras,190,9,5880,243
2020-06-05,Honduras,91,5,5971,248
2020-06-06,Honduras,184,2,6155,250
2020-06-07,Honduras,172,8,6327,258
2020-06-08,Honduras,123,4,6450,262
2020-06-09,Honduras,485,9,6935,271
2020-06-10,Honduras,425,19,7360,290
2020-06-11,Honduras,309,4,7669,294
2020-06-12,Honduras,463,12,8132,306
2020-06-13,Honduras,323,4,8455,310
2020-06-14,Honduras,403,2,8858,312
2020-06-15,Honduras,320,10,9178,322
2020-06-16,Honduras,478,8,9656,330
2020-06-17,Honduras,643,6,10299,336
2020-06-18,Honduras,440,7,10739,343
2020-06-19,Honduras,519,6,11258,349
2020-06-20,Honduras,1048,9,12306,358
2020-06-21,Honduras,463,5,12769,363
2020-06-22,Honduras,587,32,13356,395
2020-06-23,Honduras,587,10,13943,405
2020-06-24,Honduras,628,12,14571,417
2020-06-25,Honduras,795,9,15366,426
2020-06-26,Honduras,628,45,15994,471
2020-06-27,Honduras,1013,8,17007,479
2020-06-28,Honduras,1075,0,18082,479
2020-06-29,Honduras,736,6,18818,485
2020-06-30,Honduras,740,12,19558,497
2020-07-01,Honduras,704,45,20262,542
2020-07-02,Honduras,858,49,21120,591
2020-07-03,Honduras,996,14,22116,605
2020-07-04,Honduras,805,24,22921,629
2020-07-05,Honduras,1022,10,23943,639
2020-07-06,Honduras,722,17,24665,656
2020-07-07,Honduras,763,21,25428,677
2020-07-08,Honduras,550,17,25978,694
2020-07-09,Honduras,406,10,26384,704
2020-07-10,Honduras,669,46,27053,750
2020-07-11,Honduras,530,21,27583,771
2020-07-12,Honduras,507,3,28090,774
2020-07-13,Honduras,489,15,28579,789
2020-07-14,Honduras,527,18,29106,807
2020-07-15,Honduras,930,18,30036,825
2020-07-16,Honduras,831,10,30867,835
2020-07-17,Honduras,878,22,31745,857
2020-07-18,Honduras,1048,34,32793,891
2020-07-19,Honduras,1042,9,33835,900
2020-07-20,Honduras,776,35,34611,935
2020-07-21,Honduras,734,53,35345,988
2020-07-22,Honduras,757,18,36102,1006
2020-07-23,Honduras,800,5,36902,1011
2020-07-24,Honduras,657,50,37559,1061
2020-07-25,Honduras,879,37,38438,1098
2020-07-26,Honduras,838,18,39276,1116
2020-07-27,Honduras,465,50,39741,1166
2020-07-28,Honduras,719,48,40460,1214
2020-07-29,Honduras,484,45,40944,1259
2020-07-30,Honduras,482,53,41426,1312
2020-07-31,Honduras,588,25,42014,1337
2020-08-01,Honduras,671,31,42685,1368
2020-08-02,Honduras,512,9,43197,1377
2020-08-03,Honduras,597,7,43794,1384
2020-08-04,Honduras,505,16,44299,1400
2020-08-05,Honduras,799,23,45098,1423
2020-08-06,Honduras,657,23,45755,1446
2020-08-07,Honduras,610,19,46365,1465
2020-08-08,Honduras,608,11,46973,1476
2020-08-09,Honduras,481,19,47454,1495
2020-08-10,Honduras,418,11,47872,1506
2020-08-11,Honduras,531,9,48403,1515
2020-08-12,Honduras,254,18,48657,1533
2020-08-13,Honduras,385,9,49042,1542
2020-08-14,Honduras,425,6,49467,1548
2020-08-15,Honduras,512,19,49979,1567
2020-08-16,Honduras,523,8,50502,1575
2020-08-17,Honduras,493,8,50995,1583
2020-08-18,Honduras,675,10,51670,1593
2020-08-19,Honduras,628,15,52298,1608
2020-08-20,Honduras,521,11,52819,1619
2020-08-21,Honduras,562,13,53381,1632
2020-08-22,Honduras,602,11,53983,1643
2020-08-23,Honduras,528,11,54511,1654
2020-08-24,Honduras,968,29,55479,1683
2020-08-25,Honduras,398,20,55877,1703
2020-08-26,Honduras,772,44,56649,1747
2020-08-27,Honduras,1020,56,57669,1803
2020-08-28,Honduras,1141,24,58810,1827
2020-08-29,Honduras,835,15,59645,1842
2020-08-30,Honduras,529,16,60174,1858
2020-08-31,Honduras,840,15,61014,1873
2020-09-01,Honduras,755,15,61769,1888
2020-09-02,Honduras,757,36,62526,1924
2020-09-03,Honduras,632,30,63158,1954
2020-09-04,Honduras,640,30,63798,1984
2020-09-05,Honduras,554,22,64352,2006
2020-09-06,Honduras,412,1,64764,2007
2020-09-07,Honduras,50,16,64814,2023
2020-09-08,Honduras,404,11,65218,2034
2020-09-09,Honduras,379,10,65597,2044
2020-09-10,Honduras,205,5,65802,2049
2020-09-11,Honduras,247,9,66049,2058
2020-09-12,Honduras,1087,7,67136,2065
2020-09-13,Honduras,653,14,67789,2079
2020-09-14,Honduras,831,8,68620,2087
2020-09-15,Honduras,0,0,68620,2087
2020-09-16,Honduras,1040,15,69660,2102
2020-09-17,Honduras,460,20,70120,2122
2020-09-18,Honduras,491,24,70611,2146
2020-09-19,Honduras,532,20,71143,2166
2020-09-20,Honduras,473,18,71616,2184
2020-09-21,Honduras,459,20,72075,2204
2020-09-22,Honduras,231,2,72306,2206
2020-09-23,Honduras,369,16,72675,2222
2020-09-24,Honduras,518,27,73193,2249
2020-09-25,Honduras,647,22,73840,2271
2020-09-26,Honduras,708,17,74548,2288
2020-09-27,Honduras,0,0,74548,2288
2020-09-28,Honduras,989,13,75537,2301
2020-09-29,Honduras,561,22,76098,2323
2020-09-30,Honduras,802,30,76900,2353
2020-10-01,Honduras,698,27,77598,2380
2020-10-02,Honduras,671,6,78269,2386
2020-10-03,Honduras,519,13,78788,2399
2020-10-04,Honduras,841,23,79629,2422
2020-10-05,Honduras,391,11,80020,2433
2020-10-06,Honduras,642,14,80662,2447
2020-10-07,Honduras,354,19,81016,2466
2020-10-08,Honduras,656,11,81672,2477
2020-10-09,Honduras,880,15,82552,2492
2020-10-10,Honduras,594,12,83146,2504
2020-10-11,Honduras,935,8,84081,2512
2020-10-12,Honduras,332,9,84413,2521
2020-10-13,Honduras,439,7,84852,2528
2020-10-14,Honduras,606,5,85458,2533
2020-10-15,Honduras,631,19,86089,2552
2020-10-16,Honduras,602,4,86691,2556
2020-10-17,Honduras,903,7,87594,2563
2020-10-18,Honduras,831,5,88425,2568
2020-10-19,Honduras,956,8,89381,2576
2020-10-20,Honduras,851,6,90232,2582
2020-10-21,Honduras,846,14,91078,2596
2020-10-22,Honduras,431,8,91509,2604
2020-10-23,Honduras,0,0,91509,2604
2020-10-24,Honduras,1215,13,92724,2617
2020-10-25,Honduras,490,6,93214,2623
2020-10-26,Honduras,752,10,93966,2633
2020-10-27,Honduras,657,6,94623,2639
2020-10-28,Honduras,576,13,95199,2652
2020-10-29,Honduras,951,9,96150,2661
2020-10-30,Honduras,738,8,96888,2669
2020-10-31,Honduras,0,0,96888,2669
2020-11-01,Honduras,1324,6,98212,2675
2020-11-02,Honduras,193,13,98405,2688
2020-11-03,Honduras,283,18,98688,2706
2020-11-04,Honduras,436,24,99124,2730
2020-11-05,Honduras,223,6,99347,2736
2020-11-06,Honduras,229,5,99576,2741
2020-11-07,Honduras,465,4,100041,2745
2020-11-08,Honduras,0,0,100041,2745
2020-11-09,Honduras,532,20,100573,2765
2020-11-10,Honduras,231,15,100804,2780
2020-11-11,Honduras,365,17,101169,2797
2020-11-12,Honduras,299,7,101468,2804
2020-11-13,Honduras,611,16,102079,2820
2020-11-14,Honduras,476,2,102555,2822
2020-11-15,Honduras,547,1,103102,2823
2020-11-16,Honduras,137,16,103239,2839
2020-11-17,Honduras,249,0,103488,2839
2020-11-18,Honduras,0,0,103488,2839
2020-11-19,Honduras,0,0,103488,2839
2020-11-20,Honduras,63,14,103551,2853
2020-11-21,Honduras,884,4,104435,2857
2020-11-22,Honduras,0,0,104435,2857
2020-11-23,Honduras,776,12,105211,2869
2020-11-24,Honduras,0,0,105211,2869
2020-11-25,Honduras,905,19,106116,2888
2020-11-26,Honduras,565,4,106681,2892
2020-11-27,Honduras,453,7,107134,2899
2020-11-28,Honduras,379,6,107513,2905
2020-11-29,Honduras,375,4,107888,2909
2020-11-30,Honduras,365,9,108253,2918
2020-12-01,Honduras,0,0,108253,2918
2020-12-02,Honduras,891,12,109144,2930
2020-12-03,Honduras,616,8,109760,2938
2020-12-04,Honduras,0,0,109760,2938
2020-12-05,Honduras,200,3,109960,2941
2020-12-06,Honduras,1063,5,111023,2946
2020-12-07,Honduras,0,0,111023,2946
2020-12-08,Honduras,684,4,111707,2950
2020-12-09,Honduras,1085,11,112792,2961
2020-12-10,Honduras,415,7,113207,2968
2020-12-11,Honduras,501,3,113708,2971
2020-12-12,Honduras,335,3,114043,2974
2020-12-13,Honduras,316,1,114359,2975
2020-12-14,Honduras,283,14,114642,2989
2020-12-15,Honduras,301,12,114943,3001
2020-12-16,Honduras,374,12,115317,3013
2020-12-17,Honduras,157,8,115474,3021
2020-12-18,Honduras,738,2,116212,3023
2020-12-19,Honduras,0,0,116212,3023
2020-12-20,Honduras,810,4,117022,3027
2020-12-21,Honduras,168,7,117190,3034
2020-12-22,Honduras,398,12,117588,3046
2020-12-23,Honduras,448,8,118036,3054
2020-12-24,Honduras,0,0,118036,3054
2020-12-25,Honduras,623,7,118659,3061
2020-12-26,Honduras,438,4,119097,3065
2020-12-27,Honduras,0,0,119097,3065
2020-12-28,Honduras,616,1,119713,3066
2020-12-29,Honduras,1199,45,120912,3111
2020-12-30,Honduras,0,0,120912,3111
2020-12-31,Honduras,915,19,121827,3130
2021-01-01,Honduras,1147,30,122974,3160
2021-01-02,Honduras,170,13,123144,3173
2021-01-03,Honduras,225,7,123369,3180
2021-01-04,Honduras,29,1,123398,3181
2021-01-05,Honduras,424,5,123822,3186
2021-01-06,Honduras,1077,6,124899,3192
2021-01-07,Honduras,219,8,125118,3200
2021-01-08,Honduras,439,44,125557,3244
2021-01-09,Honduras,1386,20,126943,3264
2021-01-10,Honduras,1002,9,127945,3273
2021-01-11,Honduras,756,12,128701,3285
2021-01-12,Honduras,1104,9,129805,3294
2021-01-13,Honduras,1204,26,131009,3320
2021-01-14,Honduras,954,15,131963,3335
2021-01-15,Honduras,449,9,132412,3344
2021-01-16,Honduras,1095,4,133507,3348
2021-01-17,Honduras,604,6,134111,3354
2021-01-18,Honduras,827,14,134938,3368
2021-01-19,Honduras,1130,23,136068,3391
2021-01-20,Honduras,830,15,136898,3406
2021-01-21,Honduras,1146,16,138044,3422
2021-01-22,Honduras,1138,17,139182,3439
2021-01-23,Honduras,1056,2,140238,3441
2021-01-24,Honduras,691,6,140929,3447
2021-01-25,Honduras,1055,15,141984,3462
2021-01-26,Honduras,896,24,142880,3486
2021-01-27,Honduras,1127,26,144007,3512
2021-01-28,Honduras,985,37,144992,3549
2021-01-29,Honduras,1118,26,146110,3575
2021-01-30,Honduras,990,17,147100,3592
2021-01-31,Honduras,743,18,147843,3610
2021-02-01,Honduras,0,0,147843,3610
2021-02-02,Honduras,1108,4,148951,3614
2021-02-03,Honduras,2152,48,151103,3662
2021-02-04,Honduras,1122,7,152225,3669
2021-02-05,Honduras,1028,25,153253,3694
2021-02-06,Honduras,652,16,153905,3710
2021-02-07,Honduras,663,11,154568,3721
2021-02-08,Honduras,1167,21,155735,3742
2021-02-09,Honduras,871,47,156606,3789
2021-02-10,Honduras,862,17,157468,3806
2021-02-11,Honduras,887,32,158355,3838
2021-02-12,Honduras,669,10,159024,3848
2021-02-13,Honduras,764,9,159788,3857
2021-02-14,Honduras,383,9,160171,3866
2021-02-15,Honduras,812,27,160983,3893
2021-02-16,Honduras,744,20,161727,3913
2021-02-17,Honduras,857,20,162584,3933
2021-02-18,Honduras,721,32,163305,3965
2021-02-19,Honduras,772,10,164077,3975
2021-02-20,Honduras,418,17,164495,3992
2021-02-21,Honduras,600,4,165095,3996
2021-02-22,Honduras,642,28,165737,4024
2021-02-23,Honduras,810,16,166547,4040
2021-02-24,Honduras,947,36,167494,4076
2021-02-25,Honduras,749,23,168243,4099
2021-02-26,Honduras,668,18,168911,4117
2021-02-27,Honduras,843,24,169754,4141
2021-02-28,Honduras,550,10,170304,4151
2021-03-01,Honduras,681,23,170985,4174
2021-03-02,Honduras,773,13,171758,4187
2021-03-03,Honduras,342,27,172100,4214
2021-03-04,Honduras,477,17,172577,4231
2021-03-05,Honduras,0,0,172577,4231
2021-03-06,Honduras,443,16,173020,4247
2021-03-07,Honduras,709,13,173729,4260
2021-03-08,Honduras,514,23,174243,4283
2021-03-09,Honduras,265,14,174508,4297
2021-03-10,Honduras,934,4,175442,4301
2021-03-11,Honduras,985,10,176427,4311
2021-03-12,Honduras,741,14,177168,4325
2021-03-13,Honduras,664,6,177832,4331
2021-03-14,Honduras,445,3,178277,4334
2021-03-15,Honduras,648,26,178925,4360
2021-03-16,Honduras,590,13,179515,4373
2021-03-17,Honduras,756,17,180271,4390
2021-03-18,Honduras,525,12,180796,4402
2021-03-19,Honduras,561,20,181357,4422
2021-03-20,Honduras,574,8,181931,4430
2021-03-21,Honduras,478,13,182409,4443
2021-03-22,Honduras,871,26,183280,4469
2021-03-23,Honduras,751,20,184031,4489
2021-03-24,Honduras,790,17,184821,4506
2021-03-25,Honduras,663,21,185484,4527
2021-03-26,Honduras,853,9,186337,4536
2021-03-27,Honduras,678,21,187015,4557
2021-03-28,Honduras,445,1,187460,4558
2021-03-29,Honduras,515,27,187975,4585
2021-03-30,Honduras,539,14,188514,4599
2021-03-31,Honduras,529,6,189043,4605
2021-04-01,Honduras,683,17,189726,4622
2021-04-02,Honduras,0,0,189726,4622
2021-04-03,Honduras,416,11,190142,4633
2021-04-04,Honduras,489,11,190631,4644
2021-04-05,Honduras,505,37,191136,4681
2021-04-06,Honduras,1277,5,192413,4686
2021-04-07,Honduras,616,17,193029,4703
2021-04-08,Honduras,754,12,193783,4715
2020-03-04,Hungary,2,0,2,0
2020-03-05,Hungary,0,0,2,0
2020-03-06,Hungary,0,0,2,0
2020-03-07,Hungary,2,0,4,0
2020-03-08,Hungary,3,0,7,0
2020-03-09,Hungary,2,0,9,0
2020-03-10,Hungary,0,0,9,0
2020-03-11,Hungary,4,0,13,0
2020-03-12,Hungary,0,0,13,0
2020-03-13,Hungary,6,0,19,0
2020-03-14,Hungary,11,0,30,0
2020-03-15,Hungary,2,1,32,1
2020-03-16,Hungary,7,0,39,1
2020-03-17,Hungary,11,0,50,1
2020-03-18,Hungary,8,0,58,1
2020-03-19,Hungary,15,0,73,1
2020-03-20,Hungary,12,2,85,3
2020-03-21,Hungary,18,1,103,4
2020-03-22,Hungary,28,2,131,6
2020-03-23,Hungary,36,1,167,7
2020-03-24,Hungary,20,2,187,9
2020-03-25,Hungary,39,1,226,10
2020-03-26,Hungary,35,0,261,10
2020-03-27,Hungary,39,0,300,10
2020-03-28,Hungary,43,1,343,11
2020-03-29,Hungary,65,2,408,13
2020-03-30,Hungary,39,2,447,15
2020-03-31,Hungary,45,1,492,16
2020-04-01,Hungary,33,4,525,20
2020-04-02,Hungary,60,1,585,21
2020-04-03,Hungary,38,5,623,26
2020-04-04,Hungary,55,6,678,32
2020-04-05,Hungary,55,2,733,34
2020-04-06,Hungary,11,4,744,38
2020-04-07,Hungary,73,9,817,47
2020-04-08,Hungary,78,11,895,58
2020-04-09,Hungary,85,8,980,66
2020-04-10,Hungary,210,11,1190,77
2020-04-11,Hungary,120,8,1310,85
2020-04-12,Hungary,100,14,1410,99
2020-04-13,Hungary,48,10,1458,109
2020-04-14,Hungary,54,13,1512,122
2020-04-15,Hungary,67,12,1579,134
2020-04-16,Hungary,73,8,1652,142
2020-04-17,Hungary,111,14,1763,156
2020-04-18,Hungary,71,16,1834,172
2020-04-19,Hungary,82,17,1916,189
2020-04-20,Hungary,68,10,1984,199
2020-04-21,Hungary,114,14,2098,213
2020-04-22,Hungary,70,12,2168,225
2020-04-23,Hungary,116,14,2284,239
2020-04-24,Hungary,159,23,2443,262
2020-04-25,Hungary,0,0,2443,262
2020-04-26,Hungary,57,10,2500,272
2020-04-27,Hungary,83,8,2583,280
2020-04-28,Hungary,66,11,2649,291
2020-04-29,Hungary,78,9,2727,300
2020-04-30,Hungary,48,12,2775,312
2020-05-01,Hungary,88,11,2863,323
2020-05-02,Hungary,79,12,2942,335
2020-05-03,Hungary,56,5,2998,340
2020-05-04,Hungary,37,11,3035,351
2020-05-05,Hungary,30,12,3065,363
2020-05-06,Hungary,46,10,3111,373
2020-05-07,Hungary,39,10,3150,383
2020-05-08,Hungary,28,9,3178,392
2020-05-09,Hungary,35,13,3213,405
2020-05-10,Hungary,50,8,3263,413
2020-05-11,Hungary,21,8,3284,421
2020-05-12,Hungary,29,4,3313,425
2020-05-13,Hungary,28,5,3341,430
2020-05-14,Hungary,39,6,3380,436
2020-05-15,Hungary,37,6,3417,442
2020-05-16,Hungary,56,6,3473,448
2020-05-17,Hungary,36,3,3509,451
2020-05-18,Hungary,26,11,3535,462
2020-05-19,Hungary,21,5,3556,467
2020-05-20,Hungary,42,3,3598,470
2020-05-21,Hungary,43,3,3641,473
2020-05-22,Hungary,37,3,3678,476
2020-05-23,Hungary,35,6,3713,482
2020-05-24,Hungary,28,4,3741,486
2020-05-25,Hungary,15,5,3756,491
2020-05-26,Hungary,15,8,3771,499
2020-05-27,Hungary,22,6,3793,505
2020-05-28,Hungary,23,4,3816,509
2020-05-29,Hungary,25,8,3841,517
2020-05-30,Hungary,26,7,3867,524
2020-05-31,Hungary,9,2,3876,526
2020-06-01,Hungary,16,1,3892,527
2020-06-02,Hungary,29,5,3921,532
2020-06-03,Hungary,10,2,3931,534
2020-06-04,Hungary,23,5,3954,539
2020-06-05,Hungary,16,3,3970,542
2020-06-06,Hungary,20,3,3990,545
2020-06-07,Hungary,18,1,4008,546
2020-06-08,Hungary,6,2,4014,548
2020-06-09,Hungary,3,2,4017,550
2020-06-10,Hungary,10,1,4027,551
2020-06-11,Hungary,12,2,4039,553
2020-06-12,Hungary,14,2,4053,555
2020-06-13,Hungary,11,4,4064,559
2020-06-14,Hungary,5,3,4069,562
2020-06-15,Hungary,7,1,4076,563
2020-06-16,Hungary,1,2,4077,565
2020-06-17,Hungary,1,2,4078,567
2020-06-18,Hungary,1,1,4079,568
2020-06-19,Hungary,2,0,4081,568
2020-06-20,Hungary,5,2,4086,570
2020-06-21,Hungary,8,0,4094,570
2020-06-22,Hungary,8,2,4102,572
2020-06-23,Hungary,5,1,4107,573
2020-06-24,Hungary,7,3,4114,576
2020-06-25,Hungary,9,1,4123,577
2020-06-26,Hungary,4,1,4127,578
2020-06-27,Hungary,11,0,4138,578
2020-06-28,Hungary,4,3,4142,581
2020-06-29,Hungary,3,4,4145,585
2020-06-30,Hungary,10,0,4155,585
2020-07-01,Hungary,2,1,4157,586
2020-07-02,Hungary,9,1,4166,587
2020-07-03,Hungary,6,1,4172,588
2020-07-04,Hungary,2,1,4174,589
2020-07-05,Hungary,9,0,4183,589
2020-07-06,Hungary,6,0,4189,589
2020-07-07,Hungary,16,0,4205,589
2020-07-08,Hungary,5,0,4210,589
2020-07-09,Hungary,10,2,4220,591
2020-07-10,Hungary,3,2,4223,593
2020-07-11,Hungary,6,2,4229,595
2020-07-12,Hungary,5,0,4234,595
2020-07-13,Hungary,13,0,4247,595
2020-07-14,Hungary,11,0,4258,595
2020-07-15,Hungary,5,0,4263,595
2020-07-16,Hungary,16,0,4279,595
2020-07-17,Hungary,14,0,4293,595
2020-07-18,Hungary,22,1,4315,596
2020-07-19,Hungary,18,0,4333,596
2020-07-20,Hungary,6,0,4339,596
2020-07-21,Hungary,8,0,4347,596
2020-07-22,Hungary,19,0,4366,596
2020-07-23,Hungary,14,0,4380,596
2020-07-24,Hungary,18,0,4398,596
2020-07-25,Hungary,26,0,4424,596
2020-07-26,Hungary,11,0,4435,596
2020-07-27,Hungary,13,0,4448,596
2020-07-28,Hungary,8,0,4456,596
2020-07-29,Hungary,9,0,4465,596
2020-07-30,Hungary,19,0,4484,596
2020-07-31,Hungary,21,0,4505,596
2020-08-01,Hungary,21,1,4526,597
2020-08-02,Hungary,9,0,4535,597
2020-08-03,Hungary,9,0,4544,597
2020-08-04,Hungary,9,1,4553,598
2020-08-05,Hungary,11,1,4564,599
2020-08-06,Hungary,33,1,4597,600
2020-08-07,Hungary,24,2,4621,602
2020-08-08,Hungary,32,0,4653,602
2020-08-09,Hungary,43,0,4696,602
2020-08-10,Hungary,35,3,4731,605
2020-08-11,Hungary,15,0,4746,605
2020-08-12,Hungary,22,0,4768,605
2020-08-13,Hungary,45,2,4813,607
2020-08-14,Hungary,40,0,4853,607
2020-08-15,Hungary,24,0,4877,607
2020-08-16,Hungary,39,1,4916,608
2020-08-17,Hungary,30,0,4946,608
2020-08-18,Hungary,24,1,4970,609
2020-08-19,Hungary,32,0,5002,609
2020-08-20,Hungary,44,0,5046,609
2020-08-21,Hungary,52,2,5098,611
2020-08-22,Hungary,35,0,5133,611
2020-08-23,Hungary,22,2,5155,613
2020-08-24,Hungary,36,0,5191,613
2020-08-25,Hungary,24,1,5215,614
2020-08-26,Hungary,73,0,5288,614
2020-08-27,Hungary,91,0,5379,614
2020-08-28,Hungary,132,0,5511,614
2020-08-29,Hungary,158,0,5669,614
2020-08-30,Hungary,292,0,5961,614
2020-08-31,Hungary,178,1,6139,615
2020-09-01,Hungary,118,1,6257,616
2020-09-02,Hungary,365,3,6622,619
2020-09-03,Hungary,301,1,6923,620
2020-09-04,Hungary,459,1,7382,621
2020-09-05,Hungary,510,3,7892,624
2020-09-06,Hungary,495,0,8387,624
2020-09-07,Hungary,576,1,8963,625
2020-09-08,Hungary,341,1,9304,626
2020-09-09,Hungary,411,2,9715,628
2020-09-10,Hungary,476,2,10191,630
2020-09-11,Hungary,718,1,10909,631
2020-09-12,Hungary,916,2,11825,633
2020-09-13,Hungary,484,4,12309,637
2020-09-14,Hungary,844,5,13153,642
2020-09-15,Hungary,726,4,13879,646
2020-09-16,Hungary,581,8,14460,654
2020-09-17,Hungary,710,9,15170,663
2020-09-18,Hungary,941,6,16111,669
2020-09-19,Hungary,809,6,16920,675
2020-09-20,Hungary,1070,8,17990,683
2020-09-21,Hungary,876,3,18866,686
2020-09-22,Hungary,633,8,19499,694
2020-09-23,Hungary,951,8,20450,702
2020-09-24,Hungary,750,7,21200,709
2020-09-25,Hungary,927,9,22127,718
2020-09-26,Hungary,950,12,23077,730
2020-09-27,Hungary,937,6,24014,736
2020-09-28,Hungary,702,13,24716,749
2020-09-29,Hungary,851,8,25567,757
2020-09-30,Hungary,894,8,26461,765
2020-10-01,Hungary,848,16,27309,781
2020-10-02,Hungary,1322,17,28631,798
2020-10-03,Hungary,1086,14,29717,812
2020-10-04,Hungary,858,10,30575,822
2020-10-05,Hungary,905,11,31480,833
2020-10-06,Hungary,818,20,32298,853
2020-10-07,Hungary,816,24,33114,877
2020-10-08,Hungary,932,21,34046,898
2020-10-09,Hungary,1176,15,35222,913
2020-10-10,Hungary,1374,20,36596,933
2020-10-11,Hungary,1068,21,37664,954
2020-10-12,Hungary,1173,14,38837,968
2020-10-13,Hungary,1025,28,39862,996
2020-10-14,Hungary,920,27,40782,1023
2020-10-15,Hungary,950,29,41732,1052
2020-10-16,Hungary,1293,33,43025,1085
2020-10-17,Hungary,1791,24,44816,1109
2020-10-18,Hungary,1474,33,46290,1142
2020-10-19,Hungary,1478,31,47768,1173
2020-10-20,Hungary,989,38,48757,1211
2020-10-21,Hungary,1423,48,50180,1259
2020-10-22,Hungary,2032,46,52212,1305
2020-10-23,Hungary,2066,47,54278,1352
2020-10-24,Hungary,1820,38,56098,1390
2020-10-25,Hungary,3149,35,59247,1425
2020-10-26,Hungary,2316,47,61563,1472
2020-10-27,Hungary,2079,63,63642,1535
2020-10-28,Hungary,2291,43,65933,1578
2020-10-29,Hungary,2194,56,68127,1634
2020-10-30,Hungary,3286,65,71413,1699
2020-10-31,Hungary,3908,51,75321,1750
2020-11-01,Hungary,3878,69,79199,1819
2020-11-02,Hungary,3581,70,82780,1889
2020-11-03,Hungary,3989,84,86769,1973
2020-11-04,Hungary,4219,90,90988,2063
2020-11-05,Hungary,3928,84,94916,2147
2020-11-06,Hungary,4709,103,99625,2250
2020-11-07,Hungary,5318,107,104943,2357
2020-11-08,Hungary,4673,81,109616,2438
2020-11-09,Hungary,5162,55,114778,2493
2020-11-10,Hungary,4140,103,118918,2596
2020-11-11,Hungary,3945,101,122863,2697
2020-11-12,Hungary,3927,87,126790,2784
2020-11-13,Hungary,5097,99,131887,2883
2020-11-14,Hungary,4836,107,136723,2990
2020-11-15,Hungary,4238,107,140961,3097
2020-11-16,Hungary,6495,93,147456,3190
2020-11-17,Hungary,5203,91,152659,3281
2020-11-18,Hungary,4290,99,156949,3380
2020-11-19,Hungary,4512,92,161461,3472
2020-11-20,Hungary,4440,96,165901,3568
2020-11-21,Hungary,4397,121,170298,3689
2020-11-22,Hungary,4320,111,174618,3800
2020-11-23,Hungary,3334,91,177952,3891
2020-11-24,Hungary,3929,117,181881,4008
2020-11-25,Hungary,3806,106,185687,4114
2020-11-26,Hungary,6360,115,192047,4229
2020-11-27,Hungary,6393,135,198440,4364
2020-11-28,Hungary,6268,152,204708,4516
2020-11-29,Hungary,6819,156,211527,4672
2020-11-30,Hungary,5595,151,217122,4823
2020-12-01,Hungary,3951,154,221073,4977
2020-12-02,Hungary,4136,165,225209,5142
2020-12-03,Hungary,6635,182,231844,5324
2020-12-04,Hungary,6212,189,238056,5513
2020-12-05,Hungary,5525,193,243581,5706
2020-12-06,Hungary,6697,162,250278,5868
2020-12-07,Hungary,3870,116,254148,5984
2020-12-08,Hungary,2219,136,256367,6120
2020-12-09,Hungary,3221,160,259588,6280
2020-12-10,Hungary,5415,171,265003,6451
2020-12-11,Hungary,6197,171,271200,6622
2020-12-12,Hungary,5047,162,276247,6784
2020-12-13,Hungary,4153,181,280400,6965
2020-12-14,Hungary,3470,165,283870,7130
2020-12-15,Hungary,1893,107,285763,7237
2020-12-16,Hungary,2804,144,288567,7381
2020-12-17,Hungary,2982,157,291549,7538
2020-12-18,Hungary,4428,187,295977,7725
2020-12-19,Hungary,4045,189,300022,7914
2020-12-20,Hungary,2967,185,302989,8099
2020-12-21,Hungary,2141,183,305130,8282
2020-12-22,Hungary,1238,180,306368,8462
2020-12-23,Hungary,1894,154,308262,8616
2020-12-24,Hungary,3292,113,311554,8729
2020-12-25,Hungary,2610,104,314164,8833
2020-12-26,Hungary,1198,118,315362,8951
2020-12-27,Hungary,698,96,316060,9047
2020-12-28,Hungary,609,114,316669,9161
2020-12-29,Hungary,902,131,317571,9292
2020-12-30,Hungary,1972,137,319543,9429
2020-12-31,Hungary,2971,108,322514,9537
2021-01-01,Hungary,2764,130,325278,9667
2021-01-02,Hungary,1410,114,326688,9781
2021-01-03,Hungary,1307,103,327995,9884
2021-01-04,Hungary,856,93,328851,9977
2021-01-05,Hungary,870,103,329721,10080
2021-01-06,Hungary,2047,118,331768,10198
2021-01-07,Hungary,3068,127,334836,10325
2021-01-08,Hungary,2907,115,337743,10440
2021-01-09,Hungary,2716,114,340459,10554
2021-01-10,Hungary,1778,94,342237,10648
2021-01-11,Hungary,1419,77,343656,10725
2021-01-12,Hungary,696,128,344352,10853
2021-01-13,Hungary,1358,95,345710,10948
2021-01-14,Hungary,1926,118,347636,11066
2021-01-15,Hungary,1513,111,349149,11177
2021-01-16,Hungary,1438,87,350587,11264
2021-01-17,Hungary,1241,77,351828,11341
2021-01-18,Hungary,875,68,352703,11409
2021-01-19,Hungary,573,111,353276,11520
2021-01-20,Hungary,976,95,354252,11615
2021-01-21,Hungary,1410,98,355662,11713
2021-01-22,Hungary,1311,98,356973,11811
2021-01-23,Hungary,1344,93,358317,11904
2021-01-24,Hungary,1257,64,359574,11968
2021-01-25,Hungary,844,56,360418,12024
2021-01-26,Hungary,459,89,360877,12113
2021-01-27,Hungary,1004,85,361881,12198
2021-01-28,Hungary,1569,93,363450,12291
2021-01-29,Hungary,1459,83,364909,12374
2021-01-30,Hungary,1370,89,366279,12463
2021-01-31,Hungary,1307,61,367586,12524
2021-02-01,Hungary,1124,54,368710,12578
2021-02-02,Hungary,578,78,369288,12656
2021-02-03,Hungary,1048,83,370336,12739
2021-02-04,Hungary,1652,93,371988,12832
2021-02-05,Hungary,1576,98,373564,12930
2021-02-06,Hungary,1561,96,375125,13026
2021-02-07,Hungary,1370,64,376495,13090
2021-02-08,Hungary,1160,65,377655,13155
2021-02-09,Hungary,1079,94,378734,13249
2021-02-10,Hungary,1279,98,380013,13347
2021-02-11,Hungary,1862,97,381875,13444
2021-02-12,Hungary,1860,99,383735,13543
2021-02-13,Hungary,2020,93,385755,13636
2021-02-14,Hungary,1707,70,387462,13706
2021-02-15,Hungary,1337,46,388799,13752
2021-02-16,Hungary,823,85,389622,13837
2021-02-17,Hungary,1548,94,391170,13931
2021-02-18,Hungary,2853,104,394023,14035
2021-02-19,Hungary,3093,110,397116,14145
2021-02-20,Hungary,2995,107,400111,14252
2021-02-21,Hungary,2912,47,403023,14299
2021-02-22,Hungary,2623,48,405646,14347
2021-02-23,Hungary,1628,103,407274,14450
2021-02-24,Hungary,2855,102,410129,14552
2021-02-25,Hungary,4385,120,414514,14672
2021-02-26,Hungary,4668,123,419182,14795
2021-02-27,Hungary,4948,107,424130,14902
2021-02-28,Hungary,4469,72,428599,14974
2021-03-01,Hungary,4326,84,432925,15058
2021-03-02,Hungary,2764,130,435689,15188
2021-03-03,Hungary,4211,136,439900,15324
2021-03-04,Hungary,6278,152,446178,15476
2021-03-05,Hungary,6369,143,452547,15619
2021-03-06,Hungary,7269,146,459816,15765
2021-03-07,Hungary,6201,108,466017,15873
2021-03-08,Hungary,2696,115,468713,15988
2021-03-09,Hungary,6494,158,475207,16146
2021-03-10,Hungary,5653,179,480860,16325
2021-03-11,Hungary,8312,172,489172,16497
2021-03-12,Hungary,9011,130,498183,16627
2021-03-13,Hungary,9444,163,507627,16790
2021-03-14,Hungary,8863,162,516490,16952
2021-03-15,Hungary,7706,131,524196,17083
2021-03-16,Hungary,4926,143,529122,17226
2021-03-17,Hungary,3456,195,532578,17421
2021-03-18,Hungary,6502,207,539080,17628
2021-03-19,Hungary,10759,213,549839,17841
2021-03-20,Hungary,11132,227,560971,18068
2021-03-21,Hungary,10625,194,571596,18262
2021-03-22,Hungary,9046,189,580642,18451
2021-03-23,Hungary,5481,252,586123,18703
2021-03-24,Hungary,7587,249,593710,18952
2021-03-25,Hungary,9637,272,603347,19224
2021-03-26,Hungary,11265,275,614612,19499
2021-03-27,Hungary,10167,253,624779,19752
2021-03-28,Hungary,9082,220,633861,19972
2021-03-29,Hungary,7263,189,641124,20161
2021-03-30,Hungary,4609,274,645733,20435
2021-03-31,Hungary,6700,302,652433,20737
2021-04-01,Hungary,9288,258,661721,20995
2021-04-02,Hungary,9055,267,670776,21262
2021-04-03,Hungary,8637,242,679413,21504
2021-04-04,Hungary,6566,211,685979,21715
2021-04-05,Hungary,3874,213,689853,21928
2021-04-06,Hungary,1890,170,691743,22098
2021-04-07,Hungary,1933,311,693676,22409
2021-04-08,Hungary,4814,272,698490,22681
2020-02-28,Iceland,1,0,1,0
2020-02-29,Iceland,0,0,1,0
2020-03-01,Iceland,2,0,3,0
2020-03-02,Iceland,3,0,6,0
2020-03-03,Iceland,5,0,11,0
2020-03-04,Iceland,15,0,26,0
2020-03-05,Iceland,8,0,34,0
2020-03-06,Iceland,9,0,43,0
2020-03-07,Iceland,7,0,50,0
2020-03-08,Iceland,0,0,50,0
2020-03-09,Iceland,8,0,58,0
2020-03-10,Iceland,11,0,69,0
2020-03-11,Iceland,16,0,85,0
2020-03-12,Iceland,18,0,103,0
2020-03-13,Iceland,31,0,134,0
2020-03-14,Iceland,22,0,156,0
2020-03-15,Iceland,15,0,171,0
2020-03-16,Iceland,9,0,180,0
2020-03-17,Iceland,40,0,220,0
2020-03-18,Iceland,30,0,250,0
2020-03-19,Iceland,80,0,330,0
2020-03-20,Iceland,79,0,409,0
2020-03-21,Iceland,64,1,473,1
2020-03-22,Iceland,95,0,568,1
2020-03-23,Iceland,20,0,588,1
2020-03-24,Iceland,60,1,648,2
2020-03-25,Iceland,89,0,737,2
2020-03-26,Iceland,65,0,802,2
2020-03-27,Iceland,88,0,890,2
2020-03-28,Iceland,73,0,963,2
2020-03-29,Iceland,57,0,1020,2
2020-03-30,Iceland,66,0,1086,2
2020-03-31,Iceland,49,0,1135,2
2020-04-01,Iceland,85,0,1220,2
2020-04-02,Iceland,99,2,1319,4
2020-04-03,Iceland,45,0,1364,4
2020-04-04,Iceland,53,0,1417,4
2020-04-05,Iceland,69,0,1486,4
2020-04-06,Iceland,76,2,1562,6
2020-04-07,Iceland,24,0,1586,6
2020-04-08,Iceland,30,0,1616,6
2020-04-09,Iceland,32,0,1648,6
2020-04-10,Iceland,27,1,1675,7
2020-04-11,Iceland,14,1,1689,8
2020-04-12,Iceland,12,0,1701,8
2020-04-13,Iceland,10,0,1711,8
2020-04-14,Iceland,9,0,1720,8
2020-04-15,Iceland,7,0,1727,8
2020-04-16,Iceland,12,0,1739,8
2020-04-17,Iceland,15,1,1754,9
2020-04-18,Iceland,6,0,1760,9
2020-04-19,Iceland,11,0,1771,9
2020-04-20,Iceland,2,1,1773,10
2020-04-21,Iceland,5,0,1778,10
2020-04-22,Iceland,7,0,1785,10
2020-04-23,Iceland,4,0,1789,10
2020-04-24,Iceland,0,0,1789,10
2020-04-25,Iceland,1,0,1790,10
2020-04-26,Iceland,2,0,1792,10
2020-04-27,Iceland,0,0,1792,10
2020-04-28,Iceland,3,0,1795,10
2020-04-29,Iceland,2,0,1797,10
2020-04-30,Iceland,0,0,1797,10
2020-05-01,Iceland,1,0,1798,10
2020-05-02,Iceland,0,0,1798,10
2020-05-03,Iceland,1,0,1799,10
2020-05-04,Iceland,0,0,1799,10
2020-05-05,Iceland,0,0,1799,10
2020-05-06,Iceland,0,0,1799,10
2020-05-07,Iceland,2,0,1801,10
2020-05-08,Iceland,0,0,1801,10
2020-05-09,Iceland,0,0,1801,10
2020-05-10,Iceland,0,0,1801,10
2020-05-11,Iceland,0,0,1801,10
2020-05-12,Iceland,0,0,1801,10
2020-05-13,Iceland,1,0,1802,10
2020-05-14,Iceland,0,0,1802,10
2020-05-15,Iceland,0,0,1802,10
2020-05-16,Iceland,0,0,1802,10
2020-05-17,Iceland,0,0,1802,10
2020-05-18,Iceland,0,0,1802,10
2020-05-19,Iceland,0,0,1802,10
2020-05-20,Iceland,1,0,1803,10
2020-05-21,Iceland,0,0,1803,10
2020-05-22,Iceland,0,0,1803,10
2020-05-23,Iceland,1,0,1804,10
2020-05-24,Iceland,0,0,1804,10
2020-05-25,Iceland,0,0,1804,10
2020-05-26,Iceland,0,0,1804,10
2020-05-27,Iceland,1,0,1805,10
2020-05-28,Iceland,0,0,1805,10
2020-05-29,Iceland,0,0,1805,10
2020-05-30,Iceland,1,0,1806,10
2020-05-31,Iceland,0,0,1806,10
2020-06-01,Iceland,0,0,1806,10
2020-06-02,Iceland,0,0,1806,10
2020-06-03,Iceland,0,0,1806,10
2020-06-04,Iceland,0,0,1806,10
2020-06-05,Iceland,0,0,1806,10
2020-06-06,Iceland,0,0,1806,10
2020-06-07,Iceland,1,0,1807,10
2020-06-08,Iceland,0,0,1807,10
2020-06-09,Iceland,0,0,1807,10
2020-06-10,Iceland,0,0,1807,10
2020-06-11,Iceland,0,0,1807,10
2020-06-12,Iceland,0,0,1807,10
2020-06-13,Iceland,1,0,1808,10
2020-06-14,Iceland,2,0,1810,10
2020-06-15,Iceland,1,0,1811,10
2020-06-16,Iceland,1,0,1812,10
2020-06-17,Iceland,0,0,1812,10
2020-06-18,Iceland,2,0,1814,10
2020-06-19,Iceland,1,0,1815,10
2020-06-20,Iceland,0,0,1815,10
2020-06-21,Iceland,0,0,1815,10
2020-06-22,Iceland,0,0,1815,10
2020-06-23,Iceland,0,0,1815,10
2020-06-24,Iceland,2,0,1817,10
2020-06-25,Iceland,1,0,1818,10
2020-06-26,Iceland,2,0,1820,10
2020-06-27,Iceland,0,0,1820,10
2020-06-28,Iceland,1,0,1821,10
2020-06-29,Iceland,1,0,1822,10
2020-06-30,Iceland,2,0,1824,10
2020-07-01,Iceland,1,0,1825,10
2020-07-02,Iceland,5,0,1830,10
2020-07-03,Iceland,0,0,1830,10
2020-07-04,Iceland,0,0,1830,10
2020-07-05,Iceland,0,0,1830,10
2020-07-06,Iceland,2,0,1832,10
2020-07-07,Iceland,1,0,1833,10
2020-07-08,Iceland,0,0,1833,10
2020-07-09,Iceland,0,0,1833,10
2020-07-10,Iceland,0,0,1833,10
2020-07-11,Iceland,0,0,1833,10
2020-07-12,Iceland,0,0,1833,10
2020-07-13,Iceland,0,0,1833,10
2020-07-14,Iceland,2,0,1835,10
2020-07-15,Iceland,0,0,1835,10
2020-07-16,Iceland,1,0,1836,10
2020-07-17,Iceland,0,0,1836,10
2020-07-18,Iceland,2,0,1838,10
2020-07-19,Iceland,1,0,1839,10
2020-07-20,Iceland,0,0,1839,10
2020-07-21,Iceland,0,0,1839,10
2020-07-22,Iceland,1,0,1840,10
2020-07-23,Iceland,1,0,1841,10
2020-07-24,Iceland,2,0,1843,10
2020-07-25,Iceland,0,0,1843,10
2020-07-26,Iceland,4,0,1847,10
2020-07-27,Iceland,7,0,1854,10
2020-07-28,Iceland,3,0,1857,10
2020-07-29,Iceland,4,0,1861,10
2020-07-30,Iceland,11,0,1872,10
2020-07-31,Iceland,13,0,1885,10
2020-08-01,Iceland,8,0,1893,10
2020-08-02,Iceland,14,0,1907,10
2020-08-03,Iceland,8,0,1915,10
2020-08-04,Iceland,3,0,1918,10
2020-08-05,Iceland,8,0,1926,10
2020-08-06,Iceland,6,0,1932,10
2020-08-07,Iceland,20,0,1952,10
2020-08-08,Iceland,3,0,1955,10
2020-08-09,Iceland,3,0,1958,10
2020-08-10,Iceland,4,0,1962,10
2020-08-11,Iceland,6,0,1968,10
2020-08-12,Iceland,4,0,1972,10
2020-08-13,Iceland,4,0,1976,10
2020-08-14,Iceland,7,0,1983,10
2020-08-15,Iceland,16,0,1999,10
2020-08-16,Iceland,12,0,2011,10
2020-08-17,Iceland,3,0,2014,10
2020-08-18,Iceland,13,0,2027,10
2020-08-19,Iceland,8,0,2035,10
2020-08-20,Iceland,5,0,2040,10
2020-08-21,Iceland,10,0,2050,10
2020-08-22,Iceland,8,0,2058,10
2020-08-23,Iceland,6,0,2064,10
2020-08-24,Iceland,9,0,2073,10
2020-08-25,Iceland,4,0,2077,10
2020-08-26,Iceland,5,0,2082,10
2020-08-27,Iceland,5,0,2087,10
2020-08-28,Iceland,5,0,2092,10
2020-08-29,Iceland,8,0,2100,10
2020-08-30,Iceland,5,0,2105,10
2020-08-31,Iceland,2,0,2107,10
2020-09-01,Iceland,9,0,2116,10
2020-09-02,Iceland,5,0,2121,10
2020-09-03,Iceland,7,0,2128,10
2020-09-04,Iceland,7,0,2135,10
2020-09-05,Iceland,1,0,2136,10
2020-09-06,Iceland,5,0,2141,10
2020-09-07,Iceland,2,0,2143,10
2020-09-08,Iceland,7,0,2150,10
2020-09-09,Iceland,3,0,2153,10
2020-09-10,Iceland,4,0,2157,10
2020-09-11,Iceland,4,0,2161,10
2020-09-12,Iceland,1,0,2162,10
2020-09-13,Iceland,3,0,2165,10
2020-09-14,Iceland,3,0,2168,10
2020-09-15,Iceland,6,0,2174,10
2020-09-16,Iceland,15,0,2189,10
2020-09-17,Iceland,17,0,2206,10
2020-09-18,Iceland,24,0,2230,10
2020-09-19,Iceland,77,0,2307,10
2020-09-20,Iceland,0,0,2307,10
2020-09-21,Iceland,70,0,2377,10
2020-09-22,Iceland,42,0,2419,10
2020-09-23,Iceland,57,0,2476,10
2020-09-24,Iceland,36,0,2512,10
2020-09-25,Iceland,49,0,2561,10
2020-09-26,Iceland,40,0,2601,10
2020-09-27,Iceland,22,0,2623,10
2020-09-28,Iceland,40,0,2663,10
2020-09-29,Iceland,32,0,2695,10
2020-09-30,Iceland,33,0,2728,10
2020-10-01,Iceland,41,0,2769,10
2020-10-02,Iceland,40,0,2809,10
2020-10-03,Iceland,63,0,2872,10
2020-10-04,Iceland,49,0,2921,10
2020-10-05,Iceland,59,0,2980,10
2020-10-06,Iceland,101,0,3081,10
2020-10-07,Iceland,91,0,3172,10
2020-10-08,Iceland,95,0,3267,10
2020-10-09,Iceland,106,0,3373,10
2020-10-10,Iceland,87,0,3460,10
2020-10-11,Iceland,66,0,3526,10
2020-10-12,Iceland,56,0,3582,10
2020-10-13,Iceland,86,0,3668,10
2020-10-14,Iceland,89,0,3757,10
2020-10-15,Iceland,80,0,3837,10
2020-10-16,Iceland,92,1,3929,11
2020-10-17,Iceland,69,0,3998,11
2020-10-18,Iceland,57,0,4055,11
2020-10-19,Iceland,46,0,4101,11
2020-10-20,Iceland,92,0,4193,11
2020-10-21,Iceland,37,0,4230,11
2020-10-22,Iceland,38,0,4268,11
2020-10-23,Iceland,40,0,4308,11
2020-10-24,Iceland,86,0,4394,11
2020-10-25,Iceland,54,0,4448,11
2020-10-26,Iceland,56,0,4504,11
2020-10-27,Iceland,70,0,4574,11
2020-10-28,Iceland,97,1,4671,12
2020-10-29,Iceland,48,0,4719,12
2020-10-30,Iceland,78,0,4797,12
2020-10-31,Iceland,68,0,4865,12
2020-11-01,Iceland,25,0,4890,12
2020-11-02,Iceland,41,0,4931,12
2020-11-03,Iceland,26,5,4957,17
2020-11-04,Iceland,32,0,4989,17
2020-11-05,Iceland,28,1,5017,18
2020-11-06,Iceland,22,0,5039,18
2020-11-07,Iceland,24,0,5063,18
2020-11-08,Iceland,15,2,5078,20
2020-11-09,Iceland,23,3,5101,23
2020-11-10,Iceland,13,1,5114,24
2020-11-11,Iceland,28,0,5142,24
2020-11-12,Iceland,18,1,5160,25
2020-11-13,Iceland,10,0,5170,25
2020-11-14,Iceland,16,0,5186,25
2020-11-15,Iceland,3,0,5189,25
2020-11-16,Iceland,16,0,5205,25
2020-11-17,Iceland,10,0,5215,25
2020-11-18,Iceland,11,0,5226,25
2020-11-19,Iceland,5,0,5231,25
2020-11-20,Iceland,20,1,5251,26
2020-11-21,Iceland,18,0,5269,26
2020-11-22,Iceland,8,0,5277,26
2020-11-23,Iceland,12,0,5289,26
2020-11-24,Iceland,9,0,5298,26
2020-11-25,Iceland,14,0,5312,26
2020-11-26,Iceland,11,0,5323,26
2020-11-27,Iceland,23,0,5346,26
2020-11-28,Iceland,25,0,5371,26
2020-11-29,Iceland,10,0,5381,26
2020-11-30,Iceland,11,0,5392,26
2020-12-01,Iceland,21,1,5413,27
2020-12-02,Iceland,0,0,5413,27
2020-12-03,Iceland,35,0,5448,27
2020-12-04,Iceland,14,0,5462,27
2020-12-05,Iceland,14,0,5476,27
2020-12-06,Iceland,6,0,5482,27
2020-12-07,Iceland,14,0,5496,27
2020-12-08,Iceland,10,1,5506,28
2020-12-09,Iceland,10,0,5516,28
2020-12-10,Iceland,8,0,5524,28
2020-12-11,Iceland,15,0,5539,28
2020-12-12,Iceland,13,0,5552,28
2020-12-13,Iceland,5,0,5557,28
2020-12-14,Iceland,7,0,5564,28
2020-12-15,Iceland,7,0,5571,28
2020-12-16,Iceland,7,0,5578,28
2020-12-17,Iceland,10,0,5588,28
2020-12-18,Iceland,16,0,5604,28
2020-12-19,Iceland,17,0,5621,28
2020-12-20,Iceland,21,0,5642,28
2020-12-21,Iceland,14,0,5656,28
2020-12-22,Iceland,11,0,5667,28
2020-12-23,Iceland,16,0,5683,28
2020-12-24,Iceland,0,0,5683,28
2020-12-25,Iceland,0,0,5683,28
2020-12-26,Iceland,0,0,5683,28
2020-12-27,Iceland,0,0,5683,28
2020-12-28,Iceland,43,0,5726,28
2020-12-29,Iceland,10,1,5736,29
2020-12-30,Iceland,18,0,5754,29
2020-12-31,Iceland,0,0,5754,29
2021-01-01,Iceland,0,0,5754,29
2021-01-02,Iceland,0,0,5754,29
2021-01-03,Iceland,0,0,5754,29
2021-01-04,Iceland,41,0,5795,29
2021-01-05,Iceland,16,0,5811,29
2021-01-06,Iceland,21,0,5832,29
2021-01-07,Iceland,13,0,5845,29
2021-01-08,Iceland,22,0,5867,29
2021-01-09,Iceland,13,0,5880,29
2021-01-10,Iceland,10,0,5890,29
2021-01-11,Iceland,8,0,5898,29
2021-01-12,Iceland,14,0,5912,29
2021-01-13,Iceland,23,0,5935,29
2021-01-14,Iceland,13,0,5948,29
2021-01-15,Iceland,8,0,5956,29
2021-01-16,Iceland,0,0,5956,29
2021-01-17,Iceland,0,0,5956,29
2021-01-18,Iceland,14,0,5970,29
2021-01-19,Iceland,0,0,5970,29
2021-01-20,Iceland,5,0,5975,29
2021-01-21,Iceland,6,0,5981,29
2021-01-22,Iceland,0,0,5981,29
2021-01-23,Iceland,0,0,5981,29
2021-01-24,Iceland,0,0,5981,29
2021-01-25,Iceland,9,0,5990,29
2021-01-26,Iceland,2,0,5992,29
2021-01-27,Iceland,8,0,6000,29
2021-01-28,Iceland,1,0,6001,29
2021-01-29,Iceland,1,0,6002,29
2021-01-30,Iceland,0,0,6002,29
2021-01-31,Iceland,0,0,6002,29
2021-02-01,Iceland,7,0,6009,29
2021-02-02,Iceland,2,0,6011,29
2021-02-03,Iceland,2,0,6013,29
2021-02-04,Iceland,3,0,6016,29
2021-02-05,Iceland,5,0,6021,29
2021-02-06,Iceland,0,0,6021,29
2021-02-07,Iceland,0,0,6021,29
2021-02-08,Iceland,-1,0,6020,29
2021-02-09,Iceland,5,0,6025,29
2021-02-10,Iceland,1,0,6026,29
2021-02-11,Iceland,0,0,6026,29
2021-02-12,Iceland,7,0,6033,29
2021-02-13,Iceland,0,0,6033,29
2021-02-14,Iceland,0,0,6033,29
2021-02-15,Iceland,6,0,6039,29
2021-02-16,Iceland,0,0,6039,29
2021-02-17,Iceland,5,0,6044,29
2021-02-18,Iceland,0,0,6044,29
2021-02-19,Iceland,1,0,6045,29
2021-02-20,Iceland,0,0,6045,29
2021-02-21,Iceland,0,0,6045,29
2021-02-22,Iceland,4,0,6049,29
2021-02-23,Iceland,0,0,6049,29
2021-02-24,Iceland,0,0,6049,29
2021-02-25,Iceland,0,0,6049,29
2021-02-26,Iceland,0,0,6049,29
2021-02-27,Iceland,0,0,6049,29
2021-02-28,Iceland,0,0,6049,29
2021-03-01,Iceland,5,0,6054,29
2021-03-02,Iceland,1,0,6055,29
2021-03-03,Iceland,3,0,6058,29
2021-03-04,Iceland,0,0,6058,29
2021-03-05,Iceland,1,0,6059,29
2021-03-06,Iceland,0,0,6059,29
2021-03-07,Iceland,0,0,6059,29
2021-03-08,Iceland,5,0,6064,29
2021-03-09,Iceland,3,0,6067,29
2021-03-10,Iceland,2,0,6069,29
2021-03-11,Iceland,1,0,6070,29
2021-03-12,Iceland,2,0,6072,29
2021-03-13,Iceland,0,0,6072,29
2021-03-14,Iceland,0,0,6072,29
2021-03-15,Iceland,11,0,6083,29
2021-03-16,Iceland,4,0,6087,29
2021-03-17,Iceland,2,0,6089,29
2021-03-18,Iceland,2,0,6091,29
2021-03-19,Iceland,6,0,6097,29
2021-03-20,Iceland,0,0,6097,29
2021-03-21,Iceland,0,0,6097,29
2021-03-22,Iceland,22,0,6119,29
2021-03-23,Iceland,3,0,6122,29
2021-03-24,Iceland,22,0,6144,29
2021-03-25,Iceland,14,0,6158,29
2021-03-26,Iceland,5,0,6163,29
2021-03-27,Iceland,0,0,6163,29
2021-03-28,Iceland,0,0,6163,29
2021-03-29,Iceland,20,0,6183,29
2021-03-30,Iceland,11,0,6194,29
2021-03-31,Iceland,11,0,6205,29
2021-04-01,Iceland,0,0,6205,29
2021-04-02,Iceland,0,0,6205,29
2021-04-03,Iceland,20,0,6225,29
2021-04-04,Iceland,0,0,6225,29
2021-04-05,Iceland,0,0,6225,29
2021-04-06,Iceland,16,0,6241,29
2021-04-07,Iceland,10,0,6251,29
2021-04-08,Iceland,5,0,6256,29
2020-01-30,India,1,0,1,0
2020-01-31,India,0,0,1,0
2020-02-01,India,0,0,1,0
2020-02-02,India,1,0,2,0
2020-02-03,India,1,0,3,0
2020-02-04,India,0,0,3,0
2020-02-05,India,0,0,3,0
2020-02-06,India,0,0,3,0
2020-02-07,India,0,0,3,0
2020-02-08,India,0,0,3,0
2020-02-09,India,0,0,3,0
2020-02-10,India,0,0,3,0
2020-02-11,India,0,0,3,0
2020-02-12,India,0,0,3,0
2020-02-13,India,0,0,3,0
2020-02-14,India,0,0,3,0
2020-02-15,India,0,0,3,0
2020-02-16,India,0,0,3,0
2020-02-17,India,0,0,3,0
2020-02-18,India,0,0,3,0
2020-02-19,India,0,0,3,0
2020-02-20,India,0,0,3,0
2020-02-21,India,0,0,3,0
2020-02-22,India,0,0,3,0
2020-02-23,India,0,0,3,0
2020-02-24,India,0,0,3,0
2020-02-25,India,0,0,3,0
2020-02-26,India,0,0,3,0
2020-02-27,India,0,0,3,0
2020-02-28,India,0,0,3,0
2020-02-29,India,0,0,3,0
2020-03-01,India,0,0,3,0
2020-03-02,India,2,0,5,0
2020-03-03,India,0,0,5,0
2020-03-04,India,23,0,28,0
2020-03-05,India,2,0,30,0
2020-03-06,India,1,0,31,0
2020-03-07,India,3,0,34,0
2020-03-08,India,5,0,39,0
2020-03-09,India,4,0,43,0
2020-03-10,India,13,0,56,0
2020-03-11,India,6,1,62,1
2020-03-12,India,11,0,73,1
2020-03-13,India,9,1,82,2
2020-03-14,India,20,0,102,2
2020-03-15,India,11,0,113,2
2020-03-16,India,6,0,119,2
2020-03-17,India,23,1,142,3
2020-03-18,India,14,0,156,3
2020-03-19,India,38,1,194,4
2020-03-20,India,50,1,244,5
2020-03-21,India,86,-1,330,4
2020-03-22,India,66,3,396,7
2020-03-23,India,103,3,499,10
2020-03-24,India,37,0,536,10
2020-03-25,India,121,2,657,12
2020-03-26,India,70,8,727,20
2020-03-27,India,160,0,887,20
2020-03-28,India,100,4,987,24
2020-03-29,India,37,3,1024,27
2020-03-30,India,227,5,1251,32
2020-03-31,India,146,3,1397,35
2020-04-01,India,601,23,1998,58
2020-04-02,India,545,14,2543,72
2020-04-03,India,24,0,2567,72
2020-04-04,India,515,14,3082,86
2020-04-05,India,506,13,3588,99
2020-04-06,India,1190,37,4778,136
2020-04-07,India,533,14,5311,150
2020-04-08,India,605,28,5916,178
2020-04-09,India,809,48,6725,226
2020-04-10,India,873,20,7598,246
2020-04-11,India,848,42,8446,288
2020-04-12,India,759,43,9205,331
2020-04-13,India,1248,27,10453,358
2020-04-14,India,1034,35,11487,393
2020-04-15,India,835,12,12322,405
2020-04-16,India,1108,43,13430,448
2020-04-17,India,922,38,14352,486
2020-04-18,India,1370,35,15722,521
2020-04-19,India,1893,38,17615,559
2020-04-20,India,924,33,18539,592
2020-04-21,India,1541,53,20080,645
2020-04-22,India,1290,36,21370,681
2020-04-23,India,1707,40,23077,721
2020-04-24,India,1453,59,24530,780
2020-04-25,India,1753,45,26283,825
2020-04-26,India,1607,56,27890,881
2020-04-27,India,1561,58,29451,939
2020-04-28,India,1873,69,31324,1008
2020-04-29,India,1738,71,33062,1079
2020-04-30,India,1801,75,34863,1154
2020-05-01,India,2394,69,37257,1223
2020-05-02,India,2442,100,39699,1323
2020-05-03,India,2806,68,42505,1391
2020-05-04,India,3932,175,46437,1566
2020-05-05,India,2963,127,49400,1693
2020-05-06,India,3587,92,52987,1785
2020-05-07,India,3364,104,56351,1889
2020-05-08,India,3344,96,59695,1985
2020-05-09,India,3113,116,62808,2101
2020-05-10,India,4353,111,67161,2212
2020-05-11,India,3607,82,70768,2294
2020-05-12,India,3524,121,74292,2415
2020-05-13,India,3763,136,78055,2551
2020-05-14,India,3942,98,81997,2649
2020-05-15,India,3787,104,85784,2753
2020-05-16,India,4864,118,90648,2871
2020-05-17,India,5050,154,95698,3025
2020-05-18,India,4630,131,100328,3156
2020-05-19,India,6147,146,106475,3302
2020-05-20,India,5553,132,112028,3434
2020-05-21,India,6198,150,118226,3584
2020-05-22,India,6568,142,124794,3726
2020-05-23,India,6629,142,131423,3868
2020-05-24,India,7113,156,138536,4024
2020-05-25,India,6414,148,144950,4172
2020-05-26,India,5843,172,150793,4344
2020-05-27,India,7293,190,158086,4534
2020-05-28,India,7300,177,165386,4711
2020-05-29,India,8105,269,173491,4980
2020-05-30,India,8336,205,181827,5185
2020-05-31,India,8782,223,190609,5408
2020-06-01,India,7761,200,198370,5608
2020-06-02,India,8821,221,207191,5829
2020-06-03,India,9633,259,216824,6088
2020-06-04,India,9889,275,226713,6363
2020-06-05,India,9471,286,236184,6649
2020-06-06,India,10438,297,246622,6946
2020-06-07,India,10864,261,257486,7207
2020-06-08,India,8442,266,265928,7473
2020-06-09,India,10218,277,276146,7750
2020-06-10,India,10459,352,286605,8102
2020-06-11,India,10930,396,297535,8498
2020-06-12,India,11458,386,308993,8884
2020-06-13,India,11929,311,320922,9195
2020-06-14,India,11502,325,332424,9520
2020-06-15,India,10667,380,343091,9900
2020-06-16,India,10974,2003,354065,11903
2020-06-17,India,12881,334,366946,12237
2020-06-18,India,13586,336,380532,12573
2020-06-19,India,14516,375,395048,12948
2020-06-20,India,15403,306,410451,13254
2020-06-21,India,14831,445,425282,13699
2020-06-22,India,14933,312,440215,14011
2020-06-23,India,15968,465,456183,14476
2020-06-24,India,16922,418,473105,14894
2020-06-25,India,17296,407,490401,15301
2020-06-26,India,18552,384,508953,15685
2020-06-27,India,19906,410,528859,16095
2020-06-28,India,19459,380,548318,16475
2020-06-29,India,18522,418,566840,16893
2020-06-30,India,18641,507,585481,17400
2020-07-01,India,19160,434,604641,17834
2020-07-02,India,20903,379,625544,18213
2020-07-03,India,22771,442,648315,18655
2020-07-04,India,24850,613,673165,19268
2020-07-05,India,24248,425,697413,19693
2020-07-06,India,22251,466,719664,20159
2020-07-07,India,22753,483,742417,20642
2020-07-08,India,24879,487,767296,21129
2020-07-09,India,26506,475,793802,21604
2020-07-10,India,27114,519,820916,22123
2020-07-11,India,28606,550,849522,22673
2020-07-12,India,28732,501,878254,23174
2020-07-13,India,28498,553,906752,23727
2020-07-14,India,29429,582,936181,24309
2020-07-15,India,32676,605,968857,24914
2020-07-16,India,34975,688,1003832,25602
2020-07-17,India,35252,671,1039084,26273
2020-07-18,India,38697,543,1077781,26816
2020-07-19,India,40425,681,1118206,27497
2020-07-20,India,37132,585,1155338,28082
2020-07-21,India,37740,650,1193078,28732
2020-07-22,India,45720,1129,1238798,29861
2020-07-23,India,49310,740,1288108,30601
2020-07-24,India,48916,757,1337024,31358
2020-07-25,India,48611,702,1385635,32060
2020-07-26,India,49981,711,1435616,32771
2020-07-27,India,44457,637,1480073,33408
2020-07-28,India,51596,785,1531669,34193
2020-07-29,India,50294,762,1581963,34955
2020-07-30,India,52783,763,1634746,35718
2020-07-31,India,61242,793,1695988,36511
2020-08-01,India,54735,853,1750723,37364
2020-08-02,India,52972,771,1803695,38135
2020-08-03,India,52050,803,1855745,38938
2020-08-04,India,52509,857,1908254,39795
2020-08-05,India,56282,904,1964536,40699
2020-08-06,India,62538,886,2027074,41585
2020-08-07,India,61537,933,2088611,42518
2020-08-08,India,64399,861,2153010,43379
2020-08-09,India,62064,1007,2215074,44386
2020-08-10,India,53601,871,2268675,45257
2020-08-11,India,60963,834,2329638,46091
2020-08-12,India,66999,942,2396637,47033
2020-08-13,India,64553,1007,2461190,48040
2020-08-14,India,64732,996,2525922,49036
2020-08-15,India,64030,944,2589952,49980
2020-08-16,India,57711,941,2647663,50921
2020-08-17,India,55018,876,2702681,51797
2020-08-18,India,64572,1091,2767253,52888
2020-08-19,India,69672,978,2836925,53866
2020-08-20,India,68900,983,2905825,54849
2020-08-21,India,69876,945,2975701,55794
2020-08-22,India,69239,912,3044940,56706
2020-08-23,India,61408,836,3106348,57542
2020-08-24,India,60975,848,3167323,58390
2020-08-25,India,57224,967,3224547,59357
2020-08-26,India,85687,1115,3310234,60472
2020-08-27,India,77266,1057,3387500,61529
2020-08-28,India,76472,1021,3463972,62550
2020-08-29,India,78761,948,3542733,63498
2020-08-30,India,78512,971,3621245,64469
2020-08-31,India,69921,819,3691166,65288
2020-09-01,India,78357,1045,3769523,66333
2020-09-02,India,83883,1043,3853406,67376
2020-09-03,India,83341,1096,3936747,68472
2020-09-04,India,86432,1089,4023179,69561
2020-09-05,India,90632,1065,4113811,70626
2020-09-06,India,90802,1016,4204613,71642
2020-09-07,India,75809,1133,4280422,72775
2020-09-08,India,89706,1115,4370128,73890
2020-09-09,India,95735,1172,4465863,75062
2020-09-10,India,96551,1209,4562414,76271
2020-09-11,India,97570,1201,4659984,77472
2020-09-12,India,94372,1114,4754356,78586
2020-09-13,India,92071,1136,4846427,79722
2020-09-14,India,83809,1054,4930236,80776
2020-09-15,India,90123,1290,5020359,82066
2020-09-16,India,97894,1132,5118253,83198
2020-09-17,India,96424,1174,5214677,84372
2020-09-18,India,93337,1247,5308014,85619
2020-09-19,India,92605,1133,5400619,86752
2020-09-20,India,86961,1130,5487580,87882
2020-09-21,India,75083,1053,5562663,88935
2020-09-22,India,83347,1085,5646010,90020
2020-09-23,India,86508,1129,5732518,91149
2020-09-24,India,86052,1141,5818570,92290
2020-09-25,India,85362,1089,5903932,93379
2020-09-26,India,88600,1124,5992532,94503
2020-09-27,India,82170,1039,6074702,95542
2020-09-28,India,70589,776,6145291,96318
2020-09-29,India,80472,1179,6225763,97497
2020-09-30,India,86821,1181,6312584,98678
2020-10-01,India,81484,1095,6394068,99773
2020-10-02,India,79476,1069,6473544,100842
2020-10-03,India,75829,940,6549373,101782
2020-10-04,India,74442,903,6623815,102685
2020-10-05,India,61267,884,6685082,103569
2020-10-06,India,72049,986,6757131,104555
2020-10-07,India,78524,971,6835655,105526
2020-10-08,India,70496,964,6906151,106490
2020-10-09,India,73272,926,6979423,107416
2020-10-10,India,74383,918,7053806,108334
2020-10-11,India,66732,816,7120538,109150
2020-10-12,India,55342,706,7175880,109856
2020-10-13,India,63509,730,7239389,110586
2020-10-14,India,67708,680,7307097,111266
2020-10-15,India,63371,895,7370468,112161
2020-10-16,India,62212,837,7432680,112998
2020-10-17,India,61871,1033,7494551,114031
2020-10-18,India,55722,579,7550273,114610
2020-10-19,India,46790,587,7597063,115197
2020-10-20,India,54044,717,7651107,115914
2020-10-21,India,55839,702,7706946,116616
2020-10-22,India,54366,690,7761312,117306
2020-10-23,India,53370,650,7814682,117956
2020-10-24,India,50129,578,7864811,118534
2020-10-25,India,45148,480,7909959,119014
2020-10-26,India,36470,488,7946429,119502
2020-10-27,India,43893,508,7990322,120010
2020-10-28,India,49881,517,8040203,120527
2020-10-29,India,48648,563,8088851,121090
2020-10-30,India,48268,551,8137119,121641
2020-10-31,India,46963,470,8184082,122111
2020-11-01,India,45231,496,8229313,122607
2020-11-02,India,38310,490,8267623,123097
2020-11-03,India,46253,514,8313876,123611
2020-11-04,India,50210,704,8364086,124315
2020-11-05,India,47638,670,8411724,124985
2020-11-06,India,50356,577,8462080,125562
2020-11-07,India,45674,559,8507754,126121
2020-11-08,India,45903,490,8553657,126611
2020-11-09,India,38073,448,8591730,127059
2020-11-10,India,44281,512,8636011,127571
2020-11-11,India,47905,550,8683916,128121
2020-11-12,India,44879,547,8728795,128668
2020-11-13,India,44684,520,8773479,129188
2020-11-14,India,41100,447,8814579,129635
2020-11-15,India,30548,435,8845127,130070
2020-11-16,India,29163,449,8874290,130519
2020-11-17,India,38617,474,8912907,130993
2020-11-18,India,45576,585,8958483,131578
2020-11-19,India,45882,584,9004365,132162
2020-11-20,India,46232,564,9050597,132726
2020-11-21,India,45209,501,9095806,133227
2020-11-22,India,44059,511,9139865,133738
2020-11-23,India,37975,480,9177840,134218
2020-11-24,India,44376,481,9222216,134699
2020-11-25,India,44489,524,9266705,135223
2020-11-26,India,43082,492,9309787,135715
2020-11-27,India,41322,485,9351109,136200
2020-11-28,India,41810,496,9392919,136696
2020-11-29,India,38772,443,9431691,137139
2020-11-30,India,31118,482,9462809,137621
2020-12-01,India,36604,501,9499413,138122
2020-12-02,India,35551,526,9534964,138648
2020-12-03,India,36595,540,9571559,139188
2020-12-04,India,36652,512,9608211,139700
2020-12-05,India,36011,482,9644222,140182
2020-12-06,India,32981,391,9677203,140573
2020-12-07,India,26567,385,9703770,140958
2020-12-08,India,32080,402,9735850,141360
2020-12-09,India,31521,412,9767371,141772
2020-12-10,India,29373,413,9796744,142185
2020-12-11,India,30031,443,9826775,142628
2020-12-12,India,30254,391,9857029,143019
2020-12-13,India,27071,336,9884100,143355
2020-12-14,India,22065,354,9906165,143709
2020-12-15,India,26382,387,9932547,144096
2020-12-16,India,24010,355,9956557,144451
2020-12-17,India,22890,338,9979447,144789
2020-12-18,India,25152,347,10004599,145136
2020-12-19,India,26624,341,10031223,145477
2020-12-20,India,24337,333,10055560,145810
2020-12-21,India,19556,301,10075116,146111
2020-12-22,India,23950,333,10099066,146444
2020-12-23,India,24712,312,10123778,146756
2020-12-24,India,23067,336,10146845,147092
2020-12-25,India,22273,251,10169118,147343
2020-12-26,India,18732,279,10187850,147622
2020-12-27,India,20021,279,10207871,147901
2020-12-28,India,16432,252,10224303,148153
2020-12-29,India,20549,286,10244852,148439
2020-12-30,India,21822,299,10266674,148738
2020-12-31,India,0,0,10266674,148738
2021-01-01,India,20035,256,10286709,148994
2021-01-02,India,37256,441,10323965,149435
2021-01-03,India,16504,214,10340469,149649
2021-01-04,India,16375,201,10356844,149850
2021-01-05,India,18088,264,10374932,150114
2021-01-06,India,20346,222,10395278,150336
2021-01-07,India,18139,234,10413417,150570
2021-01-08,India,0,0,10413417,150570
2021-01-09,India,36867,429,10450284,150999
2021-01-10,India,16311,161,10466595,151160
2021-01-11,India,12584,167,10479179,151327
2021-01-12,India,15968,202,10495147,151529
2021-01-13,India,16946,198,10512093,151727
2021-01-14,India,15590,191,10527683,151918
2021-01-15,India,15158,175,10542841,152093
2021-01-16,India,15144,181,10557985,152274
2021-01-17,India,13788,145,10571773,152419
2021-01-18,India,10050,137,10581823,152556
2021-01-19,India,13816,162,10595639,152718
2021-01-20,India,15244,151,10610883,152869
2021-01-21,India,14545,163,10625428,153032
2021-01-22,India,14256,152,10639684,153184
2021-01-23,India,14849,155,10654533,153339
2021-01-24,India,13203,131,10667736,153470
2021-01-25,India,9102,117,10676838,153587
2021-01-26,India,12689,137,10689527,153724
2021-01-27,India,11666,123,10701193,153847
2021-01-28,India,18855,163,10720048,154010
2021-01-29,India,13082,137,10733130,154147
2021-01-30,India,13044,127,10746174,154274
2021-01-31,India,11436,118,10757610,154392
2021-02-01,India,8635,94,10766245,154486
2021-02-02,India,11039,110,10777284,154596
2021-02-03,India,12899,107,10790183,154703
2021-02-04,India,12408,120,10802591,154823
2021-02-05,India,11713,95,10814304,154918
2021-02-06,India,12059,78,10826363,154996
2021-02-07,India,11831,84,10838194,155080
2021-02-08,India,9110,78,10847304,155158
2021-02-09,India,11067,94,10858371,155252
2021-02-10,India,12923,108,10871294,155360
2021-02-11,India,9309,87,10880603,155447
2021-02-12,India,12143,103,10892746,155550
2021-02-13,India,12194,92,10904940,155642
2021-02-14,India,11649,90,10916589,155732
2021-02-15,India,9121,81,10925710,155813
2021-02-16,India,11610,100,10937320,155913
2021-02-17,India,12881,101,10950201,156014
2021-02-18,India,13193,97,10963394,156111
2021-02-19,India,13993,101,10977387,156212
2021-02-20,India,14264,90,10991651,156302
2021-02-21,India,14199,83,11005850,156385
2021-02-22,India,10584,78,11016434,156463
2021-02-23,India,13742,104,11030176,156567
2021-02-24,India,16738,138,11046914,156705
2021-02-25,India,16577,120,11063491,156825
2021-02-26,India,16488,113,11079979,156938
2021-02-27,India,16752,113,11096731,157051
2021-02-28,India,15510,106,11112241,157157
2021-03-01,India,12286,91,11124527,157248
2021-03-02,India,14989,98,11139516,157346
2021-03-03,India,17407,89,11156923,157435
2021-03-04,India,16838,113,11173761,157548
2021-03-05,India,18284,108,11192045,157656
2021-03-06,India,18754,100,11210799,157756
2021-03-07,India,18599,97,11229398,157853
2021-03-08,India,15388,77,11244786,157930
2021-03-09,India,17921,133,11262707,158063
2021-03-10,India,22854,126,11285561,158189
2021-03-11,India,23285,117,11308846,158306
2021-03-12,India,24882,140,11333728,158446
2021-03-13,India,25320,161,11359048,158607
2021-03-14,India,26291,118,11385339,158725
2021-03-15,India,24492,131,11409831,158856
2021-03-16,India,28903,188,11438734,159044
2021-03-17,India,35871,172,11474605,159216
2021-03-18,India,39726,154,11514331,159370
2021-03-19,India,40953,188,11555284,159558
2021-03-20,India,43846,197,11599130,159755
2021-03-21,India,46951,212,11646081,159967
2021-03-22,India,40715,199,11686796,160166
2021-03-23,India,47262,275,11734058,160441
2021-03-24,India,53476,251,11787534,160692
2021-03-25,India,59118,257,11846652,160949
2021-03-26,India,62258,291,11908910,161240
2021-03-27,India,62714,312,11971624,161552
2021-03-28,India,68020,291,12039644,161843
2021-03-29,India,56211,271,12095855,162114
2021-03-30,India,53480,354,12149335,162468
2021-03-31,India,72330,459,12221665,162927
2021-04-01,India,81466,469,12303131,163396
2021-04-02,India,89129,714,12392260,164110
2021-04-03,India,93249,513,12485509,164623
2021-04-04,India,103558,478,12589067,165101
2021-04-05,India,96982,446,12686049,165547
2021-04-06,India,115736,630,12801785,166177
2021-04-07,India,126789,685,12928574,166862
2021-04-08,India,131968,780,13060542,167642
2020-03-02,Indonesia,2,0,2,0
2020-03-03,Indonesia,0,0,2,0
2020-03-04,Indonesia,0,0,2,0
2020-03-05,Indonesia,0,0,2,0
2020-03-06,Indonesia,2,0,4,0
2020-03-07,Indonesia,0,0,4,0
2020-03-08,Indonesia,2,0,6,0
2020-03-09,Indonesia,13,0,19,0
2020-03-10,Indonesia,8,0,27,0
2020-03-11,Indonesia,7,1,34,1
2020-03-12,Indonesia,0,0,34,1
2020-03-13,Indonesia,35,3,69,4
2020-03-14,Indonesia,27,1,96,5
2020-03-15,Indonesia,21,0,117,5
2020-03-16,Indonesia,17,0,134,5
2020-03-17,Indonesia,38,0,172,5
2020-03-18,Indonesia,55,14,227,19
2020-03-19,Indonesia,84,6,311,25
2020-03-20,Indonesia,58,7,369,32
2020-03-21,Indonesia,81,6,450,38
2020-03-22,Indonesia,64,10,514,48
2020-03-23,Indonesia,65,1,579,49
2020-03-24,Indonesia,107,6,686,55
2020-03-25,Indonesia,104,3,790,58
2020-03-26,Indonesia,103,20,893,78
2020-03-27,Indonesia,153,9,1046,87
2020-03-28,Indonesia,109,15,1155,102
2020-03-29,Indonesia,130,12,1285,114
2020-03-30,Indonesia,129,8,1414,122
2020-03-31,Indonesia,114,14,1528,136
2020-04-01,Indonesia,149,21,1677,157
2020-04-02,Indonesia,113,13,1790,170
2020-04-03,Indonesia,196,11,1986,181
2020-04-04,Indonesia,106,10,2092,191
2020-04-05,Indonesia,181,7,2273,198
2020-04-06,Indonesia,218,11,2491,209
2020-04-07,Indonesia,247,12,2738,221
2020-04-08,Indonesia,218,19,2956,240
2020-04-09,Indonesia,337,40,3293,280
2020-04-10,Indonesia,219,26,3512,306
2020-04-11,Indonesia,330,21,3842,327
2020-04-12,Indonesia,399,46,4241,373
2020-04-13,Indonesia,316,26,4557,399
2020-04-14,Indonesia,282,60,4839,459
2020-04-15,Indonesia,297,10,5136,469
2020-04-16,Indonesia,380,27,5516,496
2020-04-17,Indonesia,407,24,5923,520
2020-04-18,Indonesia,325,15,6248,535
2020-04-19,Indonesia,327,47,6575,582
2020-04-20,Indonesia,185,8,6760,590
2020-04-21,Indonesia,375,26,7135,616
2020-04-22,Indonesia,283,19,7418,635
2020-04-23,Indonesia,357,12,7775,647
2020-04-24,Indonesia,436,42,8211,689
2020-04-25,Indonesia,396,31,8607,720
2020-04-26,Indonesia,275,23,8882,743
2020-04-27,Indonesia,214,22,9096,765
2020-04-28,Indonesia,415,8,9511,773
2020-04-29,Indonesia,260,11,9771,784
2020-04-30,Indonesia,347,8,10118,792
2020-05-01,Indonesia,433,8,10551,800
2020-05-02,Indonesia,292,31,10843,831
2020-05-03,Indonesia,349,14,11192,845
2020-05-04,Indonesia,395,19,11587,864
2020-05-05,Indonesia,484,8,12071,872
2020-05-06,Indonesia,367,23,12438,895
2020-05-07,Indonesia,338,35,12776,930
2020-05-08,Indonesia,336,13,13112,943
2020-05-09,Indonesia,533,16,13645,959
2020-05-10,Indonesia,387,14,14032,973
2020-05-11,Indonesia,233,18,14265,991
2020-05-12,Indonesia,484,16,14749,1007
2020-05-13,Indonesia,689,21,15438,1028
2020-05-14,Indonesia,568,15,16006,1043
2020-05-15,Indonesia,490,33,16496,1076
2020-05-16,Indonesia,529,13,17025,1089
2020-05-17,Indonesia,489,59,17514,1148
2020-05-18,Indonesia,496,43,18010,1191
2020-05-19,Indonesia,486,30,18496,1221
2020-05-20,Indonesia,693,21,19189,1242
2020-05-21,Indonesia,973,36,20162,1278
2020-05-22,Indonesia,634,48,20796,1326
2020-05-23,Indonesia,949,25,21745,1351
2020-05-24,Indonesia,526,21,22271,1372
2020-05-25,Indonesia,479,19,22750,1391
2020-05-26,Indonesia,415,27,23165,1418
2020-05-27,Indonesia,686,55,23851,1473
2020-05-28,Indonesia,687,23,24538,1496
2020-05-29,Indonesia,678,24,25216,1520
2020-05-30,Indonesia,557,53,25773,1573
2020-05-31,Indonesia,700,40,26473,1613
2020-06-01,Indonesia,467,28,26940,1641
2020-06-02,Indonesia,609,22,27549,1663
2020-06-03,Indonesia,684,35,28233,1698
2020-06-04,Indonesia,585,23,28818,1721
2020-06-05,Indonesia,703,49,29521,1770
2020-06-06,Indonesia,993,31,30514,1801
2020-06-07,Indonesia,672,50,31186,1851
2020-06-08,Indonesia,847,32,32033,1883
2020-06-09,Indonesia,1043,40,33076,1923
2020-06-10,Indonesia,1240,36,34316,1959
2020-06-11,Indonesia,979,41,35295,2000
2020-06-12,Indonesia,1111,48,36406,2048
2020-06-13,Indonesia,1014,43,37420,2091
2020-06-14,Indonesia,857,43,38277,2134
2020-06-15,Indonesia,1017,64,39294,2198
2020-06-16,Indonesia,1106,33,40400,2231
2020-06-17,Indonesia,1031,45,41431,2276
2020-06-18,Indonesia,1331,63,42762,2339
2020-06-19,Indonesia,1041,34,43803,2373
2020-06-20,Indonesia,1226,56,45029,2429
2020-06-21,Indonesia,862,36,45891,2465
2020-06-22,Indonesia,954,35,46845,2500
2020-06-23,Indonesia,1051,35,47896,2535
2020-06-24,Indonesia,1113,38,49009,2573
2020-06-25,Indonesia,1178,47,50187,2620
2020-06-26,Indonesia,1240,63,51427,2683
2020-06-27,Indonesia,1385,37,52812,2720
2020-06-28,Indonesia,1198,34,54010,2754
2020-06-29,Indonesia,1082,51,55092,2805
2020-06-30,Indonesia,1293,71,56385,2876
2020-07-01,Indonesia,1385,58,57770,2934
2020-07-02,Indonesia,1624,53,59394,2987
2020-07-03,Indonesia,1301,49,60695,3036
2020-07-04,Indonesia,1447,53,62142,3089
2020-07-05,Indonesia,1607,82,63749,3171
2020-07-06,Indonesia,1209,70,64958,3241
2020-07-07,Indonesia,1268,68,66226,3309
2020-07-08,Indonesia,1853,50,68079,3359
2020-07-09,Indonesia,2657,58,70736,3417
2020-07-10,Indonesia,1611,52,72347,3469
2020-07-11,Indonesia,1671,66,74018,3535
2020-07-12,Indonesia,1681,71,75699,3606
2020-07-13,Indonesia,1282,50,76981,3656
2020-07-14,Indonesia,1591,54,78572,3710
2020-07-15,Indonesia,1522,87,80094,3797
2020-07-16,Indonesia,1574,76,81668,3873
2020-07-17,Indonesia,1462,84,83130,3957
2020-07-18,Indonesia,1752,59,84882,4016
2020-07-19,Indonesia,1639,127,86521,4143
2020-07-20,Indonesia,1693,96,88214,4239
2020-07-21,Indonesia,1655,81,89869,4320
2020-07-22,Indonesia,1882,139,91751,4459
2020-07-23,Indonesia,1906,117,93657,4576
2020-07-24,Indonesia,1761,89,95418,4665
2020-07-25,Indonesia,1868,49,97286,4714
2020-07-26,Indonesia,1492,67,98778,4781
2020-07-27,Indonesia,1525,57,100303,4838
2020-07-28,Indonesia,1748,63,102051,4901
2020-07-29,Indonesia,2381,74,104432,4975
2020-07-30,Indonesia,1904,83,106336,5058
2020-07-31,Indonesia,2040,73,108376,5131
2020-08-01,Indonesia,1560,62,109936,5193
2020-08-02,Indonesia,1519,43,111455,5236
2020-08-03,Indonesia,1679,66,113134,5302
2020-08-04,Indonesia,1922,86,115056,5388
2020-08-05,Indonesia,1815,64,116871,5452
2020-08-06,Indonesia,1882,69,118753,5521
2020-08-07,Indonesia,2473,72,121226,5593
2020-08-08,Indonesia,2277,65,123503,5658
2020-08-09,Indonesia,1893,65,125396,5723
2020-08-10,Indonesia,1687,42,127083,5765
2020-08-11,Indonesia,1693,59,128776,5824
2020-08-12,Indonesia,1942,79,130718,5903
2020-08-13,Indonesia,2098,65,132816,5968
2020-08-14,Indonesia,2307,53,135123,6021
2020-08-15,Indonesia,2345,50,137468,6071
2020-08-16,Indonesia,2081,79,139549,6150
2020-08-17,Indonesia,1821,57,141370,6207
2020-08-18,Indonesia,1673,70,143043,6277
2020-08-19,Indonesia,1902,69,144945,6346
2020-08-20,Indonesia,2266,72,147211,6418
2020-08-21,Indonesia,2197,82,149408,6500
2020-08-22,Indonesia,2090,94,151498,6594
2020-08-23,Indonesia,2037,86,153535,6680
2020-08-24,Indonesia,1877,79,155412,6759
2020-08-25,Indonesia,2447,99,157859,6858
2020-08-26,Indonesia,2306,86,160165,6944
2020-08-27,Indonesia,2719,120,162884,7064
2020-08-28,Indonesia,3003,105,165887,7169
2020-08-29,Indonesia,3308,92,169195,7261
2020-08-30,Indonesia,2858,82,172053,7343
2020-08-31,Indonesia,2743,74,174796,7417
2020-09-01,Indonesia,2775,88,177571,7505
2020-09-02,Indonesia,3075,111,180646,7616
2020-09-03,Indonesia,3622,134,184268,7750
2020-09-04,Indonesia,3269,82,187537,7832
2020-09-05,Indonesia,3128,108,190665,7940
2020-09-06,Indonesia,3444,85,194109,8025
2020-09-07,Indonesia,2880,105,196989,8130
2020-09-08,Indonesia,3046,100,200035,8230
2020-09-09,Indonesia,3307,106,203342,8336
2020-09-10,Indonesia,3861,120,207203,8456
2020-09-11,Indonesia,3737,88,210940,8544
2020-09-12,Indonesia,3806,106,214746,8650
2020-09-13,Indonesia,3636,73,218382,8723
2020-09-14,Indonesia,3141,118,221523,8841
2020-09-15,Indonesia,3507,124,225030,8965
2020-09-16,Indonesia,3963,135,228993,9100
2020-09-17,Indonesia,3635,122,232628,9222
2020-09-18,Indonesia,3891,114,236519,9336
2020-09-19,Indonesia,4168,112,240687,9448
2020-09-20,Indonesia,3989,105,244676,9553
2020-09-21,Indonesia,4176,124,248852,9677
2020-09-22,Indonesia,4071,160,252923,9837
2020-09-23,Indonesia,4465,140,257388,9977
2020-09-24,Indonesia,4634,128,262022,10105
2020-09-25,Indonesia,4823,113,266845,10218
2020-09-26,Indonesia,4494,90,271339,10308
2020-09-27,Indonesia,3874,78,275213,10386
2020-09-28,Indonesia,3509,87,278722,10473
2020-09-29,Indonesia,4002,128,282724,10601
2020-09-30,Indonesia,4284,139,287008,10740
2020-10-01,Indonesia,4174,116,291182,10856
2020-10-02,Indonesia,4317,116,295499,10972
2020-10-03,Indonesia,4007,83,299506,11055
2020-10-04,Indonesia,3992,96,303498,11151
2020-10-05,Indonesia,3622,102,307120,11253
2020-10-06,Indonesia,4056,121,311176,11374
2020-10-07,Indonesia,4538,98,315714,11472
2020-10-08,Indonesia,4850,108,320564,11580
2020-10-09,Indonesia,4094,97,324658,11677
2020-10-10,Indonesia,4294,88,328952,11765
2020-10-11,Indonesia,4497,79,333449,11844
2020-10-12,Indonesia,3267,91,336716,11935
2020-10-13,Indonesia,3906,92,340622,12027
2020-10-14,Indonesia,4127,129,344749,12156
2020-10-15,Indonesia,4411,112,349160,12268
2020-10-16,Indonesia,4301,79,353461,12347
2020-10-17,Indonesia,4301,84,357762,12431
2020-10-18,Indonesia,4105,80,361867,12511
2020-10-19,Indonesia,3373,106,365240,12617
2020-10-20,Indonesia,3602,117,368842,12734
2020-10-21,Indonesia,4267,123,373109,12857
2020-10-22,Indonesia,4432,102,377541,12959
2020-10-23,Indonesia,4369,118,381910,13077
2020-10-24,Indonesia,4070,128,385980,13205
2020-10-25,Indonesia,3732,94,389712,13299
2020-10-26,Indonesia,3222,112,392934,13411
2020-10-27,Indonesia,3520,101,396454,13512
2020-10-28,Indonesia,4029,100,400483,13612
2020-10-29,Indonesia,3565,89,404048,13701
2020-10-30,Indonesia,2897,81,406945,13782
2020-10-31,Indonesia,3143,87,410088,13869
2020-11-01,Indonesia,2696,74,412784,13943
2020-11-02,Indonesia,2618,101,415402,14044
2020-11-03,Indonesia,2973,102,418375,14146
2020-11-04,Indonesia,3356,113,421731,14259
2020-11-05,Indonesia,4065,89,425796,14348
2020-11-06,Indonesia,3778,94,429574,14442
2020-11-07,Indonesia,4262,98,433836,14540
2020-11-08,Indonesia,3880,74,437716,14614
2020-11-09,Indonesia,2853,75,440569,14689
2020-11-10,Indonesia,3779,72,444348,14761
2020-11-11,Indonesia,3770,75,448118,14836
2020-11-12,Indonesia,4173,97,452291,14933
2020-11-13,Indonesia,5444,104,457735,15037
2020-11-14,Indonesia,5272,111,463007,15148
2020-11-15,Indonesia,4106,63,467113,15211
2020-11-16,Indonesia,3535,85,470648,15296
2020-11-17,Indonesia,3807,97,474455,15393
2020-11-18,Indonesia,4265,110,478720,15503
2020-11-19,Indonesia,4798,97,483518,15600
2020-11-20,Indonesia,4792,78,488310,15678
2020-11-21,Indonesia,4998,96,493308,15774
2020-11-22,Indonesia,4360,110,497668,15884
2020-11-23,Indonesia,4442,118,502110,16002
2020-11-24,Indonesia,4192,109,506302,16111
2020-11-25,Indonesia,5534,114,511836,16225
2020-11-26,Indonesia,4917,127,516753,16352
2020-11-27,Indonesia,5828,169,522581,16521
2020-11-28,Indonesia,5418,125,527999,16646
2020-11-29,Indonesia,6267,169,534266,16815
2020-11-30,Indonesia,4617,130,538883,16945
2020-12-01,Indonesia,5092,136,543975,17081
2020-12-02,Indonesia,5533,118,549508,17199
2020-12-03,Indonesia,8369,156,557877,17355
2020-12-04,Indonesia,5803,124,563680,17479
2020-12-05,Indonesia,6027,110,569707,17589
2020-12-06,Indonesia,6089,151,575796,17740
2020-12-07,Indonesia,5754,127,581550,17867
2020-12-08,Indonesia,5292,133,586842,18000
2020-12-09,Indonesia,6058,171,592900,18171
2020-12-10,Indonesia,6033,165,598933,18336
2020-12-11,Indonesia,6310,175,605243,18511
2020-12-12,Indonesia,6388,142,611631,18653
2020-12-13,Indonesia,6189,166,617820,18819
2020-12-14,Indonesia,5489,137,623309,18956
2020-12-15,Indonesia,6120,155,629429,19111
2020-12-16,Indonesia,6725,137,636154,19248
2020-12-17,Indonesia,7354,142,643508,19390
2020-12-18,Indonesia,6689,124,650197,19514
2020-12-19,Indonesia,7751,145,657948,19659
2020-12-20,Indonesia,6982,221,664930,19880
2020-12-21,Indonesia,6848,205,671778,20085
2020-12-22,Indonesia,6347,172,678125,20257
2020-12-23,Indonesia,7514,151,685639,20408
2020-12-24,Indonesia,7199,181,692838,20589
2020-12-25,Indonesia,7259,258,700097,20847
2020-12-26,Indonesia,6740,147,706837,20994
2020-12-27,Indonesia,6528,243,713365,21237
2020-12-28,Indonesia,5854,215,719219,21452
2020-12-29,Indonesia,7903,251,727122,21703
2020-12-30,Indonesia,8002,241,735124,21944
2020-12-31,Indonesia,8074,194,743198,22138
2021-01-01,Indonesia,8072,191,751270,22329
2021-01-02,Indonesia,7203,226,758473,22555
2021-01-03,Indonesia,6877,179,765350,22734
2021-01-04,Indonesia,6753,177,772103,22911
2021-01-05,Indonesia,7445,198,779548,23109
2021-01-06,Indonesia,8854,187,788402,23296
2021-01-07,Indonesia,9321,224,797723,23520
2021-01-08,Indonesia,10617,233,808340,23753
2021-01-09,Indonesia,10046,194,818386,23947
2021-01-10,Indonesia,9640,182,828026,24129
2021-01-11,Indonesia,8692,214,836718,24343
2021-01-12,Indonesia,10047,302,846765,24645
2021-01-13,Indonesia,11278,306,858043,24951
2021-01-14,Indonesia,11557,295,869600,25246
2021-01-15,Indonesia,12818,238,882418,25484
2021-01-16,Indonesia,14224,283,896642,25767
2021-01-17,Indonesia,11287,220,907929,25987
2021-01-18,Indonesia,9086,295,917015,26282
2021-01-19,Indonesia,10365,308,927380,26590
2021-01-20,Indonesia,12568,267,939948,26857
2021-01-21,Indonesia,11703,346,951651,27203
2021-01-22,Indonesia,13632,250,965283,27453
2021-01-23,Indonesia,12191,211,977474,27664
2021-01-24,Indonesia,11788,171,989262,27835
2021-01-25,Indonesia,9994,297,999256,28132
2021-01-26,Indonesia,13094,336,1012350,28468
2021-01-27,Indonesia,11948,387,1024298,28855
2021-01-28,Indonesia,13695,476,1037993,29331
2021-01-29,Indonesia,13802,187,1051795,29518
2021-01-30,Indonesia,14518,210,1066313,29728
2021-01-31,Indonesia,12001,270,1078314,29998
2021-02-01,Indonesia,10994,279,1089308,30277
2021-02-02,Indonesia,10379,304,1099687,30581
2021-02-03,Indonesia,11984,189,1111671,30770
2021-02-04,Indonesia,11434,231,1123105,31001
2021-02-05,Indonesia,11749,201,1134854,31202
2021-02-06,Indonesia,12156,191,1147010,31393
2021-02-07,Indonesia,10827,163,1157837,31556
2021-02-08,Indonesia,8242,207,1166079,31763
2021-02-09,Indonesia,8700,213,1174779,31976
2021-02-10,Indonesia,8776,191,1183555,32167
2021-02-11,Indonesia,8435,214,1191990,32381
2021-02-12,Indonesia,9869,275,1201859,32656
2021-02-13,Indonesia,8844,280,1210703,32936
2021-02-14,Indonesia,6765,247,1217468,33183
2021-02-15,Indonesia,6462,184,1223930,33367
2021-02-16,Indonesia,10029,229,1233959,33596
2021-02-17,Indonesia,9687,192,1243646,33788
2021-02-18,Indonesia,9039,181,1252685,33969
2021-02-19,Indonesia,10614,183,1263299,34152
2021-02-20,Indonesia,8054,164,1271353,34316
2021-02-21,Indonesia,7300,173,1278653,34489
2021-02-22,Indonesia,10180,202,1288833,34691
2021-02-23,Indonesia,9775,323,1298608,35014
2021-02-24,Indonesia,7533,240,1306141,35254
2021-02-25,Indonesia,8493,264,1314634,35518
2021-02-26,Indonesia,8232,268,1322866,35786
2021-02-27,Indonesia,6208,195,1329074,35981
2021-02-28,Indonesia,5560,185,1334634,36166
2021-03-01,Indonesia,6680,159,1341314,36325
2021-03-02,Indonesia,5712,193,1347026,36518
2021-03-03,Indonesia,6808,203,1353834,36721
2021-03-04,Indonesia,7264,176,1361098,36897
2021-03-05,Indonesia,6971,129,1368069,37026
2021-03-06,Indonesia,5767,128,1373836,37154
2021-03-07,Indonesia,5826,112,1379662,37266
2021-03-08,Indonesia,6894,281,1386556,37547
2021-03-09,Indonesia,6389,210,1392945,37757
2021-03-10,Indonesia,5633,175,1398578,37932
2021-03-11,Indonesia,5144,117,1403722,38049
2021-03-12,Indonesia,6412,180,1410134,38229
2021-03-13,Indonesia,4607,100,1414741,38329
2021-03-14,Indonesia,4714,97,1419455,38426
2021-03-15,Indonesia,5589,147,1425044,38573
2021-03-16,Indonesia,5414,180,1430458,38753
2021-03-17,Indonesia,6825,162,1437283,38915
2021-03-18,Indonesia,6570,227,1443853,39142
2021-03-19,Indonesia,6279,197,1450132,39339
2021-03-20,Indonesia,5656,108,1455788,39447
2021-03-21,Indonesia,4396,103,1460184,39550
2021-03-22,Indonesia,5744,161,1465928,39711
2021-03-23,Indonesia,5297,154,1471225,39865
2021-03-24,Indonesia,5227,118,1476452,39983
2021-03-25,Indonesia,6107,98,1482559,40081
2021-03-26,Indonesia,4982,85,1487541,40166
2021-03-27,Indonesia,4461,198,1492002,40364
2021-03-28,Indonesia,4083,85,1496085,40449
2021-03-29,Indonesia,5008,132,1501093,40581
2021-03-30,Indonesia,4682,173,1505775,40754
2021-03-31,Indonesia,5937,104,1511712,40858
2021-04-01,Indonesia,6142,196,1517854,41054
2021-04-02,Indonesia,5325,97,1523179,41151
2021-04-03,Indonesia,4345,91,1527524,41242
2021-04-04,Indonesia,6731,427,1534255,41669
2021-04-05,Indonesia,3712,146,1537967,41815
2021-04-06,Indonesia,4549,162,1542516,41977
2021-04-07,Indonesia,4860,87,1547376,42064
2021-04-08,Indonesia,5504,163,1552880,42227
2020-02-07,International,61,0,61,0
2020-02-08,International,0,0,61,0
2020-02-09,International,3,0,64,0
2020-02-10,International,71,0,135,0
2020-02-11,International,0,0,135,0
2020-02-12,International,40,0,175,0
2020-02-13,International,0,0,175,0
2020-02-14,International,43,0,218,0
2020-02-15,International,67,0,285,0
2020-02-16,International,70,0,355,0
2020-02-17,International,99,0,454,0
2020-02-18,International,88,0,542,0
2020-02-19,International,79,0,621,0
2020-02-20,International,13,2,634,2
2020-02-21,International,0,0,634,2
2020-02-22,International,0,0,634,2
2020-02-23,International,57,1,691,3
2020-02-24,International,0,0,691,3
2020-02-25,International,0,0,691,3
2020-02-26,International,14,1,705,4
2020-02-27,International,0,0,705,4
2020-02-28,International,0,2,705,6
2020-02-29,International,0,0,705,6
2020-03-01,International,0,0,705,6
2020-03-02,International,0,0,705,6
2020-03-03,International,1,0,706,6
2020-03-04,International,0,0,706,6
2020-03-05,International,0,0,706,6
2020-03-06,International,0,0,706,6
2020-03-07,International,0,0,706,6
2020-03-08,International,0,0,706,6
2020-03-09,International,0,0,706,6
2020-03-10,International,0,0,706,6
2020-03-11,International,0,1,706,7
2020-03-12,International,0,0,706,7
2020-03-13,International,0,0,706,7
2020-03-14,International,0,0,706,7
2020-03-15,International,0,0,706,7
2020-03-16,International,0,0,706,7
2020-03-17,International,0,0,706,7
2020-03-18,International,6,0,712,7
2020-03-19,International,0,0,712,7
2020-03-20,International,0,0,712,7
2020-03-21,International,0,1,712,8
2020-03-22,International,0,0,712,8
2020-03-23,International,0,0,712,8
2020-03-24,International,0,2,712,10
2020-03-25,International,0,0,712,10
2020-03-26,International,0,0,712,10
2020-03-27,International,0,0,712,10
2020-03-28,International,2,0,714,10
2020-03-29,International,0,0,714,10
2020-03-30,International,0,0,714,10
2020-03-31,International,0,0,714,10
2020-04-01,International,7,3,721,13
2020-04-02,International,0,0,721,13
2020-04-03,International,0,0,721,13
2020-04-04,International,0,0,721,13
2020-04-05,International,0,0,721,13
2020-04-06,International,0,0,721,13
2020-04-07,International,0,0,721,13
2020-04-08,International,0,0,721,13
2020-04-09,International,0,0,721,13
2020-04-10,International,0,0,721,13
2020-04-11,International,0,0,721,13
2020-04-12,International,0,0,721,13
2020-04-13,International,0,0,721,13
2020-04-14,International,0,1,721,14
2020-04-15,International,0,0,721,14
2020-04-16,International,0,0,721,14
2020-04-17,International,0,1,721,15
2020-04-18,International,0,0,721,15
2020-04-19,International,0,0,721,15
2020-04-20,International,0,0,721,15
2020-04-21,International,0,0,721,15
2020-04-22,International,0,0,721,15
2020-04-23,International,0,0,721,15
2020-04-24,International,0,0,721,15
2020-04-25,International,0,0,721,15
2020-04-26,International,0,0,721,15
2020-04-27,International,0,0,721,15
2020-04-28,International,0,0,721,15
2020-04-29,International,0,0,721,15
2020-04-30,International,0,0,721,15
2020-05-01,International,0,0,721,15
2020-05-02,International,0,0,721,15
2020-05-03,International,0,0,721,15
2020-05-04,International,0,0,721,15
2020-05-05,International,0,0,721,15
2020-05-06,International,0,0,721,15
2020-05-07,International,0,0,721,15
2020-05-08,International,0,0,721,15
2020-05-09,International,0,0,721,15
2020-05-10,International,0,0,721,15
2020-05-11,International,0,0,721,15
2020-05-12,International,0,0,721,15
2020-05-13,International,0,0,721,15
2020-05-14,International,0,0,721,15
2020-05-15,International,0,0,721,15
2020-05-16,International,0,0,721,15
2020-05-17,International,0,0,721,15
2020-05-18,International,0,0,721,15
2020-05-19,International,0,0,721,15
2020-05-20,International,0,0,721,15
2020-05-21,International,0,0,721,15
2020-05-22,International,0,0,721,15
2020-05-23,International,0,0,721,15
2020-05-24,International,0,0,721,15
2020-05-25,International,0,0,721,15
2020-05-26,International,0,0,721,15
2020-05-27,International,0,0,721,15
2020-05-28,International,0,0,721,15
2020-05-29,International,0,0,721,15
2020-05-30,International,0,0,721,15
2020-05-31,International,0,0,721,15
2020-06-01,International,0,0,721,15
2020-06-02,International,0,0,721,15
2020-06-03,International,0,0,721,15
2020-06-04,International,0,0,721,15
2020-06-05,International,0,0,721,15
2020-06-06,International,0,0,721,15
2020-06-07,International,0,0,721,15
2020-06-08,International,0,0,721,15
2020-06-09,International,0,0,721,15
2020-06-10,International,0,0,721,15
2020-06-11,International,0,0,721,15
2020-06-12,International,0,0,721,15
2020-06-13,International,0,0,721,15
2020-06-14,International,0,0,721,15
2020-06-15,International,0,0,721,15
2020-06-16,International,0,0,721,15
2020-06-17,International,0,0,721,15
2020-06-18,International,0,0,721,15
2020-06-19,International,0,0,721,15
2020-06-20,International,0,0,721,15
2020-06-21,International,0,0,721,15
2020-06-22,International,0,0,721,15
2020-06-23,International,0,0,721,15
2020-06-24,International,0,0,721,15
2020-06-25,International,0,0,721,15
2020-06-26,International,0,0,721,15
2020-06-27,International,0,0,721,15
2020-06-28,International,0,0,721,15
2020-06-29,International,0,0,721,15
2020-06-30,International,0,0,721,15
2020-07-01,International,0,0,721,15
2020-07-02,International,0,0,721,15
2020-07-03,International,0,0,721,15
2020-07-04,International,0,0,721,15
2020-07-05,International,0,0,721,15
2020-07-06,International,0,0,721,15
2020-07-07,International,0,0,721,15
2020-07-08,International,0,0,721,15
2020-07-09,International,0,0,721,15
2020-07-10,International,0,0,721,15
2020-07-11,International,0,0,721,15
2020-07-12,International,0,0,721,15
2020-07-13,International,0,0,721,15
2020-07-14,International,0,0,721,15
2020-07-15,International,0,0,721,15
2020-07-16,International,0,0,721,15
2020-07-17,International,0,0,721,15
2020-07-18,International,0,0,721,15
2020-07-19,International,0,0,721,15
2020-07-20,International,0,0,721,15
2020-07-21,International,0,0,721,15
2020-07-22,International,0,0,721,15
2020-07-23,International,0,0,721,15
2020-07-24,International,0,0,721,15
2020-07-25,International,0,0,721,15
2020-07-26,International,0,0,721,15
2020-07-27,International,0,0,721,15
2020-07-28,International,0,0,721,15
2020-07-29,International,0,0,721,15
2020-07-30,International,0,0,721,15
2020-07-31,International,0,0,721,15
2020-08-01,International,0,0,721,15
2020-08-02,International,0,0,721,15
2020-08-03,International,0,0,721,15
2020-08-04,International,0,0,721,15
2020-08-05,International,0,0,721,15
2020-08-06,International,0,0,721,15
2020-08-07,International,0,0,721,15
2020-08-08,International,0,0,721,15
2020-08-09,International,0,0,721,15
2020-08-10,International,0,0,721,15
2020-08-11,International,0,0,721,15
2020-08-12,International,0,0,721,15
2020-08-13,International,0,0,721,15
2020-08-14,International,0,0,721,15
2020-08-15,International,0,0,721,15
2020-08-16,International,0,0,721,15
2020-08-17,International,0,0,721,15
2020-08-18,International,0,0,721,15
2020-08-19,International,0,0,721,15
2020-08-20,International,0,0,721,15
2020-08-21,International,0,0,721,15
2020-08-22,International,0,0,721,15
2020-08-23,International,0,0,721,15
2020-08-24,International,0,0,721,15
2020-08-25,International,0,0,721,15
2020-08-26,International,0,0,721,15
2020-08-27,International,0,0,721,15
2020-08-28,International,0,0,721,15
2020-08-29,International,0,0,721,15
2020-08-30,International,0,0,721,15
2020-08-31,International,0,0,721,15
2020-09-01,International,0,0,721,15
2020-09-02,International,0,0,721,15
2020-09-03,International,0,0,721,15
2020-09-04,International,0,0,721,15
2020-09-05,International,0,0,721,15
2020-09-06,International,0,0,721,15
2020-09-07,International,0,0,721,15
2020-09-08,International,0,0,721,15
2020-09-09,International,0,0,721,15
2020-09-10,International,0,0,721,15
2020-09-11,International,0,0,721,15
2020-09-12,International,0,0,721,15
2020-09-13,International,0,0,721,15
2020-09-14,International,0,0,721,15
2020-09-15,International,0,0,721,15
2020-09-16,International,0,0,721,15
2020-09-17,International,0,0,721,15
2020-09-18,International,0,0,721,15
2020-09-19,International,0,0,721,15
2020-09-20,International,0,0,721,15
2020-09-21,International,0,0,721,15
2020-09-22,International,0,0,721,15
2020-09-23,International,0,0,721,15
2020-09-24,International,0,0,721,15
2020-09-25,International,0,0,721,15
2020-09-26,International,0,0,721,15
2020-09-27,International,0,0,721,15
2020-09-28,International,0,0,721,15
2020-09-29,International,0,0,721,15
2020-09-30,International,0,0,721,15
2020-10-01,International,0,0,721,15
2020-10-02,International,0,0,721,15
2020-10-03,International,0,0,721,15
2020-10-04,International,0,0,721,15
2020-10-05,International,0,0,721,15
2020-10-06,International,0,0,721,15
2020-10-07,International,0,0,721,15
2020-10-08,International,0,0,721,15
2020-10-09,International,0,0,721,15
2020-10-10,International,0,0,721,15
2020-10-11,International,0,0,721,15
2020-10-12,International,0,0,721,15
2020-10-13,International,0,0,721,15
2020-10-14,International,0,0,721,15
2020-10-15,International,0,0,721,15
2020-10-16,International,0,0,721,15
2020-10-17,International,0,0,721,15
2020-10-18,International,0,0,721,15
2020-10-19,International,0,0,721,15
2020-10-20,International,0,0,721,15
2020-10-21,International,0,0,721,15
2020-10-22,International,0,0,721,15
2020-10-23,International,0,0,721,15
2020-10-24,International,0,0,721,15
2020-10-25,International,0,0,721,15
2020-10-26,International,0,0,721,15
2020-10-27,International,0,0,721,15
2020-10-28,International,0,0,721,15
2020-10-29,International,0,0,721,15
2020-10-30,International,0,0,721,15
2020-10-31,International,0,0,721,15
2020-11-01,International,0,0,721,15
2020-11-02,International,0,0,721,15
2020-11-03,International,0,0,721,15
2020-11-04,International,0,0,721,15
2020-11-05,International,0,0,721,15
2020-11-06,International,0,0,721,15
2020-11-07,International,0,0,721,15
2020-11-08,International,0,0,721,15
2020-11-09,International,0,0,721,15
2020-11-10,International,0,0,721,15
2020-11-11,International,0,0,721,15
2020-11-12,International,0,0,721,15
2020-11-13,International,0,0,721,15
2020-11-14,International,0,0,721,15
2020-11-15,International,0,0,721,15
2020-11-16,International,0,0,721,15
2020-11-17,International,0,0,721,15
2020-11-18,International,0,0,721,15
2020-11-19,International,0,0,721,15
2020-11-20,International,0,0,721,15
2020-11-21,International,0,0,721,15
2020-11-22,International,0,0,721,15
2020-11-23,International,0,0,721,15
2020-11-24,International,0,0,721,15
2020-11-25,International,0,0,721,15
2020-11-26,International,0,0,721,15
2020-11-27,International,0,0,721,15
2020-11-28,International,0,0,721,15
2020-11-29,International,0,0,721,15
2020-11-30,International,0,0,721,15
2020-12-01,International,0,0,721,15
2020-12-02,International,0,0,721,15
2020-12-03,International,0,0,721,15
2020-12-04,International,0,0,721,15
2020-12-05,International,0,0,721,15
2020-12-06,International,0,0,721,15
2020-12-07,International,0,0,721,15
2020-12-08,International,0,0,721,15
2020-12-09,International,0,0,721,15
2020-12-10,International,0,0,721,15
2020-12-11,International,0,0,721,15
2020-12-12,International,0,0,721,15
2020-12-13,International,0,0,721,15
2020-12-14,International,0,0,721,15
2020-12-15,International,0,0,721,15
2020-12-16,International,0,0,721,15
2020-12-17,International,0,0,721,15
2020-12-18,International,0,0,721,15
2020-12-19,International,0,0,721,15
2020-12-20,International,0,0,721,15
2020-12-21,International,0,0,721,15
2020-12-22,International,0,0,721,15
2020-12-23,International,0,0,721,15
2020-12-24,International,0,0,721,15
2020-12-25,International,0,0,721,15
2020-12-26,International,0,0,721,15
2020-12-27,International,0,0,721,15
2020-12-28,International,0,0,721,15
2020-12-29,International,0,0,721,15
2020-12-30,International,0,0,721,15
2020-12-31,International,0,0,721,15
2021-01-01,International,0,0,721,15
2021-01-02,International,0,0,721,15
2021-01-03,International,0,0,721,15
2021-01-04,International,0,0,721,15
2021-01-05,International,0,0,721,15
2021-01-06,International,0,0,721,15
2021-01-07,International,0,0,721,15
2021-01-08,International,0,0,721,15
2021-01-09,International,0,0,721,15
2021-01-10,International,0,0,721,15
2021-01-11,International,0,0,721,15
2021-01-12,International,0,0,721,15
2021-01-13,International,0,0,721,15
2021-01-14,International,0,0,721,15
2021-01-15,International,0,0,721,15
2021-01-16,International,0,0,721,15
2021-01-17,International,0,0,721,15
2021-01-18,International,0,0,721,15
2021-01-19,International,0,0,721,15
2021-01-20,International,0,0,721,15
2021-01-21,International,0,0,721,15
2021-01-22,International,0,0,721,15
2021-01-23,International,0,0,721,15
2021-01-24,International,0,0,721,15
2021-01-25,International,0,0,721,15
2021-01-26,International,0,0,721,15
2021-01-27,International,0,0,721,15
2021-01-28,International,0,0,721,15
2021-01-29,International,0,0,721,15
2021-01-30,International,0,0,721,15
2021-01-31,International,0,0,721,15
2021-02-01,International,0,0,721,15
2021-02-02,International,0,0,721,15
2021-02-03,International,0,0,721,15
2021-02-04,International,0,0,721,15
2021-02-05,International,0,0,721,15
2021-02-06,International,0,0,721,15
2021-02-07,International,0,0,721,15
2021-02-08,International,0,0,721,15
2021-02-09,International,0,0,721,15
2021-02-10,International,0,0,721,15
2021-02-11,International,0,0,721,15
2021-02-12,International,0,0,721,15
2021-02-13,International,0,0,721,15
2021-02-14,International,0,0,721,15
2021-02-15,International,0,0,721,15
2021-02-16,International,0,0,721,15
2021-02-17,International,0,0,721,15
2021-02-18,International,0,0,721,15
2021-02-19,International,0,0,721,15
2021-02-20,International,0,0,721,15
2021-02-21,International,0,0,721,15
2021-02-22,International,0,0,721,15
2021-02-23,International,0,0,721,15
2021-02-24,International,0,0,721,15
2021-02-25,International,0,0,721,15
2021-02-26,International,0,0,721,15
2021-02-27,International,0,0,721,15
2021-02-28,International,0,0,721,15
2021-03-01,International,0,0,721,15
2021-03-02,International,0,0,721,15
2021-03-03,International,0,0,721,15
2021-03-04,International,0,0,721,15
2021-03-05,International,0,0,721,15
2021-03-06,International,0,0,721,15
2021-03-07,International,0,0,721,15
2021-03-08,International,0,0,721,15
2021-03-09,International,0,0,721,15
2021-03-10,International,0,0,721,15
2021-03-11,International,0,0,721,15
2021-03-12,International,0,0,721,15
2021-03-13,International,0,0,721,15
2021-03-14,International,0,0,721,15
2021-03-15,International,0,0,721,15
2021-03-16,International,0,0,721,15
2021-03-17,International,0,0,721,15
2021-03-18,International,0,0,721,15
2021-03-19,International,0,0,721,15
2021-03-20,International,0,0,721,15
2021-03-21,International,0,0,721,15
2021-03-22,International,0,0,721,15
2021-03-23,International,0,0,721,15
2021-03-24,International,0,0,721,15
2021-03-25,International,0,0,721,15
2021-03-26,International,0,0,721,15
2021-03-27,International,0,0,721,15
2021-03-28,International,0,0,721,15
2021-03-29,International,0,0,721,15
2021-03-30,International,0,0,721,15
2021-03-31,International,0,0,721,15
2021-04-01,International,0,0,721,15
2021-04-02,International,0,0,721,15
2021-04-03,International,0,0,721,15
2021-04-04,International,0,0,721,15
2021-04-05,International,0,0,721,15
2021-04-06,International,0,0,721,15
2021-04-07,International,0,0,721,15
2021-04-08,International,0,0,721,15
2020-02-19,Iran,2,2,2,2
2020-02-20,Iran,3,0,5,2
2020-02-21,Iran,13,2,18,4
2020-02-22,Iran,10,1,28,5
2020-02-23,Iran,15,3,43,8
2020-02-24,Iran,18,4,61,12
2020-02-25,Iran,34,4,95,16
2020-02-26,Iran,44,3,139,19
2020-02-27,Iran,106,7,245,26
2020-02-28,Iran,143,8,388,34
2020-02-29,Iran,205,9,593,43
2020-03-01,Iran,385,11,978,54
2020-03-02,Iran,523,12,1501,66
2020-03-03,Iran,835,11,2336,77
2020-03-04,Iran,586,15,2922,92
2020-03-05,Iran,591,15,3513,107
2020-03-06,Iran,1234,17,4747,124
2020-03-07,Iran,1076,21,5823,145
2020-03-08,Iran,743,49,6566,194
2020-03-09,Iran,595,43,7161,237
2020-03-10,Iran,881,54,8042,291
2020-03-11,Iran,958,63,9000,354
2020-03-12,Iran,1075,75,10075,429
2020-03-13,Iran,1289,85,11364,514
2020-03-14,Iran,1365,97,12729,611
2020-03-15,Iran,1209,113,13938,724
2020-03-16,Iran,1053,129,14991,853
2020-03-17,Iran,1178,135,16169,988
2020-03-18,Iran,1192,147,17361,1135
2020-03-19,Iran,1046,149,18407,1284
2020-03-20,Iran,1237,149,19644,1433
2020-03-21,Iran,966,123,20610,1556
2020-03-22,Iran,1028,129,21638,1685
2020-03-23,Iran,1411,127,23049,1812
2020-03-24,Iran,1762,122,24811,1934
2020-03-25,Iran,2206,143,27017,2077
2020-03-26,Iran,2389,157,29406,2234
2020-03-27,Iran,2926,144,32332,2378
2020-03-28,Iran,3076,139,35408,2517
2020-03-29,Iran,2901,123,38309,2640
2020-03-30,Iran,3186,117,41495,2757
2020-03-31,Iran,3110,141,44605,2898
2020-04-01,Iran,2988,138,47593,3036
2020-04-02,Iran,2875,124,50468,3160
2020-04-03,Iran,2715,134,53183,3294
2020-04-04,Iran,2560,158,55743,3452
2020-04-05,Iran,2483,151,58226,3603
2020-04-06,Iran,2274,136,60500,3739
2020-04-07,Iran,2089,133,62589,3872
2020-04-08,Iran,1997,121,64586,3993
2020-04-09,Iran,1634,117,66220,4110
2020-04-10,Iran,1972,122,68192,4232
2020-04-11,Iran,1837,125,70029,4357
2020-04-12,Iran,1657,117,71686,4474
2020-04-13,Iran,1617,111,73303,4585
2020-04-14,Iran,1574,98,74877,4683
2020-04-15,Iran,1512,94,76389,4777
2020-04-16,Iran,1606,92,77995,4869
2020-04-17,Iran,1499,89,79494,4958
2020-04-18,Iran,1374,73,80868,5031
2020-04-19,Iran,1343,87,82211,5118
2020-04-20,Iran,1294,91,83505,5209
2020-04-21,Iran,1297,88,84802,5297
2020-04-22,Iran,1194,94,85996,5391
2020-04-23,Iran,1030,90,87026,5481
2020-04-24,Iran,1168,93,88194,5574
2020-04-25,Iran,1134,76,89328,5650
2020-04-26,Iran,1153,60,90481,5710
2020-04-27,Iran,991,96,91472,5806
2020-04-28,Iran,1112,71,92584,5877
2020-04-29,Iran,1073,80,93657,5957
2020-04-30,Iran,983,71,94640,6028
2020-05-01,Iran,1006,63,95646,6091
2020-05-02,Iran,802,65,96448,6156
2020-05-03,Iran,976,47,97424,6203
2020-05-04,Iran,1223,74,98647,6277
2020-05-05,Iran,1323,63,99970,6340
2020-05-06,Iran,1680,78,101650,6418
2020-05-07,Iran,1485,68,103135,6486
2020-05-08,Iran,1556,55,104691,6541
2020-05-09,Iran,1529,48,106220,6589
2020-05-10,Iran,1383,51,107603,6640
2020-05-11,Iran,1683,45,109286,6685
2020-05-12,Iran,1481,48,110767,6733
2020-05-13,Iran,1958,50,112725,6783
2020-05-14,Iran,1808,71,114533,6854
2020-05-15,Iran,2102,48,116635,6902
2020-05-16,Iran,1757,35,118392,6937
2020-05-17,Iran,1806,51,120198,6988
2020-05-18,Iran,2294,69,122492,7057
2020-05-19,Iran,2111,62,124603,7119
2020-05-20,Iran,2346,64,126949,7183
2020-05-21,Iran,2392,66,129341,7249
2020-05-22,Iran,2311,51,131652,7300
2020-05-23,Iran,1869,59,133521,7359
2020-05-24,Iran,2180,58,135701,7417
2020-05-25,Iran,2023,34,137724,7451
2020-05-26,Iran,1787,57,139511,7508
2020-05-27,Iran,2080,56,141591,7564
2020-05-28,Iran,2258,63,143849,7627
2020-05-29,Iran,2819,50,146668,7677
2020-05-30,Iran,2282,57,148950,7734
2020-05-31,Iran,2516,63,151466,7797
2020-06-01,Iran,2979,81,154445,7878
2020-06-02,Iran,3117,64,157562,7942
2020-06-03,Iran,3134,70,160696,8012
2020-06-04,Iran,3574,59,164270,8071
2020-06-05,Iran,2886,63,167156,8134
2020-06-06,Iran,2269,75,169425,8209
2020-06-07,Iran,2364,72,171789,8281
2020-06-08,Iran,2043,70,173832,8351
2020-06-09,Iran,2095,74,175927,8425
2020-06-10,Iran,2011,81,177938,8506
2020-06-11,Iran,2218,78,180156,8584
2020-06-12,Iran,2369,75,182525,8659
2020-06-13,Iran,2430,71,184955,8730
2020-06-14,Iran,2472,107,187427,8837
2020-06-15,Iran,2449,113,189876,8950
2020-06-16,Iran,2563,115,192439,9065
2020-06-17,Iran,2612,120,195051,9185
2020-06-18,Iran,2596,87,197647,9272
2020-06-19,Iran,2615,120,200262,9392
2020-06-20,Iran,2322,115,202584,9507
2020-06-21,Iran,2368,116,204952,9623
2020-06-22,Iran,2573,119,207525,9742
2020-06-23,Iran,2445,121,209970,9863
2020-06-24,Iran,2531,133,212501,9996
2020-06-25,Iran,2595,134,215096,10130
2020-06-26,Iran,2628,109,217724,10239
2020-06-27,Iran,2456,125,220180,10364
2020-06-28,Iran,2489,144,222669,10508
2020-06-29,Iran,2536,162,225205,10670
2020-06-30,Iran,2457,147,227662,10817
2020-07-01,Iran,2549,141,230211,10958
2020-07-02,Iran,2652,148,232863,11106
2020-07-03,Iran,2566,154,235429,11260
2020-07-04,Iran,2449,148,237878,11408
2020-07-05,Iran,2560,163,240438,11571
2020-07-06,Iran,2613,160,243051,11731
2020-07-07,Iran,2637,200,245688,11931
2020-07-08,Iran,2691,153,248379,12084
2020-07-09,Iran,2079,221,250458,12305
2020-07-10,Iran,2262,142,252720,12447
2020-07-11,Iran,2397,188,255117,12635
2020-07-12,Iran,2186,194,257303,12829
2020-07-13,Iran,2349,203,259652,13032
2020-07-14,Iran,2521,179,262173,13211
2020-07-15,Iran,2388,199,264561,13410
2020-07-16,Iran,2500,198,267061,13608
2020-07-17,Iran,2379,183,269440,13791
2020-07-18,Iran,2166,188,271606,13979
2020-07-19,Iran,2182,209,273788,14188
2020-07-20,Iran,2414,217,276202,14405
2020-07-21,Iran,2625,229,278827,14634
2020-07-22,Iran,2586,219,281413,14853
2020-07-23,Iran,2621,221,284034,15074
2020-07-24,Iran,2489,215,286523,15289
2020-07-25,Iran,2316,195,288839,15484
2020-07-26,Iran,2333,216,291172,15700
2020-07-27,Iran,2434,212,293606,15912
2020-07-28,Iran,2667,235,296273,16147
2020-07-29,Iran,2636,196,298909,16343
2020-07-30,Iran,2621,226,301530,16569
2020-07-31,Iran,2674,197,304204,16766
2020-08-01,Iran,2548,216,306752,16982
2020-08-02,Iran,2685,208,309437,17190
2020-08-03,Iran,2598,215,312035,17405
2020-08-04,Iran,2751,212,314786,17617
2020-08-05,Iran,2697,185,317483,17802
2020-08-06,Iran,2634,174,320117,17976
2020-08-07,Iran,2450,156,322567,18132
2020-08-08,Iran,2125,132,324692,18264
2020-08-09,Iran,2020,163,326712,18427
2020-08-10,Iran,2132,189,328844,18616
2020-08-11,Iran,2345,184,331189,18800
2020-08-12,Iran,2510,188,333699,18988
2020-08-13,Iran,2625,174,336324,19162
2020-08-14,Iran,2501,169,338825,19331
2020-08-15,Iran,2245,161,341070,19492
2020-08-16,Iran,2133,147,343203,19639
2020-08-17,Iran,2247,165,345450,19804
2020-08-18,Iran,2385,168,347835,19972
2020-08-19,Iran,2444,153,350279,20125
2020-08-20,Iran,2279,139,352558,20264
2020-08-21,Iran,2206,112,354764,20376
2020-08-22,Iran,2028,126,356792,20502
2020-08-23,Iran,2113,141,358905,20643
2020-08-24,Iran,2245,133,361150,20776
2020-08-25,Iran,2213,125,363363,20901
2020-08-26,Iran,2243,119,365606,21020
2020-08-27,Iran,2190,117,367796,21137
2020-08-28,Iran,2115,112,369911,21249
2020-08-29,Iran,1905,110,371816,21359
2020-08-30,Iran,1754,103,373570,21462
2020-08-31,Iran,1642,109,375212,21571
2020-09-01,Iran,1682,101,376894,21672
2020-09-02,Iran,1858,125,378752,21797
2020-09-03,Iran,1994,129,380746,21926
2020-09-04,Iran,2026,118,382772,22044
2020-09-05,Iran,1894,110,384666,22154
2020-09-06,Iran,1992,139,386658,22293
2020-09-07,Iran,2152,117,388810,22410
2020-09-08,Iran,2302,132,391112,22542
2020-09-09,Iran,2313,127,393425,22669
2020-09-10,Iran,2063,129,395488,22798
2020-09-11,Iran,2313,115,397801,22913
2020-09-12,Iran,2139,116,399940,23029
2020-09-13,Iran,2089,128,402029,23157
2020-09-14,Iran,2619,156,404648,23313
2020-09-15,Iran,2705,140,407353,23453
2020-09-16,Iran,2981,179,410334,23632
2020-09-17,Iran,2815,176,413149,23808
2020-09-18,Iran,3049,144,416198,23952
2020-09-19,Iran,2845,166,419043,24118
2020-09-20,Iran,3097,183,422140,24301
2020-09-21,Iran,3341,177,425481,24478
2020-09-22,Iran,3712,178,429193,24656
2020-09-23,Iran,3605,184,432798,24840
2020-09-24,Iran,3521,175,436319,25015
2020-09-25,Iran,3563,207,439882,25222
2020-09-26,Iran,3204,172,443086,25394
2020-09-27,Iran,3362,195,446448,25589
2020-09-28,Iran,3512,190,449960,25779
2020-09-29,Iran,3677,207,453637,25986
2020-09-30,Iran,3582,183,457219,26169
2020-10-01,Iran,3825,211,461044,26380
2020-10-02,Iran,3552,187,464596,26567
2020-10-03,Iran,3523,179,468119,26746
2020-10-04,Iran,3653,211,471772,26957
2020-10-05,Iran,3902,235,475674,27192
2020-10-06,Iran,4151,227,479825,27419
2020-10-07,Iran,4019,239,483844,27658
2020-10-08,Iran,4392,230,488236,27888
2020-10-09,Iran,4142,210,492378,28098
2020-10-10,Iran,3875,195,496253,28293
2020-10-11,Iran,3822,251,500075,28544
2020-10-12,Iran,4206,272,504281,28816
2020-10-13,Iran,4108,254,508389,29070
2020-10-14,Iran,4830,279,513219,29349
2020-10-15,Iran,4616,256,517835,29605
2020-10-16,Iran,4552,265,522387,29870
2020-10-17,Iran,4103,253,526490,30123
2020-10-18,Iran,3890,252,530380,30375
2020-10-19,Iran,4251,337,534631,30712
2020-10-20,Iran,5039,322,539670,31034
2020-10-21,Iran,5616,312,545286,31346
2020-10-22,Iran,5471,304,550757,31650
2020-10-23,Iran,6134,335,556891,31985
2020-10-24,Iran,5814,335,562705,32320
2020-10-25,Iran,6191,296,568896,32616
2020-10-26,Iran,5960,337,574856,32953
2020-10-27,Iran,6968,346,581824,33299
2020-10-28,Iran,6824,415,588648,33714
2020-10-29,Iran,8293,399,596941,34113
2020-10-30,Iran,8011,365,604952,34478
2020-10-31,Iran,7820,386,612772,34864
2020-11-01,Iran,7719,434,620491,35298
2020-11-02,Iran,8289,440,628780,35738
2020-11-03,Iran,8932,422,637712,36160
2020-11-04,Iran,8452,419,646164,36579
2020-11-05,Iran,8772,406,654936,36985
2020-11-06,Iran,8864,424,663800,37409
2020-11-07,Iran,9450,423,673250,37832
2020-11-08,Iran,9236,459,682486,38291
2020-11-09,Iran,10463,458,692949,38749
2020-11-10,Iran,10339,453,703288,39202
2020-11-11,Iran,11780,462,715068,39664
2020-11-12,Iran,11517,457,726585,40121
2020-11-13,Iran,11737,461,738322,40582
2020-11-14,Iran,11203,452,749525,41034
2020-11-15,Iran,12543,459,762068,41493
2020-11-16,Iran,13053,486,775121,41979
2020-11-17,Iran,13352,482,788473,42461
2020-11-18,Iran,13421,480,801894,42941
2020-11-19,Iran,13223,476,815117,43417
2020-11-20,Iran,13260,479,828377,43896
2020-11-21,Iran,12931,431,841308,44327
2020-11-22,Iran,13053,475,854361,44802
2020-11-23,Iran,12460,453,866821,45255
2020-11-24,Iran,13721,483,880542,45738
2020-11-25,Iran,13843,469,894385,46207
2020-11-26,Iran,13961,482,908346,46689
2020-11-27,Iran,14051,406,922397,47095
2020-11-28,Iran,13402,391,935799,47486
2020-11-29,Iran,12950,388,948749,47874
2020-11-30,Iran,13321,372,962070,48246
2020-12-01,Iran,13881,382,975951,48628
2020-12-02,Iran,13621,362,989572,48990
2020-12-03,Iran,13922,358,1003494,49348
2020-12-04,Iran,13341,347,1016835,49695
2020-12-05,Iran,12151,321,1028986,50016
2020-12-06,Iran,11561,294,1040547,50310
2020-12-07,Iran,10827,284,1051374,50594
2020-12-08,Iran,11023,323,1062397,50917
2020-12-09,Iran,10223,295,1072620,51212
2020-12-10,Iran,10403,284,1083023,51496
2020-12-11,Iran,9384,231,1092407,51727
2020-12-12,Iran,8411,222,1100818,51949
2020-12-13,Iran,7451,247,1108269,52196
2020-12-14,Iran,7501,251,1115770,52447
2020-12-15,Iran,7704,223,1123474,52670
2020-12-16,Iran,7603,213,1131077,52883
2020-12-17,Iran,7453,212,1138530,53095
2020-12-18,Iran,7121,178,1145651,53273
2020-12-19,Iran,6421,175,1152072,53448
2020-12-20,Iran,6312,177,1158384,53625
2020-12-21,Iran,6151,191,1164535,53816
2020-12-22,Iran,6208,187,1170743,54003
2020-12-23,Iran,6261,153,1177004,54156
2020-12-24,Iran,6178,152,1183182,54308
2020-12-25,Iran,6021,132,1189203,54440
2020-12-26,Iran,5760,134,1194963,54574
2020-12-27,Iran,5502,119,1200465,54693
2020-12-28,Iran,5908,121,1206373,54814
2020-12-29,Iran,6108,132,1212481,54946
2020-12-30,Iran,6272,149,1218753,55095
2020-12-31,Iran,6389,128,1225142,55223
2021-01-01,Iran,6287,114,1231429,55337
2021-01-02,Iran,6045,101,1237474,55438
2021-01-03,Iran,5960,102,1243434,55540
2021-01-04,Iran,6073,110,1249507,55650
2021-01-05,Iran,6113,98,1255620,55748
2021-01-06,Iran,6283,82,1261903,55830
2021-01-07,Iran,6360,103,1268263,55933
2021-01-08,Iran,6251,85,1274514,56018
2021-01-09,Iran,5924,82,1280438,56100
2021-01-10,Iran,5968,71,1286406,56171
2021-01-11,Iran,6208,91,1292614,56262
2021-01-12,Iran,6408,98,1299022,56360
2021-01-13,Iran,6317,97,1305339,56457
2021-01-14,Iran,6471,81,1311810,56538
2021-01-15,Iran,6485,83,1318295,56621
2021-01-16,Iran,6100,96,1324395,56717
2021-01-17,Iran,6016,86,1330411,56803
2021-01-18,Iran,5806,83,1336217,56886
2021-01-19,Iran,5917,87,1342134,56973
2021-01-20,Iran,6182,84,1348316,57057
2021-01-21,Iran,6204,93,1354520,57150
2021-01-22,Iran,6332,75,1360852,57225
2021-01-23,Iran,6180,69,1367032,57294
2021-01-24,Iran,5945,89,1372977,57383
2021-01-25,Iran,6309,98,1379286,57481
2021-01-26,Iran,6420,79,1385706,57560
2021-01-27,Iran,6608,91,1392314,57651
2021-01-28,Iran,6527,85,1398841,57736
2021-01-29,Iran,6573,71,1405414,57807
2021-01-30,Iran,6317,82,1411731,57889
2021-01-31,Iran,6268,70,1417999,57959
2021-02-01,Iran,6597,79,1424596,58038
2021-02-02,Iran,6820,72,1431416,58110
2021-02-03,Iran,6870,79,1438286,58189
2021-02-04,Iran,7040,67,1445326,58256
2021-02-05,Iran,7054,80,1452380,58336
2021-02-06,Iran,6990,76,1459370,58412
2021-02-07,Iran,7065,57,1466435,58469
2021-02-08,Iran,7321,67,1473756,58536
2021-02-09,Iran,7640,89,1481396,58625
2021-02-10,Iran,7585,61,1488981,58686
2021-02-11,Iran,7474,65,1496455,58751
2021-02-12,Iran,7298,58,1503753,58809
2021-02-13,Iran,7120,74,1510873,58883
2021-02-14,Iran,7390,62,1518263,58945
2021-02-15,Iran,7760,83,1526023,59028
2021-02-16,Iran,8011,89,1534034,59117
2021-02-17,Iran,8042,67,1542076,59184
2021-02-18,Iran,8066,80,1550142,59264
2021-02-19,Iran,8017,77,1558159,59341
2021-02-20,Iran,7922,68,1566081,59409
2021-02-21,Iran,7931,74,1574012,59483
2021-02-22,Iran,8263,89,1582275,59572
2021-02-23,Iran,8330,91,1590605,59663
2021-02-24,Iran,8270,73,1598875,59736
2021-02-25,Iran,8206,94,1607081,59830
2021-02-26,Iran,8103,69,1615184,59899
2021-02-27,Iran,7975,81,1623159,59980
2021-02-28,Iran,8010,93,1631169,60073
2021-03-01,Iran,8510,108,1639679,60181
2021-03-02,Iran,8495,86,1648174,60267
2021-03-03,Iran,8525,86,1656699,60353
2021-03-04,Iran,8404,78,1665103,60431
2021-03-05,Iran,8367,81,1673470,60512
2021-03-06,Iran,8212,82,1681682,60594
2021-03-07,Iran,8010,93,1689692,60687
2021-03-08,Iran,8313,99,1698005,60786
2021-03-09,Iran,8554,81,1706559,60867
2021-03-10,Iran,8603,61,1715162,60928
2021-03-11,Iran,8308,88,1723470,61016
2021-03-12,Iran,8088,53,1731558,61069
2021-03-13,Iran,7802,73,1739360,61142
2021-03-14,Iran,7593,88,1746953,61230
2021-03-15,Iran,7980,100,1754933,61330
2021-03-16,Iran,8380,97,1763313,61427
2021-03-17,Iran,7802,65,1771115,61492
2021-03-18,Iran,7530,89,1778645,61581
2021-03-19,Iran,7620,68,1786265,61649
2021-03-20,Iran,7540,75,1793805,61724
2021-03-21,Iran,7260,73,1801065,61797
2021-03-22,Iran,7357,80,1808422,61877
2021-03-23,Iran,7290,74,1815712,61951
2021-03-24,Iran,7605,94,1823317,62045
2021-03-25,Iran,7506,97,1830823,62142
2021-03-26,Iran,7980,81,1838803,62223
2021-03-27,Iran,8120,85,1846923,62308
2021-03-28,Iran,8751,89,1855674,62397
2021-03-29,Iran,9310,81,1864984,62478
2021-03-30,Iran,10250,91,1875234,62569
2021-03-31,Iran,10330,96,1885564,62665
2021-04-01,Iran,11750,94,1897314,62759
2021-04-02,Iran,11660,117,1908974,62876
2021-04-03,Iran,11420,123,1920394,62999
2021-04-04,Iran,11680,161,1932074,63160
2021-04-05,Iran,13890,172,1945964,63332
2021-04-06,Iran,17430,174,1963394,63506
2021-04-07,Iran,20954,193,1984348,63699
2021-04-08,Iran,22586,185,2006934,63884
2020-02-24,Iraq,1,0,1,0
2020-02-25,Iraq,0,0,1,0
2020-02-26,Iraq,4,0,5,0
2020-02-27,Iraq,2,0,7,0
2020-02-28,Iraq,0,0,7,0
2020-02-29,Iraq,6,0,13,0
2020-03-01,Iraq,6,0,19,0
2020-03-02,Iraq,7,0,26,0
2020-03-03,Iraq,6,0,32,0
2020-03-04,Iraq,3,2,35,2
2020-03-05,Iraq,0,0,35,2
2020-03-06,Iraq,5,1,40,3
2020-03-07,Iraq,14,1,54,4
2020-03-08,Iraq,6,2,60,6
2020-03-09,Iraq,0,0,60,6
2020-03-10,Iraq,11,1,71,7
2020-03-11,Iraq,0,0,71,7
2020-03-12,Iraq,0,1,71,8
2020-03-13,Iraq,30,1,101,9
2020-03-14,Iraq,9,1,110,10
2020-03-15,Iraq,6,0,116,10
2020-03-16,Iraq,8,0,124,10
2020-03-17,Iraq,30,1,154,11
2020-03-18,Iraq,10,1,164,12
2020-03-19,Iraq,28,1,192,13
2020-03-20,Iraq,16,4,208,17
2020-03-21,Iraq,6,0,214,17
2020-03-22,Iraq,19,3,233,20
2020-03-23,Iraq,33,3,266,23
2020-03-24,Iraq,50,4,316,27
2020-03-25,Iraq,30,2,346,29
2020-03-26,Iraq,36,7,382,36
2020-03-27,Iraq,76,4,458,40
2020-03-28,Iraq,48,2,506,42
2020-03-29,Iraq,41,0,547,42
2020-03-30,Iraq,83,4,630,46
2020-03-31,Iraq,64,4,694,50
2020-04-01,Iraq,34,2,728,52
2020-04-02,Iraq,44,2,772,54
2020-04-03,Iraq,48,0,820,54
2020-04-04,Iraq,58,2,878,56
2020-04-05,Iraq,83,5,961,61
2020-04-06,Iraq,70,3,1031,64
2020-04-07,Iraq,91,1,1122,65
2020-04-08,Iraq,80,4,1202,69
2020-04-09,Iraq,30,0,1232,69
2020-04-10,Iraq,47,1,1279,70
2020-04-11,Iraq,39,2,1318,72
2020-04-12,Iraq,34,4,1352,76
2020-04-13,Iraq,26,2,1378,78
2020-04-14,Iraq,22,0,1400,78
2020-04-15,Iraq,15,1,1415,79
2020-04-16,Iraq,19,1,1434,80
2020-04-17,Iraq,48,1,1482,81
2020-04-18,Iraq,31,1,1513,82
2020-04-19,Iraq,26,0,1539,82
2020-04-20,Iraq,35,0,1574,82
2020-04-21,Iraq,28,1,1602,83
2020-04-22,Iraq,29,0,1631,83
2020-04-23,Iraq,46,0,1677,83
2020-04-24,Iraq,31,3,1708,86
2020-04-25,Iraq,55,0,1763,86
2020-04-26,Iraq,57,1,1820,87
2020-04-27,Iraq,27,1,1847,88
2020-04-28,Iraq,81,2,1928,90
2020-04-29,Iraq,75,2,2003,92
2020-04-30,Iraq,82,1,2085,93
2020-05-01,Iraq,68,1,2153,94
2020-05-02,Iraq,66,1,2219,95
2020-05-03,Iraq,77,2,2296,97
2020-05-04,Iraq,50,1,2346,98
2020-05-05,Iraq,85,4,2431,102
2020-05-06,Iraq,49,0,2480,102
2020-05-07,Iraq,63,0,2543,102
2020-05-08,Iraq,60,2,2603,104
2020-05-09,Iraq,76,3,2679,107
2020-05-10,Iraq,88,2,2767,109
2020-05-11,Iraq,51,1,2818,110
2020-05-12,Iraq,95,2,2913,112
2020-05-13,Iraq,119,3,3032,115
2020-05-14,Iraq,111,0,3143,115
2020-05-15,Iraq,50,2,3193,117
2020-05-16,Iraq,67,4,3260,121
2020-05-17,Iraq,144,2,3404,123
2020-05-18,Iraq,150,4,3554,127
2020-05-19,Iraq,57,4,3611,131
2020-05-20,Iraq,113,3,3724,134
2020-05-21,Iraq,153,6,3877,140
2020-05-22,Iraq,87,7,3964,147
2020-05-23,Iraq,308,5,4272,152
2020-05-24,Iraq,197,8,4469,160
2020-05-25,Iraq,163,3,4632,163
2020-05-26,Iraq,216,6,4848,169
2020-05-27,Iraq,287,6,5135,175
2020-05-28,Iraq,322,4,5457,179
2020-05-29,Iraq,416,6,5873,185
2020-05-30,Iraq,306,10,6179,195
2020-05-31,Iraq,260,10,6439,205
2020-06-01,Iraq,429,10,6868,215
2020-06-02,Iraq,519,20,7387,235
2020-06-03,Iraq,781,21,8168,256
2020-06-04,Iraq,672,15,8840,271
2020-06-05,Iraq,1006,14,9846,285
2020-06-06,Iraq,1252,33,11098,318
2020-06-07,Iraq,1268,28,12366,346
2020-06-08,Iraq,1115,24,13481,370
2020-06-09,Iraq,787,22,14268,392
2020-06-10,Iraq,1146,34,15414,426
2020-06-11,Iraq,1261,31,16675,457
2020-06-12,Iraq,1095,39,17770,496
2020-06-13,Iraq,1180,53,18950,549
2020-06-14,Iraq,1259,58,20209,607
2020-06-15,Iraq,1106,45,21315,652
2020-06-16,Iraq,1385,60,22700,712
2020-06-17,Iraq,1554,61,24254,773
2020-06-18,Iraq,1463,83,25717,856
2020-06-19,Iraq,1635,69,27352,925
2020-06-20,Iraq,1870,88,29222,1013
2020-06-21,Iraq,1646,87,30868,1100
2020-06-22,Iraq,1808,67,32676,1167
2020-06-23,Iraq,1826,84,34502,1251
2020-06-24,Iraq,2200,79,36702,1330
2020-06-25,Iraq,2437,107,39139,1437
2020-06-26,Iraq,2054,122,41193,1559
2020-06-27,Iraq,2069,101,43262,1660
2020-06-28,Iraq,2140,96,45402,1756
2020-06-29,Iraq,1749,83,47151,1839
2020-06-30,Iraq,1958,104,49109,1943
2020-07-01,Iraq,2415,107,51524,2050
2020-07-02,Iraq,2184,110,53708,2160
2020-07-03,Iraq,2312,102,56020,2262
2020-07-04,Iraq,2334,106,58354,2368
2020-07-05,Iraq,2125,105,60479,2473
2020-07-06,Iraq,1796,94,62275,2567
2020-07-07,Iraq,2426,118,64701,2685
2020-07-08,Iraq,2741,94,67442,2779
2020-07-09,Iraq,2170,103,69612,2882
2020-07-10,Iraq,2848,78,72460,2960
2020-07-11,Iraq,2734,95,75194,3055
2020-07-12,Iraq,2312,95,77506,3150
2020-07-13,Iraq,2229,100,79735,3250
2020-07-14,Iraq,2022,95,81757,3345
2020-07-15,Iraq,2110,87,83867,3432
2020-07-16,Iraq,2281,90,86148,3522
2020-07-17,Iraq,2023,94,88171,3616
2020-07-18,Iraq,2049,75,90220,3691
2020-07-19,Iraq,2310,90,92530,3781
2020-07-20,Iraq,2163,88,94693,3869
2020-07-21,Iraq,2466,81,97159,3950
2020-07-22,Iraq,2706,92,99865,4042
2020-07-23,Iraq,2361,80,102226,4122
2020-07-24,Iraq,2485,90,104711,4212
2020-07-25,Iraq,2862,72,107573,4284
2020-07-26,Iraq,2459,78,110032,4362
2020-07-27,Iraq,2553,96,112585,4458
2020-07-28,Iraq,2747,77,115332,4535
2020-07-29,Iraq,2968,68,118300,4603
2020-07-30,Iraq,2963,68,121263,4671
2020-07-31,Iraq,3346,70,124609,4741
2020-08-01,Iraq,2095,64,126704,4805
2020-08-02,Iraq,2447,63,129151,4868
2020-08-03,Iraq,2735,66,131886,4934
2020-08-04,Iraq,2836,83,134722,5017
2020-08-05,Iraq,2834,77,137556,5094
2020-08-06,Iraq,3047,67,140603,5161
2020-08-07,Iraq,3461,75,144064,5236
2020-08-08,Iraq,3325,74,147389,5310
2020-08-09,Iraq,2726,82,150115,5392
2020-08-10,Iraq,3484,72,153599,5464
2020-08-11,Iraq,3396,67,156995,5531
2020-08-12,Iraq,3441,57,160436,5588
2020-08-13,Iraq,3841,53,164277,5641
2020-08-14,Iraq,4013,68,168290,5709
2020-08-15,Iraq,4293,76,172583,5785
2020-08-16,Iraq,4348,75,176931,5860
2020-08-17,Iraq,3202,94,180133,5954
2020-08-18,Iraq,4576,82,184709,6036
2020-08-19,Iraq,4093,85,188802,6121
2020-08-20,Iraq,3995,87,192797,6208
2020-08-21,Iraq,4288,75,197085,6283
2020-08-22,Iraq,3965,70,201050,6353
2020-08-23,Iraq,3291,75,204341,6428
2020-08-24,Iraq,3644,91,207985,6519
2020-08-25,Iraq,3962,77,211947,6596
2020-08-26,Iraq,3837,72,215784,6668
2020-08-27,Iraq,3651,72,219435,6740
2020-08-28,Iraq,4177,74,223612,6814
2020-08-29,Iraq,3834,77,227446,6891
2020-08-30,Iraq,3731,68,231177,6959
2020-08-31,Iraq,3757,83,234934,7042
2020-09-01,Iraq,3404,81,238338,7123
2020-09-02,Iraq,3946,78,242284,7201
2020-09-03,Iraq,4755,74,247039,7275
2020-09-04,Iraq,5036,84,252075,7359
2020-09-05,Iraq,4644,63,256719,7422
2020-09-06,Iraq,3651,90,260370,7512
2020-09-07,Iraq,4314,77,264684,7589
2020-09-08,Iraq,4894,68,269578,7657
2020-09-09,Iraq,4243,75,273821,7732
2020-09-10,Iraq,4597,82,278418,7814
2020-09-11,Iraq,4254,67,282672,7881
2020-09-12,Iraq,4106,60,286778,7941
2020-09-13,Iraq,3531,73,290309,8014
2020-09-14,Iraq,4169,72,294478,8086
2020-09-15,Iraq,4224,80,298702,8166
2020-09-16,Iraq,4357,82,303059,8248
2020-09-17,Iraq,4326,84,307385,8332
2020-09-18,Iraq,4305,76,311690,8408
2020-09-19,Iraq,3907,83,315597,8491
2020-09-20,Iraq,3438,64,319035,8555
2020-09-21,Iraq,3821,70,322856,8625
2020-09-22,Iraq,4724,57,327580,8682
2020-09-23,Iraq,5055,72,332635,8754
2020-09-24,Iraq,4471,45,337106,8799
2020-09-25,Iraq,4593,68,341699,8867
2020-09-26,Iraq,4270,68,345969,8935
2020-09-27,Iraq,3481,55,349450,8990
2020-09-28,Iraq,4116,62,353566,9052
2020-09-29,Iraq,4724,70,358290,9122
2020-09-30,Iraq,4691,59,362981,9181
2020-10-01,Iraq,4493,50,367474,9231
2020-10-02,Iraq,4785,67,372259,9298
2020-10-03,Iraq,3672,49,375931,9347
2020-10-04,Iraq,3210,52,379141,9399
2020-10-05,Iraq,3808,65,382949,9464
2020-10-06,Iraq,4172,67,387121,9531
2020-10-07,Iraq,3923,73,391044,9604
2020-10-08,Iraq,3522,79,394566,9683
2020-10-09,Iraq,3214,52,397780,9735
2020-10-10,Iraq,2344,55,400124,9790
2020-10-11,Iraq,2206,62,402330,9852
2020-10-12,Iraq,3107,60,405437,9912
2020-10-13,Iraq,3921,58,409358,9970
2020-10-14,Iraq,3857,51,413215,10021
2020-10-15,Iraq,3587,65,416802,10086
2020-10-16,Iraq,3501,56,420303,10142
2020-10-17,Iraq,3221,56,423524,10198
2020-10-18,Iraq,3110,56,426634,10254
2020-10-19,Iraq,4044,63,430678,10317
2020-10-20,Iraq,3920,49,434598,10366
2020-10-21,Iraq,3667,52,438265,10418
2020-10-22,Iraq,3899,47,442164,10465
2020-10-23,Iraq,3785,48,445949,10513
2020-10-24,Iraq,3204,55,449153,10568
2020-10-25,Iraq,2554,55,451707,10623
2020-10-26,Iraq,3691,48,455398,10671
2020-10-27,Iraq,4510,53,459908,10724
2020-10-28,Iraq,4043,46,463951,10770
2020-10-29,Iraq,3804,45,467755,10815
2020-10-30,Iraq,2878,47,470633,10862
2020-10-31,Iraq,1997,48,472630,10910
2020-11-01,Iraq,2658,56,475288,10966
2020-11-02,Iraq,3413,51,478701,11017
2020-11-03,Iraq,3595,51,482296,11068
2020-11-04,Iraq,3574,60,485870,11128
2020-11-05,Iraq,3701,47,489571,11175
2020-11-06,Iraq,3568,69,493139,11244
2020-11-07,Iraq,2880,39,496019,11283
2020-11-08,Iraq,2530,44,498549,11327
2020-11-09,Iraq,3184,53,501733,11380
2020-11-10,Iraq,3577,52,505310,11432
2020-11-11,Iraq,3198,50,508508,11482
2020-11-12,Iraq,3298,50,511806,11532
2020-11-13,Iraq,2690,48,514496,11580
2020-11-14,Iraq,2419,43,516915,11623
2020-11-15,Iraq,2237,47,519152,11670
2020-11-16,Iraq,2390,42,521542,11712
2020-11-17,Iraq,2961,40,524503,11752
2020-11-18,Iraq,2349,43,526852,11795
2020-11-19,Iraq,2374,39,529226,11834
2020-11-20,Iraq,2543,49,531769,11883
2020-11-21,Iraq,1786,42,533555,11925
2020-11-22,Iraq,1766,33,535321,11958
2020-11-23,Iraq,2136,38,537457,11996
2020-11-24,Iraq,2292,35,539749,12031
2020-11-25,Iraq,2438,55,542187,12086
2020-11-26,Iraq,2483,39,544670,12125
2020-11-27,Iraq,2545,42,547215,12167
2020-11-28,Iraq,1606,33,548821,12200
2020-11-29,Iraq,1614,24,550435,12224
2020-11-30,Iraq,2114,34,552549,12258
2020-12-01,Iraq,2218,48,554767,12306
2020-12-02,Iraq,1961,34,556728,12340
2020-12-03,Iraq,2039,21,558767,12361
2020-12-04,Iraq,1855,26,560622,12387
2020-12-05,Iraq,1898,24,562520,12411
2020-12-06,Iraq,1680,21,564200,12432
2020-12-07,Iraq,1815,28,566015,12460
2020-12-08,Iraq,2123,17,568138,12477
2020-12-09,Iraq,1735,24,569873,12501
2020-12-10,Iraq,1380,25,571253,12526
2020-12-11,Iraq,1347,23,572600,12549
2020-12-12,Iraq,1022,16,573622,12565
2020-12-13,Iraq,1012,14,574634,12579
2020-12-14,Iraq,1338,24,575972,12603
2020-12-15,Iraq,1391,11,577363,12614
2020-12-16,Iraq,1553,22,578916,12636
2020-12-17,Iraq,1533,14,580449,12650
2020-12-18,Iraq,1362,20,581811,12670
2020-12-19,Iraq,1307,10,583118,12680
2020-12-20,Iraq,1027,17,584145,12697
2020-12-21,Iraq,1200,13,585345,12710
2020-12-22,Iraq,1158,15,586503,12725
2020-12-23,Iraq,1173,12,587676,12737
2020-12-24,Iraq,1127,7,588803,12744
2020-12-25,Iraq,1140,11,589943,12755
2020-12-26,Iraq,836,12,590779,12767
2020-12-27,Iraq,818,13,591597,12780
2020-12-28,Iraq,931,11,592528,12791
2020-12-29,Iraq,1013,9,593541,12800
2020-12-30,Iraq,901,8,594442,12808
2020-12-31,Iraq,849,5,595291,12813
2021-01-01,Iraq,902,11,596193,12824
2021-01-02,Iraq,840,5,597033,12829
2021-01-03,Iraq,741,5,597774,12834
2021-01-04,Iraq,595,10,598369,12844
2021-01-05,Iraq,757,12,599126,12856
2021-01-06,Iraq,839,9,599965,12865
2021-01-07,Iraq,790,4,600755,12869
2021-01-08,Iraq,669,8,601424,12877
2021-01-09,Iraq,907,4,602331,12881
2021-01-10,Iraq,607,14,602938,12895
2021-01-11,Iraq,801,11,603739,12906
2021-01-12,Iraq,810,5,604549,12911
2021-01-13,Iraq,867,4,605416,12915
2021-01-14,Iraq,770,7,606186,12922
2021-01-15,Iraq,805,10,606991,12932
2021-01-16,Iraq,596,3,607587,12935
2021-01-17,Iraq,645,9,608232,12944
2021-01-18,Iraq,797,9,609029,12953
2021-01-19,Iraq,823,9,609852,12962
2021-01-20,Iraq,746,6,610598,12968
2021-01-21,Iraq,809,9,611407,12977
2021-01-22,Iraq,685,7,612092,12984
2021-01-23,Iraq,778,4,612870,12988
2021-01-24,Iraq,893,5,613763,12993
2021-01-25,Iraq,813,7,614576,13000
2021-01-26,Iraq,804,10,615380,13010
2021-01-27,Iraq,879,8,616259,13018
2021-01-28,Iraq,943,6,617202,13024
2021-01-29,Iraq,945,12,618147,13036
2021-01-30,Iraq,775,5,618922,13041
2021-01-31,Iraq,714,6,619636,13047
2021-02-01,Iraq,984,10,620620,13057
2021-02-02,Iraq,1135,11,621755,13068
2021-02-03,Iraq,1317,11,623072,13079
2021-02-04,Iraq,1150,12,624222,13091
2021-02-05,Iraq,1534,12,625756,13103
2021-02-06,Iraq,1660,8,627416,13111
2021-02-07,Iraq,1134,9,628550,13120
2021-02-08,Iraq,1713,6,630263,13126
2021-02-09,Iraq,1994,8,632257,13134
2021-02-10,Iraq,2282,6,634539,13140
2021-02-11,Iraq,2369,4,636908,13144
2021-02-12,Iraq,2530,13,639438,13157
2021-02-13,Iraq,2190,7,641628,13164
2021-02-14,Iraq,2224,15,643852,13179
2021-02-15,Iraq,2798,6,646650,13185
2021-02-16,Iraq,3332,7,649982,13192
2021-02-17,Iraq,3575,12,653557,13204
2021-02-18,Iraq,3896,16,657453,13220
2021-02-19,Iraq,4024,12,661477,13232
2021-02-20,Iraq,3273,13,664750,13245
2021-02-21,Iraq,3187,27,667937,13272
2021-02-22,Iraq,3864,23,671801,13295
2021-02-23,Iraq,4181,16,675982,13311
2021-02-24,Iraq,4306,13,680288,13324
2021-02-25,Iraq,4074,27,684362,13351
2021-02-26,Iraq,4336,14,688698,13365
2021-02-27,Iraq,3543,18,692241,13383
2021-02-28,Iraq,3248,23,695489,13406
2021-03-01,Iraq,3599,22,699088,13428
2021-03-02,Iraq,4690,30,703778,13458
2021-03-03,Iraq,5173,25,708951,13483
2021-03-04,Iraq,5043,24,713994,13507
2021-03-05,Iraq,5127,30,719121,13537
2021-03-06,Iraq,4068,11,723189,13548
2021-03-07,Iraq,3359,24,726548,13572
2021-03-08,Iraq,4468,24,731016,13596
2021-03-09,Iraq,4610,22,735626,13618
2021-03-10,Iraq,4846,27,740472,13645
2021-03-11,Iraq,5170,26,745642,13671
2021-03-12,Iraq,4622,25,750264,13696
2021-03-13,Iraq,4054,23,754318,13719
2021-03-14,Iraq,3866,32,758184,13751
2021-03-15,Iraq,4901,37,763085,13788
2021-03-16,Iraq,5267,39,768352,13827
2021-03-17,Iraq,5663,33,774015,13860
2021-03-18,Iraq,5443,36,779458,13896
2021-03-19,Iraq,5258,41,784716,13937
2021-03-20,Iraq,4674,32,789390,13969
2021-03-21,Iraq,4502,38,793892,14007
2021-03-22,Iraq,4655,29,798547,14036
2021-03-23,Iraq,4494,30,803041,14066
2021-03-24,Iraq,6051,29,809092,14095
2021-03-25,Iraq,6513,33,815605,14128
2021-03-26,Iraq,6490,29,822095,14157
2021-03-27,Iraq,5062,20,827157,14177
2021-03-28,Iraq,5271,35,832428,14212
2021-03-29,Iraq,5837,37,838265,14249
2021-03-30,Iraq,5995,37,844260,14286
2021-03-31,Iraq,6664,37,850924,14323
2021-04-01,Iraq,6015,37,856939,14360
2021-04-02,Iraq,5882,30,862821,14390
2021-04-03,Iraq,5379,40,868200,14430
2021-04-04,Iraq,5368,33,873568,14463
2021-04-05,Iraq,6423,39,879991,14502
2021-04-06,Iraq,7300,33,887291,14535
2021-04-07,Iraq,8331,37,895622,14572
2021-04-08,Iraq,7817,34,903439,14606
2020-02-29,Ireland,1,0,1,0
2020-03-01,Ireland,0,0,1,0
2020-03-02,Ireland,0,0,1,0
2020-03-03,Ireland,1,0,2,0
2020-03-04,Ireland,4,0,6,0
2020-03-05,Ireland,0,0,6,0
2020-03-06,Ireland,12,0,18,0
2020-03-07,Ireland,0,0,18,0
2020-03-08,Ireland,1,0,19,0
2020-03-09,Ireland,2,0,21,0
2020-03-10,Ireland,13,0,34,0
2020-03-11,Ireland,9,1,43,1
2020-03-12,Ireland,0,0,43,1
2020-03-13,Ireland,47,0,90,1
2020-03-14,Ireland,39,1,129,2
2020-03-15,Ireland,0,0,129,2
2020-03-16,Ireland,40,0,169,2
2020-03-17,Ireland,54,0,223,2
2020-03-18,Ireland,69,0,292,2
2020-03-19,Ireland,265,1,557,3
2020-03-20,Ireland,126,0,683,3
2020-03-21,Ireland,102,0,785,3
2020-03-22,Ireland,121,1,906,4
2020-03-23,Ireland,219,2,1125,6
2020-03-24,Ireland,204,1,1329,7
2020-03-25,Ireland,235,2,1564,9
2020-03-26,Ireland,255,10,1819,19
2020-03-27,Ireland,302,3,2121,22
2020-03-28,Ireland,294,14,2415,36
2020-03-29,Ireland,200,10,2615,46
2020-03-30,Ireland,295,8,2910,54
2020-03-31,Ireland,325,17,3235,71
2020-04-01,Ireland,212,14,3447,85
2020-04-02,Ireland,402,13,3849,98
2020-04-03,Ireland,424,22,4273,120
2020-04-04,Ireland,331,17,4604,137
2020-04-05,Ireland,390,21,4994,158
2020-04-06,Ireland,370,16,5364,174
2020-04-07,Ireland,345,36,5709,210
2020-04-08,Ireland,365,25,6074,235
2020-04-09,Ireland,500,28,6574,263
2020-04-10,Ireland,1515,24,8089,287
2020-04-11,Ireland,839,33,8928,320
2020-04-12,Ireland,727,14,9655,334
2020-04-13,Ireland,992,31,10647,365
2020-04-14,Ireland,832,41,11479,406
2020-04-15,Ireland,1068,38,12547,444
2020-04-16,Ireland,724,42,13271,486
2020-04-17,Ireland,709,44,13980,530
2020-04-18,Ireland,778,41,14758,571
2020-04-19,Ireland,493,39,15251,610
2020-04-20,Ireland,401,77,15652,687
2020-04-21,Ireland,388,43,16040,730
2020-04-22,Ireland,631,39,16671,769
2020-04-23,Ireland,936,25,17607,794
2020-04-24,Ireland,577,220,18184,1014
2020-04-25,Ireland,377,49,18561,1063
2020-04-26,Ireland,701,24,19262,1087
2020-04-27,Ireland,386,15,19648,1102
2020-04-28,Ireland,229,57,19877,1159
2020-04-29,Ireland,376,31,20253,1190
2020-04-30,Ireland,359,42,20612,1232
2020-05-01,Ireland,221,33,20833,1265
2020-05-02,Ireland,343,21,21176,1286
2020-05-03,Ireland,330,17,21506,1303
2020-05-04,Ireland,266,16,21772,1319
2020-05-05,Ireland,211,20,21983,1339
2020-05-06,Ireland,265,36,22248,1375
2020-05-07,Ireland,137,28,22385,1403
2020-05-08,Ireland,156,26,22541,1429
2020-05-09,Ireland,219,17,22760,1446
2020-05-10,Ireland,236,12,22996,1458
2020-05-11,Ireland,139,9,23135,1467
2020-05-12,Ireland,107,21,23242,1488
2020-05-13,Ireland,159,9,23401,1497
2020-05-14,Ireland,426,9,23827,1506
2020-05-15,Ireland,129,12,23956,1518
2020-05-16,Ireland,92,15,24048,1533
2020-05-17,Ireland,64,10,24112,1543
2020-05-18,Ireland,88,4,24200,1547
2020-05-19,Ireland,51,14,24251,1561
2020-05-20,Ireland,64,10,24315,1571
2020-05-21,Ireland,76,12,24391,1583
2020-05-22,Ireland,115,9,24506,1592
2020-05-23,Ireland,76,12,24582,1604
2020-05-24,Ireland,57,4,24639,1608
2020-05-25,Ireland,59,-2,24698,1606
2020-05-26,Ireland,37,9,24735,1615
2020-05-27,Ireland,68,16,24803,1631
2020-05-28,Ireland,38,8,24841,1639
2020-05-29,Ireland,35,6,24876,1645
2020-05-30,Ireland,53,6,24929,1651
2020-05-31,Ireland,61,1,24990,1652
2020-06-01,Ireland,72,-2,25062,1650
2020-06-02,Ireland,4,8,25066,1658
2020-06-03,Ireland,45,1,25111,1659
2020-06-04,Ireland,31,5,25142,1664
2020-06-05,Ireland,21,6,25163,1670
2020-06-06,Ireland,20,8,25183,1678
2020-06-07,Ireland,18,1,25201,1679
2020-06-08,Ireland,6,4,25207,1683
2020-06-09,Ireland,8,8,25215,1691
2020-06-10,Ireland,16,4,25231,1695
2020-06-11,Ireland,7,8,25238,1703
2020-06-12,Ireland,12,2,25250,1705
2020-06-13,Ireland,45,0,25295,1705
2020-06-14,Ireland,8,1,25303,1706
2020-06-15,Ireland,18,0,25321,1706
2020-06-16,Ireland,13,3,25334,1709
2020-06-17,Ireland,7,1,25341,1710
2020-06-18,Ireland,14,4,25355,1714
2020-06-19,Ireland,13,0,25368,1714
2020-06-20,Ireland,6,1,25374,1715
2020-06-21,Ireland,5,0,25379,1715
2020-06-22,Ireland,4,2,25383,1717
2020-06-23,Ireland,8,3,25391,1720
2020-06-24,Ireland,5,6,25396,1726
2020-06-25,Ireland,9,1,25405,1727
2020-06-26,Ireland,9,3,25414,1730
2020-06-27,Ireland,23,4,25437,1734
2020-06-28,Ireland,2,1,25439,1735
2020-06-29,Ireland,23,0,25462,1735
2020-06-30,Ireland,11,1,25473,1736
2020-07-01,Ireland,4,2,25477,1738
2020-07-02,Ireland,12,0,25489,1738
2020-07-03,Ireland,9,2,25498,1740
2020-07-04,Ireland,11,1,25509,1741
2020-07-05,Ireland,18,0,25527,1741
2020-07-06,Ireland,4,0,25531,1741
2020-07-07,Ireland,7,1,25538,1742
2020-07-08,Ireland,4,-4,25542,1738
2020-07-09,Ireland,23,5,25565,1743
2020-07-10,Ireland,24,1,25589,1744
2020-07-11,Ireland,22,2,25611,1746
2020-07-12,Ireland,17,0,25628,1746
2020-07-13,Ireland,10,0,25638,1746
2020-07-14,Ireland,32,0,25670,1746
2020-07-15,Ireland,13,2,25683,1748
2020-07-16,Ireland,15,1,25698,1749
2020-07-17,Ireland,32,3,25730,1752
2020-07-18,Ireland,20,1,25750,1753
2020-07-19,Ireland,10,0,25760,1753
2020-07-20,Ireland,6,0,25766,1753
2020-07-21,Ireland,36,0,25802,1753
2020-07-22,Ireland,17,1,25819,1754
2020-07-23,Ireland,7,9,25826,1763
2020-07-24,Ireland,19,0,25845,1763
2020-07-25,Ireland,24,1,25869,1764
2020-07-26,Ireland,12,0,25881,1764
2020-07-27,Ireland,11,0,25892,1764
2020-07-28,Ireland,37,0,25929,1764
2020-07-29,Ireland,13,0,25942,1764
2020-07-30,Ireland,85,-1,26027,1763
2020-07-31,Ireland,38,0,26065,1763
2020-08-01,Ireland,44,0,26109,1763
2020-08-02,Ireland,53,0,26162,1763
2020-08-03,Ireland,46,0,26208,1763
2020-08-04,Ireland,45,0,26253,1763
2020-08-05,Ireland,50,0,26303,1763
2020-08-06,Ireland,69,5,26372,1768
2020-08-07,Ireland,98,4,26470,1772
2020-08-08,Ireland,174,0,26644,1772
2020-08-09,Ireland,68,0,26712,1772
2020-08-10,Ireland,56,0,26768,1772
2020-08-11,Ireland,33,1,26801,1773
2020-08-12,Ireland,37,1,26838,1774
2020-08-13,Ireland,91,0,26929,1774
2020-08-14,Ireland,66,0,26995,1774
2020-08-15,Ireland,196,0,27191,1774
2020-08-16,Ireland,66,0,27257,1774
2020-08-17,Ireland,56,0,27313,1774
2020-08-18,Ireland,186,1,27499,1775
2020-08-19,Ireland,48,0,27547,1775
2020-08-20,Ireland,129,1,27676,1776
2020-08-21,Ireland,79,0,27755,1776
2020-08-22,Ireland,153,1,27908,1777
2020-08-23,Ireland,61,0,27969,1777
2020-08-24,Ireland,147,0,28116,1777
2020-08-25,Ireland,85,0,28201,1777
2020-08-26,Ireland,162,0,28363,1777
2020-08-27,Ireland,90,0,28453,1777
2020-08-28,Ireland,125,0,28578,1777
2020-08-29,Ireland,142,0,28720,1777
2020-08-30,Ireland,40,0,28760,1777
2020-08-31,Ireland,51,0,28811,1777
2020-09-01,Ireland,214,0,29025,1777
2020-09-02,Ireland,89,0,29114,1777
2020-09-03,Ireland,92,0,29206,1777
2020-09-04,Ireland,97,0,29303,1777
2020-09-05,Ireland,231,0,29534,1777
2020-09-06,Ireland,138,0,29672,1777
2020-09-07,Ireland,102,0,29774,1777
2020-09-08,Ireland,306,1,30080,1778
2020-09-09,Ireland,84,3,30164,1781
2020-09-10,Ireland,196,0,30360,1781
2020-09-11,Ireland,211,0,30571,1781
2020-09-12,Ireland,159,2,30730,1783
2020-09-13,Ireland,255,1,30985,1784
2020-09-14,Ireland,207,0,31192,1784
2020-09-15,Ireland,357,3,31549,1787
2020-09-16,Ireland,250,1,31799,1788
2020-09-17,Ireland,224,1,32023,1789
2020-09-18,Ireland,248,3,32271,1792
2020-09-19,Ireland,267,0,32538,1792
2020-09-20,Ireland,395,0,32933,1792
2020-09-21,Ireland,188,0,33121,1792
2020-09-22,Ireland,323,0,33444,1792
2020-09-23,Ireland,231,2,33675,1794
2020-09-24,Ireland,319,3,33994,1797
2020-09-25,Ireland,321,0,34315,1797
2020-09-26,Ireland,245,5,34560,1802
2020-09-27,Ireland,430,0,34990,1802
2020-09-28,Ireland,387,0,35377,1802
2020-09-29,Ireland,363,1,35740,1803
2020-09-30,Ireland,415,1,36155,1804
2020-10-01,Ireland,442,2,36597,1806
2020-10-02,Ireland,466,-5,37063,1801
2020-10-03,Ireland,605,9,37668,1810
2020-10-04,Ireland,364,0,38032,1810
2020-10-05,Ireland,517,0,38549,1810
2020-10-06,Ireland,424,1,38973,1811
2020-10-07,Ireland,611,5,39584,1816
2020-10-08,Ireland,502,1,40086,1817
2020-10-09,Ireland,617,4,40703,1821
2020-10-10,Ireland,1011,3,41714,1824
2020-10-11,Ireland,814,2,42528,1826
2020-10-12,Ireland,823,1,43351,1827
2020-10-13,Ireland,808,3,44159,1830
2020-10-14,Ireland,1084,5,45243,1835
2020-10-15,Ireland,1186,3,46429,1838
2020-10-16,Ireland,998,3,47427,1841
2020-10-17,Ireland,1251,8,48678,1849
2020-10-18,Ireland,1284,3,49962,1852
2020-10-19,Ireland,1031,0,50993,1852
2020-10-20,Ireland,1263,13,52256,1865
2020-10-21,Ireland,1166,3,53422,1868
2020-10-22,Ireland,1054,3,54476,1871
2020-10-23,Ireland,785,7,55261,1878
2020-10-24,Ireland,847,4,56108,1882
2020-10-25,Ireland,1020,0,57128,1882
2020-10-26,Ireland,939,3,58067,1885
2020-10-27,Ireland,700,5,58767,1890
2020-10-28,Ireland,667,6,59434,1896
2020-10-29,Ireland,863,6,60297,1902
2020-10-30,Ireland,762,6,61059,1908
2020-10-31,Ireland,397,5,61456,1913
2020-11-01,Ireland,546,2,62002,1915
2020-11-02,Ireland,748,2,62750,1917
2020-11-03,Ireland,298,5,63048,1922
2020-11-04,Ireland,435,8,63483,1930
2020-11-05,Ireland,563,3,64046,1933
2020-11-06,Ireland,492,7,64538,1940
2020-11-07,Ireland,317,5,64855,1945
2020-11-08,Ireland,539,2,65394,1947
2020-11-09,Ireland,265,1,65659,1948
2020-11-10,Ireland,230,15,65889,1963
2020-11-11,Ireland,358,2,66247,1965
2020-11-12,Ireland,385,0,66632,1965
2020-11-13,Ireland,467,7,67099,1972
2020-11-14,Ireland,427,6,67526,1978
2020-11-15,Ireland,377,1,67903,1979
2020-11-16,Ireland,453,5,68356,1984
2020-11-17,Ireland,330,11,68686,1995
2020-11-18,Ireland,372,11,69058,2006
2020-11-19,Ireland,415,4,69473,2010
2020-11-20,Ireland,329,8,69802,2018
2020-11-21,Ireland,341,4,70143,2022
2020-11-22,Ireland,318,1,70461,2023
2020-11-23,Ireland,250,0,70711,2023
2020-11-24,Ireland,219,5,70930,2028
2020-11-25,Ireland,257,5,71187,2033
2020-11-26,Ireland,307,3,71494,2036
2020-11-27,Ireland,205,7,71699,2043
2020-11-28,Ireland,243,7,71942,2050
2020-11-29,Ireland,299,2,72241,2052
2020-11-30,Ireland,303,1,72544,2053
2020-12-01,Ireland,254,16,72798,2069
2020-12-02,Ireland,268,5,73066,2074
2020-12-03,Ireland,162,6,73228,2080
2020-12-04,Ireland,263,6,73491,2086
2020-12-05,Ireland,457,13,73948,2099
2020-12-06,Ireland,298,0,74246,2099
2020-12-07,Ireland,222,0,74468,2099
2020-12-08,Ireland,214,-2,74682,2097
2020-12-09,Ireland,218,5,74900,2102
2020-12-10,Ireland,303,15,75203,2117
2020-12-11,Ireland,304,3,75507,2120
2020-12-12,Ireland,249,3,75756,2123
2020-12-13,Ireland,429,1,76185,2124
2020-12-14,Ireland,264,2,76449,2126
2020-12-15,Ireland,327,8,76776,2134
2020-12-16,Ireland,421,6,77197,2140
2020-12-17,Ireland,481,3,77678,2143
2020-12-18,Ireland,576,6,78254,2149
2020-12-19,Ireland,522,5,78776,2154
2020-12-20,Ireland,766,4,79542,2158
2020-12-21,Ireland,725,0,80267,2158
2020-12-22,Ireland,961,13,81228,2171
2020-12-23,Ireland,927,13,82155,2184
2020-12-24,Ireland,918,8,83073,2192
2020-12-25,Ireland,1025,2,84098,2194
2020-12-26,Ireland,1296,6,85394,2200
2020-12-27,Ireland,735,4,86129,2204
2020-12-28,Ireland,765,1,86894,2205
2020-12-29,Ireland,1545,8,88439,2213
2020-12-30,Ireland,1718,13,90157,2226
2020-12-31,Ireland,1622,11,91779,2237
2021-01-01,Ireland,1753,11,93532,2248
2021-01-02,Ireland,3394,4,96926,2252
2021-01-03,Ireland,4961,7,101887,2259
2021-01-04,Ireland,6110,6,107997,2265
2021-01-05,Ireland,5325,17,113322,2282
2021-01-06,Ireland,7832,17,121154,2299
2021-01-07,Ireland,6503,8,127657,2307
2021-01-08,Ireland,8227,20,135884,2327
2021-01-09,Ireland,4843,9,140727,2336
2021-01-10,Ireland,6886,8,147613,2344
2021-01-11,Ireland,4926,8,152539,2352
2021-01-12,Ireland,3052,45,155591,2397
2021-01-13,Ireland,3553,63,159144,2460
2021-01-14,Ireland,3913,28,163057,2488
2021-01-15,Ireland,3491,48,166548,2536
2021-01-16,Ireland,3232,59,169780,2595
2021-01-17,Ireland,2946,13,172726,2608
2021-01-18,Ireland,2117,8,174843,2616
2021-01-19,Ireland,1996,92,176839,2708
2021-01-20,Ireland,2485,60,179324,2768
2021-01-21,Ireland,2598,50,181922,2818
2021-01-22,Ireland,2357,52,184279,2870
2021-01-23,Ireland,1905,77,186184,2947
2021-01-24,Ireland,1370,23,187554,2970
2021-01-25,Ireland,1369,7,188923,2977
2021-01-26,Ireland,928,89,189851,3066
2021-01-27,Ireland,1331,54,191182,3120
2021-01-28,Ireland,1463,47,192645,3167
2021-01-29,Ireland,1247,47,193892,3214
2021-01-30,Ireland,1411,78,195303,3292
2021-01-31,Ireland,1244,15,196547,3307
2021-02-01,Ireland,1006,10,197553,3317
2021-02-02,Ireland,871,101,198424,3418
2021-02-03,Ireland,1006,94,199430,3512
2021-02-04,Ireland,1314,74,200744,3586
2021-02-05,Ireland,1019,35,201763,3621
2021-02-06,Ireland,785,53,202548,3674
2021-02-07,Ireland,1020,12,203568,3686
2021-02-08,Ireland,829,1,204397,3687
2021-02-09,Ireland,543,65,204940,3752
2021-02-10,Ireland,999,42,205939,3794
2021-02-11,Ireland,862,52,206801,3846
2021-02-12,Ireland,919,19,207720,3865
2021-02-13,Ireland,1076,66,208796,3931
2021-02-14,Ireland,786,17,209582,3948
2021-02-15,Ireland,820,0,210402,3948
2021-02-16,Ireland,711,32,211113,3980
2021-02-17,Ireland,638,56,211751,4036
2021-02-18,Ireland,896,46,212647,4082
2021-02-19,Ireland,753,27,213400,4109
2021-02-20,Ireland,978,26,214378,4135
2021-02-21,Ireland,679,1,215057,4136
2021-02-22,Ireland,686,1,215743,4137
2021-02-23,Ireland,557,44,216300,4181
2021-02-24,Ireland,540,56,216840,4237
2021-02-25,Ireland,638,34,217478,4271
2021-02-26,Ireland,773,29,218251,4300
2021-02-27,Ireland,729,13,218980,4313
2021-02-28,Ireland,612,6,219592,4319
2021-03-01,Ireland,681,0,220273,4319
2021-03-02,Ireland,357,14,220630,4333
2021-03-03,Ireland,559,24,221189,4357
2021-03-04,Ireland,460,39,221649,4396
2021-03-05,Ireland,520,9,222169,4405
2021-03-06,Ireland,530,14,222699,4419
2021-03-07,Ireland,520,3,223219,4422
2021-03-08,Ireland,432,0,223651,4422
2021-03-09,Ireland,306,30,223957,4452
2021-03-10,Ireland,631,47,224588,4499
2021-03-11,Ireland,591,10,225179,4509
2021-03-12,Ireland,641,9,225820,4518
2021-03-13,Ireland,538,16,226358,4534
2021-03-14,Ireland,383,0,226741,4534
2021-03-15,Ireland,575,0,227316,4534
2021-03-16,Ireland,347,18,227663,4552
2021-03-17,Ireland,552,14,228215,4566
2021-03-18,Ireland,581,0,228796,4566
2021-03-19,Ireland,510,10,229306,4576
2021-03-20,Ireland,525,9,229831,4585
2021-03-21,Ireland,768,2,230599,4587
2021-03-22,Ireland,520,1,231119,4588
2021-03-23,Ireland,365,22,231484,4610
2021-03-24,Ireland,680,18,232164,4628
2021-03-25,Ireland,594,3,232758,4631
2021-03-26,Ireland,569,20,233327,4651
2021-03-27,Ireland,610,2,233937,4653
2021-03-28,Ireland,604,13,234541,4666
2021-03-29,Ireland,537,1,235078,4667
2021-03-30,Ireland,366,14,235444,4681
2021-03-31,Ireland,410,6,235854,4687
2021-04-01,Ireland,746,18,236600,4705
2021-04-02,Ireland,587,8,237187,4713
2021-04-03,Ireland,508,2,237695,4715
2021-04-04,Ireland,453,3,238148,4718
2021-04-05,Ireland,318,0,238466,4718
2021-04-06,Ireland,441,9,238907,4727
2021-04-07,Ireland,418,5,239325,4732
2021-04-08,Ireland,398,5,239723,4737
2020-02-21,Israel,1,0,1,0
2020-02-22,Israel,0,0,1,0
2020-02-23,Israel,0,0,1,0
2020-02-24,Israel,0,0,1,0
2020-02-25,Israel,0,0,1,0
2020-02-26,Israel,1,0,2,0
2020-02-27,Israel,1,0,3,0
2020-02-28,Israel,3,0,6,0
2020-02-29,Israel,0,0,6,0
2020-03-01,Israel,1,0,7,0
2020-03-02,Israel,5,0,12,0
2020-03-03,Israel,3,0,15,0
2020-03-04,Israel,0,0,15,0
2020-03-05,Israel,6,0,21,0
2020-03-06,Israel,16,0,37,0
2020-03-07,Israel,10,0,47,0
2020-03-08,Israel,9,0,56,0
2020-03-09,Israel,4,0,60,0
2020-03-10,Israel,28,0,88,0
2020-03-11,Israel,-28,0,60,0
2020-03-12,Israel,21,0,81,0
2020-03-13,Israel,31,0,112,0
2020-03-14,Israel,26,0,138,0
2020-03-15,Israel,39,0,177,0
2020-03-16,Israel,74,0,251,0
2020-03-17,Israel,44,0,295,0
2020-03-18,Israel,76,0,371,0
2020-03-19,Israel,15,0,386,0
2020-03-20,Israel,242,1,628,1
2020-03-21,Israel,215,0,843,1
2020-03-22,Israel,237,0,1080,1
2020-03-23,Israel,169,0,1249,1
2020-03-24,Israel,102,3,1351,4
2020-03-25,Israel,1117,1,2468,5
2020-03-26,Israel,520,5,2988,10
2020-03-27,Israel,433,2,3421,12
2020-03-28,Israel,480,1,3901,13
2020-03-29,Israel,532,3,4433,16
2020-03-30,Israel,546,1,4979,17
2020-03-31,Israel,738,4,5717,21
2020-04-01,Israel,696,8,6413,29
2020-04-02,Israel,719,9,7132,38
2020-04-03,Israel,597,5,7729,43
2020-04-04,Israel,428,6,8157,49
2020-04-05,Israel,583,7,8740,56
2020-04-06,Israel,451,8,9191,64
2020-04-07,Israel,377,8,9568,72
2020-04-08,Israel,338,8,9906,80
2020-04-09,Israel,343,9,10249,89
2020-04-10,Israel,358,8,10607,97
2020-04-11,Israel,345,6,10952,103
2020-04-12,Israel,552,6,11504,109
2020-04-13,Israel,438,9,11942,118
2020-04-14,Israel,399,8,12341,126
2020-04-15,Israel,311,13,12652,139
2020-04-16,Israel,296,7,12948,146
2020-04-17,Israel,298,9,13246,155
2020-04-18,Israel,291,11,13537,166
2020-04-19,Israel,276,8,13813,174
2020-04-20,Israel,299,6,14112,180
2020-04-21,Israel,282,9,14394,189
2020-04-22,Israel,225,3,14619,192
2020-04-23,Israel,276,4,14895,196
2020-04-24,Israel,248,3,15143,199
2020-04-25,Israel,159,3,15302,202
2020-04-26,Israel,83,2,15385,204
2020-04-27,Israel,128,4,15513,208
2020-04-28,Israel,159,5,15672,213
2020-04-29,Israel,82,6,15754,219
2020-04-30,Israel,142,6,15896,225
2020-05-01,Israel,116,4,16012,229
2020-05-02,Israel,57,3,16069,232
2020-05-03,Israel,27,3,16096,235
2020-05-04,Israel,53,3,16149,238
2020-05-05,Israel,32,2,16181,240
2020-05-06,Israel,65,1,16246,241
2020-05-07,Israel,61,1,16307,242
2020-05-08,Israel,33,6,16340,248
2020-05-09,Israel,19,3,16359,251
2020-05-10,Israel,29,4,16388,255
2020-05-11,Israel,39,5,16427,260
2020-05-12,Israel,23,3,16450,263
2020-05-13,Israel,39,3,16489,266
2020-05-14,Israel,22,2,16511,268
2020-05-15,Israel,12,0,16523,268
2020-05-16,Israel,5,3,16528,271
2020-05-17,Israel,15,4,16543,275
2020-05-18,Israel,27,3,16570,278
2020-05-19,Israel,22,2,16592,280
2020-05-20,Israel,15,1,16607,281
2020-05-21,Israel,17,0,16624,281
2020-05-22,Israel,19,0,16643,281
2020-05-23,Israel,5,0,16648,281
2020-05-24,Israel,13,1,16661,282
2020-05-25,Israel,22,2,16683,284
2020-05-26,Israel,50,0,16733,284
2020-05-27,Israel,40,2,16773,286
2020-05-28,Israel,77,1,16850,287
2020-05-29,Israel,113,0,16963,287
2020-05-30,Israel,29,0,16992,287
2020-05-31,Israel,87,0,17079,287
2020-06-01,Israel,100,3,17179,290
2020-06-02,Israel,121,2,17300,292
2020-06-03,Israel,97,1,17397,293
2020-06-04,Israel,142,0,17539,293
2020-06-05,Israel,127,1,17666,294
2020-06-06,Israel,78,4,17744,298
2020-06-07,Israel,140,2,17884,300
2020-06-08,Israel,179,0,18063,300
2020-06-09,Israel,173,1,18236,301
2020-06-10,Israel,240,1,18476,302
2020-06-11,Israel,191,0,18667,302
2020-06-12,Israel,184,0,18851,302
2020-06-13,Israel,149,1,19000,303
2020-06-14,Israel,136,2,19136,305
2020-06-15,Israel,198,0,19334,305
2020-06-16,Israel,300,1,19634,306
2020-06-17,Israel,271,0,19905,306
2020-06-18,Israel,302,0,20207,306
2020-06-19,Israel,310,1,20517,307
2020-06-20,Israel,159,1,20676,308
2020-06-21,Israel,173,0,20849,308
2020-06-22,Israel,345,1,21194,309
2020-06-23,Israel,451,2,21645,311
2020-06-24,Israel,487,3,22132,314
2020-06-25,Israel,516,4,22648,318
2020-06-26,Israel,464,3,23112,321
2020-06-27,Israel,398,3,23510,324
2020-06-28,Israel,385,2,23895,326
2020-06-29,Israel,757,0,24652,326
2020-06-30,Israel,786,1,25438,327
2020-07-01,Israel,972,3,26410,330
2020-07-02,Israel,1146,1,27556,331
2020-07-03,Israel,939,3,28495,334
2020-07-04,Israel,821,5,29316,339
2020-07-05,Israel,831,2,30147,341
2020-07-06,Israel,1134,8,31281,349
2020-07-07,Israel,1390,5,32671,354
2020-07-08,Israel,1327,5,33998,359
2020-07-09,Israel,1525,5,35523,364
2020-07-10,Israel,1409,4,36932,368
2020-07-11,Israel,1168,5,38100,373
2020-07-12,Israel,1238,7,39338,380
2020-07-13,Israel,1720,4,41058,384
2020-07-14,Israel,1604,7,42662,391
2020-07-15,Israel,1877,6,44539,397
2020-07-16,Israel,1939,9,46478,406
2020-07-17,Israel,1605,12,48083,418
2020-07-18,Israel,1448,8,49531,426
2020-07-19,Israel,1016,10,50547,436
2020-07-20,Israel,1887,12,52434,448
2020-07-21,Israel,2006,9,54440,457
2020-07-22,Israel,2044,6,56484,463
2020-07-23,Israel,1990,16,58474,479
2020-07-24,Israel,1830,8,60304,487
2020-07-25,Israel,1112,7,61416,494
2020-07-26,Israel,1042,11,62458,505
2020-07-27,Israel,2048,7,64506,512
2020-07-28,Israel,2125,8,66631,520
2020-07-29,Israel,1954,15,68585,535
2020-07-30,Israel,1787,15,70372,550
2020-07-31,Israel,1362,14,71734,564
2020-08-01,Israel,625,14,72359,578
2020-08-02,Israel,708,11,73067,589
2020-08-03,Israel,1800,15,74867,604
2020-08-04,Israel,1729,11,76596,615
2020-08-05,Israel,1690,10,78286,625
2020-08-06,Israel,1677,9,79963,634
2020-08-07,Israel,1764,12,81727,646
2020-08-08,Israel,754,13,82481,659
2020-08-09,Israel,924,7,83405,666
2020-08-10,Israel,1704,15,85109,681
2020-08-11,Israel,1823,11,86932,692
2020-08-12,Israel,1622,15,88554,707
2020-08-13,Israel,1643,16,90197,723
2020-08-14,Israel,1388,12,91585,735
2020-08-15,Israel,757,10,92342,745
2020-08-16,Israel,1068,19,93410,764
2020-08-17,Israel,1650,4,95060,768
2020-08-18,Israel,1649,14,96709,782
2020-08-19,Israel,1640,12,98349,794
2020-08-20,Israel,1487,12,99836,806
2020-08-21,Israel,1493,13,101329,819
2020-08-22,Israel,711,10,102040,829
2020-08-23,Israel,965,13,103005,842
2020-08-24,Israel,1900,16,104905,858
2020-08-25,Israel,1956,19,106861,877
2020-08-26,Israel,1953,11,108814,888
2020-08-27,Israel,2071,11,110885,899
2020-08-28,Israel,1832,12,112717,911
2020-08-29,Israel,910,5,113627,916
2020-08-30,Israel,1101,14,114728,930
2020-08-31,Israel,2178,23,116906,953
2020-09-01,Israel,2252,15,119158,968
2020-09-02,Israel,3193,14,122351,982
2020-09-03,Israel,2661,16,125012,998
2020-09-04,Israel,2623,12,127635,1010
2020-09-05,Israel,1505,15,129140,1025
2020-09-06,Israel,2177,12,131317,1037
2020-09-07,Israel,3388,17,134705,1054
2020-09-08,Israel,3489,20,138194,1074
2020-09-09,Israel,3996,15,142190,1089
2020-09-10,Israel,4161,14,146351,1103
2020-09-11,Israel,3975,20,150326,1123
2020-09-12,Israel,2719,15,153045,1138
2020-09-13,Israel,3175,17,156220,1155
2020-09-14,Israel,4805,20,161025,1175
2020-09-15,Israel,5539,16,166564,1191
2020-09-16,Israel,4574,26,171138,1217
2020-09-17,Israel,5385,18,176523,1235
2020-09-18,Israel,5340,20,181863,1255
2020-09-19,Israel,3809,27,185672,1282
2020-09-20,Israel,2579,21,188251,1303
2020-09-21,Israel,3866,31,192117,1334
2020-09-22,Israel,7021,26,199138,1360
2020-09-23,Israel,7125,25,206263,1385
2020-09-24,Israel,8234,31,214497,1416
2020-09-25,Israel,8390,30,222887,1446
2020-09-26,Israel,5882,25,228769,1471
2020-09-27,Israel,3414,32,232183,1503
2020-09-28,Israel,1159,29,233342,1532
2020-09-29,Israel,4991,35,238333,1567
2020-09-30,Israel,9078,37,247411,1604
2020-10-01,Israel,7731,46,255142,1650
2020-10-02,Israel,7058,25,262200,1675
2020-10-03,Israel,2593,37,264793,1712
2020-10-04,Israel,2937,36,267730,1748
2020-10-05,Israel,5721,27,273451,1775
2020-10-06,Israel,4724,45,278175,1820
2020-10-07,Israel,4165,26,282340,1846
2020-10-08,Israel,3755,47,286095,1893
2020-10-09,Israel,2963,40,289058,1933
2020-10-10,Israel,916,35,289974,1968
2020-10-11,Israel,1646,46,291620,2014
2020-10-12,Israel,3169,30,294789,2044
2020-10-13,Israel,2336,38,297125,2082
2020-10-14,Israel,2117,35,299242,2117
2020-10-15,Israel,1612,31,300854,2148
2020-10-16,Israel,1500,34,302354,2182
2020-10-17,Israel,411,32,302765,2214
2020-10-18,Israel,922,33,303687,2247
2020-10-19,Israel,1517,31,305204,2278
2020-10-20,Israel,1193,20,306397,2298
2020-10-21,Israel,1172,25,307569,2323
2020-10-22,Israel,1032,29,308601,2352
2020-10-23,Israel,849,26,309450,2378
2020-10-24,Israel,246,27,309696,2405
2020-10-25,Israel,607,35,310303,2440
2020-10-26,Israel,884,28,311187,2468
2020-10-27,Israel,887,28,312074,2496
2020-10-28,Israel,723,10,312797,2506
2020-10-29,Israel,644,19,313441,2525
2020-10-30,Israel,680,11,314121,2536
2020-10-31,Israel,228,25,314349,2561
2020-11-01,Israel,658,19,315007,2580
2020-11-02,Israel,788,16,315795,2596
2020-11-03,Israel,846,26,316641,2622
2020-11-04,Israel,769,17,317410,2639
2020-11-05,Israel,570,13,317980,2652
2020-11-06,Israel,691,16,318671,2668
2020-11-07,Israel,212,8,318883,2676
2020-11-08,Israel,534,7,319417,2683
2020-11-09,Israel,719,6,320136,2689
2020-11-10,Israel,675,10,320811,2699
2020-11-11,Israel,763,7,321574,2706
2020-11-12,Israel,836,12,322410,2718
2020-11-13,Israel,761,5,323171,2723
2020-11-14,Israel,292,12,323463,2735
2020-11-15,Israel,625,9,324088,2744
2020-11-16,Israel,873,7,324961,2751
2020-11-17,Israel,829,12,325790,2763
2020-11-18,Israel,795,7,326585,2770
2020-11-19,Israel,770,8,327355,2778
2020-11-20,Israel,774,6,328129,2784
2020-11-21,Israel,422,12,328551,2796
2020-11-22,Israel,765,17,329316,2813
2020-11-23,Israel,959,7,330275,2820
2020-11-24,Israel,857,6,331132,2826
2020-11-25,Israel,1079,5,332211,2831
2020-11-26,Israel,1085,9,333296,2840
2020-11-27,Israel,1032,6,334328,2846
2020-11-28,Israel,580,10,334908,2856
2020-11-29,Israel,1025,8,335933,2864
2020-11-30,Israel,1258,8,337191,2872
2020-12-01,Israel,1198,10,338389,2882
2020-12-02,Israel,1579,4,339968,2886
2020-12-03,Israel,1438,9,341406,2895
2020-12-04,Israel,695,1,342101,2896
2020-12-05,Israel,1725,13,343826,2909
2020-12-06,Israel,1080,8,344906,2917
2020-12-07,Israel,1891,7,346797,2924
2020-12-08,Israel,1488,8,348285,2932
2020-12-09,Israel,1986,2,350271,2934
2020-12-10,Israel,2126,27,352397,2961
2020-12-11,Israel,872,8,353269,2969
2020-12-12,Israel,2517,14,355786,2983
2020-12-13,Israel,1390,16,357176,2999
2020-12-14,Israel,2330,5,359506,3004
2020-12-15,Israel,1124,10,360630,3014
2020-12-16,Israel,4412,20,365042,3034
2020-12-17,Israel,2933,16,367975,3050
2020-12-18,Israel,2177,7,370152,3057
2020-12-19,Israel,2734,17,372886,3074
2020-12-20,Israel,1874,25,374760,3099
2020-12-21,Israel,3499,12,378259,3111
2020-12-22,Israel,4228,25,382487,3136
2020-12-23,Israel,2535,14,385022,3150
2020-12-24,Israel,4656,21,389678,3171
2020-12-25,Israel,4713,15,394391,3186
2020-12-26,Israel,4273,24,398664,3210
2020-12-27,Israel,2806,16,401470,3226
2020-12-28,Israel,5815,30,407285,3256
2020-12-29,Israel,5113,36,412398,3292
2020-12-30,Israel,4186,15,416584,3307
2020-12-31,Israel,6678,18,423262,3325
2021-01-01,Israel,5248,31,428510,3356
2021-01-02,Israel,6289,36,434799,3392
2021-01-03,Israel,6743,24,441542,3416
2021-01-04,Israel,6631,29,448173,3445
2021-01-05,Israel,7966,51,456139,3496
2021-01-06,Israel,7309,33,463448,3529
2021-01-07,Israel,7600,23,471048,3552
2021-01-08,Israel,6309,44,477357,3596
2021-01-09,Israel,8077,49,485434,3645
2021-01-10,Israel,5885,26,491319,3671
2021-01-11,Israel,9754,33,501073,3704
2021-01-12,Israel,8990,67,510063,3771
2021-01-13,Israel,9997,46,520060,3817
2021-01-14,Israel,9754,53,529814,3870
2021-01-15,Israel,5235,40,535049,3910
2021-01-16,Israel,8450,49,543499,3959
2021-01-17,Israel,8190,46,551689,4005
2021-01-18,Israel,6560,39,558249,4044
2021-01-19,Israel,7380,36,565629,4080
2021-01-20,Israel,10213,101,575842,4181
2021-01-21,Israel,7027,64,582869,4245
2021-01-22,Israel,6159,21,589028,4266
2021-01-23,Israel,4933,75,593961,4341
2021-01-24,Israel,3442,78,597403,4419
2021-01-25,Israel,3666,79,601069,4498
2021-01-26,Israel,8587,15,609656,4513
2021-01-27,Israel,11934,92,621590,4605
2021-01-28,Israel,7305,64,628895,4669
2021-01-29,Israel,5096,31,633991,4700
2021-01-30,Israel,4798,38,638789,4738
2021-01-31,Israel,4646,58,643435,4796
2021-02-01,Israel,8811,20,652246,4816
2021-02-02,Israel,7732,71,659978,4887
2021-02-03,Israel,8896,61,668874,4948
2021-02-04,Israel,6744,53,675618,5001
2021-02-05,Israel,5238,19,680856,5020
2021-02-06,Israel,4727,51,685583,5071
2021-02-07,Israel,6518,50,692101,5121
2021-02-08,Israel,4427,50,696528,5171
2021-02-09,Israel,7191,45,703719,5216
2021-02-10,Israel,6010,41,709729,5257
2021-02-11,Israel,5083,26,714812,5283
2021-02-12,Israel,3934,21,718746,5304
2021-02-13,Israel,3100,47,721846,5351
2021-02-14,Israel,2534,37,724380,5388
2021-02-15,Israel,5913,26,730293,5414
2021-02-16,Israel,4282,27,734575,5441
2021-02-17,Israel,4054,32,738629,5473
2021-02-18,Israel,3305,36,741934,5509
2021-02-19,Israel,2579,17,744513,5526
2021-02-20,Israel,0,0,744513,5526
2021-02-21,Israel,5530,51,750043,5577
2021-02-22,Israel,4955,19,754998,5596
2021-02-23,Israel,4574,38,759572,5634
2021-02-24,Israel,4184,26,763756,5660
2021-02-25,Israel,3970,27,767726,5687
2021-02-26,Israel,3054,10,770780,5697
2021-02-27,Israel,2555,35,773335,5732
2021-02-28,Israel,2472,20,775807,5752
2021-03-01,Israel,4151,8,779958,5760
2021-03-02,Israel,5260,30,785218,5790
2021-03-03,Israel,4267,13,789485,5803
2021-03-04,Israel,3922,19,793407,5822
2021-03-05,Israel,3058,12,796465,5834
2021-03-06,Israel,3262,22,799727,5856
2021-03-07,Israel,1848,35,801575,5891
2021-03-08,Israel,3541,26,805116,5917
2021-03-09,Israel,3146,16,808262,5933
2021-03-10,Israel,3230,17,811492,5950
2021-03-11,Israel,2758,17,814250,5967
2021-03-12,Israel,1948,13,816198,5980
2021-03-13,Israel,1601,8,817799,5988
2021-03-14,Israel,1178,23,818977,6011
2021-03-15,Israel,1936,19,820913,6030
2021-03-16,Israel,1790,18,822703,6048
2021-03-17,Israel,1475,9,824178,6057
2021-03-18,Israel,1384,12,825562,6069
2021-03-19,Israel,1047,4,826609,6073
2021-03-20,Israel,611,9,827220,6082
2021-03-21,Israel,552,10,827772,6092
2021-03-22,Israel,992,17,828764,6109
2021-03-23,Israel,925,13,829689,6122
2021-03-24,Israel,339,32,830028,6154
2021-03-25,Israel,817,9,830845,6163
2021-03-26,Israel,538,2,831383,6165
2021-03-27,Israel,0,0,831383,6165
2021-03-28,Israel,541,20,831924,6185
2021-03-29,Israel,201,12,832125,6197
2021-03-30,Israel,514,-4,832639,6193
2021-03-31,Israel,466,16,833105,6209
2021-04-01,Israel,351,11,833456,6220
2021-04-02,Israel,251,0,833707,6220
2021-04-03,Israel,363,16,834070,6236
2021-04-04,Israel,177,7,834247,6243
2021-04-05,Israel,356,5,834603,6248
2021-04-06,Israel,317,9,834920,6257
2021-04-07,Israel,296,9,835216,6266
2021-04-08,Israel,270,13,835486,6279
2020-01-31,Italy,2,0,2,0
2020-02-01,Italy,0,0,2,0
2020-02-02,Italy,0,0,2,0
2020-02-03,Italy,0,0,2,0
2020-02-04,Italy,0,0,2,0
2020-02-05,Italy,0,0,2,0
2020-02-06,Italy,0,0,2,0
2020-02-07,Italy,1,0,3,0
2020-02-08,Italy,0,0,3,0
2020-02-09,Italy,0,0,3,0
2020-02-10,Italy,0,0,3,0
2020-02-11,Italy,0,0,3,0
2020-02-12,Italy,0,0,3,0
2020-02-13,Italy,0,0,3,0
2020-02-14,Italy,0,0,3,0
2020-02-15,Italy,0,0,3,0
2020-02-16,Italy,0,0,3,0
2020-02-17,Italy,0,0,3,0
2020-02-18,Italy,0,0,3,0
2020-02-19,Italy,0,0,3,0
2020-02-20,Italy,0,0,3,0
2020-02-21,Italy,17,1,20,1
2020-02-22,Italy,42,1,62,2
2020-02-23,Italy,93,1,155,3
2020-02-24,Italy,74,4,229,7
2020-02-25,Italy,93,3,322,10
2020-02-26,Italy,131,2,453,12
2020-02-27,Italy,202,5,655,17
2020-02-28,Italy,233,4,888,21
2020-02-29,Italy,240,8,1128,29
2020-03-01,Italy,566,5,1694,34
2020-03-02,Italy,342,18,2036,52
2020-03-03,Italy,466,27,2502,79
2020-03-04,Italy,587,28,3089,107
2020-03-05,Italy,769,41,3858,148
2020-03-06,Italy,778,49,4636,197
2020-03-07,Italy,1247,36,5883,233
2020-03-08,Italy,1492,133,7375,366
2020-03-09,Italy,1797,97,9172,463
2020-03-10,Italy,977,168,10149,631
2020-03-11,Italy,2313,196,12462,827
2020-03-12,Italy,2651,189,15113,1016
2020-03-13,Italy,2547,250,17660,1266
2020-03-14,Italy,3497,175,21157,1441
2020-03-15,Italy,3590,368,24747,1809
2020-03-16,Italy,3233,349,27980,2158
2020-03-17,Italy,3526,345,31506,2503
2020-03-18,Italy,4207,475,35713,2978
2020-03-19,Italy,5322,427,41035,3405
2020-03-20,Italy,5986,627,47021,4032
2020-03-21,Italy,6557,793,53578,4825
2020-03-22,Italy,5560,651,59138,5476
2020-03-23,Italy,4789,601,63927,6077
2020-03-24,Italy,5249,743,69176,6820
2020-03-25,Italy,5210,683,74386,7503
2020-03-26,Italy,6203,712,80589,8215
2020-03-27,Italy,5909,919,86498,9134
2020-03-28,Italy,5974,889,92472,10023
2020-03-29,Italy,5217,756,97689,10779
2020-03-30,Italy,4050,812,101739,11591
2020-03-31,Italy,4053,837,105792,12428
2020-04-01,Italy,4782,727,110574,13155
2020-04-02,Italy,4668,760,115242,13915
2020-04-03,Italy,4585,766,119827,14681
2020-04-04,Italy,4805,681,124632,15362
2020-04-05,Italy,4316,525,128948,15887
2020-04-06,Italy,3599,636,132547,16523
2020-04-07,Italy,3039,604,135586,17127
2020-04-08,Italy,3836,542,139422,17669
2020-04-09,Italy,4204,610,143626,18279
2020-04-10,Italy,3951,570,147577,18849
2020-04-11,Italy,4694,619,152271,19468
2020-04-12,Italy,4092,431,156363,19899
2020-04-13,Italy,3153,566,159516,20465
2020-04-14,Italy,2972,602,162488,21067
2020-04-15,Italy,2667,578,165155,21645
2020-04-16,Italy,3786,525,168941,22170
2020-04-17,Italy,3493,575,172434,22745
2020-04-18,Italy,3491,482,175925,23227
2020-04-19,Italy,3047,433,178972,23660
2020-04-20,Italy,2256,454,181228,24114
2020-04-21,Italy,2729,534,183957,24648
2020-04-22,Italy,3370,437,187327,25085
2020-04-23,Italy,2646,464,189973,25549
2020-04-24,Italy,3021,420,192994,25969
2020-04-25,Italy,2357,415,195351,26384
2020-04-26,Italy,2324,260,197675,26644
2020-04-27,Italy,1739,333,199414,26977
2020-04-28,Italy,2091,382,201505,27359
2020-04-29,Italy,2086,323,203591,27682
2020-04-30,Italy,1872,285,205463,27967
2020-05-01,Italy,1965,269,207428,28236
2020-05-02,Italy,1900,474,209328,28710
2020-05-03,Italy,1389,174,210717,28884
2020-05-04,Italy,1221,195,211938,29079
2020-05-05,Italy,1075,236,213013,29315
2020-05-06,Italy,1444,369,214457,29684
2020-05-07,Italy,1401,274,215858,29958
2020-05-08,Italy,1327,243,217185,30201
2020-05-09,Italy,1083,194,218268,30395
2020-05-10,Italy,802,165,219070,30560
2020-05-11,Italy,744,179,219814,30739
2020-05-12,Italy,1402,172,221216,30911
2020-05-13,Italy,888,195,222104,31106
2020-05-14,Italy,992,262,223096,31368
2020-05-15,Italy,789,242,223885,31610
2020-05-16,Italy,875,153,224760,31763
2020-05-17,Italy,675,145,225435,31908
2020-05-18,Italy,451,99,225886,32007
2020-05-19,Italy,813,162,226699,32169
2020-05-20,Italy,665,161,227364,32330
2020-05-21,Italy,642,156,228006,32486
2020-05-22,Italy,652,130,228658,32616
2020-05-23,Italy,669,119,229327,32735
2020-05-24,Italy,531,50,229858,32785
2020-05-25,Italy,300,92,230158,32877
2020-05-26,Italy,397,78,230555,32955
2020-05-27,Italy,584,117,231139,33072
2020-05-28,Italy,593,70,231732,33142
2020-05-29,Italy,516,87,232248,33229
2020-05-30,Italy,416,111,232664,33340
2020-05-31,Italy,333,75,232997,33415
2020-06-01,Italy,200,60,233197,33475
2020-06-02,Italy,318,55,233515,33530
2020-06-03,Italy,321,71,233836,33601
2020-06-04,Italy,177,88,234013,33689
2020-06-05,Italy,518,85,234531,33774
2020-06-06,Italy,270,72,234801,33846
2020-06-07,Italy,197,53,234998,33899
2020-06-08,Italy,280,65,235278,33964
2020-06-09,Italy,283,79,235561,34043
2020-06-10,Italy,202,71,235763,34114
2020-06-11,Italy,379,53,236142,34167
2020-06-12,Italy,163,56,236305,34223
2020-06-13,Italy,346,78,236651,34301
2020-06-14,Italy,338,44,236989,34345
2020-06-15,Italy,301,26,237290,34371
2020-06-16,Italy,210,34,237500,34405
2020-06-17,Italy,328,43,237828,34448
2020-06-18,Italy,331,66,238159,34514
2020-06-19,Italy,-148,47,238011,34561
2020-06-20,Italy,264,49,238275,34610
2020-06-21,Italy,224,24,238499,34634
2020-06-22,Italy,221,23,238720,34657
2020-06-23,Italy,113,18,238833,34675
2020-06-24,Italy,577,-31,239410,34644
2020-06-25,Italy,296,34,239706,34678
2020-06-26,Italy,255,30,239961,34708
2020-06-27,Italy,175,8,240136,34716
2020-06-28,Italy,174,22,240310,34738
2020-06-29,Italy,126,6,240436,34744
2020-06-30,Italy,142,23,240578,34767
2020-07-01,Italy,182,21,240760,34788
2020-07-02,Italy,201,30,240961,34818
2020-07-03,Italy,223,15,241184,34833
2020-07-04,Italy,235,21,241419,34854
2020-07-05,Italy,192,7,241611,34861
2020-07-06,Italy,208,8,241819,34869
2020-07-07,Italy,137,30,241956,34899
2020-07-08,Italy,193,15,242149,34914
2020-07-09,Italy,214,12,242363,34926
2020-07-10,Italy,276,12,242639,34938
2020-07-11,Italy,188,7,242827,34945
2020-07-12,Italy,234,9,243061,34954
2020-07-13,Italy,169,13,243230,34967
2020-07-14,Italy,114,17,243344,34984
2020-07-15,Italy,162,13,243506,34997
2020-07-16,Italy,230,20,243736,35017
2020-07-17,Italy,231,11,243967,35028
2020-07-18,Italy,249,14,244216,35042
2020-07-19,Italy,218,3,244434,35045
2020-07-20,Italy,190,13,244624,35058
2020-07-21,Italy,128,15,244752,35073
2020-07-22,Italy,280,9,245032,35082
2020-07-23,Italy,306,10,245338,35092
2020-07-24,Italy,252,5,245590,35097
2020-07-25,Italy,274,5,245864,35102
2020-07-26,Italy,254,5,246118,35107
2020-07-27,Italy,168,5,246286,35112
2020-07-28,Italy,202,11,246488,35123
2020-07-29,Italy,288,6,246776,35129
2020-07-30,Italy,382,3,247158,35132
2020-07-31,Italy,379,9,247537,35141
2020-08-01,Italy,295,5,247832,35146
2020-08-02,Italy,238,8,248070,35154
2020-08-03,Italy,159,12,248229,35166
2020-08-04,Italy,190,5,248419,35171
2020-08-05,Italy,384,10,248803,35181
2020-08-06,Italy,401,6,249204,35187
2020-08-07,Italy,552,3,249756,35190
2020-08-08,Italy,347,13,250103,35203
2020-08-09,Italy,463,2,250566,35205
2020-08-10,Italy,259,4,250825,35209
2020-08-11,Italy,412,6,251237,35215
2020-08-12,Italy,476,10,251713,35225
2020-08-13,Italy,522,6,252235,35231
2020-08-14,Italy,574,3,252809,35234
2020-08-15,Italy,629,158,253438,35392
2020-08-16,Italy,477,4,253915,35396
2020-08-17,Italy,320,4,254235,35400
2020-08-18,Italy,401,5,254636,35405
2020-08-19,Italy,642,7,255278,35412
2020-08-20,Italy,840,6,256118,35418
2020-08-21,Italy,947,9,257065,35427
2020-08-22,Italy,1071,3,258136,35430
2020-08-23,Italy,1209,7,259345,35437
2020-08-24,Italy,953,4,260298,35441
2020-08-25,Italy,876,4,261174,35445
2020-08-26,Italy,1366,13,262540,35458
2020-08-27,Italy,1409,5,263949,35463
2020-08-28,Italy,1460,9,265409,35472
2020-08-29,Italy,1444,1,266853,35473
2020-08-30,Italy,1365,4,268218,35477
2020-08-31,Italy,996,6,269214,35483
2020-09-01,Italy,975,8,270189,35491
2020-09-02,Italy,1326,6,271515,35497
2020-09-03,Italy,1397,10,272912,35507
2020-09-04,Italy,1732,11,274644,35518
2020-09-05,Italy,1694,16,276338,35534
2020-09-06,Italy,1296,7,277634,35541
2020-09-07,Italy,1150,12,278784,35553
2020-09-08,Italy,1369,10,280153,35563
2020-09-09,Italy,1430,14,281583,35577
2020-09-10,Italy,1597,10,283180,35587
2020-09-11,Italy,1616,10,284796,35597
2020-09-12,Italy,1501,6,286297,35603
2020-09-13,Italy,1456,7,287753,35610
2020-09-14,Italy,1008,14,288761,35624
2020-09-15,Italy,1229,9,289990,35633
2020-09-16,Italy,1452,12,291442,35645
2020-09-17,Italy,1583,13,293025,35658
2020-09-18,Italy,1907,10,294932,35668
2020-09-19,Italy,1637,24,296569,35692
2020-09-20,Italy,1587,15,298156,35707
2020-09-21,Italy,1350,17,299506,35724
2020-09-22,Italy,1391,14,300897,35738
2020-09-23,Italy,1640,20,302537,35758
2020-09-24,Italy,1786,23,304323,35781
2020-09-25,Italy,1912,20,306235,35801
2020-09-26,Italy,1869,17,308104,35818
2020-09-27,Italy,1766,17,309870,35835
2020-09-28,Italy,1494,16,311364,35851
2020-09-29,Italy,1647,24,313011,35875
2020-09-30,Italy,1850,19,314861,35894
2020-10-01,Italy,2548,24,317409,35918
2020-10-02,Italy,2499,23,319908,35941
2020-10-03,Italy,2843,27,322751,35968
2020-10-04,Italy,2578,18,325329,35986
2020-10-05,Italy,2257,16,327586,36002
2020-10-06,Italy,2677,28,330263,36030
2020-10-07,Italy,3677,31,333940,36061
2020-10-08,Italy,4458,22,338398,36083
2020-10-09,Italy,5372,28,343770,36111
2020-10-10,Italy,5724,29,349494,36140
2020-10-11,Italy,5456,26,354950,36166
2020-10-12,Italy,4619,39,359569,36205
2020-10-13,Italy,5898,41,365467,36246
2020-10-14,Italy,7332,43,372799,36289
2020-10-15,Italy,8803,83,381602,36372
2020-10-16,Italy,10009,55,391611,36427
2020-10-17,Italy,10925,47,402536,36474
2020-10-18,Italy,11705,69,414241,36543
2020-10-19,Italy,9337,73,423578,36616
2020-10-20,Italy,10871,89,434449,36705
2020-10-21,Italy,15199,127,449648,36832
2020-10-22,Italy,16078,136,465726,36968
2020-10-23,Italy,19143,91,484869,37059
2020-10-24,Italy,19640,151,504509,37210
2020-10-25,Italy,21273,128,525782,37338
2020-10-26,Italy,17007,141,542789,37479
2020-10-27,Italy,21989,221,564778,37700
2020-10-28,Italy,24988,205,589766,37905
2020-10-29,Italy,26829,217,616595,38122
2020-10-30,Italy,31079,199,647674,38321
2020-10-31,Italy,31756,297,679430,38618
2020-11-01,Italy,29905,208,709335,38826
2020-11-02,Italy,22253,233,731588,39059
2020-11-03,Italy,28241,353,759829,39412
2020-11-04,Italy,30548,352,790377,39764
2020-11-05,Italy,34502,428,824879,40192
2020-11-06,Italy,37802,446,862681,40638
2020-11-07,Italy,39809,425,902490,41063
2020-11-08,Italy,32614,331,935104,41394
2020-11-09,Italy,25269,356,960373,41750
2020-11-10,Italy,35090,580,995463,42330
2020-11-11,Italy,32961,623,1028424,42953
2020-11-12,Italy,37977,636,1066401,43589
2020-11-13,Italy,40902,550,1107303,44139
2020-11-14,Italy,37249,544,1144552,44683
2020-11-15,Italy,33977,546,1178529,45229
2020-11-16,Italy,27352,504,1205881,45733
2020-11-17,Italy,32191,731,1238072,46464
2020-11-18,Italy,34280,753,1272352,47217
2020-11-19,Italy,36176,653,1308528,47870
2020-11-20,Italy,37239,699,1345767,48569
2020-11-21,Italy,34764,692,1380531,49261
2020-11-22,Italy,28337,562,1408868,49823
2020-11-23,Italy,22927,630,1431795,50453
2020-11-24,Italy,23227,853,1455022,51306
2020-11-25,Italy,25852,722,1480874,52028
2020-11-26,Italy,29001,822,1509875,52850
2020-11-27,Italy,28342,827,1538217,53677
2020-11-28,Italy,26315,686,1564532,54363
2020-11-29,Italy,20646,541,1585178,54904
2020-11-30,Italy,16376,672,1601554,55576
2020-12-01,Italy,19347,785,1620901,56361
2020-12-02,Italy,20709,684,1641610,57045
2020-12-03,Italy,23219,993,1664829,58038
2020-12-04,Italy,24110,814,1688939,58852
2020-12-05,Italy,21052,662,1709991,59514
2020-12-06,Italy,18887,564,1728878,60078
2020-12-07,Italy,13679,528,1742557,60606
2020-12-08,Italy,14837,634,1757394,61240
2020-12-09,Italy,12755,499,1770149,61739
2020-12-10,Italy,16998,887,1787147,62626
2020-12-11,Italy,18726,761,1805873,63387
2020-12-12,Italy,19902,649,1825775,64036
2020-12-13,Italy,17937,484,1843712,64520
2020-12-14,Italy,12025,491,1855737,65011
2020-12-15,Italy,14839,846,1870576,65857
2020-12-16,Italy,17568,680,1888144,66537
2020-12-17,Italy,18233,683,1906377,67220
2020-12-18,Italy,15401,674,1921778,67894
2020-12-19,Italy,16305,553,1938083,68447
2020-12-20,Italy,15102,352,1953185,68799
2020-12-21,Italy,10869,415,1964054,69214
2020-12-22,Italy,13316,628,1977370,69842
2020-12-23,Italy,13908,553,1991278,70395
2020-12-24,Italy,18039,505,2009317,70900
2020-12-25,Italy,19037,459,2028354,71359
2020-12-26,Italy,10405,261,2038759,71620
2020-12-27,Italy,8937,305,2047696,71925
2020-12-28,Italy,8581,445,2056277,72370
2020-12-29,Italy,11210,659,2067487,73029
2020-12-30,Italy,16202,575,2083689,73604
2020-12-31,Italy,23477,555,2107166,74159
2021-01-01,Italy,22210,462,2129376,74621
2021-01-02,Italy,11825,364,2141201,74985
2021-01-03,Italy,14245,347,2155446,75332
2021-01-04,Italy,10798,348,2166244,75680
2021-01-05,Italy,15375,649,2181619,76329
2021-01-06,Italy,20326,548,2201945,76877
2021-01-07,Italy,18416,414,2220361,77291
2021-01-08,Italy,17529,620,2237890,77911
2021-01-09,Italy,19976,483,2257866,78394
2021-01-10,Italy,18625,361,2276491,78755
2021-01-11,Italy,12530,448,2289021,79203
2021-01-12,Italy,14242,616,2303263,79819
2021-01-13,Italy,15773,507,2319036,80326
2021-01-14,Italy,17243,522,2336279,80848
2021-01-15,Italy,16144,477,2352423,81325
2021-01-16,Italy,16310,475,2368733,81800
2021-01-17,Italy,12544,377,2381277,82177
2021-01-18,Italy,8825,377,2390102,82554
2021-01-19,Italy,10496,603,2400598,83157
2021-01-20,Italy,13568,524,2414166,83681
2021-01-21,Italy,14055,521,2428221,84202
2021-01-22,Italy,13633,472,2441854,84674
2021-01-23,Italy,13331,488,2455185,85162
2021-01-24,Italy,11628,299,2466813,85461
2021-01-25,Italy,8559,420,2475372,85881
2021-01-26,Italy,10584,541,2485956,86422
2021-01-27,Italy,15191,467,2501147,86889
2021-01-28,Italy,14360,492,2515507,87381
2021-01-29,Italy,13563,477,2529070,87858
2021-01-30,Italy,12713,421,2541783,88279
2021-01-31,Italy,11249,237,2553032,88516
2021-02-01,Italy,7925,329,2560957,88845
2021-02-02,Italy,9651,499,2570608,89344
2021-02-03,Italy,13182,476,2583790,89820
2021-02-04,Italy,13656,421,2597446,90241
2021-02-05,Italy,14213,377,2611659,90618
2021-02-06,Italy,13439,385,2625098,91003
2021-02-07,Italy,11640,270,2636738,91273
2021-02-08,Italy,7969,307,2644707,91580
2021-02-09,Italy,10612,422,2655319,92002
2021-02-10,Italy,12947,336,2668266,92338
2021-02-11,Italy,15137,391,2683403,92729
2021-02-12,Italy,13893,316,2697296,93045
2021-02-13,Italy,13523,311,2710819,93356
2021-02-14,Italy,11060,221,2721879,93577
2021-02-15,Italy,7344,258,2729223,93835
2021-02-16,Italy,10368,336,2739591,94171
2021-02-17,Italy,12066,369,2751657,94540
2021-02-18,Italy,13755,347,2765412,94887
2021-02-19,Italy,15470,348,2780882,95235
2021-02-20,Italy,14914,251,2795796,95486
2021-02-21,Italy,13450,232,2809246,95718
2021-02-22,Italy,9617,274,2818863,95992
2021-02-23,Italy,13299,356,2832162,96348
2021-02-24,Italy,16402,318,2848564,96666
2021-02-25,Italy,19871,308,2868435,96974
2021-02-26,Italy,20488,253,2888923,97227
2021-02-27,Italy,18902,280,2907825,97507
2021-02-28,Italy,17440,192,2925265,97699
2021-03-01,Italy,13106,246,2938371,97945
2021-03-02,Italy,17063,343,2955434,98288
2021-03-03,Italy,20840,347,2976274,98635
2021-03-04,Italy,22845,339,2999119,98974
2021-03-05,Italy,24010,297,3023129,99271
2021-03-06,Italy,23633,307,3046762,99578
2021-03-07,Italy,20724,207,3067486,99785
2021-03-08,Italy,13882,318,3081368,100103
2021-03-09,Italy,19725,376,3101093,100479
2021-03-10,Italy,22275,332,3123368,100811
2021-03-11,Italy,25649,373,3149017,101184
2021-03-12,Italy,26790,380,3175807,101564
2021-03-13,Italy,26031,317,3201838,101881
2021-03-14,Italy,21304,264,3223142,102145
2021-03-15,Italy,15252,354,3238394,102499
2021-03-16,Italy,20376,502,3258770,103001
2021-03-17,Italy,23040,431,3281810,103432
2021-03-18,Italy,24901,423,3306711,103855
2021-03-19,Italy,25707,386,3332418,104241
2021-03-20,Italy,23913,401,3356331,104642
2021-03-21,Italy,20045,300,3376376,104942
2021-03-22,Italy,24501,386,3400877,105328
2021-03-23,Italy,18739,551,3419616,105879
2021-03-24,Italy,21246,460,3440862,106339
2021-03-25,Italy,23681,460,3464543,106799
2021-03-26,Italy,24076,457,3488619,107256
2021-03-27,Italy,23834,380,3512453,107636
2021-03-28,Italy,19604,297,3532057,107933
2021-03-29,Italy,12900,417,3544957,108350
2021-03-30,Italy,16055,529,3561012,108879
2021-03-31,Italy,23887,467,3584899,109346
2021-04-01,Italy,22184,501,3607083,109847
2021-04-02,Italy,21917,481,3629000,110328
2021-04-03,Italy,21247,376,3650247,110704
2021-04-04,Italy,18017,326,3668264,111030
2021-04-05,Italy,10680,296,3678944,111326
2021-04-06,Italy,7763,421,3686707,111747
2021-04-07,Italy,13686,627,3700393,112374
2021-04-08,Italy,17209,487,3717602,112861
2020-03-11,Jamaica,1,0,1,0
2020-03-12,Jamaica,1,0,2,0
2020-03-13,Jamaica,6,0,8,0
2020-03-14,Jamaica,0,0,8,0
2020-03-15,Jamaica,2,0,10,0
2020-03-16,Jamaica,0,0,10,0
2020-03-17,Jamaica,2,0,12,0
2020-03-18,Jamaica,1,0,13,0
2020-03-19,Jamaica,2,1,15,1
2020-03-20,Jamaica,1,0,16,1
2020-03-21,Jamaica,0,0,16,1
2020-03-22,Jamaica,3,0,19,1
2020-03-23,Jamaica,0,0,19,1
2020-03-24,Jamaica,2,0,21,1
2020-03-25,Jamaica,5,0,26,1
2020-03-26,Jamaica,0,0,26,1
2020-03-27,Jamaica,0,0,26,1
2020-03-28,Jamaica,4,0,30,1
2020-03-29,Jamaica,2,0,32,1
2020-03-30,Jamaica,4,0,36,1
2020-03-31,Jamaica,0,0,36,1
2020-04-01,Jamaica,8,2,44,3
2020-04-02,Jamaica,3,0,47,3
2020-04-03,Jamaica,0,0,47,3
2020-04-04,Jamaica,6,0,53,3
2020-04-05,Jamaica,5,0,58,3
2020-04-06,Jamaica,0,0,58,3
2020-04-07,Jamaica,5,0,63,3
2020-04-08,Jamaica,0,1,63,4
2020-04-09,Jamaica,0,0,63,4
2020-04-10,Jamaica,0,0,63,4
2020-04-11,Jamaica,2,0,65,4
2020-04-12,Jamaica,4,0,69,4
2020-04-13,Jamaica,4,0,73,4
2020-04-14,Jamaica,0,0,73,4
2020-04-15,Jamaica,52,1,125,5
2020-04-16,Jamaica,18,0,143,5
2020-04-17,Jamaica,0,0,143,5
2020-04-18,Jamaica,20,0,163,5
2020-04-19,Jamaica,10,0,173,5
2020-04-20,Jamaica,50,0,223,5
2020-04-21,Jamaica,0,1,223,6
2020-04-22,Jamaica,10,0,233,6
2020-04-23,Jamaica,24,0,257,6
2020-04-24,Jamaica,31,1,288,7
2020-04-25,Jamaica,17,0,305,7
2020-04-26,Jamaica,45,0,350,7
2020-04-27,Jamaica,14,0,364,7
2020-04-28,Jamaica,0,0,364,7
2020-04-29,Jamaica,32,0,396,7
2020-04-30,Jamaica,26,1,422,8
2020-05-01,Jamaica,10,0,432,8
2020-05-02,Jamaica,31,0,463,8
2020-05-03,Jamaica,6,1,469,9
2020-05-04,Jamaica,2,0,471,9
2020-05-05,Jamaica,2,0,473,9
2020-05-06,Jamaica,5,0,478,9
2020-05-07,Jamaica,10,0,488,9
2020-05-08,Jamaica,2,0,490,9
2020-05-09,Jamaica,0,0,490,9
2020-05-10,Jamaica,12,0,502,9
2020-05-11,Jamaica,3,0,505,9
2020-05-12,Jamaica,2,0,507,9
2020-05-13,Jamaica,2,0,509,9
2020-05-14,Jamaica,0,0,509,9
2020-05-15,Jamaica,2,0,511,9
2020-05-16,Jamaica,6,0,517,9
2020-05-17,Jamaica,3,0,520,9
2020-05-18,Jamaica,0,0,520,9
2020-05-19,Jamaica,0,0,520,9
2020-05-20,Jamaica,9,0,529,9
2020-05-21,Jamaica,5,0,534,9
2020-05-22,Jamaica,10,0,544,9
2020-05-23,Jamaica,6,0,550,9
2020-05-24,Jamaica,2,0,552,9
2020-05-25,Jamaica,4,0,556,9
2020-05-26,Jamaica,8,0,564,9
2020-05-27,Jamaica,5,0,569,9
2020-05-28,Jamaica,0,0,569,9
2020-05-29,Jamaica,6,0,575,9
2020-05-30,Jamaica,6,0,581,9
2020-05-31,Jamaica,5,0,586,9
2020-06-01,Jamaica,2,0,588,9
2020-06-02,Jamaica,2,0,590,9
2020-06-03,Jamaica,1,1,591,10
2020-06-04,Jamaica,0,0,591,10
2020-06-05,Jamaica,4,0,595,10
2020-06-06,Jamaica,1,0,596,10
2020-06-07,Jamaica,2,0,598,10
2020-06-08,Jamaica,1,0,599,10
2020-06-09,Jamaica,6,0,605,10
2020-06-10,Jamaica,0,0,605,10
2020-06-11,Jamaica,6,0,611,10
2020-06-12,Jamaica,3,0,614,10
2020-06-13,Jamaica,1,0,615,10
2020-06-14,Jamaica,2,0,617,10
2020-06-15,Jamaica,4,0,621,10
2020-06-16,Jamaica,0,0,621,10
2020-06-17,Jamaica,5,0,626,10
2020-06-18,Jamaica,12,0,638,10
2020-06-19,Jamaica,14,0,652,10
2020-06-20,Jamaica,5,0,657,10
2020-06-21,Jamaica,2,0,659,10
2020-06-22,Jamaica,6,0,665,10
2020-06-23,Jamaica,5,0,670,10
2020-06-24,Jamaica,8,0,678,10
2020-06-25,Jamaica,6,0,684,10
2020-06-26,Jamaica,2,0,686,10
2020-06-27,Jamaica,4,0,690,10
2020-06-28,Jamaica,6,0,696,10
2020-06-29,Jamaica,2,0,698,10
2020-06-30,Jamaica,4,0,702,10
2020-07-01,Jamaica,5,0,707,10
2020-07-02,Jamaica,8,0,715,10
2020-07-03,Jamaica,6,0,721,10
2020-07-04,Jamaica,7,0,728,10
2020-07-05,Jamaica,4,0,732,10
2020-07-06,Jamaica,5,0,737,10
2020-07-07,Jamaica,8,0,745,10
2020-07-08,Jamaica,6,0,751,10
2020-07-09,Jamaica,2,0,753,10
2020-07-10,Jamaica,0,0,753,10
2020-07-11,Jamaica,5,0,758,10
2020-07-12,Jamaica,0,0,758,10
2020-07-13,Jamaica,1,0,759,10
2020-07-14,Jamaica,3,0,762,10
2020-07-15,Jamaica,1,0,763,10
2020-07-16,Jamaica,2,0,765,10
2020-07-17,Jamaica,3,0,768,10
2020-07-18,Jamaica,6,0,774,10
2020-07-19,Jamaica,16,0,790,10
2020-07-20,Jamaica,19,0,809,10
2020-07-21,Jamaica,1,0,810,10
2020-07-22,Jamaica,6,0,816,10
2020-07-23,Jamaica,5,0,821,10
2020-07-24,Jamaica,10,0,831,10
2020-07-25,Jamaica,6,0,837,10
2020-07-26,Jamaica,5,0,842,10
2020-07-27,Jamaica,11,0,853,10
2020-07-28,Jamaica,2,0,855,10
2020-07-29,Jamaica,1,0,856,10
2020-07-30,Jamaica,8,0,864,10
2020-07-31,Jamaica,14,0,878,10
2020-08-01,Jamaica,5,0,883,10
2020-08-02,Jamaica,11,2,894,12
2020-08-03,Jamaica,11,0,905,12
2020-08-04,Jamaica,15,0,920,12
2020-08-05,Jamaica,8,0,928,12
2020-08-06,Jamaica,30,0,958,12
2020-08-07,Jamaica,29,1,987,13
2020-08-08,Jamaica,16,0,1003,13
2020-08-09,Jamaica,20,1,1023,14
2020-08-10,Jamaica,8,0,1031,14
2020-08-11,Jamaica,16,0,1047,14
2020-08-12,Jamaica,18,0,1065,14
2020-08-13,Jamaica,6,0,1071,14
2020-08-14,Jamaica,11,0,1082,14
2020-08-15,Jamaica,0,0,1082,14
2020-08-16,Jamaica,31,0,1113,14
2020-08-17,Jamaica,16,0,1129,14
2020-08-18,Jamaica,17,0,1146,14
2020-08-19,Jamaica,46,0,1192,14
2020-08-20,Jamaica,98,1,1290,15
2020-08-21,Jamaica,56,1,1346,16
2020-08-22,Jamaica,0,0,1346,16
2020-08-23,Jamaica,183,0,1529,16
2020-08-24,Jamaica,83,0,1612,16
2020-08-25,Jamaica,120,3,1732,19
2020-08-26,Jamaica,72,0,1804,19
2020-08-27,Jamaica,66,0,1870,19
2020-08-28,Jamaica,141,0,2011,19
2020-08-29,Jamaica,102,1,2113,20
2020-08-30,Jamaica,244,1,2357,21
2020-08-31,Jamaica,102,0,2459,21
2020-09-01,Jamaica,0,0,2459,21
2020-09-02,Jamaica,224,3,2683,24
2020-09-03,Jamaica,213,5,2896,29
2020-09-04,Jamaica,68,1,2964,30
2020-09-05,Jamaica,60,2,3024,32
2020-09-06,Jamaica,79,1,3103,33
2020-09-07,Jamaica,80,1,3183,34
2020-09-08,Jamaica,140,2,3323,36
2020-09-09,Jamaica,114,2,3437,38
2020-09-10,Jamaica,74,2,3511,40
2020-09-11,Jamaica,0,0,3511,40
2020-09-12,Jamaica,112,0,3623,40
2020-09-13,Jamaica,148,2,3771,42
2020-09-14,Jamaica,162,2,3933,44
2020-09-15,Jamaica,109,2,4042,46
2020-09-16,Jamaica,122,0,4164,46
2020-09-17,Jamaica,210,5,4374,51
2020-09-18,Jamaica,197,4,4571,55
2020-09-19,Jamaica,187,5,4758,60
2020-09-20,Jamaica,230,7,4988,67
2020-09-21,Jamaica,155,3,5143,70
2020-09-22,Jamaica,127,5,5270,75
2020-09-23,Jamaica,125,1,5395,76
2020-09-24,Jamaica,193,1,5588,77
2020-09-25,Jamaica,135,3,5723,80
2020-09-26,Jamaica,131,8,5854,88
2020-09-27,Jamaica,163,1,6017,89
2020-09-28,Jamaica,153,4,6170,93
2020-09-29,Jamaica,238,8,6408,101
2020-09-30,Jamaica,74,6,6482,107
2020-10-01,Jamaica,73,4,6555,111
2020-10-02,Jamaica,149,5,6704,116
2020-10-03,Jamaica,91,3,6795,119
2020-10-04,Jamaica,100,1,6895,120
2020-10-05,Jamaica,117,0,7012,120
2020-10-06,Jamaica,97,3,7109,123
2020-10-07,Jamaica,82,3,7191,126
2020-10-08,Jamaica,82,2,7273,128
2020-10-09,Jamaica,90,4,7363,132
2020-10-10,Jamaica,196,6,7559,138
2020-10-11,Jamaica,159,1,7718,139
2020-10-12,Jamaica,95,7,7813,146
2020-10-13,Jamaica,97,0,7910,146
2020-10-14,Jamaica,79,5,7989,151
2020-10-15,Jamaica,78,9,8067,160
2020-10-16,Jamaica,65,2,8132,162
2020-10-17,Jamaica,63,6,8195,168
2020-10-18,Jamaica,79,3,8274,171
2020-10-19,Jamaica,47,2,8321,173
2020-10-20,Jamaica,53,1,8374,174
2020-10-21,Jamaica,71,0,8445,174
2020-10-22,Jamaica,155,5,8600,179
2020-10-23,Jamaica,38,3,8638,182
2020-10-24,Jamaica,32,4,8670,186
2020-10-25,Jamaica,44,2,8714,188
2020-10-26,Jamaica,35,4,8749,192
2020-10-27,Jamaica,38,4,8787,196
2020-10-28,Jamaica,64,2,8851,198
2020-10-29,Jamaica,76,4,8927,202
2020-10-30,Jamaica,78,3,9005,205
2020-10-31,Jamaica,89,1,9094,206
2020-11-01,Jamaica,37,2,9131,208
2020-11-02,Jamaica,126,2,9257,210
2020-11-03,Jamaica,39,4,9296,214
2020-11-04,Jamaica,30,1,9326,215
2020-11-05,Jamaica,47,2,9373,217
2020-11-06,Jamaica,53,1,9426,218
2020-11-07,Jamaica,46,0,9472,218
2020-11-08,Jamaica,34,3,9506,221
2020-11-09,Jamaica,36,0,9542,221
2020-11-10,Jamaica,31,3,9573,224
2020-11-11,Jamaica,8,1,9581,225
2020-11-12,Jamaica,53,0,9634,225
2020-11-13,Jamaica,89,2,9723,227
2020-11-14,Jamaica,57,2,9780,229
2020-11-15,Jamaica,104,2,9884,231
2020-11-16,Jamaica,45,0,9929,231
2020-11-17,Jamaica,30,0,9959,231
2020-11-18,Jamaica,60,2,10019,233
2020-11-19,Jamaica,69,2,10088,235
2020-11-20,Jamaica,63,0,10151,235
2020-11-21,Jamaica,89,2,10240,237
2020-11-22,Jamaica,44,1,10284,238
2020-11-23,Jamaica,59,1,10343,239
2020-11-24,Jamaica,79,4,10422,243
2020-11-25,Jamaica,66,4,10488,247
2020-11-26,Jamaica,53,1,10541,248
2020-11-27,Jamaica,59,2,10600,250
2020-11-28,Jamaica,69,1,10669,251
2020-11-29,Jamaica,40,5,10709,256
2020-11-30,Jamaica,54,1,10763,257
2020-12-01,Jamaica,47,1,10810,258
2020-12-02,Jamaica,54,0,10864,258
2020-12-03,Jamaica,47,1,10911,259
2020-12-04,Jamaica,76,1,10987,260
2020-12-05,Jamaica,76,1,11063,261
2020-12-06,Jamaica,57,4,11120,265
2020-12-07,Jamaica,64,0,11184,265
2020-12-08,Jamaica,87,0,11271,265
2020-12-09,Jamaica,98,1,11369,266
2020-12-10,Jamaica,74,4,11443,270
2020-12-11,Jamaica,66,0,11509,270
2020-12-12,Jamaica,99,1,11608,271
2020-12-13,Jamaica,102,2,11710,273
2020-12-14,Jamaica,82,0,11792,273
2020-12-15,Jamaica,83,3,11875,276
2020-12-16,Jamaica,32,0,11907,276
2020-12-17,Jamaica,61,3,11968,279
2020-12-18,Jamaica,71,4,12039,283
2020-12-19,Jamaica,96,2,12135,285
2020-12-20,Jamaica,89,1,12224,286
2020-12-21,Jamaica,65,0,12289,286
2020-12-22,Jamaica,65,2,12354,288
2020-12-23,Jamaica,69,2,12423,290
2020-12-24,Jamaica,96,2,12519,292
2020-12-25,Jamaica,78,2,12597,294
2020-12-26,Jamaica,87,0,12684,294
2020-12-27,Jamaica,39,1,12723,295
2020-12-28,Jamaica,9,3,12732,298
2020-12-29,Jamaica,20,0,12752,298
2020-12-30,Jamaica,41,4,12793,302
2020-12-31,Jamaica,34,0,12827,302
2021-01-01,Jamaica,88,1,12915,303
2021-01-02,Jamaica,16,0,12931,303
2021-01-03,Jamaica,118,1,13049,304
2021-01-04,Jamaica,154,0,13203,304
2021-01-05,Jamaica,43,1,13246,305
2021-01-06,Jamaica,84,1,13330,306
2021-01-07,Jamaica,38,0,13368,306
2021-01-08,Jamaica,43,1,13411,307
2021-01-09,Jamaica,44,4,13455,311
2021-01-10,Jamaica,93,1,13548,312
2021-01-11,Jamaica,89,1,13637,313
2021-01-12,Jamaica,123,2,13760,315
2021-01-13,Jamaica,92,2,13852,317
2021-01-14,Jamaica,63,5,13915,322
2021-01-15,Jamaica,77,1,13992,323
2021-01-16,Jamaica,104,0,14096,323
2021-01-17,Jamaica,65,1,14161,324
2021-01-18,Jamaica,113,2,14274,326
2021-01-19,Jamaica,145,3,14419,329
2021-01-20,Jamaica,68,2,14487,331
2021-01-21,Jamaica,63,0,14550,331
2021-01-22,Jamaica,108,1,14658,332
2021-01-23,Jamaica,114,4,14772,336
2021-01-24,Jamaica,107,0,14879,336
2021-01-25,Jamaica,133,2,15012,338
2021-01-26,Jamaica,141,1,15153,339
2021-01-27,Jamaica,88,3,15241,342
2021-01-28,Jamaica,194,2,15435,344
2021-01-29,Jamaica,27,1,15462,345
2021-01-30,Jamaica,65,3,15527,348
2021-01-31,Jamaica,126,2,15653,350
2021-02-01,Jamaica,125,2,15778,352
2021-02-02,Jamaica,195,1,15973,353
2021-02-03,Jamaica,100,2,16073,355
2021-02-04,Jamaica,177,0,16250,355
2021-02-05,Jamaica,263,2,16513,357
2021-02-06,Jamaica,328,0,16841,357
2021-02-07,Jamaica,244,1,17085,358
2021-02-08,Jamaica,213,0,17298,358
2021-02-09,Jamaica,403,1,17701,359
2021-02-10,Jamaica,207,3,17908,362
2021-02-11,Jamaica,329,1,18237,363
2021-02-12,Jamaica,290,5,18527,368
2021-02-13,Jamaica,303,4,18830,372
2021-02-14,Jamaica,205,2,19035,374
2021-02-15,Jamaica,270,4,19305,378
2021-02-16,Jamaica,468,0,19773,378
2021-02-17,Jamaica,243,3,20016,381
2021-02-18,Jamaica,294,3,20310,384
2021-02-19,Jamaica,271,7,20581,391
2021-02-20,Jamaica,343,0,20924,391
2021-02-21,Jamaica,458,5,21382,396
2021-02-22,Jamaica,297,3,21679,399
2021-02-23,Jamaica,147,6,21826,405
2021-02-24,Jamaica,193,1,22019,406
2021-02-25,Jamaica,248,4,22267,410
2021-02-26,Jamaica,204,3,22471,413
2021-02-27,Jamaica,346,4,22817,417
2021-02-28,Jamaica,446,5,23263,422
2021-03-01,Jamaica,336,3,23599,425
2021-03-02,Jamaica,239,7,23838,432
2021-03-03,Jamaica,265,3,24103,435
2021-03-04,Jamaica,341,1,24444,436
2021-03-05,Jamaica,332,7,24776,443
2021-03-06,Jamaica,527,3,25303,446
2021-03-07,Jamaica,723,7,26026,453
2021-03-08,Jamaica,878,1,26904,454
2021-03-09,Jamaica,561,6,27465,460
2021-03-10,Jamaica,808,3,28273,463
2021-03-11,Jamaica,695,12,28968,475
2021-03-12,Jamaica,419,5,29387,480
2021-03-13,Jamaica,525,4,29912,484
2021-03-14,Jamaica,587,1,30499,485
2021-03-15,Jamaica,806,7,31305,492
2021-03-16,Jamaica,602,2,31907,494
2021-03-17,Jamaica,821,13,32728,507
2021-03-18,Jamaica,638,4,33366,511
2021-03-19,Jamaica,604,8,33970,519
2021-03-20,Jamaica,695,5,34665,524
2021-03-21,Jamaica,673,9,35338,533
2021-03-22,Jamaica,558,3,35896,536
2021-03-23,Jamaica,335,6,36231,542
2021-03-24,Jamaica,439,3,36670,545
2021-03-25,Jamaica,458,1,37128,546
2021-03-26,Jamaica,330,11,37458,557
2021-03-27,Jamaica,289,9,37747,566
2021-03-28,Jamaica,480,4,38227,570
2021-03-29,Jamaica,287,16,38514,586
2021-03-30,Jamaica,334,1,38848,587
2021-03-31,Jamaica,389,9,39237,596
2021-04-01,Jamaica,306,3,39543,599
2021-04-02,Jamaica,424,8,39967,607
2021-04-03,Jamaica,482,6,40449,613
2021-04-04,Jamaica,214,2,40663,615
2021-04-05,Jamaica,350,3,41013,618
2021-04-06,Jamaica,315,4,41328,622
2021-04-07,Jamaica,72,9,41400,631
2021-04-08,Jamaica,204,15,41604,646
2020-01-22,Japan,0,0,2,0
2020-01-23,Japan,0,0,2,0
2020-01-24,Japan,0,0,2,0
2020-01-25,Japan,0,0,2,0
2020-01-26,Japan,2,0,4,0
2020-01-27,Japan,0,0,4,0
2020-01-28,Japan,3,0,7,0
2020-01-29,Japan,0,0,7,0
2020-01-30,Japan,4,0,11,0
2020-01-31,Japan,4,0,15,0
2020-02-01,Japan,5,0,20,0
2020-02-02,Japan,0,0,20,0
2020-02-03,Japan,0,0,20,0
2020-02-04,Japan,2,0,22,0
2020-02-05,Japan,1,0,23,0
2020-02-06,Japan,0,0,23,0
2020-02-07,Japan,0,0,23,0
2020-02-08,Japan,1,0,24,0
2020-02-09,Japan,0,0,24,0
2020-02-10,Japan,2,0,26,0
2020-02-11,Japan,1,0,27,0
2020-02-12,Japan,1,0,28,0
2020-02-13,Japan,5,1,33,1
2020-02-14,Japan,10,0,43,1
2020-02-15,Japan,11,0,54,1
2020-02-16,Japan,6,0,60,1
2020-02-17,Japan,7,0,67,1
2020-02-18,Japan,12,1,79,2
2020-02-19,Japan,6,0,85,2
2020-02-20,Japan,10,0,95,2
2020-02-21,Japan,17,0,112,2
2020-02-22,Japan,25,0,137,2
2020-02-23,Japan,12,0,149,2
2020-02-24,Japan,11,0,160,2
2020-02-25,Japan,13,1,173,3
2020-02-26,Japan,19,0,192,3
2020-02-27,Japan,26,1,218,4
2020-02-28,Japan,18,1,236,5
2020-02-29,Japan,9,1,245,6
2020-03-01,Japan,14,0,259,6
2020-03-02,Japan,19,0,278,6
2020-03-03,Japan,20,0,298,6
2020-03-04,Japan,35,1,333,7
2020-03-05,Japan,32,0,365,7
2020-03-06,Japan,55,0,420,7
2020-03-07,Japan,46,0,466,7
2020-03-08,Japan,33,1,499,8
2020-03-09,Japan,28,2,527,10
2020-03-10,Japan,58,3,585,13
2020-03-11,Japan,55,2,640,15
2020-03-12,Japan,56,4,696,19
2020-03-13,Japan,37,2,733,21
2020-03-14,Japan,62,1,795,22
2020-03-15,Japan,31,2,826,24
2020-03-16,Japan,17,6,843,30
2020-03-17,Japan,50,0,893,30
2020-03-18,Japan,35,2,928,32
2020-03-19,Japan,40,1,968,33
2020-03-20,Japan,54,1,1022,34
2020-03-21,Japan,37,2,1059,36
2020-03-22,Japan,45,4,1104,40
2020-03-23,Japan,40,1,1144,41
2020-03-24,Japan,73,1,1217,42
2020-03-25,Japan,97,3,1314,45
2020-03-26,Japan,102,2,1416,47
2020-03-27,Japan,114,6,1530,53
2020-03-28,Japan,198,3,1728,56
2020-03-29,Japan,179,7,1907,63
2020-03-30,Japan,94,2,2001,65
2020-03-31,Japan,254,2,2255,67
2020-04-01,Japan,280,5,2535,72
2020-04-02,Japan,283,3,2818,75
2020-04-03,Japan,336,6,3154,81
2020-04-04,Japan,371,6,3525,87
2020-04-05,Japan,351,6,3876,93
2020-04-06,Japan,234,3,4110,96
2020-04-07,Japan,375,2,4485,98
2020-04-08,Japan,535,7,5020,105
2020-04-09,Japan,594,8,5614,113
2020-04-10,Japan,636,12,6250,125
2020-04-11,Japan,701,13,6951,138
2020-04-12,Japan,522,9,7473,147
2020-04-13,Japan,300,9,7773,156
2020-04-14,Japan,504,14,8277,170
2020-04-15,Japan,558,16,8835,186
2020-04-16,Japan,563,18,9398,204
2020-04-17,Japan,560,13,9958,217
2020-04-18,Japan,590,19,10548,236
2020-04-19,Japan,366,19,10914,255
2020-04-20,Japan,344,20,11258,275
2020-04-21,Japan,383,28,11641,303
2020-04-22,Japan,396,20,12037,323
2020-04-23,Japan,432,28,12469,351
2020-04-24,Japan,385,9,12854,360
2020-04-25,Japan,332,19,13186,379
2020-04-26,Japan,219,16,13405,395
2020-04-27,Japan,171,22,13576,417
2020-04-28,Japan,284,19,13860,436
2020-04-29,Japan,216,18,14076,454
2020-04-30,Japan,208,27,14284,481
2020-05-01,Japan,274,29,14558,510
2020-05-02,Japan,303,26,14861,536
2020-05-03,Japan,200,24,15061,560
2020-05-04,Japan,168,22,15229,582
2020-05-05,Japan,125,11,15354,593
2020-05-06,Japan,101,12,15455,605
2020-05-07,Japan,98,12,15553,617
2020-05-08,Japan,87,17,15640,634
2020-05-09,Japan,115,20,15755,654
2020-05-10,Japan,69,12,15824,666
2020-05-11,Japan,37,19,15861,685
2020-05-12,Japan,87,22,15948,707
2020-05-13,Japan,50,19,15998,726
2020-05-14,Japan,98,16,16096,742
2020-05-15,Japan,52,18,16148,760
2020-05-16,Japan,54,18,16202,778
2020-05-17,Japan,24,9,16226,787
2020-05-18,Japan,33,9,16259,796
2020-05-19,Japan,28,9,16287,805
2020-05-20,Japan,34,13,16321,818
2020-05-21,Japan,41,8,16362,826
2020-05-22,Japan,23,10,16385,836
2020-05-23,Japan,25,9,16410,845
2020-05-24,Japan,41,7,16451,852
2020-05-25,Japan,21,5,16472,857
2020-05-26,Japan,30,6,16502,863
2020-05-27,Japan,26,7,16528,870
2020-05-28,Japan,70,11,16598,881
2020-05-29,Japan,75,6,16673,887
2020-05-30,Japan,43,7,16716,894
2020-05-31,Japan,35,4,16751,898
2020-06-01,Japan,36,1,16787,899
2020-06-02,Japan,50,3,16837,902
2020-06-03,Japan,30,3,16867,905
2020-06-04,Japan,44,6,16911,911
2020-06-05,Japan,47,5,16958,916
2020-06-06,Japan,42,-1,17000,915
2020-06-07,Japan,39,2,17039,917
2020-06-08,Japan,21,3,17060,920
2020-06-09,Japan,51,0,17111,920
2020-06-10,Japan,35,2,17146,922
2020-06-11,Japan,41,0,17187,922
2020-06-12,Japan,63,2,17250,924
2020-06-13,Japan,43,3,17293,927
2020-06-14,Japan,76,0,17369,927
2020-06-15,Japan,70,2,17439,929
2020-06-16,Japan,45,5,17484,934
2020-06-17,Japan,46,1,17530,935
2020-06-18,Japan,58,0,17588,935
2020-06-19,Japan,70,16,17658,951
2020-06-20,Japan,67,4,17725,955
2020-06-21,Japan,55,0,17780,955
2020-06-22,Japan,40,0,17820,955
2020-06-23,Japan,59,10,17879,965
2020-06-24,Japan,84,2,17963,967
2020-06-25,Japan,92,4,18055,971
2020-06-26,Japan,107,0,18162,971
2020-06-27,Japan,92,0,18254,971
2020-06-28,Japan,112,1,18366,972
2020-06-29,Japan,110,0,18476,972
2020-06-30,Japan,139,0,18615,972
2020-07-01,Japan,223,4,18838,976
2020-07-02,Japan,217,1,19055,977
2020-07-03,Japan,130,0,19185,977
2020-07-04,Japan,276,0,19461,977
2020-07-05,Japan,207,0,19668,977
2020-07-06,Japan,180,1,19848,978
2020-07-07,Japan,207,3,20055,981
2020-07-08,Japan,206,1,20261,982
2020-07-09,Japan,356,0,20617,982
2020-07-10,Japan,427,0,21044,982
2020-07-11,Japan,386,0,21430,982
2020-07-12,Japan,411,1,21841,983
2020-07-13,Japan,284,1,22125,984
2020-07-14,Japan,312,0,22437,984
2020-07-15,Japan,735,0,23172,984
2020-07-16,Japan,338,1,23510,985
2020-07-17,Japan,594,0,24104,985
2020-07-18,Japan,842,1,24946,986
2020-07-19,Japan,500,0,25446,986
2020-07-20,Japan,260,2,25706,988
2020-07-21,Japan,757,0,26463,988
2020-07-22,Japan,673,2,27136,990
2020-07-23,Japan,978,2,28114,992
2020-07-24,Japan,769,2,28883,994
2020-07-25,Japan,801,2,29684,996
2020-07-26,Japan,864,2,30548,998
2020-07-27,Japan,594,0,31142,998
2020-07-28,Japan,974,3,32116,1001
2020-07-29,Japan,1266,0,33382,1001
2020-07-30,Japan,1762,6,35144,1007
2020-07-31,Japan,1090,1,36234,1008
2020-08-01,Japan,1570,4,37804,1012
2020-08-02,Japan,1312,1,39116,1013
2020-08-03,Japan,983,5,40099,1018
2020-08-04,Japan,1248,5,41347,1023
2020-08-05,Japan,1339,5,42686,1028
2020-08-06,Japan,1481,6,44167,1034
2020-08-07,Japan,1597,8,45764,1042
2020-08-08,Japan,1578,0,47342,1042
2020-08-09,Japan,1440,5,48782,1047
2020-08-10,Japan,835,5,49617,1052
2020-08-11,Japan,685,6,50302,1058
2020-08-12,Japan,986,8,51288,1066
2020-08-13,Japan,1183,7,52471,1073
2020-08-14,Japan,1347,7,53818,1080
2020-08-15,Japan,1233,13,55051,1093
2020-08-16,Japan,1023,10,56074,1103
2020-08-17,Japan,643,9,56717,1112
2020-08-18,Japan,919,23,57636,1135
2020-08-19,Japan,1092,13,58728,1148
2020-08-20,Japan,1172,9,59900,1157
2020-08-21,Japan,1049,18,60949,1175
2020-08-22,Japan,967,4,61916,1179
2020-08-23,Japan,742,9,62658,1188
2020-08-24,Japan,500,13,63158,1201
2020-08-25,Japan,730,18,63888,1219
2020-08-26,Japan,891,11,64779,1230
2020-08-27,Japan,874,11,65653,1241
2020-08-28,Japan,846,10,66499,1251
2020-08-29,Japan,854,20,67353,1271
2020-08-30,Japan,605,14,67958,1285
2020-08-31,Japan,438,13,68396,1298
2020-09-01,Japan,627,15,69023,1313
2020-09-02,Japan,596,14,69619,1327
2020-09-03,Japan,659,7,70278,1334
2020-09-04,Japan,588,18,70866,1352
2020-09-05,Japan,601,9,71467,1361
2020-09-06,Japan,451,5,71918,1366
2020-09-07,Japan,295,11,72213,1377
2020-09-08,Japan,511,21,72724,1398
2020-09-09,Japan,540,14,73264,1412
2020-09-10,Japan,652,4,73916,1416
2020-09-11,Japan,642,12,74558,1428
2020-09-12,Japan,648,13,75206,1441
2020-09-13,Japan,440,7,75646,1448
2020-09-14,Japan,268,7,75914,1455
2020-09-15,Japan,532,8,76446,1463
2020-09-16,Japan,551,18,76997,1481
2020-09-17,Japan,491,9,77488,1490
2020-09-18,Japan,573,10,78061,1500
2020-09-19,Japan,601,4,78662,1504
2020-09-20,Japan,480,4,79142,1508
2020-09-21,Japan,320,10,79462,1518
2020-09-22,Japan,311,1,79773,1519
2020-09-23,Japan,236,6,80009,1525
2020-09-24,Japan,481,15,80490,1540
2020-09-25,Japan,564,4,81054,1544
2020-09-26,Japan,649,3,81703,1547
2020-09-27,Japan,483,2,82186,1549
2020-09-28,Japan,298,12,82484,1561
2020-09-29,Japan,538,7,83022,1568
2020-09-30,Japan,569,7,83591,1575
2020-10-01,Japan,653,5,84244,1580
2020-10-02,Japan,524,11,84768,1591
2020-10-03,Japan,577,3,85345,1594
2020-10-04,Japan,401,4,85746,1598
2020-10-05,Japan,281,4,86027,1602
2020-10-06,Japan,513,7,86540,1609
2020-10-07,Japan,499,5,87039,1614
2020-10-08,Japan,640,3,87679,1617
2020-10-09,Japan,588,6,88267,1623
2020-10-10,Japan,695,3,88962,1626
2020-10-11,Japan,438,2,89400,1628
2020-10-12,Japan,252,3,89652,1631
2020-10-13,Japan,501,4,90153,1635
2020-10-14,Japan,541,11,90694,1646
2020-10-15,Japan,708,4,91402,1650
2020-10-16,Japan,642,14,92044,1664
2020-10-17,Japan,626,6,92670,1670
2020-10-18,Japan,428,2,93098,1672
2020-10-19,Japan,310,4,93408,1676
2020-10-20,Japan,487,3,93895,1679
2020-10-21,Japan,620,7,94515,1686
2020-10-22,Japan,619,11,95134,1697
2020-10-23,Japan,734,9,95868,1706
2020-10-24,Japan,731,4,96599,1710
2020-10-25,Japan,496,6,97095,1716
2020-10-26,Japan,408,5,97503,1721
2020-10-27,Japan,643,5,98146,1726
2020-10-28,Japan,731,5,98877,1731
2020-10-29,Japan,797,17,99674,1748
2020-10-30,Japan,776,8,100450,1756
2020-10-31,Japan,877,13,101327,1769
2020-11-01,Japan,616,7,101943,1776
2020-11-02,Japan,488,11,102431,1787
2020-11-03,Japan,878,7,103309,1794
2020-11-04,Japan,619,5,103928,1799
2020-11-05,Japan,1036,7,104964,1806
2020-11-06,Japan,1172,4,106136,1810
2020-11-07,Japan,1303,5,107439,1815
2020-11-08,Japan,955,6,108394,1821
2020-11-09,Japan,797,13,109191,1834
2020-11-10,Japan,1296,6,110487,1840
2020-11-11,Japan,1524,7,112011,1847
2020-11-12,Japan,1644,7,113655,1854
2020-11-13,Japan,1705,10,115360,1864
2020-11-14,Japan,1753,1,117113,1865
2020-11-15,Japan,1498,9,118611,1874
2020-11-16,Japan,946,9,119557,1883
2020-11-17,Japan,1690,12,121247,1895
2020-11-18,Japan,2230,13,123477,1908
2020-11-19,Japan,2382,12,125859,1920
2020-11-20,Japan,2426,10,128285,1930
2020-11-21,Japan,2586,2,130871,1932
2020-11-22,Japan,2163,11,133034,1943
2020-11-23,Japan,1520,6,134554,1949
2020-11-24,Japan,1232,14,135786,1963
2020-11-25,Japan,1949,20,137735,1983
2020-11-26,Japan,2490,13,140225,1996
2020-11-27,Japan,2553,32,142778,2028
2020-11-28,Japan,2679,14,145457,2042
2020-11-29,Japan,2058,15,147515,2057
2020-11-30,Japan,1447,19,148962,2076
2020-12-01,Japan,2014,33,150976,2109
2020-12-02,Japan,2456,32,153432,2141
2020-12-03,Japan,2506,33,155938,2174
2020-12-04,Japan,2449,36,158387,2210
2020-12-05,Japan,2483,19,160870,2229
2020-12-06,Japan,2047,30,162917,2259
2020-12-07,Japan,1517,40,164434,2299
2020-12-08,Japan,2158,35,166592,2334
2020-12-09,Japan,2837,42,169429,2376
2020-12-10,Japan,2977,19,172406,2395
2020-12-11,Japan,2904,51,175310,2446
2020-12-12,Japan,2962,16,178272,2462
2020-12-13,Japan,2367,19,180639,2481
2020-12-14,Japan,1672,49,182311,2530
2020-12-15,Japan,2441,51,184752,2581
2020-12-16,Japan,2999,42,187751,2623
2020-12-17,Japan,3199,38,190950,2661
2020-12-18,Japan,2803,48,193753,2709
2020-12-19,Japan,3062,40,196815,2749
2020-12-20,Japan,2455,35,199270,2784
2020-12-21,Japan,1804,49,201074,2833
2020-12-22,Japan,2658,44,203732,2877
2020-12-23,Japan,3275,64,207007,2941
2020-12-24,Japan,3762,26,210769,2967
2020-12-25,Japan,3806,49,214575,3016
2020-12-26,Japan,3892,46,218467,3062
2020-12-27,Japan,2945,38,221412,3100
2020-12-28,Japan,2374,52,223786,3152
2020-12-29,Japan,3629,44,227415,3196
2020-12-30,Japan,3856,47,231271,3243
2020-12-31,Japan,4540,49,235811,3292
2021-01-01,Japan,3257,248,239068,3540
2021-01-02,Japan,3029,31,242097,3571
2021-01-03,Japan,3196,60,245293,3631
2021-01-04,Japan,3332,48,248625,3679
2021-01-05,Japan,4946,76,253571,3755
2021-01-06,Japan,5950,65,259521,3820
2021-01-07,Japan,7563,64,267084,3884
2021-01-08,Japan,7863,78,274947,3962
2021-01-09,Japan,7790,59,282737,4021
2021-01-10,Japan,6081,45,288818,4066
2021-01-11,Japan,4928,48,293746,4114
2021-01-12,Japan,4575,64,298321,4178
2021-01-13,Japan,5819,97,304140,4275
2021-01-14,Japan,6594,66,310734,4341
2021-01-15,Japan,7137,78,317871,4419
2021-01-16,Japan,7071,56,324942,4475
2021-01-17,Japan,5773,49,330715,4524
2021-01-18,Japan,4890,58,335605,4582
2021-01-19,Japan,5384,104,340989,4686
2021-01-20,Japan,5519,92,346508,4778
2021-01-21,Japan,5621,94,352129,4872
2021-01-22,Japan,5045,108,357174,4980
2021-01-23,Japan,4754,83,361928,5063
2021-01-24,Japan,3971,56,365899,5119
2021-01-25,Japan,2785,74,368684,5193
2021-01-26,Japan,3861,104,372545,5297
2021-01-27,Japan,3937,90,376482,5387
2021-01-28,Japan,4162,113,380644,5500
2021-01-29,Japan,3536,97,384180,5597
2021-01-30,Japan,3319,91,387499,5688
2021-01-31,Japan,2667,65,390166,5753
2021-02-01,Japan,1790,80,391956,5833
2021-02-02,Japan,2313,119,394269,5952
2021-02-03,Japan,2631,116,396900,6068
2021-02-04,Japan,2592,104,399492,6172
2021-02-05,Japan,2366,106,401858,6278
2021-02-06,Japan,2270,94,404128,6372
2021-02-07,Japan,1637,52,405765,6424
2021-02-08,Japan,1227,83,406992,6507
2021-02-09,Japan,1558,95,408550,6602
2021-02-10,Japan,1884,121,410434,6723
2021-02-11,Japan,1691,77,412125,6800
2021-02-12,Japan,1316,63,413441,6863
2021-02-13,Japan,1362,65,414803,6928
2021-02-14,Japan,1351,38,416154,6966
2021-02-15,Japan,973,72,417127,7038
2021-02-16,Japan,1308,101,418435,7139
2021-02-17,Japan,1461,79,419896,7218
2021-02-18,Japan,1525,76,421421,7294
2021-02-19,Japan,1297,66,422718,7360
2021-02-20,Japan,1234,78,423952,7438
2021-02-21,Japan,1036,47,424988,7485
2021-02-22,Japan,737,56,425725,7541
2021-02-23,Japan,1103,54,426828,7595
2021-02-24,Japan,904,69,427732,7664
2021-02-25,Japan,1084,74,428816,7738
2021-02-26,Japan,1057,80,429873,7818
2021-02-27,Japan,1220,41,431093,7859
2021-02-28,Japan,997,30,432090,7889
2021-03-01,Japan,688,51,432778,7940
2021-03-02,Japan,922,65,433700,8005
2021-03-03,Japan,1244,63,434944,8068
2021-03-04,Japan,1149,67,436093,8135
2021-03-05,Japan,1129,55,437222,8190
2021-03-06,Japan,412,6,437634,8196
2021-03-07,Japan,1722,59,439356,8255
2021-03-08,Japan,621,46,439977,8301
2021-03-09,Japan,1175,58,441152,8359
2021-03-10,Japan,1259,53,442411,8412
2021-03-11,Japan,1303,45,443714,8457
2021-03-12,Japan,1263,58,444977,8515
2021-03-13,Japan,1335,51,446312,8566
2021-03-14,Japan,975,21,447287,8587
2021-03-15,Japan,713,38,448000,8625
2021-03-16,Japan,1142,57,449142,8682
2021-03-17,Japan,1545,36,450687,8718
2021-03-18,Japan,1460,32,452147,8750
2021-03-19,Japan,1469,33,453616,8783
2021-03-20,Japan,1596,19,455212,8802
2021-03-21,Japan,1106,19,456318,8821
2021-03-22,Japan,786,36,457104,8857
2021-03-23,Japan,1517,51,458621,8908
2021-03-24,Japan,1974,21,460595,8929
2021-03-25,Japan,1911,27,462506,8956
2021-03-26,Japan,1977,33,464483,8989
2021-03-27,Japan,2080,32,466563,9021
2021-03-28,Japan,1783,29,468346,9050
2021-03-29,Japan,1290,29,469636,9079
2021-03-30,Japan,2141,33,471777,9112
2021-03-31,Japan,2864,43,474641,9155
2021-04-01,Japan,2598,18,477239,9173
2021-04-02,Japan,2714,18,479953,9191
2021-04-03,Japan,2751,7,482704,9198
2021-04-04,Japan,2522,12,485226,9210
2021-04-05,Japan,1566,19,486792,9229
2021-04-06,Japan,2615,22,489407,9251
2021-04-07,Japan,3453,35,492860,9286
2021-04-08,Japan,3491,25,496351,9311
2020-03-03,Jordan,1,0,1,0
2020-03-04,Jordan,0,0,1,0
2020-03-05,Jordan,0,0,1,0
2020-03-06,Jordan,0,0,1,0
2020-03-07,Jordan,0,0,1,0
2020-03-08,Jordan,0,0,1,0
2020-03-09,Jordan,0,0,1,0
2020-03-10,Jordan,0,0,1,0
2020-03-11,Jordan,0,0,1,0
2020-03-12,Jordan,0,0,1,0
2020-03-13,Jordan,0,0,1,0
2020-03-14,Jordan,0,0,1,0
2020-03-15,Jordan,7,0,8,0
2020-03-16,Jordan,9,0,17,0
2020-03-17,Jordan,17,0,34,0
2020-03-18,Jordan,18,0,52,0
2020-03-19,Jordan,17,0,69,0
2020-03-20,Jordan,16,0,85,0
2020-03-21,Jordan,0,0,85,0
2020-03-22,Jordan,27,0,112,0
2020-03-23,Jordan,15,0,127,0
2020-03-24,Jordan,27,0,154,0
2020-03-25,Jordan,18,0,172,0
2020-03-26,Jordan,40,0,212,0
2020-03-27,Jordan,23,1,235,1
2020-03-28,Jordan,11,0,246,1
2020-03-29,Jordan,13,2,259,3
2020-03-30,Jordan,9,2,268,5
2020-03-31,Jordan,6,0,274,5
2020-04-01,Jordan,4,0,278,5
2020-04-02,Jordan,21,0,299,5
2020-04-03,Jordan,11,0,310,5
2020-04-04,Jordan,13,0,323,5
2020-04-05,Jordan,22,0,345,5
2020-04-06,Jordan,4,1,349,6
2020-04-07,Jordan,4,0,353,6
2020-04-08,Jordan,5,0,358,6
2020-04-09,Jordan,14,1,372,7
2020-04-10,Jordan,0,0,372,7
2020-04-11,Jordan,9,0,381,7
2020-04-12,Jordan,8,0,389,7
2020-04-13,Jordan,2,0,391,7
2020-04-14,Jordan,6,0,397,7
2020-04-15,Jordan,4,0,401,7
2020-04-16,Jordan,1,0,402,7
2020-04-17,Jordan,5,0,407,7
2020-04-18,Jordan,6,0,413,7
2020-04-19,Jordan,4,0,417,7
2020-04-20,Jordan,8,0,425,7
2020-04-21,Jordan,3,0,428,7
2020-04-22,Jordan,7,0,435,7
2020-04-23,Jordan,2,0,437,7
2020-04-24,Jordan,4,0,441,7
2020-04-25,Jordan,3,0,444,7
2020-04-26,Jordan,3,0,447,7
2020-04-27,Jordan,2,0,449,7
2020-04-28,Jordan,0,1,449,8
2020-04-29,Jordan,2,0,451,8
2020-04-30,Jordan,2,0,453,8
2020-05-01,Jordan,6,0,459,8
2020-05-02,Jordan,1,1,460,9
2020-05-03,Jordan,1,0,461,9
2020-05-04,Jordan,4,0,465,9
2020-05-05,Jordan,6,0,471,9
2020-05-06,Jordan,2,0,473,9
2020-05-07,Jordan,21,0,494,9
2020-05-08,Jordan,14,0,508,9
2020-05-09,Jordan,14,0,522,9
2020-05-10,Jordan,18,0,540,9
2020-05-11,Jordan,22,0,562,9
2020-05-12,Jordan,14,0,576,9
2020-05-13,Jordan,6,0,582,9
2020-05-14,Jordan,4,0,586,9
2020-05-15,Jordan,10,0,596,9
2020-05-16,Jordan,11,0,607,9
2020-05-17,Jordan,6,0,613,9
2020-05-18,Jordan,16,0,629,9
2020-05-19,Jordan,20,0,649,9
2020-05-20,Jordan,23,0,672,9
2020-05-21,Jordan,12,0,684,9
2020-05-22,Jordan,16,0,700,9
2020-05-23,Jordan,4,0,704,9
2020-05-24,Jordan,4,0,708,9
2020-05-25,Jordan,3,0,711,9
2020-05-26,Jordan,7,0,718,9
2020-05-27,Jordan,2,0,720,9
2020-05-28,Jordan,8,0,728,9
2020-05-29,Jordan,2,0,730,9
2020-05-30,Jordan,4,0,734,9
2020-05-31,Jordan,5,0,739,9
2020-06-01,Jordan,7,0,746,9
2020-06-02,Jordan,9,0,755,9
2020-06-03,Jordan,2,0,757,9
2020-06-04,Jordan,8,0,765,9
2020-06-05,Jordan,19,0,784,9
2020-06-06,Jordan,11,0,795,9
2020-06-07,Jordan,13,0,808,9
2020-06-08,Jordan,23,0,831,9
2020-06-09,Jordan,14,0,845,9
2020-06-10,Jordan,18,0,863,9
2020-06-11,Jordan,27,0,890,9
2020-06-12,Jordan,25,0,915,9
2020-06-13,Jordan,38,0,953,9
2020-06-14,Jordan,8,0,961,9
2020-06-15,Jordan,18,0,979,9
2020-06-16,Jordan,2,0,981,9
2020-06-17,Jordan,6,0,987,9
2020-06-18,Jordan,14,0,1001,9
2020-06-19,Jordan,7,0,1008,9
2020-06-20,Jordan,7,0,1015,9
2020-06-21,Jordan,18,0,1033,9
2020-06-22,Jordan,9,0,1042,9
2020-06-23,Jordan,5,0,1047,9
2020-06-24,Jordan,24,0,1071,9
2020-06-25,Jordan,15,0,1086,9
2020-06-26,Jordan,18,0,1104,9
2020-06-27,Jordan,7,0,1111,9
2020-06-28,Jordan,10,0,1121,9
2020-06-29,Jordan,7,0,1128,9
2020-06-30,Jordan,4,0,1132,9
2020-07-01,Jordan,1,0,1133,9
2020-07-02,Jordan,3,0,1136,9
2020-07-03,Jordan,11,1,1147,10
2020-07-04,Jordan,3,0,1150,10
2020-07-05,Jordan,14,0,1164,10
2020-07-06,Jordan,3,0,1167,10
2020-07-07,Jordan,2,0,1169,10
2020-07-08,Jordan,0,0,1169,10
2020-07-09,Jordan,0,0,1169,10
2020-07-10,Jordan,4,0,1173,10
2020-07-11,Jordan,3,0,1176,10
2020-07-12,Jordan,3,0,1179,10
2020-07-13,Jordan,4,0,1183,10
2020-07-14,Jordan,15,0,1198,10
2020-07-15,Jordan,3,0,1201,10
2020-07-16,Jordan,5,0,1206,10
2020-07-17,Jordan,3,0,1209,10
2020-07-18,Jordan,5,1,1214,11
2020-07-19,Jordan,4,0,1218,11
2020-07-20,Jordan,5,0,1223,11
2020-07-21,Jordan,-110,0,1113,11
2020-07-22,Jordan,7,0,1120,11
2020-07-23,Jordan,11,0,1131,11
2020-07-24,Jordan,15,0,1146,11
2020-07-25,Jordan,8,0,1154,11
2020-07-26,Jordan,14,0,1168,11
2020-07-27,Jordan,8,0,1176,11
2020-07-28,Jordan,6,0,1182,11
2020-07-29,Jordan,5,0,1187,11
2020-07-30,Jordan,4,0,1191,11
2020-07-31,Jordan,2,0,1193,11
2020-08-01,Jordan,15,0,1208,11
2020-08-02,Jordan,5,0,1213,11
2020-08-03,Jordan,5,0,1218,11
2020-08-04,Jordan,6,0,1224,11
2020-08-05,Jordan,7,0,1231,11
2020-08-06,Jordan,1,0,1232,11
2020-08-07,Jordan,5,0,1237,11
2020-08-08,Jordan,9,0,1246,11
2020-08-09,Jordan,6,0,1252,11
2020-08-10,Jordan,16,0,1268,11
2020-08-11,Jordan,15,0,1283,11
2020-08-12,Jordan,20,0,1303,11
2020-08-13,Jordan,17,0,1320,11
2020-08-14,Jordan,9,0,1329,11
2020-08-15,Jordan,10,0,1339,11
2020-08-16,Jordan,39,0,1378,11
2020-08-17,Jordan,20,0,1398,11
2020-08-18,Jordan,40,0,1438,11
2020-08-19,Jordan,44,0,1482,11
2020-08-20,Jordan,16,0,1498,11
2020-08-21,Jordan,34,0,1532,11
2020-08-22,Jordan,44,0,1576,11
2020-08-23,Jordan,33,1,1609,12
2020-08-24,Jordan,30,2,1639,14
2020-08-25,Jordan,77,0,1716,14
2020-08-26,Jordan,40,1,1756,15
2020-08-27,Jordan,45,0,1801,15
2020-08-28,Jordan,68,0,1869,15
2020-08-29,Jordan,24,0,1893,15
2020-08-30,Jordan,73,0,1966,15
2020-08-31,Jordan,68,0,2034,15
2020-09-01,Jordan,63,0,2097,15
2020-09-02,Jordan,64,0,2161,15
2020-09-03,Jordan,72,0,2233,15
2020-09-04,Jordan,68,1,2301,16
2020-09-05,Jordan,52,0,2353,16
2020-09-06,Jordan,58,0,2411,16
2020-09-07,Jordan,67,1,2478,17
2020-09-08,Jordan,103,2,2581,19
2020-09-09,Jordan,78,0,2659,19
2020-09-10,Jordan,80,1,2739,20
2020-09-11,Jordan,206,1,2945,21
2020-09-12,Jordan,117,1,3062,22
2020-09-13,Jordan,252,2,3314,24
2020-09-14,Jordan,214,2,3528,26
2020-09-15,Jordan,149,0,3677,26
2020-09-16,Jordan,175,0,3852,26
2020-09-17,Jordan,279,0,4131,26
2020-09-18,Jordan,213,3,4344,29
2020-09-19,Jordan,196,1,4540,30
2020-09-20,Jordan,239,0,4779,30
2020-09-21,Jordan,266,2,5045,32
2020-09-22,Jordan,634,1,5679,33
2020-09-23,Jordan,363,2,6042,35
2020-09-24,Jordan,549,1,6591,36
2020-09-25,Jordan,620,3,7211,39
2020-09-26,Jordan,850,4,8061,43
2020-09-27,Jordan,431,2,8492,45
2020-09-28,Jordan,734,6,9226,51
2020-09-29,Jordan,823,6,10049,57
2020-09-30,Jordan,1776,4,11825,61
2020-10-01,Jordan,1276,8,13101,69
2020-10-02,Jordan,549,10,13650,79
2020-10-03,Jordan,1099,9,14749,88
2020-10-04,Jordan,891,13,15640,101
2020-10-05,Jordan,1824,9,17464,110
2020-10-06,Jordan,1537,12,19001,122
2020-10-07,Jordan,1199,9,20200,131
2020-10-08,Jordan,1317,13,21517,144
2020-10-09,Jordan,1246,22,22763,166
2020-10-10,Jordan,1235,15,23998,181
2020-10-11,Jordan,928,10,24926,191
2020-10-12,Jordan,1147,16,26073,207
2020-10-13,Jordan,2054,18,28127,225
2020-10-14,Jordan,2423,32,30550,257
2020-10-15,Jordan,2459,25,33009,282
2020-10-16,Jordan,1539,28,34548,310
2020-10-17,Jordan,1505,20,36053,330
2020-10-18,Jordan,1520,15,37573,345
2020-10-19,Jordan,1364,35,38937,380
2020-10-20,Jordan,2035,34,40972,414
2020-10-21,Jordan,2648,29,43620,443
2020-10-22,Jordan,2821,38,46441,481
2020-10-23,Jordan,2489,27,48930,508
2020-10-24,Jordan,1820,32,50750,540
2020-10-25,Jordan,2337,39,53087,579
2020-10-26,Jordan,1968,45,55055,624
2020-10-27,Jordan,3800,44,58855,668
2020-10-28,Jordan,3087,32,61942,700
2020-10-29,Jordan,3443,40,65385,740
2020-10-30,Jordan,3921,32,69306,772
2020-10-31,Jordan,3301,57,72607,829
2020-11-01,Jordan,3259,37,75866,866
2020-11-02,Jordan,5877,47,81743,913
2020-11-03,Jordan,4833,54,86576,967
2020-11-04,Jordan,4658,62,91234,1029
2020-11-05,Jordan,4630,40,95864,1069
2020-11-06,Jordan,5384,67,101248,1136
2020-11-07,Jordan,3554,45,104802,1181
2020-11-08,Jordan,4519,52,109321,1233
2020-11-09,Jordan,5665,62,114986,1295
2020-11-10,Jordan,5996,91,120982,1386
2020-11-11,Jordan,5419,81,126401,1467
2020-11-12,Jordan,5685,80,132086,1547
2020-11-13,Jordan,4469,71,136555,1618
2020-11-14,Jordan,4750,86,141305,1704
2020-11-15,Jordan,2373,68,143678,1772
2020-11-16,Jordan,5861,71,149539,1843
2020-11-17,Jordan,6454,66,155993,1909
2020-11-18,Jordan,7933,60,163926,1969
2020-11-19,Jordan,5469,84,169395,2053
2020-11-20,Jordan,4940,63,174335,2116
2020-11-21,Jordan,3826,56,178161,2172
2020-11-22,Jordan,5268,64,183429,2236
2020-11-23,Jordan,4981,66,188410,2302
2020-11-24,Jordan,4586,78,192996,2380
2020-11-25,Jordan,5025,62,198021,2442
2020-11-26,Jordan,5000,67,203021,2509
2020-11-27,Jordan,4580,61,207601,2570
2020-11-28,Jordan,3108,56,210709,2626
2020-11-29,Jordan,3598,68,214307,2694
2020-11-30,Jordan,5123,57,219430,2751
2020-12-01,Jordan,4187,51,223617,2802
2020-12-02,Jordan,3591,52,227208,2854
2020-12-03,Jordan,4029,55,231237,2909
2020-12-04,Jordan,3116,51,234353,2960
2020-12-05,Jordan,3160,50,237513,3010
2020-12-06,Jordan,2576,46,240089,3056
2020-12-07,Jordan,3980,60,244069,3116
2020-12-08,Jordan,3062,46,247131,3162
2020-12-09,Jordan,3088,44,250219,3206
2020-12-10,Jordan,2902,44,253121,3250
2020-12-11,Jordan,2338,36,255459,3286
2020-12-12,Jordan,1816,49,257275,3335
2020-12-13,Jordan,2339,30,259614,3365
2020-12-14,Jordan,2863,42,262477,3407
2020-12-15,Jordan,2547,30,265024,3437
2020-12-16,Jordan,2561,28,267585,3465
2020-12-17,Jordan,2221,31,269806,3496
2020-12-18,Jordan,1708,22,271514,3518
2020-12-19,Jordan,1283,27,272797,3545
2020-12-20,Jordan,2152,23,274949,3568
2020-12-21,Jordan,2499,36,277448,3604
2020-12-22,Jordan,2444,23,279892,3627
2020-12-23,Jordan,2091,25,281983,3652
2020-12-24,Jordan,1707,29,283690,3681
2020-12-25,Jordan,1616,30,285306,3711
2020-12-26,Jordan,1050,18,286356,3729
2020-12-27,Jordan,1590,29,287946,3758
2020-12-28,Jordan,1802,20,289748,3778
2020-12-29,Jordan,1645,23,291393,3801
2020-12-30,Jordan,1674,14,293067,3815
2020-12-31,Jordan,1427,19,294494,3834
2021-01-01,Jordan,1271,17,295765,3851
2021-01-02,Jordan,903,26,296668,3877
2021-01-03,Jordan,1540,26,298208,3903
2021-01-04,Jordan,1623,16,299831,3919
2021-01-05,Jordan,1472,21,301303,3940
2021-01-06,Jordan,1553,15,302856,3955
2021-01-07,Jordan,1215,13,304071,3968
2021-01-08,Jordan,1092,21,305163,3989
2021-01-09,Jordan,796,20,305959,4009
2021-01-10,Jordan,1250,15,307209,4024
2021-01-11,Jordan,1461,19,308670,4043
2021-01-12,Jordan,1176,33,309846,4076
2021-01-13,Jordan,1122,15,310968,4091
2021-01-14,Jordan,1075,16,312043,4107
2021-01-15,Jordan,808,14,312851,4121
2021-01-16,Jordan,706,16,313557,4137
2021-01-17,Jordan,957,8,314514,4145
2021-01-18,Jordan,1030,8,315544,4153
2021-01-19,Jordan,883,17,316427,4170
2021-01-20,Jordan,978,17,317405,4187
2021-01-21,Jordan,776,11,318181,4198
2021-01-22,Jordan,730,9,318911,4207
2021-01-23,Jordan,608,10,319519,4217
2021-01-24,Jordan,934,7,320453,4224
2021-01-25,Jordan,845,15,321298,4239
2021-01-26,Jordan,943,9,322241,4248
2021-01-27,Jordan,870,14,323111,4262
2021-01-28,Jordan,1058,7,324169,4269
2021-01-29,Jordan,864,12,325033,4281
2021-01-30,Jordan,641,23,325674,4304
2021-01-31,Jordan,1181,12,326855,4316
2021-02-01,Jordan,1207,10,328062,4326
2021-02-02,Jordan,1132,8,329194,4334
2021-02-03,Jordan,1280,10,330474,4344
2021-02-04,Jordan,1294,10,331768,4354
2021-02-05,Jordan,1222,8,332990,4362
2021-02-06,Jordan,865,7,333855,4369
2021-02-07,Jordan,1299,10,335154,4379
2021-02-08,Jordan,1685,6,336839,4385
2021-02-09,Jordan,1483,10,338322,4395
2021-02-10,Jordan,1855,16,340177,4411
2021-02-11,Jordan,1807,10,341984,4421
2021-02-12,Jordan,1579,12,343563,4433
2021-02-13,Jordan,1240,11,344803,4444
2021-02-14,Jordan,2447,11,347250,4455
2021-02-15,Jordan,2312,18,349562,4473
2021-02-16,Jordan,2657,18,352219,4491
2021-02-17,Jordan,2887,12,355106,4503
2021-02-18,Jordan,1638,9,356744,4512
2021-02-19,Jordan,867,16,357611,4528
2021-02-20,Jordan,2200,15,359811,4543
2021-02-21,Jordan,3917,11,363728,4554
2021-02-22,Jordan,4550,16,368278,4570
2021-02-23,Jordan,4139,19,372417,4589
2021-02-24,Jordan,4024,22,376441,4611
2021-02-25,Jordan,3827,16,380268,4627
2021-02-26,Jordan,3644,23,383912,4650
2021-02-27,Jordan,2584,25,386496,4675
2021-02-28,Jordan,4594,26,391090,4701
2021-03-01,Jordan,6068,26,397158,4727
2021-03-02,Jordan,5124,29,402282,4756
2021-03-03,Jordan,5335,37,407617,4793
2021-03-04,Jordan,5733,40,413350,4833
2021-03-05,Jordan,4584,29,417934,4862
2021-03-06,Jordan,3481,38,421415,4900
2021-03-07,Jordan,6302,35,427717,4935
2021-03-08,Jordan,7413,52,435130,4987
2021-03-09,Jordan,7072,59,442202,5046
2021-03-10,Jordan,6649,60,448851,5106
2021-03-11,Jordan,8300,63,457151,5169
2021-03-12,Jordan,7705,55,464856,5224
2021-03-13,Jordan,4144,61,469000,5285
2021-03-14,Jordan,8053,61,477053,5346
2021-03-15,Jordan,9417,82,486470,5428
2021-03-16,Jordan,8910,69,495380,5497
2021-03-17,Jordan,9535,56,504915,5553
2021-03-18,Jordan,9192,74,514107,5627
2021-03-19,Jordan,7354,74,521461,5701
2021-03-20,Jordan,5205,87,526666,5788
2021-03-21,Jordan,8789,88,535455,5876
2021-03-22,Jordan,9269,109,544724,5985
2021-03-23,Jordan,9003,92,553727,6077
2021-03-24,Jordan,9130,104,562857,6181
2021-03-25,Jordan,8433,96,571290,6277
2021-03-26,Jordan,6444,97,577734,6374
2021-03-27,Jordan,4399,98,582133,6472
2021-03-28,Jordan,7183,82,589316,6554
2021-03-29,Jordan,7940,97,597256,6651
2021-03-30,Jordan,7751,96,605007,6747
2021-03-31,Jordan,6570,111,611577,6858
2021-04-01,Jordan,6482,82,618059,6940
2021-04-02,Jordan,4774,99,622833,7039
2021-04-03,Jordan,4042,91,626875,7130
2021-04-04,Jordan,6032,71,632907,7201
2021-04-05,Jordan,6537,82,639444,7283
2021-04-06,Jordan,6005,100,645449,7383
2021-04-07,Jordan,5232,86,650681,7469
2021-04-08,Jordan,4775,96,655456,7565
2020-03-13,Kazakhstan,4,0,4,0
2020-03-14,Kazakhstan,2,0,6,0
2020-03-15,Kazakhstan,3,0,9,0
2020-03-16,Kazakhstan,1,0,10,0
2020-03-17,Kazakhstan,23,0,33,0
2020-03-18,Kazakhstan,2,0,35,0
2020-03-19,Kazakhstan,9,0,44,0
2020-03-20,Kazakhstan,5,0,49,0
2020-03-21,Kazakhstan,4,0,53,0
2020-03-22,Kazakhstan,8,0,61,0
2020-03-23,Kazakhstan,1,0,62,0
2020-03-24,Kazakhstan,10,0,72,0
2020-03-25,Kazakhstan,9,0,81,0
2020-03-26,Kazakhstan,30,1,111,1
2020-03-27,Kazakhstan,39,0,150,1
2020-03-28,Kazakhstan,78,0,228,1
2020-03-29,Kazakhstan,56,0,284,1
2020-03-30,Kazakhstan,18,0,302,1
2020-03-31,Kazakhstan,41,1,343,2
2020-04-01,Kazakhstan,37,1,380,3
2020-04-02,Kazakhstan,55,0,435,3
2020-04-03,Kazakhstan,29,3,464,6
2020-04-04,Kazakhstan,67,-1,531,5
2020-04-05,Kazakhstan,53,1,584,6
2020-04-06,Kazakhstan,78,0,662,6
2020-04-07,Kazakhstan,35,0,697,6
2020-04-08,Kazakhstan,30,1,727,7
2020-04-09,Kazakhstan,54,1,781,8
2020-04-10,Kazakhstan,31,2,812,10
2020-04-11,Kazakhstan,53,0,865,10
2020-04-12,Kazakhstan,86,0,951,10
2020-04-13,Kazakhstan,140,2,1091,12
2020-04-14,Kazakhstan,141,2,1232,14
2020-04-15,Kazakhstan,63,2,1295,16
2020-04-16,Kazakhstan,107,1,1402,17
2020-04-17,Kazakhstan,144,0,1546,17
2020-04-18,Kazakhstan,69,0,1615,17
2020-04-19,Kazakhstan,61,0,1676,17
2020-04-20,Kazakhstan,176,2,1852,19
2020-04-21,Kazakhstan,143,0,1995,19
2020-04-22,Kazakhstan,140,0,2135,19
2020-04-23,Kazakhstan,154,1,2289,20
2020-04-24,Kazakhstan,193,5,2482,25
2020-04-25,Kazakhstan,119,0,2601,25
2020-04-26,Kazakhstan,116,0,2717,25
2020-04-27,Kazakhstan,118,0,2835,25
2020-04-28,Kazakhstan,192,0,3027,25
2020-04-29,Kazakhstan,111,0,3138,25
2020-04-30,Kazakhstan,264,0,3402,25
2020-05-01,Kazakhstan,195,0,3597,25
2020-05-02,Kazakhstan,260,0,3857,25
2020-05-03,Kazakhstan,63,2,3920,27
2020-05-04,Kazakhstan,129,2,4049,29
2020-05-05,Kazakhstan,156,0,4205,29
2020-05-06,Kazakhstan,217,1,4422,30
2020-05-07,Kazakhstan,156,0,4578,30
2020-05-08,Kazakhstan,256,1,4834,31
2020-05-09,Kazakhstan,141,0,4975,31
2020-05-10,Kazakhstan,115,0,5090,31
2020-05-11,Kazakhstan,117,1,5207,32
2020-05-12,Kazakhstan,72,0,5279,32
2020-05-13,Kazakhstan,138,0,5417,32
2020-05-14,Kazakhstan,154,0,5571,32
2020-05-15,Kazakhstan,118,2,5689,34
2020-05-16,Kazakhstan,161,0,5850,34
2020-05-17,Kazakhstan,307,0,6157,34
2020-05-18,Kazakhstan,594,1,6751,35
2020-05-19,Kazakhstan,0,0,6751,35
2020-05-20,Kazakhstan,218,0,6969,35
2020-05-21,Kazakhstan,265,0,7234,35
2020-05-22,Kazakhstan,685,0,7919,35
2020-05-23,Kazakhstan,0,0,7919,35
2020-05-24,Kazakhstan,612,0,8531,35
2020-05-25,Kazakhstan,438,0,8969,35
2020-05-26,Kazakhstan,0,2,8969,37
2020-05-27,Kazakhstan,335,0,9304,37
2020-05-28,Kazakhstan,272,0,9576,37
2020-05-29,Kazakhstan,356,0,9932,37
2020-05-30,Kazakhstan,450,1,10382,38
2020-05-31,Kazakhstan,476,2,10858,40
2020-06-01,Kazakhstan,450,1,11308,41
2020-06-02,Kazakhstan,263,3,11571,44
2020-06-03,Kazakhstan,496,4,12067,48
2020-06-04,Kazakhstan,0,4,12067,52
2020-06-05,Kazakhstan,245,0,12312,52
2020-06-06,Kazakhstan,199,1,12511,53
2020-06-07,Kazakhstan,183,3,12694,56
2020-06-08,Kazakhstan,165,0,12859,56
2020-06-09,Kazakhstan,215,5,13074,61
2020-06-10,Kazakhstan,245,6,13319,67
2020-06-11,Kazakhstan,553,0,13872,67
2020-06-12,Kazakhstan,0,3,13872,70
2020-06-13,Kazakhstan,366,3,14238,73
2020-06-14,Kazakhstan,258,4,14496,77
2020-06-15,Kazakhstan,696,4,15192,81
2020-06-16,Kazakhstan,350,7,15542,88
2020-06-17,Kazakhstan,335,9,15877,97
2020-06-18,Kazakhstan,0,3,15877,100
2020-06-19,Kazakhstan,902,13,16779,113
2020-06-20,Kazakhstan,446,5,17225,118
2020-06-21,Kazakhstan,507,2,17732,120
2020-06-22,Kazakhstan,499,7,18231,127
2020-06-23,Kazakhstan,534,7,18765,134
2020-06-24,Kazakhstan,520,2,19285,136
2020-06-25,Kazakhstan,465,4,19750,140
2020-06-26,Kazakhstan,569,10,20319,150
2020-06-27,Kazakhstan,0,16,20319,166
2020-06-28,Kazakhstan,1008,12,21327,178
2020-06-29,Kazakhstan,492,10,21819,188
2020-06-30,Kazakhstan,489,0,22308,188
2020-07-01,Kazakhstan,18757,0,41065,188
2020-07-02,Kazakhstan,1509,0,42574,188
2020-07-03,Kazakhstan,3145,0,45719,188
2020-07-04,Kazakhstan,1452,0,47171,188
2020-07-05,Kazakhstan,1403,0,48574,188
2020-07-06,Kazakhstan,1109,76,49683,264
2020-07-07,Kazakhstan,1376,0,51059,264
2020-07-08,Kazakhstan,0,0,51059,264
2020-07-09,Kazakhstan,3688,0,54747,264
2020-07-10,Kazakhstan,1708,0,56455,264
2020-07-11,Kazakhstan,1798,0,58253,264
2020-07-12,Kazakhstan,0,111,58253,375
2020-07-13,Kazakhstan,3502,0,61755,375
2020-07-14,Kazakhstan,1759,0,63514,375
2020-07-15,Kazakhstan,1674,0,65188,375
2020-07-16,Kazakhstan,1707,0,66895,375
2020-07-17,Kazakhstan,1808,0,68703,375
2020-07-18,Kazakhstan,0,0,68703,375
2020-07-19,Kazakhstan,3135,0,71838,375
2020-07-20,Kazakhstan,1630,210,73468,585
2020-07-21,Kazakhstan,1685,0,75153,585
2020-07-22,Kazakhstan,0,0,75153,585
2020-07-23,Kazakhstan,3333,0,78486,585
2020-07-24,Kazakhstan,1740,0,80226,585
2020-07-25,Kazakhstan,1494,0,81720,585
2020-07-26,Kazakhstan,1402,0,83122,585
2020-07-27,Kazakhstan,1526,0,84648,585
2020-07-28,Kazakhstan,1544,208,86192,793
2020-07-29,Kazakhstan,1472,0,87664,793
2020-07-30,Kazakhstan,1414,0,89078,793
2020-07-31,Kazakhstan,1289,0,90367,793
2020-08-01,Kazakhstan,0,0,90367,793
2020-08-02,Kazakhstan,6407,30,96774,823
2020-08-03,Kazakhstan,1867,286,98641,1109
2020-08-04,Kazakhstan,1434,0,100075,1109
2020-08-05,Kazakhstan,2861,0,102936,1109
2020-08-06,Kazakhstan,2590,0,105526,1109
2020-08-07,Kazakhstan,2404,0,107930,1109
2020-08-08,Kazakhstan,2009,0,109939,1109
2020-08-09,Kazakhstan,1883,0,111822,1109
2020-08-10,Kazakhstan,900,324,112722,1433
2020-08-11,Kazakhstan,779,0,113501,1433
2020-08-12,Kazakhstan,2114,0,115615,1433
2020-08-13,Kazakhstan,1489,0,117104,1433
2020-08-14,Kazakhstan,1410,0,118514,1433
2020-08-15,Kazakhstan,1267,47,119781,1480
2020-08-16,Kazakhstan,1380,5,121161,1485
2020-08-17,Kazakhstan,478,2,121639,1487
2020-08-18,Kazakhstan,334,148,121973,1635
2020-08-19,Kazakhstan,1352,11,123325,1646
2020-08-20,Kazakhstan,1031,6,124356,1652
2020-08-21,Kazakhstan,979,6,125335,1658
2020-08-22,Kazakhstan,908,5,126243,1663
2020-08-23,Kazakhstan,960,8,127203,1671
2020-08-24,Kazakhstan,259,110,127462,1781
2020-08-25,Kazakhstan,0,0,127462,1781
2020-08-26,Kazakhstan,0,0,127462,1781
2020-08-27,Kazakhstan,202,0,127664,1781
2020-08-28,Kazakhstan,954,0,128618,1781
2020-08-29,Kazakhstan,1422,0,130040,1781
2020-08-30,Kazakhstan,633,0,130673,1781
2020-08-31,Kazakhstan,0,0,130673,1781
2020-09-01,Kazakhstan,923,34,131596,1815
2020-09-02,Kazakhstan,99,68,131695,1883
2020-09-03,Kazakhstan,659,6,132354,1889
2020-09-04,Kazakhstan,570,4,132924,1893
2020-09-05,Kazakhstan,104,0,133028,1893
2020-09-06,Kazakhstan,896,8,133924,1901
2020-09-07,Kazakhstan,199,1,134123,1902
2020-09-08,Kazakhstan,80,1,134203,1903
2020-09-09,Kazakhstan,523,47,134726,1950
2020-09-10,Kazakhstan,433,1,135159,1951
2020-09-11,Kazakhstan,430,1,135589,1952
2020-09-12,Kazakhstan,375,2,135964,1954
2020-09-13,Kazakhstan,420,1,136384,1955
2020-09-14,Kazakhstan,129,7,136513,1962
2020-09-15,Kazakhstan,73,3,136586,1965
2020-09-16,Kazakhstan,472,38,137058,2003
2020-09-17,Kazakhstan,335,3,137393,2006
2020-09-18,Kazakhstan,320,2,137713,2008
2020-09-19,Kazakhstan,300,1,138013,2009
2020-09-20,Kazakhstan,335,5,138348,2014
2020-09-21,Kazakhstan,107,1,138455,2015
2020-09-22,Kazakhstan,87,1,138542,2016
2020-09-23,Kazakhstan,440,28,138982,2044
2020-09-24,Kazakhstan,307,1,139289,2045
2020-09-25,Kazakhstan,292,1,139581,2046
2020-09-26,Kazakhstan,301,0,139882,2046
2020-09-27,Kazakhstan,293,2,140175,2048
2020-09-28,Kazakhstan,90,1,140265,2049
2020-09-29,Kazakhstan,68,1,140333,2050
2020-09-30,Kazakhstan,374,28,140707,2078
2020-10-01,Kazakhstan,251,2,140958,2080
2020-10-02,Kazakhstan,298,2,141256,2082
2020-10-03,Kazakhstan,228,1,141484,2083
2020-10-04,Kazakhstan,264,0,141748,2083
2020-10-05,Kazakhstan,96,2,141844,2085
2020-10-06,Kazakhstan,60,0,141904,2085
2020-10-07,Kazakhstan,335,22,142239,2107
2020-10-08,Kazakhstan,358,1,142597,2108
2020-10-09,Kazakhstan,348,2,142945,2110
2020-10-10,Kazakhstan,335,1,143280,2111
2020-10-11,Kazakhstan,352,2,143632,2113
2020-10-12,Kazakhstan,108,1,143740,2114
2020-10-13,Kazakhstan,74,2,143814,2116
2020-10-14,Kazakhstan,404,25,144218,2141
2020-10-15,Kazakhstan,110,0,144328,2141
2020-10-16,Kazakhstan,433,3,144761,2144
2020-10-17,Kazakhstan,258,4,145019,2148
2020-10-18,Kazakhstan,301,1,145320,2149
2020-10-19,Kazakhstan,153,1,145473,2150
2020-10-20,Kazakhstan,130,5,145603,2155
2020-10-21,Kazakhstan,363,29,145966,2184
2020-10-22,Kazakhstan,322,2,146288,2186
2020-10-23,Kazakhstan,365,1,146653,2187
2020-10-24,Kazakhstan,329,2,146982,2189
2020-10-25,Kazakhstan,315,0,147297,2189
2020-10-26,Kazakhstan,166,1,147463,2190
2020-10-27,Kazakhstan,152,1,147615,2191
2020-10-28,Kazakhstan,422,30,148037,2221
2020-10-29,Kazakhstan,442,1,148479,2222
2020-10-30,Kazakhstan,587,2,149066,2224
2020-10-31,Kazakhstan,633,2,149699,2226
2020-11-01,Kazakhstan,681,1,150380,2227
2020-11-02,Kazakhstan,483,0,150863,2227
2020-11-03,Kazakhstan,458,34,151321,2261
2020-11-04,Kazakhstan,701,1,152022,2262
2020-11-05,Kazakhstan,703,1,152725,2263
2020-11-06,Kazakhstan,822,0,153547,2263
2020-11-07,Kazakhstan,774,2,154321,2265
2020-11-08,Kazakhstan,899,1,155220,2266
2020-11-09,Kazakhstan,656,0,155876,2266
2020-11-10,Kazakhstan,575,1,156451,2267
2020-11-11,Kazakhstan,810,0,157261,2267
2020-11-12,Kazakhstan,775,44,158036,2311
2020-11-13,Kazakhstan,817,3,158853,2314
2020-11-14,Kazakhstan,903,1,159756,2315
2020-11-15,Kazakhstan,856,2,160612,2317
2020-11-16,Kazakhstan,1238,2,161850,2319
2020-11-17,Kazakhstan,705,1,162555,2320
2020-11-18,Kazakhstan,1030,46,163585,2366
2020-11-19,Kazakhstan,993,2,164578,2368
2020-11-20,Kazakhstan,980,1,165558,2369
2020-11-21,Kazakhstan,910,1,166468,2370
2020-11-22,Kazakhstan,873,2,167341,2372
2020-11-23,Kazakhstan,44,0,167385,2372
2020-11-24,Kazakhstan,1418,1,168803,2373
2020-11-25,Kazakhstan,1024,49,169827,2422
2020-11-26,Kazakhstan,981,2,170808,2424
2020-11-27,Kazakhstan,987,5,171795,2429
2020-11-28,Kazakhstan,1010,1,172805,2430
2020-11-29,Kazakhstan,958,3,173763,2433
2020-11-30,Kazakhstan,800,0,174563,2433
2020-12-01,Kazakhstan,1002,1,175565,2434
2020-12-02,Kazakhstan,777,2,176342,2436
2020-12-03,Kazakhstan,1044,2,177386,2438
2020-12-04,Kazakhstan,992,46,178378,2484
2020-12-05,Kazakhstan,966,4,179344,2488
2020-12-06,Kazakhstan,745,0,180089,2488
2020-12-07,Kazakhstan,688,2,180777,2490
2020-12-08,Kazakhstan,944,54,181721,2544
2020-12-09,Kazakhstan,936,2,182657,2546
2020-12-10,Kazakhstan,973,4,183630,2550
2020-12-11,Kazakhstan,927,1,184557,2551
2020-12-12,Kazakhstan,956,1,185513,2552
2020-12-13,Kazakhstan,764,0,186277,2552
2020-12-14,Kazakhstan,683,2,186960,2554
2020-12-15,Kazakhstan,930,59,187890,2613
2020-12-16,Kazakhstan,947,0,188837,2613
2020-12-17,Kazakhstan,714,2,189551,2615
2020-12-18,Kazakhstan,741,2,190292,2617
2020-12-19,Kazakhstan,677,4,190969,2621
2020-12-20,Kazakhstan,681,1,191650,2622
2020-12-21,Kazakhstan,929,4,192579,2626
2020-12-22,Kazakhstan,924,51,193503,2677
2020-12-23,Kazakhstan,754,0,194257,2677
2020-12-24,Kazakhstan,736,0,194993,2677
2020-12-25,Kazakhstan,1223,8,196216,2685
2020-12-26,Kazakhstan,926,1,197142,2686
2020-12-27,Kazakhstan,760,0,197902,2686
2020-12-28,Kazakhstan,757,3,198659,2689
2020-12-29,Kazakhstan,896,71,199555,2760
2020-12-30,Kazakhstan,888,1,200443,2761
2020-12-31,Kazakhstan,753,0,201196,2761
2021-01-01,Kazakhstan,864,4,202060,2765
2021-01-02,Kazakhstan,820,5,202880,2770
2021-01-03,Kazakhstan,683,1,203563,2771
2021-01-04,Kazakhstan,730,4,204293,2775
2021-01-05,Kazakhstan,771,0,205064,2775
2021-01-06,Kazakhstan,869,6,205933,2781
2021-01-07,Kazakhstan,907,0,206840,2781
2021-01-08,Kazakhstan,843,57,207683,2838
2021-01-09,Kazakhstan,913,5,208596,2843
2021-01-10,Kazakhstan,773,1,209369,2844
2021-01-11,Kazakhstan,717,1,210086,2845
2021-01-12,Kazakhstan,890,34,210976,2879
2021-01-13,Kazakhstan,925,2,211901,2881
2021-01-14,Kazakhstan,911,1,212812,2882
2021-01-15,Kazakhstan,1043,1,213855,2883
2021-01-16,Kazakhstan,1072,4,214927,2887
2021-01-17,Kazakhstan,1020,2,215947,2889
2021-01-18,Kazakhstan,1017,2,216964,2891
2021-01-19,Kazakhstan,1252,3,218216,2894
2021-01-20,Kazakhstan,1311,56,219527,2950
2021-01-21,Kazakhstan,1526,2,221053,2952
2021-01-22,Kazakhstan,1648,1,222701,2953
2021-01-23,Kazakhstan,1694,2,224395,2955
2021-01-24,Kazakhstan,1496,3,225891,2958
2021-01-25,Kazakhstan,1274,3,227165,2961
2021-01-26,Kazakhstan,1527,74,228692,3035
2021-01-27,Kazakhstan,1496,5,230188,3040
2021-01-28,Kazakhstan,1528,0,231716,3040
2021-01-29,Kazakhstan,1440,2,233156,3042
2021-01-30,Kazakhstan,1413,3,234569,3045
2021-01-31,Kazakhstan,1275,1,235844,3046
2021-02-01,Kazakhstan,1185,0,237029,3046
2021-02-02,Kazakhstan,1335,1,238364,3047
2021-02-03,Kazakhstan,1362,1,239726,3048
2021-02-04,Kazakhstan,1257,71,240983,3119
2021-02-05,Kazakhstan,0,0,240983,3119
2021-02-06,Kazakhstan,2421,0,243404,3119
2021-02-07,Kazakhstan,1024,5,244428,3124
2021-02-08,Kazakhstan,923,0,245351,3124
2021-02-09,Kazakhstan,1123,3,246474,3127
2021-02-10,Kazakhstan,1059,4,247533,3131
2021-02-11,Kazakhstan,1033,1,248566,3132
2021-02-12,Kazakhstan,996,3,249562,3135
2021-02-13,Kazakhstan,837,0,250399,3135
2021-02-14,Kazakhstan,868,5,251267,3140
2021-02-15,Kazakhstan,692,2,251959,3142
2021-02-16,Kazakhstan,862,2,252821,3144
2021-02-17,Kazakhstan,930,0,253751,3144
2021-02-18,Kazakhstan,961,1,254712,3145
2021-02-19,Kazakhstan,872,3,255584,3148
2021-02-20,Kazakhstan,804,2,256388,3150
2021-02-21,Kazakhstan,712,2,257100,3152
2021-02-22,Kazakhstan,700,1,257800,3153
2021-02-23,Kazakhstan,809,2,258609,3155
2021-02-24,Kazakhstan,869,4,259478,3159
2021-02-25,Kazakhstan,906,1,260384,3160
2021-02-26,Kazakhstan,860,0,261244,3160
2021-02-27,Kazakhstan,849,2,262093,3162
2021-02-28,Kazakhstan,622,0,262715,3162
2021-03-01,Kazakhstan,681,6,263396,3168
2021-03-02,Kazakhstan,782,2,264178,3170
2021-03-03,Kazakhstan,850,5,265028,3175
2021-03-04,Kazakhstan,901,0,265929,3175
2021-03-05,Kazakhstan,874,2,266803,3177
2021-03-06,Kazakhstan,854,3,267657,3180
2021-03-07,Kazakhstan,670,4,268327,3184
2021-03-08,Kazakhstan,575,2,268902,3186
2021-03-09,Kazakhstan,697,1,269599,3187
2021-03-10,Kazakhstan,800,3,270399,3190
2021-03-11,Kazakhstan,964,2,271363,3192
2021-03-12,Kazakhstan,1002,0,272365,3192
2021-03-13,Kazakhstan,1104,1,273469,3193
2021-03-14,Kazakhstan,1072,2,274541,3195
2021-03-15,Kazakhstan,961,1,275502,3196
2021-03-16,Kazakhstan,1161,0,276663,3196
2021-03-17,Kazakhstan,1243,3,277906,3199
2021-03-18,Kazakhstan,1314,0,279220,3199
2021-03-19,Kazakhstan,1356,1,280576,3200
2021-03-20,Kazakhstan,1222,1,281798,3201
2021-03-21,Kazakhstan,1229,1,283027,3202
2021-03-22,Kazakhstan,1111,2,284138,3204
2021-03-23,Kazakhstan,1103,3,285241,3207
2021-03-24,Kazakhstan,1111,2,286352,3209
2021-03-25,Kazakhstan,1121,3,287473,3212
2021-03-26,Kazakhstan,1629,5,289102,3217
2021-03-27,Kazakhstan,1690,3,290792,3220
2021-03-28,Kazakhstan,1514,2,292306,3222
2021-03-29,Kazakhstan,1455,2,293761,3224
2021-03-30,Kazakhstan,1745,4,295506,3228
2021-03-31,Kazakhstan,1966,4,297472,3232
2021-04-01,Kazakhstan,2154,2,299626,3234
2021-04-02,Kazakhstan,2192,2,301818,3236
2021-04-03,Kazakhstan,2104,4,303922,3240
2021-04-04,Kazakhstan,1938,2,305860,3242
2021-04-05,Kazakhstan,1816,7,307676,3249
2021-04-06,Kazakhstan,2080,0,309756,3249
2021-04-07,Kazakhstan,2802,9,312558,3258
2021-04-08,Kazakhstan,2544,3,315102,3261
2020-03-13,Kenya,1,0,1,0
2020-03-14,Kenya,0,0,1,0
2020-03-15,Kenya,2,0,3,0
2020-03-16,Kenya,0,0,3,0
2020-03-17,Kenya,0,0,3,0
2020-03-18,Kenya,0,0,3,0
2020-03-19,Kenya,4,0,7,0
2020-03-20,Kenya,0,0,7,0
2020-03-21,Kenya,0,0,7,0
2020-03-22,Kenya,8,0,15,0
2020-03-23,Kenya,1,0,16,0
2020-03-24,Kenya,9,0,25,0
2020-03-25,Kenya,3,0,28,0
2020-03-26,Kenya,3,1,31,1
2020-03-27,Kenya,0,0,31,1
2020-03-28,Kenya,7,0,38,1
2020-03-29,Kenya,4,0,42,1
2020-03-30,Kenya,8,0,50,1
2020-03-31,Kenya,9,0,59,1
2020-04-01,Kenya,22,0,81,1
2020-04-02,Kenya,29,2,110,3
2020-04-03,Kenya,12,1,122,4
2020-04-04,Kenya,4,0,126,4
2020-04-05,Kenya,16,0,142,4
2020-04-06,Kenya,16,2,158,6
2020-04-07,Kenya,14,0,172,6
2020-04-08,Kenya,7,0,179,6
2020-04-09,Kenya,5,1,184,7
2020-04-10,Kenya,5,0,189,7
2020-04-11,Kenya,2,0,191,7
2020-04-12,Kenya,6,1,197,8
2020-04-13,Kenya,11,1,208,9
2020-04-14,Kenya,8,0,216,9
2020-04-15,Kenya,9,1,225,10
2020-04-16,Kenya,9,1,234,11
2020-04-17,Kenya,12,0,246,11
2020-04-18,Kenya,16,1,262,12
2020-04-19,Kenya,8,2,270,14
2020-04-20,Kenya,11,0,281,14
2020-04-21,Kenya,15,0,296,14
2020-04-22,Kenya,7,0,303,14
2020-04-23,Kenya,17,0,320,14
2020-04-24,Kenya,16,0,336,14
2020-04-25,Kenya,7,0,343,14
2020-04-26,Kenya,12,0,355,14
2020-04-27,Kenya,8,0,363,14
2020-04-28,Kenya,11,0,374,14
2020-04-29,Kenya,10,1,384,15
2020-04-30,Kenya,12,2,396,17
2020-05-01,Kenya,15,4,411,21
2020-05-02,Kenya,24,1,435,22
2020-05-03,Kenya,30,2,465,24
2020-05-04,Kenya,25,0,490,24
2020-05-05,Kenya,45,0,535,24
2020-05-06,Kenya,47,2,582,26
2020-05-07,Kenya,25,3,607,29
2020-05-08,Kenya,14,0,621,29
2020-05-09,Kenya,28,1,649,30
2020-05-10,Kenya,23,2,672,32
2020-05-11,Kenya,28,1,700,33
2020-05-12,Kenya,15,3,715,36
2020-05-13,Kenya,22,4,737,40
2020-05-14,Kenya,21,2,758,42
2020-05-15,Kenya,23,3,781,45
2020-05-16,Kenya,49,5,830,50
2020-05-17,Kenya,57,0,887,50
2020-05-18,Kenya,25,0,912,50
2020-05-19,Kenya,51,0,963,50
2020-05-20,Kenya,66,0,1029,50
2020-05-21,Kenya,80,0,1109,50
2020-05-22,Kenya,52,0,1161,50
2020-05-23,Kenya,31,0,1192,50
2020-05-24,Kenya,22,1,1214,51
2020-05-25,Kenya,72,1,1286,52
2020-05-26,Kenya,62,0,1348,52
2020-05-27,Kenya,123,3,1471,55
2020-05-28,Kenya,147,3,1618,58
2020-05-29,Kenya,127,4,1745,62
2020-05-30,Kenya,143,1,1888,63
2020-05-31,Kenya,74,1,1962,64
2020-06-01,Kenya,59,5,2021,69
2020-06-02,Kenya,72,2,2093,71
2020-06-03,Kenya,123,3,2216,74
2020-06-04,Kenya,124,4,2340,78
2020-06-05,Kenya,134,1,2474,79
2020-06-06,Kenya,126,4,2600,83
2020-06-07,Kenya,167,1,2767,84
2020-06-08,Kenya,105,1,2872,85
2020-06-09,Kenya,117,3,2989,88
2020-06-10,Kenya,105,1,3094,89
2020-06-11,Kenya,121,3,3215,92
2020-06-12,Kenya,90,4,3305,96
2020-06-13,Kenya,152,4,3457,100
2020-06-14,Kenya,137,3,3594,103
2020-06-15,Kenya,133,1,3727,104
2020-06-16,Kenya,133,1,3860,105
2020-06-17,Kenya,184,2,4044,107
2020-06-18,Kenya,213,10,4257,117
2020-06-19,Kenya,117,2,4374,119
2020-06-20,Kenya,104,2,4478,121
2020-06-21,Kenya,260,2,4738,123
2020-06-22,Kenya,59,2,4797,125
2020-06-23,Kenya,155,3,4952,128
2020-06-24,Kenya,254,2,5206,130
2020-06-25,Kenya,178,2,5384,132
2020-06-26,Kenya,149,5,5533,137
2020-06-27,Kenya,278,4,5811,141
2020-06-28,Kenya,259,2,6070,143
2020-06-29,Kenya,120,1,6190,144
2020-06-30,Kenya,176,4,6366,148
2020-07-01,Kenya,307,1,6673,149
2020-07-02,Kenya,268,3,6941,152
2020-07-03,Kenya,247,2,7188,154
2020-07-04,Kenya,389,5,7577,159
2020-07-05,Kenya,309,1,7886,160
2020-07-06,Kenya,181,4,8067,164
2020-07-07,Kenya,183,3,8250,167
2020-07-08,Kenya,278,2,8528,169
2020-07-09,Kenya,447,4,8975,173
2020-07-10,Kenya,473,8,9448,181
2020-07-11,Kenya,278,3,9726,184
2020-07-12,Kenya,379,1,10105,185
2020-07-13,Kenya,189,12,10294,197
2020-07-14,Kenya,497,5,10791,202
2020-07-15,Kenya,461,7,11252,209
2020-07-16,Kenya,421,8,11673,217
2020-07-17,Kenya,389,5,12062,222
2020-07-18,Kenya,688,3,12750,225
2020-07-19,Kenya,603,9,13353,234
2020-07-20,Kenya,418,4,13771,238
2020-07-21,Kenya,397,12,14168,250
2020-07-22,Kenya,637,10,14805,260
2020-07-23,Kenya,796,3,15601,263
2020-07-24,Kenya,667,11,16268,274
2020-07-25,Kenya,375,4,16643,278
2020-07-26,Kenya,960,2,17603,280
2020-07-27,Kenya,372,5,17975,285
2020-07-28,Kenya,606,14,18581,299
2020-07-29,Kenya,544,12,19125,311
2020-07-30,Kenya,788,14,19913,325
2020-07-31,Kenya,723,16,20636,341
2020-08-01,Kenya,727,23,21363,364
2020-08-02,Kenya,690,5,22053,369
2020-08-03,Kenya,544,13,22597,382
2020-08-04,Kenya,605,6,23202,388
2020-08-05,Kenya,671,3,23873,391
2020-08-06,Kenya,538,8,24411,399
2020-08-07,Kenya,727,14,25138,413
2020-08-08,Kenya,699,5,25837,418
2020-08-09,Kenya,599,2,26436,420
2020-08-10,Kenya,492,3,26928,423
2020-08-11,Kenya,497,15,27425,438
2020-08-12,Kenya,679,18,28104,456
2020-08-13,Kenya,650,4,28754,460
2020-08-14,Kenya,580,5,29334,465
2020-08-15,Kenya,515,7,29849,472
2020-08-16,Kenya,271,2,30120,474
2020-08-17,Kenya,245,8,30365,482
2020-08-18,Kenya,271,5,30636,487
2020-08-19,Kenya,379,19,31015,506
2020-08-20,Kenya,426,10,31441,516
2020-08-21,Kenya,322,16,31763,532
2020-08-22,Kenya,355,10,32118,542
2020-08-23,Kenya,246,6,32364,548
2020-08-24,Kenya,193,6,32557,554
2020-08-25,Kenya,246,5,32803,559
2020-08-26,Kenya,213,5,33016,564
2020-08-27,Kenya,373,3,33389,567
2020-08-28,Kenya,241,0,33630,567
2020-08-29,Kenya,164,5,33794,572
2020-08-30,Kenya,263,2,34057,574
2020-08-31,Kenya,144,3,34201,577
2020-09-01,Kenya,114,0,34315,577
2020-09-02,Kenya,178,4,34493,581
2020-09-03,Kenya,212,4,34705,585
2020-09-04,Kenya,179,4,34884,589
2020-09-05,Kenya,136,5,35020,594
2020-09-06,Kenya,83,3,35103,597
2020-09-07,Kenya,102,2,35205,599
2020-09-08,Kenya,151,0,35356,599
2020-09-09,Kenya,104,8,35460,607
2020-09-10,Kenya,143,5,35603,612
2020-09-11,Kenya,190,4,35793,616
2020-09-12,Kenya,176,3,35969,619
2020-09-13,Kenya,188,3,36157,622
2020-09-14,Kenya,48,2,36205,624
2020-09-15,Kenya,96,10,36301,634
2020-09-16,Kenya,0,0,36301,634
2020-09-17,Kenya,275,8,36576,642
2020-09-18,Kenya,148,4,36724,646
2020-09-19,Kenya,105,0,36829,646
2020-09-20,Kenya,152,2,36981,648
2020-09-21,Kenya,98,2,37079,650
2020-09-22,Kenya,139,9,37218,659
2020-09-23,Kenya,130,5,37348,664
2020-09-24,Kenya,141,5,37489,669
2020-09-25,Kenya,218,13,37707,682
2020-09-26,Kenya,164,7,37871,689
2020-09-27,Kenya,244,2,38115,691
2020-09-28,Kenya,53,9,38168,700
2020-09-29,Kenya,210,7,38378,707
2020-09-30,Kenya,151,4,38529,711
2020-10-01,Kenya,184,0,38713,711
2020-10-02,Kenya,210,14,38923,725
2020-10-03,Kenya,261,3,39184,728
2020-10-04,Kenya,243,3,39427,731
2020-10-05,Kenya,22,4,39449,735
2020-10-06,Kenya,137,8,39586,743
2020-10-07,Kenya,321,5,39907,748
2020-10-08,Kenya,271,3,40178,751
2020-10-09,Kenya,442,4,40620,755
2020-10-10,Kenya,538,5,41158,760
2020-10-11,Kenya,388,6,41546,766
2020-10-12,Kenya,73,11,41619,777
2020-10-13,Kenya,318,10,41937,787
2020-10-14,Kenya,604,10,42541,797
2020-10-15,Kenya,602,8,43143,805
2020-10-16,Kenya,437,8,43580,813
2020-10-17,Kenya,616,12,44196,825
2020-10-18,Kenya,685,7,44881,832
2020-10-19,Kenya,195,7,45076,839
2020-10-20,Kenya,571,3,45647,842
2020-10-21,Kenya,497,16,46144,858
2020-10-22,Kenya,1068,12,47212,870
2020-10-23,Kenya,631,14,47843,884
2020-10-24,Kenya,947,12,48790,896
2020-10-25,Kenya,931,6,49721,902
2020-10-26,Kenya,276,18,49997,920
2020-10-27,Kenya,836,14,50833,934
2020-10-28,Kenya,1018,0,51851,934
2020-10-29,Kenya,761,30,52612,964
2020-10-30,Kenya,1185,17,53797,981
2020-10-31,Kenya,1395,0,55192,981
2020-11-01,Kenya,685,32,55877,1013
2020-11-02,Kenya,724,14,56601,1027
2020-11-03,Kenya,492,12,57093,1039
2020-11-04,Kenya,1494,12,58587,1051
2020-11-05,Kenya,1008,21,59595,1072
2020-11-06,Kenya,1109,21,60704,1093
2020-11-07,Kenya,1065,10,61769,1103
2020-11-08,Kenya,719,8,62488,1111
2020-11-09,Kenya,756,19,63244,1130
2020-11-10,Kenya,1344,24,64588,1154
2020-11-11,Kenya,1216,26,65804,1180
2020-11-12,Kenya,919,23,66723,1203
2020-11-13,Kenya,1470,25,68193,1228
2020-11-14,Kenya,1080,0,69273,1228
2020-11-15,Kenya,972,41,70245,1269
2020-11-16,Kenya,559,18,70804,1287
2020-11-17,Kenya,925,15,71729,1302
2020-11-18,Kenya,957,11,72686,1313
2020-11-19,Kenya,1459,17,74145,1330
2020-11-20,Kenya,1048,19,75193,1349
2020-11-21,Kenya,1211,17,76404,1366
2020-11-22,Kenya,968,14,77372,1380
2020-11-23,Kenya,413,12,77785,1392
2020-11-24,Kenya,727,17,78512,1409
2020-11-25,Kenya,810,8,79322,1417
2020-11-26,Kenya,780,10,80102,1427
2020-11-27,Kenya,1554,14,81656,1441
2020-11-28,Kenya,949,4,82605,1445
2020-11-29,Kenya,711,7,83316,1452
2020-11-30,Kenya,302,17,83618,1469
2020-12-01,Kenya,551,5,84169,1474
2020-12-02,Kenya,961,10,85130,1484
2020-12-03,Kenya,1253,16,86383,1500
2020-12-04,Kenya,866,6,87249,1506
2020-12-05,Kenya,735,12,87984,1518
2020-12-06,Kenya,396,8,88380,1526
2020-12-07,Kenya,199,5,88579,1531
2020-12-08,Kenya,521,14,89100,1545
2020-12-09,Kenya,561,7,89661,1552
2020-12-10,Kenya,644,16,90305,1568
2020-12-11,Kenya,673,14,90978,1582
2020-12-12,Kenya,548,4,91526,1586
2020-12-13,Kenya,366,1,91892,1587
2020-12-14,Kenya,163,6,92055,1593
2020-12-15,Kenya,404,11,92459,1604
2020-12-16,Kenya,394,10,92853,1614
2020-12-17,Kenya,552,4,93405,1618
2020-12-18,Kenya,356,11,93761,1629
2020-12-19,Kenya,390,4,94151,1633
2020-12-20,Kenya,349,6,94500,1639
2020-12-21,Kenya,114,5,94614,1644
2020-12-22,Kenya,154,3,94768,1647
2020-12-23,Kenya,427,1,95195,1648
2020-12-24,Kenya,236,4,95431,1652
2020-12-25,Kenya,282,1,95713,1653
2020-12-26,Kenya,130,2,95843,1655
2020-12-27,Kenya,80,3,95923,1658
2020-12-28,Kenya,69,6,95992,1664
2020-12-29,Kenya,147,1,96139,1665
2020-12-30,Kenya,112,2,96251,1667
2020-12-31,Kenya,207,3,96458,1670
2021-01-01,Kenya,156,11,96614,1681
2021-01-02,Kenya,64,4,96678,1685
2021-01-03,Kenya,124,0,96802,1685
2021-01-04,Kenya,106,1,96908,1686
2021-01-05,Kenya,219,4,97127,1690
2021-01-06,Kenya,271,4,97398,1694
2021-01-07,Kenya,335,8,97733,1702
2021-01-08,Kenya,221,1,97954,1703
2021-01-09,Kenya,230,1,98184,1704
2021-01-10,Kenya,87,6,98271,1710
2021-01-11,Kenya,63,3,98334,1713
2021-01-12,Kenya,98,3,98432,1716
2021-01-13,Kenya,123,4,98555,1720
2021-01-14,Kenya,138,3,98693,1723
2021-01-15,Kenya,166,3,98859,1726
2021-01-16,Kenya,223,2,99082,1728
2021-01-17,Kenya,80,3,99162,1731
2021-01-18,Kenya,65,3,99227,1734
2021-01-19,Kenya,81,0,99308,1734
2021-01-20,Kenya,136,2,99444,1736
2021-01-21,Kenya,186,3,99630,1739
2021-01-22,Kenya,139,1,99769,1740
2021-01-23,Kenya,129,0,99898,1740
2021-01-24,Kenya,85,4,99983,1744
2021-01-25,Kenya,69,0,100052,1744
2021-01-26,Kenya,141,6,100193,1750
2021-01-27,Kenya,130,1,100323,1751
2021-01-28,Kenya,99,2,100422,1753
2021-01-29,Kenya,141,0,100563,1753
2021-01-30,Kenya,112,2,100675,1755
2021-01-31,Kenya,98,8,100773,1763
2021-02-01,Kenya,83,3,100856,1766
2021-02-02,Kenya,153,0,101009,1766
2021-02-03,Kenya,150,3,101159,1769
2021-02-04,Kenya,180,4,101339,1773
2021-02-05,Kenya,195,3,101534,1776
2021-02-06,Kenya,156,0,101690,1776
2021-02-07,Kenya,129,3,101819,1779
2021-02-08,Kenya,125,7,101944,1786
2021-02-09,Kenya,104,3,102048,1789
2021-02-10,Kenya,173,2,102221,1791
2021-02-11,Kenya,132,3,102353,1794
2021-02-12,Kenya,260,0,102613,1794
2021-02-13,Kenya,179,1,102792,1795
2021-02-14,Kenya,75,0,102867,1795
2021-02-15,Kenya,147,0,103014,1795
2021-02-16,Kenya,174,2,103188,1797
2021-02-17,Kenya,144,4,103332,1801
2021-02-18,Kenya,283,6,103615,1807
2021-02-19,Kenya,226,6,103841,1813
2021-02-20,Kenya,152,4,103993,1817
2021-02-21,Kenya,208,6,104201,1823
2021-02-22,Kenya,105,4,104306,1827
2021-02-23,Kenya,194,10,104500,1837
2021-02-24,Kenya,280,2,104780,1839
2021-02-25,Kenya,277,8,105057,1847
2021-02-26,Kenya,410,6,105467,1853
2021-02-27,Kenya,181,1,105648,1854
2021-02-28,Kenya,325,2,105973,1856
2021-03-01,Kenya,152,3,106125,1859
2021-03-02,Kenya,345,4,106470,1863
2021-03-03,Kenya,331,3,106801,1866
2021-03-04,Kenya,528,4,107329,1870
2021-03-05,Kenya,400,3,107729,1873
2021-03-06,Kenya,633,1,108362,1874
2021-03-07,Kenya,465,2,108827,1876
2021-03-08,Kenya,337,3,109164,1879
2021-03-09,Kenya,479,7,109643,1886
2021-03-10,Kenya,713,12,110356,1898
2021-03-11,Kenya,829,1,111185,1899
2021-03-12,Kenya,750,2,111935,1901
2021-03-13,Kenya,870,7,112805,1908
2021-03-14,Kenya,431,5,113236,1913
2021-03-15,Kenya,731,5,113967,1918
2021-03-16,Kenya,1064,7,115031,1925
2021-03-17,Kenya,1279,12,116310,1937
2021-03-18,Kenya,1225,17,117535,1954
2021-03-19,Kenya,1354,28,118889,1982
2021-03-20,Kenya,1274,12,120163,1994
2021-03-21,Kenya,747,17,120910,2011
2021-03-22,Kenya,1130,12,122040,2023
2021-03-23,Kenya,1127,25,123167,2048
2021-03-24,Kenya,1540,18,124707,2066
2021-03-25,Kenya,1463,26,126170,2092
2021-03-26,Kenya,2008,6,128178,2098
2021-03-27,Kenya,1152,6,129330,2104
2021-03-28,Kenya,884,13,130214,2117
2021-03-29,Kenya,902,18,131116,2135
2021-03-30,Kenya,1530,12,132646,2147
2021-03-31,Kenya,1412,6,134058,2153
2021-04-01,Kenya,984,14,135042,2167
2021-04-02,Kenya,1851,19,136893,2186
2021-04-03,Kenya,1184,20,138077,2206
2021-04-04,Kenya,911,18,138988,2224
2021-04-05,Kenya,460,20,139448,2244
2021-04-06,Kenya,394,14,139842,2258
2021-04-07,Kenya,1523,18,141365,2276
2021-04-08,Kenya,1698,16,143063,2292
2020-03-14,Kosovo,2,0,2,0
2020-03-15,Kosovo,3,0,5,0
2020-03-16,Kosovo,8,0,13,0
2020-03-17,Kosovo,3,0,16,0
2020-03-18,Kosovo,3,0,19,0
2020-03-19,Kosovo,1,0,20,0
2020-03-20,Kosovo,1,0,21,0
2020-03-21,Kosovo,3,0,24,0
2020-03-22,Kosovo,7,0,31,0
2020-03-23,Kosovo,2,1,33,1
2020-03-24,Kosovo,28,0,61,1
2020-03-25,Kosovo,2,0,63,1
2020-03-26,Kosovo,8,0,71,1
2020-03-27,Kosovo,15,0,86,1
2020-03-28,Kosovo,2,0,88,1
2020-03-29,Kosovo,3,0,91,1
2020-03-30,Kosovo,3,0,94,1
2020-03-31,Kosovo,12,0,106,1
2020-04-01,Kosovo,6,0,112,1
2020-04-02,Kosovo,13,0,125,1
2020-04-03,Kosovo,1,0,126,1
2020-04-04,Kosovo,9,0,135,1
2020-04-05,Kosovo,5,0,140,1
2020-04-06,Kosovo,5,0,145,1
2020-04-07,Kosovo,20,2,165,3
2020-04-08,Kosovo,19,2,184,5
2020-04-09,Kosovo,40,1,224,6
2020-04-10,Kosovo,3,1,227,7
2020-04-11,Kosovo,23,0,250,7
2020-04-12,Kosovo,33,0,283,7
2020-04-13,Kosovo,79,0,362,7
2020-04-14,Kosovo,15,1,377,8
2020-04-15,Kosovo,10,0,387,8
2020-04-16,Kosovo,36,1,423,9
2020-04-17,Kosovo,26,2,449,11
2020-04-18,Kosovo,31,1,480,12
2020-04-19,Kosovo,30,0,510,12
2020-04-20,Kosovo,51,0,561,12
2020-04-21,Kosovo,37,3,598,15
2020-04-22,Kosovo,6,3,604,18
2020-04-23,Kosovo,26,0,630,18
2020-04-24,Kosovo,39,1,669,19
2020-04-25,Kosovo,34,0,703,19
2020-04-26,Kosovo,28,1,731,20
2020-04-27,Kosovo,32,1,763,21
2020-04-28,Kosovo,17,1,780,22
2020-04-29,Kosovo,10,0,790,22
2020-04-30,Kosovo,9,0,799,22
2020-05-01,Kosovo,7,0,806,22
2020-05-02,Kosovo,7,0,813,22
2020-05-03,Kosovo,10,0,823,22
2020-05-04,Kosovo,28,0,851,22
2020-05-05,Kosovo,4,4,855,26
2020-05-06,Kosovo,1,0,856,26
2020-05-07,Kosovo,4,0,860,26
2020-05-08,Kosovo,1,1,861,27
2020-05-09,Kosovo,1,1,862,28
2020-05-10,Kosovo,8,0,870,28
2020-05-11,Kosovo,14,0,884,28
2020-05-12,Kosovo,11,0,895,28
2020-05-13,Kosovo,24,1,919,29
2020-05-14,Kosovo,8,0,927,29
2020-05-15,Kosovo,18,0,945,29
2020-05-16,Kosovo,10,0,955,29
2020-05-17,Kosovo,23,0,978,29
2020-05-18,Kosovo,7,0,985,29
2020-05-19,Kosovo,3,0,988,29
2020-05-20,Kosovo,1,0,989,29
2020-05-21,Kosovo,14,0,1003,29
2020-05-22,Kosovo,1,0,1004,29
2020-05-23,Kosovo,21,0,1025,29
2020-05-24,Kosovo,7,0,1032,29
2020-05-25,Kosovo,6,1,1038,30
2020-05-26,Kosovo,0,0,1038,30
2020-05-27,Kosovo,9,0,1047,30
2020-05-28,Kosovo,1,0,1048,30
2020-05-29,Kosovo,4,0,1052,30
2020-05-30,Kosovo,12,0,1064,30
2020-05-31,Kosovo,6,0,1070,30
2020-06-01,Kosovo,13,0,1083,30
2020-06-02,Kosovo,27,0,1110,30
2020-06-03,Kosovo,13,0,1123,30
2020-06-04,Kosovo,19,0,1142,30
2020-06-05,Kosovo,5,0,1147,30
2020-06-06,Kosovo,11,0,1158,30
2020-06-07,Kosovo,36,0,1194,30
2020-06-08,Kosovo,40,1,1234,31
2020-06-09,Kosovo,29,0,1263,31
2020-06-10,Kosovo,6,0,1269,31
2020-06-11,Kosovo,29,0,1298,31
2020-06-12,Kosovo,28,0,1326,31
2020-06-13,Kosovo,58,0,1384,31
2020-06-14,Kosovo,53,1,1437,32
2020-06-15,Kosovo,49,1,1486,33
2020-06-16,Kosovo,129,0,1615,33
2020-06-17,Kosovo,141,1,1756,34
2020-06-18,Kosovo,77,0,1833,34
2020-06-19,Kosovo,83,0,1916,34
2020-06-20,Kosovo,82,0,1998,34
2020-06-21,Kosovo,75,1,2073,35
2020-06-22,Kosovo,96,1,2169,36
2020-06-23,Kosovo,47,1,2216,37
2020-06-24,Kosovo,52,1,2268,38
2020-06-25,Kosovo,95,2,2363,40
2020-06-26,Kosovo,69,2,2432,42
2020-06-27,Kosovo,62,2,2494,44
2020-06-28,Kosovo,96,4,2590,48
2020-06-29,Kosovo,87,1,2677,49
2020-06-30,Kosovo,122,0,2799,49
2020-07-01,Kosovo,79,2,2878,51
2020-07-02,Kosovo,113,3,2991,54
2020-07-03,Kosovo,73,1,3064,55
2020-07-04,Kosovo,114,3,3178,58
2020-07-05,Kosovo,178,8,3356,66
2020-07-06,Kosovo,152,9,3508,75
2020-07-07,Kosovo,195,4,3703,79
2020-07-08,Kosovo,183,3,3886,82
2020-07-09,Kosovo,214,4,4100,86
2020-07-10,Kosovo,207,8,4307,94
2020-07-11,Kosovo,205,3,4512,97
2020-07-12,Kosovo,203,4,4715,101
2020-07-13,Kosovo,216,1,4931,102
2020-07-14,Kosovo,187,6,5118,108
2020-07-15,Kosovo,119,4,5237,112
2020-07-16,Kosovo,132,6,5369,118
2020-07-17,Kosovo,103,6,5472,124
2020-07-18,Kosovo,145,6,5617,130
2020-07-19,Kosovo,118,5,5735,135
2020-07-20,Kosovo,142,4,5877,139
2020-07-21,Kosovo,168,5,6045,144
2020-07-22,Kosovo,241,6,6286,150
2020-07-23,Kosovo,181,8,6467,158
2020-07-24,Kosovo,213,6,6680,164
2020-07-25,Kosovo,237,5,6917,169
2020-07-26,Kosovo,220,8,7137,177
2020-07-27,Kosovo,276,8,7413,185
2020-07-28,Kosovo,239,7,7652,192
2020-07-29,Kosovo,194,4,7846,196
2020-07-30,Kosovo,258,16,8104,212
2020-07-31,Kosovo,226,15,8330,227
2020-08-01,Kosovo,224,9,8554,236
2020-08-02,Kosovo,245,13,8799,249
2020-08-03,Kosovo,250,7,9049,256
2020-08-04,Kosovo,225,13,9274,269
2020-08-05,Kosovo,218,15,9492,284
2020-08-06,Kosovo,196,16,9688,300
2020-08-07,Kosovo,181,3,9869,303
2020-08-08,Kosovo,190,13,10059,316
2020-08-09,Kosovo,188,12,10247,328
2020-08-10,Kosovo,172,13,10419,341
2020-08-11,Kosovo,171,13,10590,354
2020-08-12,Kosovo,205,11,10795,365
2020-08-13,Kosovo,193,8,10988,373
2020-08-14,Kosovo,142,8,11130,381
2020-08-15,Kosovo,145,9,11275,390
2020-08-16,Kosovo,141,11,11416,401
2020-08-17,Kosovo,129,9,11545,410
2020-08-18,Kosovo,141,6,11686,416
2020-08-19,Kosovo,162,9,11848,425
2020-08-20,Kosovo,158,13,12006,438
2020-08-21,Kosovo,162,10,12168,448
2020-08-22,Kosovo,169,9,12337,457
2020-08-23,Kosovo,111,10,12448,467
2020-08-24,Kosovo,99,13,12547,480
2020-08-25,Kosovo,136,8,12683,488
2020-08-26,Kosovo,157,4,12840,492
2020-08-27,Kosovo,141,6,12981,498
2020-08-28,Kosovo,119,1,13100,499
2020-08-29,Kosovo,115,9,13215,508
2020-08-30,Kosovo,119,8,13334,516
2020-08-31,Kosovo,120,9,13454,525
2020-09-01,Kosovo,147,8,13601,533
2020-09-02,Kosovo,112,6,13713,539
2020-09-03,Kosovo,78,9,13791,548
2020-09-04,Kosovo,119,3,13910,551
2020-09-05,Kosovo,117,5,14027,556
2020-09-06,Kosovo,92,7,14119,563
2020-09-07,Kosovo,85,5,14204,568
2020-09-08,Kosovo,97,0,14301,568
2020-09-09,Kosovo,76,6,14377,574
2020-09-10,Kosovo,69,7,14446,581
2020-09-11,Kosovo,50,5,14496,586
2020-09-12,Kosovo,70,3,14566,589
2020-09-13,Kosovo,71,7,14637,596
2020-09-14,Kosovo,55,4,14692,600
2020-09-15,Kosovo,71,1,14763,601
2020-09-16,Kosovo,76,3,14839,604
2020-09-17,Kosovo,43,3,14882,607
2020-09-18,Kosovo,57,4,14939,611
2020-09-19,Kosovo,63,3,15002,614
2020-09-20,Kosovo,61,0,15063,614
2020-09-21,Kosovo,79,1,15142,615
2020-09-22,Kosovo,66,0,15208,615
2020-09-23,Kosovo,62,1,15270,616
2020-09-24,Kosovo,63,0,15333,616
2020-09-25,Kosovo,46,1,15379,617
2020-09-26,Kosovo,46,2,15425,619
2020-09-27,Kosovo,47,3,15472,622
2020-09-28,Kosovo,48,3,15520,625
2020-09-29,Kosovo,54,0,15574,625
2020-09-30,Kosovo,46,0,15620,625
2020-10-01,Kosovo,43,2,15663,627
2020-10-02,Kosovo,42,0,15705,627
2020-10-03,Kosovo,53,3,15758,630
2020-10-04,Kosovo,56,0,15814,630
2020-10-05,Kosovo,41,3,15855,633
2020-10-06,Kosovo,34,2,15889,635
2020-10-07,Kosovo,49,3,15938,638
2020-10-08,Kosovo,33,0,15971,638
2020-10-09,Kosovo,79,3,16050,641
2020-10-10,Kosovo,80,4,16130,645
2020-10-11,Kosovo,49,2,16179,647
2020-10-12,Kosovo,68,1,16247,648
2020-10-13,Kosovo,98,1,16345,649
2020-10-14,Kosovo,80,1,16425,650
2020-10-15,Kosovo,77,0,16502,650
2020-10-16,Kosovo,104,2,16606,652
2020-10-17,Kosovo,148,0,16754,652
2020-10-18,Kosovo,137,1,16891,653
2020-10-19,Kosovo,118,3,17009,656
2020-10-20,Kosovo,130,1,17139,657
2020-10-21,Kosovo,124,0,17263,657
2020-10-22,Kosovo,159,0,17422,657
2020-10-23,Kosovo,169,2,17591,659
2020-10-24,Kosovo,166,2,17757,661
2020-10-25,Kosovo,186,2,17943,663
2020-10-26,Kosovo,0,0,17943,663
2020-10-27,Kosovo,0,0,17943,663
2020-10-28,Kosovo,683,10,18626,673
2020-10-29,Kosovo,0,0,18626,673
2020-10-30,Kosovo,702,5,19328,678
2020-10-31,Kosovo,0,0,19328,678
2020-11-01,Kosovo,0,0,19328,678
2020-11-02,Kosovo,851,10,20179,688
2020-11-03,Kosovo,820,17,20999,705
2020-11-04,Kosovo,546,9,21545,714
2020-11-05,Kosovo,661,6,22206,720
2020-11-06,Kosovo,728,12,22934,732
2020-11-07,Kosovo,0,0,22934,732
2020-11-08,Kosovo,0,0,22934,732
2020-11-09,Kosovo,1858,36,24792,768
2020-11-10,Kosovo,596,5,25388,773
2020-11-11,Kosovo,733,4,26121,777
2020-11-12,Kosovo,767,8,26888,785
2020-11-13,Kosovo,963,13,27851,798
2020-11-14,Kosovo,0,0,27851,798
2020-11-15,Kosovo,1266,24,29117,822
2020-11-16,Kosovo,688,11,29805,833
2020-11-17,Kosovo,0,0,29805,833
2020-11-18,Kosovo,1410,27,31215,860
2020-11-19,Kosovo,807,14,32022,874
2020-11-20,Kosovo,855,11,32877,885
2020-11-21,Kosovo,711,19,33588,904
2020-11-22,Kosovo,707,10,34295,914
2020-11-23,Kosovo,645,12,34940,926
2020-11-24,Kosovo,609,13,35549,939
2020-11-25,Kosovo,704,9,36253,948
2020-11-26,Kosovo,775,15,37028,963
2020-11-27,Kosovo,764,12,37792,975
2020-11-28,Kosovo,639,14,38431,989
2020-11-29,Kosovo,626,16,39057,1005
2020-11-30,Kosovo,539,11,39596,1016
2020-12-01,Kosovo,521,10,40117,1026
2020-12-02,Kosovo,0,0,40117,1026
2020-12-03,Kosovo,0,0,40117,1026
2020-12-04,Kosovo,0,0,40117,1026
2020-12-05,Kosovo,2220,61,42337,1087
2020-12-06,Kosovo,468,19,42805,1106
2020-12-07,Kosovo,519,14,43324,1120
2020-12-08,Kosovo,557,17,43881,1137
2020-12-09,Kosovo,561,11,44442,1148
2020-12-10,Kosovo,562,13,45004,1161
2020-12-11,Kosovo,590,13,45594,1174
2020-12-12,Kosovo,524,12,46118,1186
2020-12-13,Kosovo,462,12,46580,1198
2020-12-14,Kosovo,329,5,46909,1203
2020-12-15,Kosovo,294,17,47203,1220
2020-12-16,Kosovo,296,5,47499,1225
2020-12-17,Kosovo,0,0,47499,1225
2020-12-18,Kosovo,838,15,48337,1240
2020-12-19,Kosovo,345,8,48682,1248
2020-12-20,Kosovo,223,8,48905,1256
2020-12-21,Kosovo,264,6,49169,1262
2020-12-22,Kosovo,0,0,49169,1262
2020-12-23,Kosovo,271,12,49440,1274
2020-12-24,Kosovo,0,0,49440,1274
2020-12-25,Kosovo,695,24,50135,1298
2020-12-26,Kosovo,270,7,50405,1305
2020-12-27,Kosovo,215,4,50620,1309
2020-12-28,Kosovo,181,8,50801,1317
2020-12-29,Kosovo,109,8,50910,1325
2020-12-30,Kosovo,0,0,50910,1325
2020-12-31,Kosovo,234,7,51144,1332
2021-01-01,Kosovo,358,4,51502,1336
2021-01-02,Kosovo,0,0,51502,1336
2021-01-03,Kosovo,463,8,51965,1344
2021-01-04,Kosovo,0,0,51965,1344
2021-01-05,Kosovo,368,11,52333,1355
2021-01-06,Kosovo,0,0,52333,1355
2021-01-07,Kosovo,610,8,52943,1363
2021-01-08,Kosovo,321,5,53264,1368
2021-01-09,Kosovo,0,0,53264,1368
2021-01-10,Kosovo,512,9,53776,1377
2021-01-11,Kosovo,206,6,53982,1383
2021-01-12,Kosovo,279,4,54261,1387
2021-01-13,Kosovo,299,1,54560,1388
2021-01-14,Kosovo,279,4,54839,1392
2021-01-15,Kosovo,296,7,55135,1399
2021-01-16,Kosovo,0,0,55135,1399
2021-01-17,Kosovo,716,11,55851,1410
2021-01-18,Kosovo,0,0,55851,1410
2021-01-19,Kosovo,267,1,56118,1411
2021-01-20,Kosovo,294,9,56412,1420
2021-01-21,Kosovo,616,13,57028,1433
2021-01-22,Kosovo,289,14,57317,1447
2021-01-23,Kosovo,0,0,57317,1447
2021-01-24,Kosovo,0,0,57317,1447
2021-01-25,Kosovo,1082,19,58399,1466
2021-01-26,Kosovo,0,0,58399,1466
2021-01-27,Kosovo,589,13,58988,1479
2021-01-28,Kosovo,0,0,58988,1479
2021-01-29,Kosovo,658,8,59646,1487
2021-01-30,Kosovo,0,0,59646,1487
2021-01-31,Kosovo,572,11,60218,1498
2021-02-01,Kosovo,0,0,60218,1498
2021-02-02,Kosovo,0,0,60218,1498
2021-02-03,Kosovo,868,11,61086,1509
2021-02-04,Kosovo,318,5,61404,1514
2021-02-05,Kosovo,284,5,61688,1519
2021-02-06,Kosovo,0,0,61688,1519
2021-02-07,Kosovo,0,0,61688,1519
2021-02-08,Kosovo,860,7,62548,1526
2021-02-09,Kosovo,0,0,62548,1526
2021-02-10,Kosovo,541,6,63089,1532
2021-02-11,Kosovo,0,0,63089,1532
2021-02-12,Kosovo,716,8,63805,1540
2021-02-13,Kosovo,0,0,63805,1540
2021-02-14,Kosovo,0,0,63805,1540
2021-02-15,Kosovo,814,5,64619,1545
2021-02-16,Kosovo,249,3,64868,1548
2021-02-17,Kosovo,0,0,64868,1548
2021-02-18,Kosovo,297,5,65165,1553
2021-02-19,Kosovo,285,5,65450,1558
2021-02-20,Kosovo,0,0,65450,1558
2021-02-21,Kosovo,1030,14,66480,1572
2021-02-22,Kosovo,0,0,66480,1572
2021-02-23,Kosovo,260,3,66740,1575
2021-02-24,Kosovo,829,7,67569,1582
2021-02-25,Kosovo,437,5,68006,1587
2021-02-26,Kosovo,445,5,68451,1592
2021-02-27,Kosovo,0,0,68451,1592
2021-02-28,Kosovo,0,0,68451,1592
2021-03-01,Kosovo,0,0,68451,1592
2021-03-02,Kosovo,1834,24,70285,1616
2021-03-03,Kosovo,568,4,70853,1620
2021-03-04,Kosovo,0,0,70853,1620
2021-03-05,Kosovo,591,7,71444,1627
2021-03-06,Kosovo,1156,13,72600,1640
2021-03-07,Kosovo,0,0,72600,1640
2021-03-08,Kosovo,1135,15,73735,1655
2021-03-09,Kosovo,0,0,73735,1655
2021-03-10,Kosovo,973,19,74708,1674
2021-03-11,Kosovo,0,0,74708,1674
2021-03-12,Kosovo,1362,14,76070,1688
2021-03-13,Kosovo,0,0,76070,1688
2021-03-14,Kosovo,0,0,76070,1688
2021-03-15,Kosovo,1717,27,77787,1715
2021-03-16,Kosovo,553,8,78340,1723
2021-03-17,Kosovo,0,0,78340,1723
2021-03-18,Kosovo,0,0,78340,1723
2021-03-19,Kosovo,1955,29,80295,1752
2021-03-20,Kosovo,0,0,80295,1752
2021-03-21,Kosovo,0,0,80295,1752
2021-03-22,Kosovo,0,0,80295,1752
2021-03-23,Kosovo,0,0,80295,1752
2021-03-24,Kosovo,3877,59,84172,1811
2021-03-25,Kosovo,0,0,84172,1811
2021-03-26,Kosovo,0,0,84172,1811
2021-03-27,Kosovo,0,0,84172,1811
2021-03-28,Kosovo,0,0,84172,1811
2021-03-29,Kosovo,4257,41,88429,1852
2021-03-30,Kosovo,752,14,89181,1866
2021-03-31,Kosovo,0,0,89181,1866
2021-04-01,Kosovo,1898,26,91079,1892
2021-04-02,Kosovo,0,0,91079,1892
2021-04-03,Kosovo,0,0,91079,1892
2021-04-04,Kosovo,0,0,91079,1892
2021-04-05,Kosovo,0,0,91079,1892
2021-04-06,Kosovo,3251,50,94330,1942
2021-04-07,Kosovo,685,14,95015,1956
2021-04-08,Kosovo,871,12,95886,1968
2020-02-24,Kuwait,1,0,1,0
2020-02-25,Kuwait,10,0,11,0
2020-02-26,Kuwait,15,0,26,0
2020-02-27,Kuwait,17,0,43,0
2020-02-28,Kuwait,2,0,45,0
2020-02-29,Kuwait,0,0,45,0
2020-03-01,Kuwait,0,0,45,0
2020-03-02,Kuwait,11,0,56,0
2020-03-03,Kuwait,0,0,56,0
2020-03-04,Kuwait,0,0,56,0
2020-03-05,Kuwait,2,0,58,0
2020-03-06,Kuwait,0,0,58,0
2020-03-07,Kuwait,3,0,61,0
2020-03-08,Kuwait,3,0,64,0
2020-03-09,Kuwait,0,0,64,0
2020-03-10,Kuwait,5,0,69,0
2020-03-11,Kuwait,3,0,72,0
2020-03-12,Kuwait,8,0,80,0
2020-03-13,Kuwait,0,0,80,0
2020-03-14,Kuwait,24,0,104,0
2020-03-15,Kuwait,8,0,112,0
2020-03-16,Kuwait,11,0,123,0
2020-03-17,Kuwait,7,0,130,0
2020-03-18,Kuwait,12,0,142,0
2020-03-19,Kuwait,6,0,148,0
2020-03-20,Kuwait,11,0,159,0
2020-03-21,Kuwait,17,0,176,0
2020-03-22,Kuwait,12,0,188,0
2020-03-23,Kuwait,1,0,189,0
2020-03-24,Kuwait,2,0,191,0
2020-03-25,Kuwait,4,0,195,0
2020-03-26,Kuwait,13,0,208,0
2020-03-27,Kuwait,17,0,225,0
2020-03-28,Kuwait,10,0,235,0
2020-03-29,Kuwait,20,0,255,0
2020-03-30,Kuwait,11,0,266,0
2020-03-31,Kuwait,23,0,289,0
2020-04-01,Kuwait,28,0,317,0
2020-04-02,Kuwait,25,0,342,0
2020-04-03,Kuwait,75,0,417,0
2020-04-04,Kuwait,62,1,479,1
2020-04-05,Kuwait,77,0,556,1
2020-04-06,Kuwait,109,0,665,1
2020-04-07,Kuwait,78,0,743,1
2020-04-08,Kuwait,112,0,855,1
2020-04-09,Kuwait,55,0,910,1
2020-04-10,Kuwait,83,0,993,1
2020-04-11,Kuwait,161,0,1154,1
2020-04-12,Kuwait,80,0,1234,1
2020-04-13,Kuwait,66,1,1300,2
2020-04-14,Kuwait,55,1,1355,3
2020-04-15,Kuwait,50,0,1405,3
2020-04-16,Kuwait,119,0,1524,3
2020-04-17,Kuwait,134,2,1658,5
2020-04-18,Kuwait,93,1,1751,6
2020-04-19,Kuwait,164,1,1915,7
2020-04-20,Kuwait,80,2,1995,9
2020-04-21,Kuwait,85,2,2080,11
2020-04-22,Kuwait,168,2,2248,13
2020-04-23,Kuwait,151,1,2399,14
2020-04-24,Kuwait,215,1,2614,15
2020-04-25,Kuwait,278,4,2892,19
2020-04-26,Kuwait,183,1,3075,20
2020-04-27,Kuwait,213,2,3288,22
2020-04-28,Kuwait,152,1,3440,23
2020-04-29,Kuwait,300,1,3740,24
2020-04-30,Kuwait,284,2,4024,26
2020-05-01,Kuwait,353,4,4377,30
2020-05-02,Kuwait,242,3,4619,33
2020-05-03,Kuwait,364,5,4983,38
2020-05-04,Kuwait,295,2,5278,40
2020-05-05,Kuwait,526,0,5804,40
2020-05-06,Kuwait,485,2,6289,42
2020-05-07,Kuwait,278,2,6567,44
2020-05-08,Kuwait,641,3,7208,47
2020-05-09,Kuwait,415,2,7623,49
2020-05-10,Kuwait,1065,9,8688,58
2020-05-11,Kuwait,598,7,9286,65
2020-05-12,Kuwait,991,10,10277,75
2020-05-13,Kuwait,751,7,11028,82
2020-05-14,Kuwait,947,6,11975,88
2020-05-15,Kuwait,885,8,12860,96
2020-05-16,Kuwait,942,11,13802,107
2020-05-17,Kuwait,1048,5,14850,112
2020-05-18,Kuwait,841,6,15691,118
2020-05-19,Kuwait,1073,3,16764,121
2020-05-20,Kuwait,804,3,17568,124
2020-05-21,Kuwait,1041,5,18609,129
2020-05-22,Kuwait,955,9,19564,138
2020-05-23,Kuwait,900,10,20464,148
2020-05-24,Kuwait,838,8,21302,156
2020-05-25,Kuwait,665,9,21967,165
2020-05-26,Kuwait,608,7,22575,172
2020-05-27,Kuwait,692,3,23267,175
2020-05-28,Kuwait,845,10,24112,185
2020-05-29,Kuwait,1072,9,25184,194
2020-05-30,Kuwait,1008,11,26192,205
2020-05-31,Kuwait,851,7,27043,212
2020-06-01,Kuwait,719,8,27762,220
2020-06-02,Kuwait,887,6,28649,226
2020-06-03,Kuwait,710,4,29359,230
2020-06-04,Kuwait,562,6,29921,236
2020-06-05,Kuwait,723,8,30644,244
2020-06-06,Kuwait,487,10,31131,254
2020-06-07,Kuwait,717,10,31848,264
2020-06-08,Kuwait,662,5,32510,269
2020-06-09,Kuwait,630,4,33140,273
2020-06-10,Kuwait,683,2,33823,275
2020-06-11,Kuwait,609,4,34432,279
2020-06-12,Kuwait,520,6,34952,285
2020-06-13,Kuwait,514,4,35466,289
2020-06-14,Kuwait,454,7,35920,296
2020-06-15,Kuwait,511,2,36431,298
2020-06-16,Kuwait,527,5,36958,303
2020-06-17,Kuwait,575,3,37533,306
2020-06-18,Kuwait,541,2,38074,308
2020-06-19,Kuwait,604,5,38678,313
2020-06-20,Kuwait,467,6,39145,319
2020-06-21,Kuwait,505,7,39650,326
2020-06-22,Kuwait,641,4,40291,330
2020-06-23,Kuwait,742,4,41033,334
2020-06-24,Kuwait,846,3,41879,337
2020-06-25,Kuwait,909,2,42788,339
2020-06-26,Kuwait,915,2,43703,341
2020-06-27,Kuwait,688,3,44391,344
2020-06-28,Kuwait,551,4,44942,348
2020-06-29,Kuwait,582,2,45524,350
2020-06-30,Kuwait,671,4,46195,354
2020-07-01,Kuwait,745,4,46940,358
2020-07-02,Kuwait,919,1,47859,359
2020-07-03,Kuwait,813,1,48672,360
2020-07-04,Kuwait,631,5,49303,365
2020-07-05,Kuwait,638,3,49941,368
2020-07-06,Kuwait,703,5,50644,373
2020-07-07,Kuwait,601,4,51245,377
2020-07-08,Kuwait,762,2,52007,379
2020-07-09,Kuwait,833,3,52840,382
2020-07-10,Kuwait,740,1,53580,383
2020-07-11,Kuwait,478,3,54058,386
2020-07-12,Kuwait,836,4,54894,390
2020-07-13,Kuwait,614,3,55508,393
2020-07-14,Kuwait,666,3,56174,396
2020-07-15,Kuwait,703,3,56877,399
2020-07-16,Kuwait,791,3,57668,402
2020-07-17,Kuwait,553,2,58221,404
2020-07-18,Kuwait,683,3,58904,407
2020-07-19,Kuwait,300,1,59204,408
2020-07-20,Kuwait,559,0,59763,408
2020-07-21,Kuwait,671,4,60434,412
2020-07-22,Kuwait,751,5,61185,417
2020-07-23,Kuwait,687,4,61872,421
2020-07-24,Kuwait,753,4,62625,425
2020-07-25,Kuwait,684,4,63309,429
2020-07-26,Kuwait,464,4,63773,433
2020-07-27,Kuwait,606,5,64379,438
2020-07-28,Kuwait,770,4,65149,442
2020-07-29,Kuwait,754,2,65903,444
2020-07-30,Kuwait,626,1,66529,445
2020-07-31,Kuwait,428,2,66957,447
2020-08-01,Kuwait,491,6,67448,453
2020-08-02,Kuwait,463,4,67911,457
2020-08-03,Kuwait,388,4,68299,461
2020-08-04,Kuwait,475,4,68774,465
2020-08-05,Kuwait,651,3,69425,468
2020-08-06,Kuwait,620,1,70045,469
2020-08-07,Kuwait,682,2,70727,471
2020-08-08,Kuwait,472,3,71199,474
2020-08-09,Kuwait,514,4,71713,478
2020-08-10,Kuwait,687,4,72400,482
2020-08-11,Kuwait,668,4,73068,486
2020-08-12,Kuwait,717,3,73785,489
2020-08-13,Kuwait,701,0,74486,489
2020-08-14,Kuwait,699,5,75185,494
2020-08-15,Kuwait,512,4,75697,498
2020-08-16,Kuwait,508,3,76205,501
2020-08-17,Kuwait,622,1,76827,502
2020-08-18,Kuwait,643,3,77470,505
2020-08-19,Kuwait,675,2,78145,507
2020-08-20,Kuwait,622,2,78767,509
2020-08-21,Kuwait,502,2,79269,511
2020-08-22,Kuwait,688,2,79957,513
2020-08-23,Kuwait,571,2,80528,515
2020-08-24,Kuwait,432,3,80960,518
2020-08-25,Kuwait,613,1,81573,519
2020-08-26,Kuwait,698,2,82271,521
2020-08-27,Kuwait,674,1,82945,522
2020-08-28,Kuwait,633,3,83578,525
2020-08-29,Kuwait,646,3,84224,528
2020-08-30,Kuwait,412,2,84636,530
2020-08-31,Kuwait,473,1,85109,531
2020-09-01,Kuwait,702,3,85811,534
2020-09-02,Kuwait,667,1,86478,535
2020-09-03,Kuwait,900,1,87378,536
2020-09-04,Kuwait,865,1,88243,537
2020-09-05,Kuwait,720,3,88963,540
2020-09-06,Kuwait,619,4,89582,544
2020-09-07,Kuwait,805,2,90387,546
2020-09-08,Kuwait,857,2,91244,548
2020-09-09,Kuwait,838,4,92082,552
2020-09-10,Kuwait,740,4,92822,556
2020-09-11,Kuwait,653,1,93475,557
2020-09-12,Kuwait,736,1,94211,558
2020-09-13,Kuwait,553,2,94764,560
2020-09-14,Kuwait,708,3,95472,563
2020-09-15,Kuwait,829,5,96301,568
2020-09-16,Kuwait,698,3,96999,571
2020-09-17,Kuwait,825,4,97824,575
2020-09-18,Kuwait,704,5,98528,580
2020-09-19,Kuwait,521,1,99049,581
2020-09-20,Kuwait,385,3,99434,584
2020-09-21,Kuwait,530,1,99964,585
2020-09-22,Kuwait,719,3,100683,588
2020-09-23,Kuwait,616,2,101299,590
2020-09-24,Kuwait,552,2,101851,592
2020-09-25,Kuwait,590,3,102441,595
2020-09-26,Kuwait,758,2,103199,597
2020-09-27,Kuwait,345,4,103544,601
2020-09-28,Kuwait,437,4,103981,605
2020-09-29,Kuwait,587,2,104568,607
2020-09-30,Kuwait,614,3,105182,610
2020-10-01,Kuwait,494,2,105676,612
2020-10-02,Kuwait,411,3,106087,615
2020-10-03,Kuwait,371,5,106458,620
2020-10-04,Kuwait,567,4,107025,624
2020-10-05,Kuwait,567,4,107592,628
2020-10-06,Kuwait,676,4,108268,632
2020-10-07,Kuwait,475,7,108743,639
2020-10-08,Kuwait,698,3,109441,642
2020-10-09,Kuwait,635,7,110076,649
2020-10-10,Kuwait,492,6,110568,655
2020-10-11,Kuwait,548,3,111116,658
2020-10-12,Kuwait,777,6,111893,664
2020-10-13,Kuwait,844,8,112737,672
2020-10-14,Kuwait,532,4,113269,676
2020-10-15,Kuwait,746,8,114015,684
2020-10-16,Kuwait,729,6,114744,690
2020-10-17,Kuwait,739,4,115483,694
2020-10-18,Kuwait,663,7,116146,701
2020-10-19,Kuwait,686,9,116832,710
2020-10-20,Kuwait,886,4,117718,714
2020-10-21,Kuwait,813,7,118531,721
2020-10-22,Kuwait,889,9,119420,730
2020-10-23,Kuwait,812,10,120232,740
2020-10-24,Kuwait,695,4,120927,744
2020-10-25,Kuwait,708,2,121635,746
2020-10-26,Kuwait,682,3,122317,749
2020-10-27,Kuwait,775,7,123092,756
2020-10-28,Kuwait,814,7,123906,763
2020-10-29,Kuwait,760,4,124666,767
2020-10-30,Kuwait,671,6,125337,773
2020-10-31,Kuwait,589,6,125926,779
2020-11-01,Kuwait,608,3,126534,782
2020-11-02,Kuwait,759,4,127293,786
2020-11-03,Kuwait,787,3,128080,789
2020-11-04,Kuwait,763,5,128843,794
2020-11-05,Kuwait,795,5,129638,799
2020-11-06,Kuwait,825,5,130463,804
2020-11-07,Kuwait,742,4,131205,808
2020-11-08,Kuwait,538,3,131743,811
2020-11-09,Kuwait,735,5,132478,816
2020-11-10,Kuwait,903,5,133381,821
2020-11-11,Kuwait,778,5,134159,826
2020-11-12,Kuwait,773,4,134932,830
2020-11-13,Kuwait,718,3,135650,833
2020-11-14,Kuwait,691,2,136341,835
2020-11-15,Kuwait,499,3,136840,838
2020-11-16,Kuwait,489,4,137329,842
2020-11-17,Kuwait,556,6,137885,848
2020-11-18,Kuwait,452,9,138337,857
2020-11-19,Kuwait,485,2,138822,859
2020-11-20,Kuwait,486,2,139308,861
2020-11-21,Kuwait,426,2,139734,863
2020-11-22,Kuwait,322,3,140056,866
2020-11-23,Kuwait,337,2,140393,868
2020-11-24,Kuwait,402,2,140795,870
2020-11-25,Kuwait,422,1,141217,871
2020-11-26,Kuwait,330,1,141547,872
2020-11-27,Kuwait,329,2,141876,874
2020-11-28,Kuwait,319,1,142195,875
2020-11-29,Kuwait,231,3,142426,878
2020-11-30,Kuwait,209,2,142635,880
2020-12-01,Kuwait,357,1,142992,881
2020-12-02,Kuwait,268,1,143260,882
2020-12-03,Kuwait,314,2,143574,884
2020-12-04,Kuwait,343,2,143917,886
2020-12-05,Kuwait,247,3,144164,889
2020-12-06,Kuwait,205,2,144369,891
2020-12-07,Kuwait,230,6,144599,897
2020-12-08,Kuwait,301,3,144900,900
2020-12-09,Kuwait,304,5,145204,905
2020-12-10,Kuwait,291,5,145495,910
2020-12-11,Kuwait,294,0,145789,910
2020-12-12,Kuwait,255,1,146044,911
2020-12-13,Kuwait,174,0,146218,911
2020-12-14,Kuwait,231,1,146449,912
2020-12-15,Kuwait,261,1,146710,913
2020-12-16,Kuwait,261,0,146971,913
2020-12-17,Kuwait,221,0,147192,913
2020-12-18,Kuwait,339,3,147531,916
2020-12-19,Kuwait,244,2,147775,918
2020-12-20,Kuwait,204,3,147979,921
2020-12-21,Kuwait,230,1,148209,922
2020-12-22,Kuwait,298,1,148507,923
2020-12-23,Kuwait,266,1,148773,924
2020-12-24,Kuwait,244,2,149017,926
2020-12-25,Kuwait,260,0,149277,926
2020-12-26,Kuwait,172,3,149449,929
2020-12-27,Kuwait,204,2,149653,931
2020-12-28,Kuwait,204,1,149857,932
2020-12-29,Kuwait,236,0,150093,932
2020-12-30,Kuwait,205,1,150298,933
2020-12-31,Kuwait,286,1,150584,934
2021-01-01,Kuwait,285,2,150869,936
2021-01-02,Kuwait,205,1,151074,937
2021-01-03,Kuwait,269,0,151343,937
2021-01-04,Kuwait,372,1,151715,938
2021-01-05,Kuwait,312,0,152027,938
2021-01-06,Kuwait,411,0,152438,938
2021-01-07,Kuwait,540,0,152978,938
2021-01-08,Kuwait,495,2,153473,940
2021-01-09,Kuwait,427,2,153900,942
2021-01-10,Kuwait,414,1,154314,943
2021-01-11,Kuwait,527,2,154841,945
2021-01-12,Kuwait,494,1,155335,946
2021-01-13,Kuwait,539,0,155874,946
2021-01-14,Kuwait,560,0,156434,946
2021-01-15,Kuwait,530,1,156964,947
2021-01-16,Kuwait,435,0,157399,947
2021-01-17,Kuwait,378,0,157777,947
2021-01-18,Kuwait,467,1,158244,948
2021-01-19,Kuwait,578,2,158822,950
2021-01-20,Kuwait,442,1,159264,951
2021-01-21,Kuwait,570,0,159834,951
2021-01-22,Kuwait,533,1,160367,952
2021-01-23,Kuwait,534,0,160901,952
2021-01-24,Kuwait,384,0,161285,952
2021-01-25,Kuwait,492,2,161777,954
2021-01-26,Kuwait,505,3,162282,957
2021-01-27,Kuwait,580,0,162862,957
2021-01-28,Kuwait,588,1,163450,958
2021-01-29,Kuwait,658,0,164108,958
2021-01-30,Kuwait,514,1,164622,959
2021-01-31,Kuwait,635,0,165257,959
2021-02-01,Kuwait,586,0,165843,959
2021-02-02,Kuwait,811,1,166654,960
2021-02-03,Kuwait,756,1,167410,961
2021-02-04,Kuwait,840,1,168250,962
2021-02-05,Kuwait,940,2,169190,964
2021-02-06,Kuwait,846,0,170036,964
2021-02-07,Kuwait,962,2,170998,966
2021-02-08,Kuwait,996,3,171994,969
2021-02-09,Kuwait,1002,6,172996,975
2021-02-10,Kuwait,987,5,173983,980
2021-02-11,Kuwait,1048,5,175031,985
2021-02-12,Kuwait,1021,7,176052,992
2021-02-13,Kuwait,851,6,176903,998
2021-02-14,Kuwait,798,5,177701,1003
2021-02-15,Kuwait,823,6,178524,1009
2021-02-16,Kuwait,964,5,179488,1014
2021-02-17,Kuwait,1017,5,180505,1019
2021-02-18,Kuwait,979,8,181484,1027
2021-02-19,Kuwait,976,7,182460,1034
2021-02-20,Kuwait,862,5,183322,1039
2021-02-21,Kuwait,768,5,184090,1044
2021-02-22,Kuwait,899,5,184989,1049
2021-02-23,Kuwait,1015,8,186004,1057
2021-02-24,Kuwait,1001,5,187005,1062
2021-02-25,Kuwait,1019,5,188024,1067
2021-02-26,Kuwait,1022,5,189046,1072
2021-02-27,Kuwait,844,6,189890,1078
2021-02-28,Kuwait,962,5,190852,1083
2021-03-01,Kuwait,1179,2,192031,1085
2021-03-02,Kuwait,1341,7,193372,1092
2021-03-03,Kuwait,1409,5,194781,1097
2021-03-04,Kuwait,1716,8,196497,1105
2021-03-05,Kuwait,1613,8,198110,1113
2021-03-06,Kuwait,1318,7,199428,1120
2021-03-07,Kuwait,1144,7,200572,1127
2021-03-08,Kuwait,1326,6,201898,1133
2021-03-09,Kuwait,1157,8,203055,1141
2021-03-10,Kuwait,1333,3,204388,1144
2021-03-11,Kuwait,1505,4,205893,1148
2021-03-12,Kuwait,1356,8,207249,1156
2021-03-13,Kuwait,1211,9,208460,1165
2021-03-14,Kuwait,1063,7,209523,1172
2021-03-15,Kuwait,1332,7,210855,1179
2021-03-16,Kuwait,1314,7,212169,1186
2021-03-17,Kuwait,1504,8,213673,1194
2021-03-18,Kuwait,1394,8,215067,1202
2021-03-19,Kuwait,1519,8,216586,1210
2021-03-20,Kuwait,1347,5,217933,1215
2021-03-21,Kuwait,1192,11,219125,1226
2021-03-22,Kuwait,1330,7,220455,1233
2021-03-23,Kuwait,1288,13,221743,1246
2021-03-24,Kuwait,1299,10,223042,1256
2021-03-25,Kuwait,1390,2,224432,1258
2021-03-26,Kuwait,1548,12,225980,1270
2021-03-27,Kuwait,1198,9,227178,1279
2021-03-28,Kuwait,1121,7,228299,1286
2021-03-29,Kuwait,1251,12,229550,1298
2021-03-30,Kuwait,1271,10,230821,1308
2021-03-31,Kuwait,1282,5,232103,1313
2021-04-01,Kuwait,1418,6,233521,1319
2021-04-02,Kuwait,1233,8,234754,1327
2021-04-03,Kuwait,1235,12,235989,1339
2021-04-04,Kuwait,1203,14,237192,1353
2021-04-05,Kuwait,1357,12,238549,1365
2021-04-06,Kuwait,1403,8,239952,1373
2021-04-07,Kuwait,1517,6,241469,1379
2021-04-08,Kuwait,1379,4,242848,1383
2020-03-18,Kyrgyzstan,3,0,3,0
2020-03-19,Kyrgyzstan,0,0,3,0
2020-03-20,Kyrgyzstan,3,0,6,0
2020-03-21,Kyrgyzstan,8,0,14,0
2020-03-22,Kyrgyzstan,0,0,14,0
2020-03-23,Kyrgyzstan,2,0,16,0
2020-03-24,Kyrgyzstan,26,0,42,0
2020-03-25,Kyrgyzstan,2,0,44,0
2020-03-26,Kyrgyzstan,0,0,44,0
2020-03-27,Kyrgyzstan,14,0,58,0
2020-03-28,Kyrgyzstan,0,0,58,0
2020-03-29,Kyrgyzstan,26,0,84,0
2020-03-30,Kyrgyzstan,10,0,94,0
2020-03-31,Kyrgyzstan,13,0,107,0
2020-04-01,Kyrgyzstan,4,0,111,0
2020-04-02,Kyrgyzstan,5,0,116,0
2020-04-03,Kyrgyzstan,14,1,130,1
2020-04-04,Kyrgyzstan,14,0,144,1
2020-04-05,Kyrgyzstan,3,0,147,1
2020-04-06,Kyrgyzstan,69,3,216,4
2020-04-07,Kyrgyzstan,12,0,228,4
2020-04-08,Kyrgyzstan,42,0,270,4
2020-04-09,Kyrgyzstan,10,0,280,4
2020-04-10,Kyrgyzstan,18,1,298,5
2020-04-11,Kyrgyzstan,41,0,339,5
2020-04-12,Kyrgyzstan,38,0,377,5
2020-04-13,Kyrgyzstan,42,0,419,5
2020-04-14,Kyrgyzstan,11,0,430,5
2020-04-15,Kyrgyzstan,19,0,449,5
2020-04-16,Kyrgyzstan,17,0,466,5
2020-04-17,Kyrgyzstan,23,0,489,5
2020-04-18,Kyrgyzstan,17,0,506,5
2020-04-19,Kyrgyzstan,48,0,554,5
2020-04-20,Kyrgyzstan,14,2,568,7
2020-04-21,Kyrgyzstan,22,0,590,7
2020-04-22,Kyrgyzstan,22,0,612,7
2020-04-23,Kyrgyzstan,19,1,631,8
2020-04-24,Kyrgyzstan,34,0,665,8
2020-04-25,Kyrgyzstan,0,0,665,8
2020-04-26,Kyrgyzstan,17,0,682,8
2020-04-27,Kyrgyzstan,13,0,695,8
2020-04-28,Kyrgyzstan,13,0,708,8
2020-04-29,Kyrgyzstan,21,0,729,8
2020-04-30,Kyrgyzstan,17,0,746,8
2020-05-01,Kyrgyzstan,10,0,756,8
2020-05-02,Kyrgyzstan,13,0,769,8
2020-05-03,Kyrgyzstan,26,2,795,10
2020-05-04,Kyrgyzstan,35,0,830,10
2020-05-05,Kyrgyzstan,13,1,843,11
2020-05-06,Kyrgyzstan,28,1,871,12
2020-05-07,Kyrgyzstan,24,0,895,12
2020-05-08,Kyrgyzstan,11,0,906,12
2020-05-09,Kyrgyzstan,25,0,931,12
2020-05-10,Kyrgyzstan,71,0,1002,12
2020-05-11,Kyrgyzstan,14,0,1016,12
2020-05-12,Kyrgyzstan,21,0,1037,12
2020-05-13,Kyrgyzstan,7,0,1044,12
2020-05-14,Kyrgyzstan,38,0,1082,12
2020-05-15,Kyrgyzstan,29,2,1111,14
2020-05-16,Kyrgyzstan,6,0,1117,14
2020-05-17,Kyrgyzstan,21,0,1138,14
2020-05-18,Kyrgyzstan,78,0,1216,14
2020-05-19,Kyrgyzstan,27,0,1243,14
2020-05-20,Kyrgyzstan,27,0,1270,14
2020-05-21,Kyrgyzstan,43,0,1313,14
2020-05-22,Kyrgyzstan,37,0,1350,14
2020-05-23,Kyrgyzstan,15,0,1365,14
2020-05-24,Kyrgyzstan,38,0,1403,14
2020-05-25,Kyrgyzstan,30,2,1433,16
2020-05-26,Kyrgyzstan,35,0,1468,16
2020-05-27,Kyrgyzstan,52,0,1520,16
2020-05-28,Kyrgyzstan,74,0,1594,16
2020-05-29,Kyrgyzstan,68,0,1662,16
2020-05-30,Kyrgyzstan,60,0,1722,16
2020-05-31,Kyrgyzstan,26,0,1748,16
2020-06-01,Kyrgyzstan,69,0,1817,16
2020-06-02,Kyrgyzstan,28,1,1845,17
2020-06-03,Kyrgyzstan,26,3,1871,20
2020-06-04,Kyrgyzstan,28,0,1899,20
2020-06-05,Kyrgyzstan,37,2,1936,22
2020-06-06,Kyrgyzstan,38,0,1974,22
2020-06-07,Kyrgyzstan,33,0,2007,22
2020-06-08,Kyrgyzstan,25,1,2032,23
2020-06-09,Kyrgyzstan,23,1,2055,24
2020-06-10,Kyrgyzstan,38,2,2093,26
2020-06-11,Kyrgyzstan,73,0,2166,26
2020-06-12,Kyrgyzstan,0,0,2166,26
2020-06-13,Kyrgyzstan,41,1,2207,27
2020-06-14,Kyrgyzstan,78,0,2285,27
2020-06-15,Kyrgyzstan,187,1,2472,28
2020-06-16,Kyrgyzstan,90,2,2562,30
2020-06-17,Kyrgyzstan,95,1,2657,31
2020-06-18,Kyrgyzstan,0,0,2657,31
2020-06-19,Kyrgyzstan,132,1,2789,32
2020-06-20,Kyrgyzstan,192,3,2981,35
2020-06-21,Kyrgyzstan,375,5,3356,40
2020-06-22,Kyrgyzstan,0,0,3356,40
2020-06-23,Kyrgyzstan,370,2,3726,42
2020-06-24,Kyrgyzstan,228,1,3954,43
2020-06-25,Kyrgyzstan,250,0,4204,43
2020-06-26,Kyrgyzstan,242,3,4446,46
2020-06-27,Kyrgyzstan,67,0,4513,46
2020-06-28,Kyrgyzstan,504,4,5017,50
2020-06-29,Kyrgyzstan,279,7,5296,57
2020-06-30,Kyrgyzstan,210,4,5506,61
2020-07-01,Kyrgyzstan,755,5,6261,66
2020-07-02,Kyrgyzstan,506,10,6767,76
2020-07-03,Kyrgyzstan,111,0,6878,76
2020-07-04,Kyrgyzstan,216,2,7094,78
2020-07-05,Kyrgyzstan,283,10,7377,88
2020-07-06,Kyrgyzstan,764,11,8141,99
2020-07-07,Kyrgyzstan,138,8,8279,107
2020-07-08,Kyrgyzstan,568,9,8847,116
2020-07-09,Kyrgyzstan,511,6,9358,122
2020-07-10,Kyrgyzstan,552,3,9910,125
2020-07-11,Kyrgyzstan,500,4,10410,129
2020-07-12,Kyrgyzstan,707,18,11117,147
2020-07-13,Kyrgyzstan,327,2,11444,149
2020-07-14,Kyrgyzstan,0,0,11444,149
2020-07-15,Kyrgyzstan,838,16,12282,165
2020-07-16,Kyrgyzstan,216,2,12498,167
2020-07-17,Kyrgyzstan,603,6,13101,173
2020-07-18,Kyrgyzstan,11505,727,24606,900
2020-07-19,Kyrgyzstan,2537,137,27143,1037
2020-07-20,Kyrgyzstan,0,0,27143,1037
2020-07-21,Kyrgyzstan,1108,42,28251,1079
2020-07-22,Kyrgyzstan,729,32,28980,1111
2020-07-23,Kyrgyzstan,2267,100,31247,1211
2020-07-24,Kyrgyzstan,0,0,31247,1211
2020-07-25,Kyrgyzstan,877,38,32124,1249
2020-07-26,Kyrgyzstan,689,28,32813,1277
2020-07-27,Kyrgyzstan,483,24,33296,1301
2020-07-28,Kyrgyzstan,548,28,33844,1329
2020-07-29,Kyrgyzstan,748,18,34592,1347
2020-07-30,Kyrgyzstan,631,17,35223,1364
2020-07-31,Kyrgyzstan,582,14,35805,1378
2020-08-01,Kyrgyzstan,494,19,36299,1397
2020-08-02,Kyrgyzstan,420,12,36719,1409
2020-08-03,Kyrgyzstan,410,11,37129,1420
2020-08-04,Kyrgyzstan,412,7,37541,1427
2020-08-05,Kyrgyzstan,569,11,38110,1438
2020-08-06,Kyrgyzstan,549,9,38659,1447
2020-08-07,Kyrgyzstan,503,4,39162,1451
2020-08-08,Kyrgyzstan,409,8,39571,1459
2020-08-09,Kyrgyzstan,348,9,39919,1468
2020-08-10,Kyrgyzstan,166,6,40085,1474
2020-08-11,Kyrgyzstan,370,4,40455,1478
2020-08-12,Kyrgyzstan,304,6,40759,1484
2020-08-13,Kyrgyzstan,310,3,41069,1487
2020-08-14,Kyrgyzstan,304,4,41373,1491
2020-08-15,Kyrgyzstan,272,2,41645,1493
2020-08-16,Kyrgyzstan,211,2,41856,1495
2020-08-17,Kyrgyzstan,135,1,41991,1496
2020-08-18,Kyrgyzstan,155,2,42146,1498
2020-08-19,Kyrgyzstan,179,0,42325,1498
2020-08-20,Kyrgyzstan,182,0,42507,1498
2020-08-21,Kyrgyzstan,196,-443,42703,1055
2020-08-22,Kyrgyzstan,186,0,42889,1055
2020-08-23,Kyrgyzstan,134,1,43023,1056
2020-08-24,Kyrgyzstan,103,1,43126,1057
2020-08-25,Kyrgyzstan,119,0,43245,1057
2020-08-26,Kyrgyzstan,113,0,43358,1057
2020-08-27,Kyrgyzstan,101,0,43459,1057
2020-08-28,Kyrgyzstan,128,0,43587,1057
2020-08-29,Kyrgyzstan,125,0,43712,1057
2020-08-30,Kyrgyzstan,108,1,43820,1058
2020-08-31,Kyrgyzstan,78,0,43898,1058
2020-09-01,Kyrgyzstan,60,1,43958,1059
2020-09-02,Kyrgyzstan,78,0,44036,1059
2020-09-03,Kyrgyzstan,99,0,44135,1059
2020-09-04,Kyrgyzstan,64,1,44199,1060
2020-09-05,Kyrgyzstan,94,0,44293,1060
2020-09-06,Kyrgyzstan,110,0,44403,1060
2020-09-07,Kyrgyzstan,55,0,44458,1060
2020-09-08,Kyrgyzstan,29,0,44487,1060
2020-09-09,Kyrgyzstan,126,1,44613,1061
2020-09-10,Kyrgyzstan,71,0,44684,1061
2020-09-11,Kyrgyzstan,77,2,44761,1063
2020-09-12,Kyrgyzstan,67,0,44828,1063
2020-09-13,Kyrgyzstan,53,0,44881,1063
2020-09-14,Kyrgyzstan,47,0,44928,1063
2020-09-15,Kyrgyzstan,71,0,44999,1063
2020-09-16,Kyrgyzstan,73,0,45072,1063
2020-09-17,Kyrgyzstan,81,0,45153,1063
2020-09-18,Kyrgyzstan,91,0,45244,1063
2020-09-19,Kyrgyzstan,91,0,45335,1063
2020-09-20,Kyrgyzstan,0,0,45335,1063
2020-09-21,Kyrgyzstan,136,0,45471,1063
2020-09-22,Kyrgyzstan,71,0,45542,1063
2020-09-23,Kyrgyzstan,88,0,45630,1063
2020-09-24,Kyrgyzstan,127,0,45757,1063
2020-09-25,Kyrgyzstan,175,0,45932,1063
2020-09-26,Kyrgyzstan,158,0,46090,1063
2020-09-27,Kyrgyzstan,161,0,46251,1063
2020-09-28,Kyrgyzstan,104,1,46355,1064
2020-09-29,Kyrgyzstan,167,0,46522,1064
2020-09-30,Kyrgyzstan,147,0,46669,1064
2020-10-01,Kyrgyzstan,172,1,46841,1065
2020-10-02,Kyrgyzstan,215,0,47056,1065
2020-10-03,Kyrgyzstan,128,1,47184,1066
2020-10-04,Kyrgyzstan,244,0,47428,1066
2020-10-05,Kyrgyzstan,207,0,47635,1066
2020-10-06,Kyrgyzstan,164,0,47799,1066
2020-10-07,Kyrgyzstan,298,3,48097,1069
2020-10-08,Kyrgyzstan,245,4,48342,1073
2020-10-09,Kyrgyzstan,275,4,48617,1077
2020-10-10,Kyrgyzstan,307,5,48924,1082
2020-10-11,Kyrgyzstan,306,3,49230,1085
2020-10-12,Kyrgyzstan,298,5,49528,1090
2020-10-13,Kyrgyzstan,343,2,49871,1092
2020-10-14,Kyrgyzstan,330,2,50201,1094
2020-10-15,Kyrgyzstan,388,5,50589,1099
2020-10-16,Kyrgyzstan,431,4,51020,1103
2020-10-17,Kyrgyzstan,470,5,51490,1108
2020-10-18,Kyrgyzstan,554,3,52044,1111
2020-10-19,Kyrgyzstan,482,0,52526,1111
2020-10-20,Kyrgyzstan,384,2,52910,1113
2020-10-21,Kyrgyzstan,549,5,53459,1118
2020-10-22,Kyrgyzstan,547,4,54006,1122
2020-10-23,Kyrgyzstan,582,4,54588,1126
2020-10-24,Kyrgyzstan,556,4,55144,1130
2020-10-25,Kyrgyzstan,606,4,55750,1134
2020-10-26,Kyrgyzstan,420,0,56170,1134
2020-10-27,Kyrgyzstan,568,2,56738,1136
2020-10-28,Kyrgyzstan,538,2,57276,1138
2020-10-29,Kyrgyzstan,522,1,57798,1139
2020-10-30,Kyrgyzstan,596,3,58394,1142
2020-10-31,Kyrgyzstan,484,2,58878,1144
2020-11-01,Kyrgyzstan,0,0,58878,1144
2020-11-02,Kyrgyzstan,1001,11,59879,1155
2020-11-03,Kyrgyzstan,895,8,60774,1163
2020-11-04,Kyrgyzstan,535,4,61309,1167
2020-11-05,Kyrgyzstan,0,0,61309,1167
2020-11-06,Kyrgyzstan,439,3,61748,1170
2020-11-07,Kyrgyzstan,556,2,62304,1172
2020-11-08,Kyrgyzstan,515,5,62819,1177
2020-11-09,Kyrgyzstan,571,5,63390,1182
2020-11-10,Kyrgyzstan,970,6,64360,1188
2020-11-11,Kyrgyzstan,0,0,64360,1188
2020-11-12,Kyrgyzstan,527,5,64887,1193
2020-11-13,Kyrgyzstan,567,2,65454,1195
2020-11-14,Kyrgyzstan,499,1,65953,1196
2020-11-15,Kyrgyzstan,1030,7,66983,1203
2020-11-16,Kyrgyzstan,0,0,66983,1203
2020-11-17,Kyrgyzstan,486,4,67469,1207
2020-11-18,Kyrgyzstan,425,5,67894,1212
2020-11-19,Kyrgyzstan,422,5,68316,1217
2020-11-20,Kyrgyzstan,386,6,68702,1223
2020-11-21,Kyrgyzstan,447,4,69149,1227
2020-11-22,Kyrgyzstan,432,4,69581,1231
2020-11-23,Kyrgyzstan,304,6,69885,1237
2020-11-24,Kyrgyzstan,481,4,70366,1241
2020-11-25,Kyrgyzstan,805,10,71171,1251
2020-11-26,Kyrgyzstan,377,5,71548,1256
2020-11-27,Kyrgyzstan,0,0,71548,1256
2020-11-28,Kyrgyzstan,423,6,71971,1262
2020-11-29,Kyrgyzstan,836,9,72807,1271
2020-11-30,Kyrgyzstan,371,4,73178,1275
2020-12-01,Kyrgyzstan,0,0,73178,1275
2020-12-02,Kyrgyzstan,335,2,73513,1277
2020-12-03,Kyrgyzstan,420,8,73933,1285
2020-12-04,Kyrgyzstan,440,0,74373,1285
2020-12-05,Kyrgyzstan,401,5,74774,1290
2020-12-06,Kyrgyzstan,621,7,75395,1297
2020-12-07,Kyrgyzstan,0,0,75395,1297
2020-12-08,Kyrgyzstan,295,4,75690,1301
2020-12-09,Kyrgyzstan,322,5,76012,1306
2020-12-10,Kyrgyzstan,379,0,76391,1306
2020-12-11,Kyrgyzstan,668,1,77059,1307
2020-12-12,Kyrgyzstan,0,0,77059,1307
2020-12-13,Kyrgyzstan,297,5,77356,1312
2020-12-14,Kyrgyzstan,318,0,77674,1312
2020-12-15,Kyrgyzstan,477,5,78151,1317
2020-12-16,Kyrgyzstan,0,0,78151,1317
2020-12-17,Kyrgyzstan,264,4,78415,1321
2020-12-18,Kyrgyzstan,264,3,78679,1324
2020-12-19,Kyrgyzstan,232,4,78911,1328
2020-12-20,Kyrgyzstan,343,3,79254,1331
2020-12-21,Kyrgyzstan,0,0,79254,1331
2020-12-22,Kyrgyzstan,175,4,79429,1335
2020-12-23,Kyrgyzstan,230,2,79659,1337
2020-12-24,Kyrgyzstan,186,3,79845,1340
2020-12-25,Kyrgyzstan,180,0,80025,1340
2020-12-26,Kyrgyzstan,157,4,80182,1344
2020-12-27,Kyrgyzstan,191,4,80373,1348
2020-12-28,Kyrgyzstan,162,1,80535,1349
2020-12-29,Kyrgyzstan,119,4,80654,1353
2020-12-30,Kyrgyzstan,189,1,80843,1354
2020-12-31,Kyrgyzstan,191,1,81034,1355
2021-01-01,Kyrgyzstan,122,1,81156,1356
2021-01-02,Kyrgyzstan,58,2,81214,1358
2021-01-03,Kyrgyzstan,174,2,81388,1360
2021-01-04,Kyrgyzstan,0,0,81388,1360
2021-01-05,Kyrgyzstan,124,0,81512,1360
2021-01-06,Kyrgyzstan,144,1,81656,1361
2021-01-07,Kyrgyzstan,170,2,81826,1363
2021-01-08,Kyrgyzstan,165,2,81991,1365
2021-01-09,Kyrgyzstan,147,2,82138,1367
2021-01-10,Kyrgyzstan,135,2,82273,1369
2021-01-11,Kyrgyzstan,107,2,82380,1371
2021-01-12,Kyrgyzstan,207,4,82587,1375
2021-01-13,Kyrgyzstan,0,0,82587,1375
2021-01-14,Kyrgyzstan,136,3,82723,1378
2021-01-15,Kyrgyzstan,263,4,82986,1382
2021-01-16,Kyrgyzstan,123,2,83109,1384
2021-01-17,Kyrgyzstan,69,3,83178,1387
2021-01-18,Kyrgyzstan,0,0,83178,1387
2021-01-19,Kyrgyzstan,252,5,83430,1392
2021-01-20,Kyrgyzstan,0,0,83430,1392
2021-01-21,Kyrgyzstan,155,2,83585,1394
2021-01-22,Kyrgyzstan,211,4,83796,1398
2021-01-23,Kyrgyzstan,0,0,83796,1398
2021-01-24,Kyrgyzstan,104,2,83900,1400
2021-01-25,Kyrgyzstan,168,2,84068,1402
2021-01-26,Kyrgyzstan,107,3,84175,1405
2021-01-27,Kyrgyzstan,128,3,84303,1408
2021-01-28,Kyrgyzstan,0,0,84303,1408
2021-01-29,Kyrgyzstan,74,1,84377,1409
2021-01-30,Kyrgyzstan,152,3,84529,1412
2021-01-31,Kyrgyzstan,59,0,84588,1412
2021-02-01,Kyrgyzstan,0,0,84588,1412
2021-02-02,Kyrgyzstan,58,2,84646,1414
2021-02-03,Kyrgyzstan,186,4,84832,1418
2021-02-04,Kyrgyzstan,88,2,84920,1420
2021-02-05,Kyrgyzstan,0,0,84920,1420
2021-02-06,Kyrgyzstan,72,3,84992,1423
2021-02-07,Kyrgyzstan,79,3,85071,1426
2021-02-08,Kyrgyzstan,42,5,85113,1431
2021-02-09,Kyrgyzstan,58,2,85171,1433
2021-02-10,Kyrgyzstan,82,3,85253,1436
2021-02-11,Kyrgyzstan,75,1,85328,1437
2021-02-12,Kyrgyzstan,70,2,85398,1439
2021-02-13,Kyrgyzstan,43,2,85441,1441
2021-02-14,Kyrgyzstan,34,1,85475,1442
2021-02-15,Kyrgyzstan,41,0,85516,1442
2021-02-16,Kyrgyzstan,48,2,85564,1444
2021-02-17,Kyrgyzstan,125,3,85689,1447
2021-02-18,Kyrgyzstan,0,0,85689,1447
2021-02-19,Kyrgyzstan,142,5,85831,1452
2021-02-20,Kyrgyzstan,0,0,85831,1452
2021-02-21,Kyrgyzstan,98,6,85929,1458
2021-02-22,Kyrgyzstan,0,0,85929,1458
2021-02-23,Kyrgyzstan,72,2,86001,1460
2021-02-24,Kyrgyzstan,24,0,86025,1460
2021-02-25,Kyrgyzstan,66,3,86091,1463
2021-02-26,Kyrgyzstan,51,0,86142,1463
2021-02-27,Kyrgyzstan,43,0,86185,1463
2021-02-28,Kyrgyzstan,66,3,86251,1466
2021-03-01,Kyrgyzstan,57,1,86308,1467
2021-03-02,Kyrgyzstan,48,1,86356,1468
2021-03-03,Kyrgyzstan,54,0,86410,1468
2021-03-04,Kyrgyzstan,0,2,86410,1470
2021-03-05,Kyrgyzstan,41,0,86451,1470
2021-03-06,Kyrgyzstan,55,1,86506,1471
2021-03-07,Kyrgyzstan,44,0,86550,1471
2021-03-08,Kyrgyzstan,33,2,86583,1473
2021-03-09,Kyrgyzstan,57,3,86640,1476
2021-03-10,Kyrgyzstan,0,0,86640,1476
2021-03-11,Kyrgyzstan,115,4,86755,1480
2021-03-12,Kyrgyzstan,63,0,86818,1480
2021-03-13,Kyrgyzstan,0,0,86818,1480
2021-03-14,Kyrgyzstan,32,3,86850,1483
2021-03-15,Kyrgyzstan,67,0,86917,1483
2021-03-16,Kyrgyzstan,128,2,87045,1485
2021-03-17,Kyrgyzstan,98,0,87143,1485
2021-03-18,Kyrgyzstan,0,0,87143,1485
2021-03-19,Kyrgyzstan,96,2,87239,1487
2021-03-20,Kyrgyzstan,150,3,87389,1490
2021-03-21,Kyrgyzstan,0,0,87389,1490
2021-03-22,Kyrgyzstan,73,0,87462,1490
2021-03-23,Kyrgyzstan,190,2,87652,1492
2021-03-24,Kyrgyzstan,106,2,87758,1494
2021-03-25,Kyrgyzstan,0,0,87758,1494
2021-03-26,Kyrgyzstan,100,0,87858,1494
2021-03-27,Kyrgyzstan,88,1,87946,1495
2021-03-28,Kyrgyzstan,146,0,88092,1495
2021-03-29,Kyrgyzstan,71,2,88163,1497
2021-03-30,Kyrgyzstan,113,1,88276,1498
2021-03-31,Kyrgyzstan,262,2,88538,1500
2021-04-01,Kyrgyzstan,0,0,88538,1500
2021-04-02,Kyrgyzstan,162,0,88700,1500
2021-04-03,Kyrgyzstan,142,2,88842,1502
2021-04-04,Kyrgyzstan,172,4,89014,1506
2021-04-05,Kyrgyzstan,139,1,89153,1507
2021-04-06,Kyrgyzstan,124,2,89277,1509
2021-04-07,Kyrgyzstan,161,3,89438,1512
2021-04-08,Kyrgyzstan,222,4,89660,1516
2020-03-24,Laos,2,0,2,0
2020-03-25,Laos,1,0,3,0
2020-03-26,Laos,3,0,6,0
2020-03-27,Laos,0,0,6,0
2020-03-28,Laos,2,0,8,0
2020-03-29,Laos,0,0,8,0
2020-03-30,Laos,0,0,8,0
2020-03-31,Laos,1,0,9,0
2020-04-01,Laos,1,0,10,0
2020-04-02,Laos,0,0,10,0
2020-04-03,Laos,0,0,10,0
2020-04-04,Laos,0,0,10,0
2020-04-05,Laos,1,0,11,0
2020-04-06,Laos,1,0,12,0
2020-04-07,Laos,2,0,14,0
2020-04-08,Laos,1,0,15,0
2020-04-09,Laos,1,0,16,0
2020-04-10,Laos,0,0,16,0
2020-04-11,Laos,2,0,18,0
2020-04-12,Laos,1,0,19,0
2020-04-13,Laos,0,0,19,0
2020-04-14,Laos,0,0,19,0
2020-04-15,Laos,0,0,19,0
2020-04-16,Laos,0,0,19,0
2020-04-17,Laos,0,0,19,0
2020-04-18,Laos,0,0,19,0
2020-04-19,Laos,0,0,19,0
2020-04-20,Laos,0,0,19,0
2020-04-21,Laos,0,0,19,0
2020-04-22,Laos,0,0,19,0
2020-04-23,Laos,0,0,19,0
2020-04-24,Laos,0,0,19,0
2020-04-25,Laos,0,0,19,0
2020-04-26,Laos,0,0,19,0
2020-04-27,Laos,0,0,19,0
2020-04-28,Laos,0,0,19,0
2020-04-29,Laos,0,0,19,0
2020-04-30,Laos,0,0,19,0
2020-05-01,Laos,0,0,19,0
2020-05-02,Laos,0,0,19,0
2020-05-03,Laos,0,0,19,0
2020-05-04,Laos,0,0,19,0
2020-05-05,Laos,0,0,19,0
2020-05-06,Laos,0,0,19,0
2020-05-07,Laos,0,0,19,0
2020-05-08,Laos,0,0,19,0
2020-05-09,Laos,0,0,19,0
2020-05-10,Laos,0,0,19,0
2020-05-11,Laos,0,0,19,0
2020-05-12,Laos,0,0,19,0
2020-05-13,Laos,0,0,19,0
2020-05-14,Laos,0,0,19,0
2020-05-15,Laos,0,0,19,0
2020-05-16,Laos,0,0,19,0
2020-05-17,Laos,0,0,19,0
2020-05-18,Laos,0,0,19,0
2020-05-19,Laos,0,0,19,0
2020-05-20,Laos,0,0,19,0
2020-05-21,Laos,0,0,19,0
2020-05-22,Laos,0,0,19,0
2020-05-23,Laos,0,0,19,0
2020-05-24,Laos,0,0,19,0
2020-05-25,Laos,0,0,19,0
2020-05-26,Laos,0,0,19,0
2020-05-27,Laos,0,0,19,0
2020-05-28,Laos,0,0,19,0
2020-05-29,Laos,0,0,19,0
2020-05-30,Laos,0,0,19,0
2020-05-31,Laos,0,0,19,0
2020-06-01,Laos,0,0,19,0
2020-06-02,Laos,0,0,19,0
2020-06-03,Laos,0,0,19,0
2020-06-04,Laos,0,0,19,0
2020-06-05,Laos,0,0,19,0
2020-06-06,Laos,0,0,19,0
2020-06-07,Laos,0,0,19,0
2020-06-08,Laos,0,0,19,0
2020-06-09,Laos,0,0,19,0
2020-06-10,Laos,0,0,19,0
2020-06-11,Laos,0,0,19,0
2020-06-12,Laos,0,0,19,0
2020-06-13,Laos,0,0,19,0
2020-06-14,Laos,0,0,19,0
2020-06-15,Laos,0,0,19,0
2020-06-16,Laos,0,0,19,0
2020-06-17,Laos,0,0,19,0
2020-06-18,Laos,0,0,19,0
2020-06-19,Laos,0,0,19,0
2020-06-20,Laos,0,0,19,0
2020-06-21,Laos,0,0,19,0
2020-06-22,Laos,0,0,19,0
2020-06-23,Laos,0,0,19,0
2020-06-24,Laos,0,0,19,0
2020-06-25,Laos,0,0,19,0
2020-06-26,Laos,0,0,19,0
2020-06-27,Laos,0,0,19,0
2020-06-28,Laos,0,0,19,0
2020-06-29,Laos,0,0,19,0
2020-06-30,Laos,0,0,19,0
2020-07-01,Laos,0,0,19,0
2020-07-02,Laos,0,0,19,0
2020-07-03,Laos,0,0,19,0
2020-07-04,Laos,0,0,19,0
2020-07-05,Laos,0,0,19,0
2020-07-06,Laos,0,0,19,0
2020-07-07,Laos,0,0,19,0
2020-07-08,Laos,0,0,19,0
2020-07-09,Laos,0,0,19,0
2020-07-10,Laos,0,0,19,0
2020-07-11,Laos,0,0,19,0
2020-07-12,Laos,0,0,19,0
2020-07-13,Laos,0,0,19,0
2020-07-14,Laos,0,0,19,0
2020-07-15,Laos,0,0,19,0
2020-07-16,Laos,0,0,19,0
2020-07-17,Laos,0,0,19,0
2020-07-18,Laos,0,0,19,0
2020-07-19,Laos,0,0,19,0
2020-07-20,Laos,0,0,19,0
2020-07-21,Laos,0,0,19,0
2020-07-22,Laos,0,0,19,0
2020-07-23,Laos,0,0,19,0
2020-07-24,Laos,1,0,20,0
2020-07-25,Laos,0,0,20,0
2020-07-26,Laos,0,0,20,0
2020-07-27,Laos,0,0,20,0
2020-07-28,Laos,0,0,20,0
2020-07-29,Laos,0,0,20,0
2020-07-30,Laos,0,0,20,0
2020-07-31,Laos,0,0,20,0
2020-08-01,Laos,0,0,20,0
2020-08-02,Laos,0,0,20,0
2020-08-03,Laos,0,0,20,0
2020-08-04,Laos,0,0,20,0
2020-08-05,Laos,0,0,20,0
2020-08-06,Laos,0,0,20,0
2020-08-07,Laos,0,0,20,0
2020-08-08,Laos,0,0,20,0
2020-08-09,Laos,0,0,20,0
2020-08-10,Laos,0,0,20,0
2020-08-11,Laos,0,0,20,0
2020-08-12,Laos,0,0,20,0
2020-08-13,Laos,0,0,20,0
2020-08-14,Laos,2,0,22,0
2020-08-15,Laos,0,0,22,0
2020-08-16,Laos,0,0,22,0
2020-08-17,Laos,0,0,22,0
2020-08-18,Laos,0,0,22,0
2020-08-19,Laos,0,0,22,0
2020-08-20,Laos,0,0,22,0
2020-08-21,Laos,0,0,22,0
2020-08-22,Laos,0,0,22,0
2020-08-23,Laos,0,0,22,0
2020-08-24,Laos,0,0,22,0
2020-08-25,Laos,0,0,22,0
2020-08-26,Laos,0,0,22,0
2020-08-27,Laos,0,0,22,0
2020-08-28,Laos,0,0,22,0
2020-08-29,Laos,0,0,22,0
2020-08-30,Laos,0,0,22,0
2020-08-31,Laos,0,0,22,0
2020-09-01,Laos,0,0,22,0
2020-09-02,Laos,0,0,22,0
2020-09-03,Laos,0,0,22,0
2020-09-04,Laos,0,0,22,0
2020-09-05,Laos,0,0,22,0
2020-09-06,Laos,0,0,22,0
2020-09-07,Laos,0,0,22,0
2020-09-08,Laos,0,0,22,0
2020-09-09,Laos,0,0,22,0
2020-09-10,Laos,0,0,22,0
2020-09-11,Laos,1,0,23,0
2020-09-12,Laos,0,0,23,0
2020-09-13,Laos,0,0,23,0
2020-09-14,Laos,0,0,23,0
2020-09-15,Laos,0,0,23,0
2020-09-16,Laos,0,0,23,0
2020-09-17,Laos,0,0,23,0
2020-09-18,Laos,0,0,23,0
2020-09-19,Laos,0,0,23,0
2020-09-20,Laos,0,0,23,0
2020-09-21,Laos,0,0,23,0
2020-09-22,Laos,0,0,23,0
2020-09-23,Laos,0,0,23,0
2020-09-24,Laos,0,0,23,0
2020-09-25,Laos,0,0,23,0
2020-09-26,Laos,0,0,23,0
2020-09-27,Laos,0,0,23,0
2020-09-28,Laos,0,0,23,0
2020-09-29,Laos,0,0,23,0
2020-09-30,Laos,0,0,23,0
2020-10-01,Laos,0,0,23,0
2020-10-02,Laos,0,0,23,0
2020-10-03,Laos,0,0,23,0
2020-10-04,Laos,0,0,23,0
2020-10-05,Laos,0,0,23,0
2020-10-06,Laos,0,0,23,0
2020-10-07,Laos,0,0,23,0
2020-10-08,Laos,0,0,23,0
2020-10-09,Laos,0,0,23,0
2020-10-10,Laos,0,0,23,0
2020-10-11,Laos,0,0,23,0
2020-10-12,Laos,0,0,23,0
2020-10-13,Laos,0,0,23,0
2020-10-14,Laos,0,0,23,0
2020-10-15,Laos,0,0,23,0
2020-10-16,Laos,0,0,23,0
2020-10-17,Laos,0,0,23,0
2020-10-18,Laos,0,0,23,0
2020-10-19,Laos,0,0,23,0
2020-10-20,Laos,0,0,23,0
2020-10-21,Laos,1,0,24,0
2020-10-22,Laos,0,0,24,0
2020-10-23,Laos,0,0,24,0
2020-10-24,Laos,0,0,24,0
2020-10-25,Laos,0,0,24,0
2020-10-26,Laos,0,0,24,0
2020-10-27,Laos,0,0,24,0
2020-10-28,Laos,0,0,24,0
2020-10-29,Laos,0,0,24,0
2020-10-30,Laos,0,0,24,0
2020-10-31,Laos,0,0,24,0
2020-11-01,Laos,0,0,24,0
2020-11-02,Laos,0,0,24,0
2020-11-03,Laos,0,0,24,0
2020-11-04,Laos,0,0,24,0
2020-11-05,Laos,0,0,24,0
2020-11-06,Laos,0,0,24,0
2020-11-07,Laos,0,0,24,0
2020-11-08,Laos,0,0,24,0
2020-11-09,Laos,0,0,24,0
2020-11-10,Laos,0,0,24,0
2020-11-11,Laos,0,0,24,0
2020-11-12,Laos,0,0,24,0
2020-11-13,Laos,0,0,24,0
2020-11-14,Laos,0,0,24,0
2020-11-15,Laos,0,0,24,0
2020-11-16,Laos,0,0,24,0
2020-11-17,Laos,1,0,25,0
2020-11-18,Laos,0,0,25,0
2020-11-19,Laos,0,0,25,0
2020-11-20,Laos,0,0,25,0
2020-11-21,Laos,0,0,25,0
2020-11-22,Laos,0,0,25,0
2020-11-23,Laos,14,0,39,0
2020-11-24,Laos,0,0,39,0
2020-11-25,Laos,0,0,39,0
2020-11-26,Laos,0,0,39,0
2020-11-27,Laos,0,0,39,0
2020-11-28,Laos,0,0,39,0
2020-11-29,Laos,0,0,39,0
2020-11-30,Laos,0,0,39,0
2020-12-01,Laos,0,0,39,0
2020-12-02,Laos,0,0,39,0
2020-12-03,Laos,0,0,39,0
2020-12-04,Laos,0,0,39,0
2020-12-05,Laos,0,0,39,0
2020-12-06,Laos,0,0,39,0
2020-12-07,Laos,2,0,41,0
2020-12-08,Laos,0,0,41,0
2020-12-09,Laos,0,0,41,0
2020-12-10,Laos,0,0,41,0
2020-12-11,Laos,0,0,41,0
2020-12-12,Laos,0,0,41,0
2020-12-13,Laos,0,0,41,0
2020-12-14,Laos,0,0,41,0
2020-12-15,Laos,0,0,41,0
2020-12-16,Laos,0,0,41,0
2020-12-17,Laos,0,0,41,0
2020-12-18,Laos,0,0,41,0
2020-12-19,Laos,0,0,41,0
2020-12-20,Laos,0,0,41,0
2020-12-21,Laos,0,0,41,0
2020-12-22,Laos,0,0,41,0
2020-12-23,Laos,0,0,41,0
2020-12-24,Laos,0,0,41,0
2020-12-25,Laos,0,0,41,0
2020-12-26,Laos,0,0,41,0
2020-12-27,Laos,0,0,41,0
2020-12-28,Laos,0,0,41,0
2020-12-29,Laos,0,0,41,0
2020-12-30,Laos,0,0,41,0
2020-12-31,Laos,0,0,41,0
2021-01-01,Laos,0,0,41,0
2021-01-02,Laos,0,0,41,0
2021-01-03,Laos,0,0,41,0
2021-01-04,Laos,0,0,41,0
2021-01-05,Laos,0,0,41,0
2021-01-06,Laos,0,0,41,0
2021-01-07,Laos,0,0,41,0
2021-01-08,Laos,0,0,41,0
2021-01-09,Laos,0,0,41,0
2021-01-10,Laos,0,0,41,0
2021-01-11,Laos,0,0,41,0
2021-01-12,Laos,0,0,41,0
2021-01-13,Laos,0,0,41,0
2021-01-14,Laos,0,0,41,0
2021-01-15,Laos,0,0,41,0
2021-01-16,Laos,0,0,41,0
2021-01-17,Laos,0,0,41,0
2021-01-18,Laos,0,0,41,0
2021-01-19,Laos,0,0,41,0
2021-01-20,Laos,0,0,41,0
2021-01-21,Laos,0,0,41,0
2021-01-22,Laos,0,0,41,0
2021-01-23,Laos,0,0,41,0
2021-01-24,Laos,0,0,41,0
2021-01-25,Laos,3,0,44,0
2021-01-26,Laos,0,0,44,0
2021-01-27,Laos,0,0,44,0
2021-01-28,Laos,0,0,44,0
2021-01-29,Laos,0,0,44,0
2021-01-30,Laos,0,0,44,0
2021-01-31,Laos,0,0,44,0
2021-02-01,Laos,0,0,44,0
2021-02-02,Laos,0,0,44,0
2021-02-03,Laos,1,0,45,0
2021-02-04,Laos,0,0,45,0
2021-02-05,Laos,0,0,45,0
2021-02-06,Laos,0,0,45,0
2021-02-07,Laos,0,0,45,0
2021-02-08,Laos,0,0,45,0
2021-02-09,Laos,0,0,45,0
2021-02-10,Laos,0,0,45,0
2021-02-11,Laos,0,0,45,0
2021-02-12,Laos,0,0,45,0
2021-02-13,Laos,0,0,45,0
2021-02-14,Laos,0,0,45,0
2021-02-15,Laos,0,0,45,0
2021-02-16,Laos,0,0,45,0
2021-02-17,Laos,0,0,45,0
2021-02-18,Laos,0,0,45,0
2021-02-19,Laos,0,0,45,0
2021-02-20,Laos,0,0,45,0
2021-02-21,Laos,0,0,45,0
2021-02-22,Laos,0,0,45,0
2021-02-23,Laos,0,0,45,0
2021-02-24,Laos,0,0,45,0
2021-02-25,Laos,0,0,45,0
2021-02-26,Laos,0,0,45,0
2021-02-27,Laos,0,0,45,0
2021-02-28,Laos,0,0,45,0
2021-03-01,Laos,0,0,45,0
2021-03-02,Laos,0,0,45,0
2021-03-03,Laos,0,0,45,0
2021-03-04,Laos,0,0,45,0
2021-03-05,Laos,2,0,47,0
2021-03-06,Laos,0,0,47,0
2021-03-07,Laos,0,0,47,0
2021-03-08,Laos,0,0,47,0
2021-03-09,Laos,0,0,47,0
2021-03-10,Laos,0,0,47,0
2021-03-11,Laos,1,0,48,0
2021-03-12,Laos,0,0,48,0
2021-03-13,Laos,0,0,48,0
2021-03-14,Laos,0,0,48,0
2021-03-15,Laos,0,0,48,0
2021-03-16,Laos,0,0,48,0
2021-03-17,Laos,1,0,49,0
2021-03-18,Laos,0,0,49,0
2021-03-19,Laos,0,0,49,0
2021-03-20,Laos,0,0,49,0
2021-03-21,Laos,0,0,49,0
2021-03-22,Laos,0,0,49,0
2021-03-23,Laos,0,0,49,0
2021-03-24,Laos,0,0,49,0
2021-03-25,Laos,0,0,49,0
2021-03-26,Laos,0,0,49,0
2021-03-27,Laos,0,0,49,0
2021-03-28,Laos,0,0,49,0
2021-03-29,Laos,0,0,49,0
2021-03-30,Laos,0,0,49,0
2021-03-31,Laos,0,0,49,0
2021-04-01,Laos,0,0,49,0
2021-04-02,Laos,0,0,49,0
2021-04-03,Laos,0,0,49,0
2021-04-04,Laos,0,0,49,0
2021-04-05,Laos,0,0,49,0
2021-04-06,Laos,0,0,49,0
2021-04-07,Laos,0,0,49,0
2021-04-08,Laos,0,0,49,0
2020-03-02,Latvia,1,0,1,0
2020-03-03,Latvia,0,0,1,0
2020-03-04,Latvia,0,0,1,0
2020-03-05,Latvia,0,0,1,0
2020-03-06,Latvia,0,0,1,0
2020-03-07,Latvia,0,0,1,0
2020-03-08,Latvia,1,0,2,0
2020-03-09,Latvia,4,0,6,0
2020-03-10,Latvia,2,0,8,0
2020-03-11,Latvia,2,0,10,0
2020-03-12,Latvia,0,0,10,0
2020-03-13,Latvia,7,0,17,0
2020-03-14,Latvia,9,0,26,0
2020-03-15,Latvia,4,0,30,0
2020-03-16,Latvia,4,0,34,0
2020-03-17,Latvia,15,0,49,0
2020-03-18,Latvia,22,0,71,0
2020-03-19,Latvia,15,0,86,0
2020-03-20,Latvia,25,0,111,0
2020-03-21,Latvia,13,0,124,0
2020-03-22,Latvia,15,0,139,0
2020-03-23,Latvia,41,0,180,0
2020-03-24,Latvia,17,0,197,0
2020-03-25,Latvia,24,0,221,0
2020-03-26,Latvia,23,0,244,0
2020-03-27,Latvia,36,0,280,0
2020-03-28,Latvia,25,0,305,0
2020-03-29,Latvia,42,0,347,0
2020-03-30,Latvia,29,0,376,0
2020-03-31,Latvia,22,0,398,0
2020-04-01,Latvia,48,0,446,0
2020-04-02,Latvia,12,0,458,0
2020-04-03,Latvia,35,1,493,1
2020-04-04,Latvia,16,0,509,1
2020-04-05,Latvia,24,0,533,1
2020-04-06,Latvia,9,0,542,1
2020-04-07,Latvia,6,1,548,2
2020-04-08,Latvia,29,0,577,2
2020-04-09,Latvia,12,1,589,3
2020-04-10,Latvia,23,0,612,3
2020-04-11,Latvia,18,0,630,3
2020-04-12,Latvia,21,2,651,5
2020-04-13,Latvia,4,0,655,5
2020-04-14,Latvia,2,0,657,5
2020-04-15,Latvia,9,0,666,5
2020-04-16,Latvia,9,0,675,5
2020-04-17,Latvia,7,0,682,5
2020-04-18,Latvia,30,0,712,5
2020-04-19,Latvia,15,0,727,5
2020-04-20,Latvia,12,0,739,5
2020-04-21,Latvia,9,4,748,9
2020-04-22,Latvia,13,2,761,11
2020-04-23,Latvia,17,0,778,11
2020-04-24,Latvia,6,1,784,12
2020-04-25,Latvia,20,0,804,12
2020-04-26,Latvia,8,0,812,12
2020-04-27,Latvia,6,1,818,13
2020-04-28,Latvia,18,0,836,13
2020-04-29,Latvia,13,2,849,15
2020-04-30,Latvia,9,0,858,15
2020-05-01,Latvia,12,1,870,16
2020-05-02,Latvia,1,0,871,16
2020-05-03,Latvia,8,0,879,16
2020-05-04,Latvia,17,0,896,16
2020-05-05,Latvia,0,1,896,17
2020-05-06,Latvia,4,0,900,17
2020-05-07,Latvia,9,1,909,18
2020-05-08,Latvia,19,0,928,18
2020-05-09,Latvia,2,0,930,18
2020-05-10,Latvia,9,0,939,18
2020-05-11,Latvia,7,0,946,18
2020-05-12,Latvia,4,0,950,18
2020-05-13,Latvia,1,1,951,19
2020-05-14,Latvia,11,0,962,19
2020-05-15,Latvia,8,0,970,19
2020-05-16,Latvia,27,0,997,19
2020-05-17,Latvia,11,0,1008,19
2020-05-18,Latvia,1,0,1009,19
2020-05-19,Latvia,3,2,1012,21
2020-05-20,Latvia,4,0,1016,21
2020-05-21,Latvia,9,1,1025,22
2020-05-22,Latvia,5,0,1030,22
2020-05-23,Latvia,16,0,1046,22
2020-05-24,Latvia,1,0,1047,22
2020-05-25,Latvia,2,0,1049,22
2020-05-26,Latvia,4,0,1053,22
2020-05-27,Latvia,4,1,1057,23
2020-05-28,Latvia,4,1,1061,24
2020-05-29,Latvia,3,0,1064,24
2020-05-30,Latvia,1,0,1065,24
2020-05-31,Latvia,1,0,1066,24
2020-06-01,Latvia,0,0,1066,24
2020-06-02,Latvia,5,0,1071,24
2020-06-03,Latvia,8,0,1079,24
2020-06-04,Latvia,3,1,1082,25
2020-06-05,Latvia,3,0,1085,25
2020-06-06,Latvia,1,0,1086,25
2020-06-07,Latvia,2,0,1088,25
2020-06-08,Latvia,0,1,1088,26
2020-06-09,Latvia,1,0,1089,26
2020-06-10,Latvia,3,0,1092,26
2020-06-11,Latvia,2,0,1094,26
2020-06-12,Latvia,2,1,1096,27
2020-06-13,Latvia,1,1,1097,28
2020-06-14,Latvia,0,0,1097,28
2020-06-15,Latvia,0,0,1097,28
2020-06-16,Latvia,1,0,1098,28
2020-06-17,Latvia,6,2,1104,30
2020-06-18,Latvia,4,0,1108,30
2020-06-19,Latvia,2,0,1110,30
2020-06-20,Latvia,1,0,1111,30
2020-06-21,Latvia,0,0,1111,30
2020-06-22,Latvia,0,0,1111,30
2020-06-23,Latvia,0,0,1111,30
2020-06-24,Latvia,0,0,1111,30
2020-06-25,Latvia,0,0,1111,30
2020-06-26,Latvia,1,0,1112,30
2020-06-27,Latvia,3,0,1115,30
2020-06-28,Latvia,1,0,1116,30
2020-06-29,Latvia,1,0,1117,30
2020-06-30,Latvia,1,0,1118,30
2020-07-01,Latvia,3,0,1121,30
2020-07-02,Latvia,1,0,1122,30
2020-07-03,Latvia,0,0,1122,30
2020-07-04,Latvia,1,0,1123,30
2020-07-05,Latvia,1,0,1124,30
2020-07-06,Latvia,3,0,1127,30
2020-07-07,Latvia,7,0,1134,30
2020-07-08,Latvia,7,0,1141,30
2020-07-09,Latvia,13,0,1154,30
2020-07-10,Latvia,11,0,1165,30
2020-07-11,Latvia,8,0,1173,30
2020-07-12,Latvia,0,0,1173,30
2020-07-13,Latvia,1,1,1174,31
2020-07-14,Latvia,0,0,1174,31
2020-07-15,Latvia,4,0,1178,31
2020-07-16,Latvia,1,0,1179,31
2020-07-17,Latvia,6,0,1185,31
2020-07-18,Latvia,4,0,1189,31
2020-07-19,Latvia,3,0,1192,31
2020-07-20,Latvia,0,0,1192,31
2020-07-21,Latvia,1,0,1193,31
2020-07-22,Latvia,4,0,1197,31
2020-07-23,Latvia,6,0,1203,31
2020-07-24,Latvia,2,0,1205,31
2020-07-25,Latvia,1,0,1206,31
2020-07-26,Latvia,13,0,1219,31
2020-07-27,Latvia,0,0,1219,31
2020-07-28,Latvia,1,0,1220,31
2020-07-29,Latvia,4,0,1224,31
2020-07-30,Latvia,4,0,1228,31
2020-07-31,Latvia,3,1,1231,32
2020-08-01,Latvia,7,0,1238,32
2020-08-02,Latvia,5,0,1243,32
2020-08-03,Latvia,3,0,1246,32
2020-08-04,Latvia,3,0,1249,32
2020-08-05,Latvia,8,0,1257,32
2020-08-06,Latvia,18,0,1275,32
2020-08-07,Latvia,6,0,1281,32
2020-08-08,Latvia,7,0,1288,32
2020-08-09,Latvia,2,0,1290,32
2020-08-10,Latvia,0,0,1290,32
2020-08-11,Latvia,3,0,1293,32
2020-08-12,Latvia,10,0,1303,32
2020-08-13,Latvia,4,0,1307,32
2020-08-14,Latvia,1,0,1308,32
2020-08-15,Latvia,7,0,1315,32
2020-08-16,Latvia,7,0,1322,32
2020-08-17,Latvia,1,0,1323,32
2020-08-18,Latvia,0,1,1323,33
2020-08-19,Latvia,3,0,1326,33
2020-08-20,Latvia,1,0,1327,33
2020-08-21,Latvia,3,0,1330,33
2020-08-22,Latvia,3,0,1333,33
2020-08-23,Latvia,4,0,1337,33
2020-08-24,Latvia,0,0,1337,33
2020-08-25,Latvia,5,0,1342,33
2020-08-26,Latvia,18,0,1360,33
2020-08-27,Latvia,6,1,1366,34
2020-08-28,Latvia,9,0,1375,34
2020-08-29,Latvia,6,0,1381,34
2020-08-30,Latvia,12,0,1393,34
2020-08-31,Latvia,3,0,1396,34
2020-09-01,Latvia,8,0,1404,34
2020-09-02,Latvia,2,0,1406,34
2020-09-03,Latvia,4,0,1410,34
2020-09-04,Latvia,6,1,1416,35
2020-09-05,Latvia,9,0,1425,35
2020-09-06,Latvia,3,0,1428,35
2020-09-07,Latvia,1,0,1429,35
2020-09-08,Latvia,3,0,1432,35
2020-09-09,Latvia,11,0,1443,35
2020-09-10,Latvia,5,0,1448,35
2020-09-11,Latvia,11,0,1459,35
2020-09-12,Latvia,5,0,1464,35
2020-09-13,Latvia,10,0,1474,35
2020-09-14,Latvia,3,0,1477,35
2020-09-15,Latvia,5,0,1482,35
2020-09-16,Latvia,4,0,1486,35
2020-09-17,Latvia,8,1,1494,36
2020-09-18,Latvia,4,0,1498,36
2020-09-19,Latvia,17,0,1515,36
2020-09-20,Latvia,10,0,1525,36
2020-09-21,Latvia,1,0,1526,36
2020-09-22,Latvia,34,0,1560,36
2020-09-23,Latvia,12,0,1572,36
2020-09-24,Latvia,22,0,1594,36
2020-09-25,Latvia,31,0,1625,36
2020-09-26,Latvia,29,0,1654,36
2020-09-27,Latvia,22,0,1676,36
2020-09-28,Latvia,21,0,1697,36
2020-09-29,Latvia,32,1,1729,37
2020-09-30,Latvia,95,0,1824,37
2020-10-01,Latvia,44,0,1868,37
2020-10-02,Latvia,77,1,1945,38
2020-10-03,Latvia,74,0,2019,38
2020-10-04,Latvia,67,0,2086,38
2020-10-05,Latvia,40,1,2126,39
2020-10-06,Latvia,68,1,2194,40
2020-10-07,Latvia,67,0,2261,40
2020-10-08,Latvia,109,0,2370,40
2020-10-09,Latvia,137,0,2507,40
2020-10-10,Latvia,89,0,2596,40
2020-10-11,Latvia,74,0,2670,40
2020-10-12,Latvia,95,0,2765,40
2020-10-13,Latvia,75,1,2840,41
2020-10-14,Latvia,102,0,2942,41
2020-10-15,Latvia,114,0,3056,41
2020-10-16,Latvia,148,1,3204,42
2020-10-17,Latvia,188,1,3392,43
2020-10-18,Latvia,58,1,3450,44
2020-10-19,Latvia,44,0,3494,44
2020-10-20,Latvia,115,3,3609,47
2020-10-21,Latvia,188,0,3797,47
2020-10-22,Latvia,161,2,3958,49
2020-10-23,Latvia,250,1,4208,50
2020-10-24,Latvia,259,4,4467,54
2020-10-25,Latvia,211,2,4678,56
2020-10-26,Latvia,79,4,4757,60
2020-10-27,Latvia,136,3,4893,63
2020-10-28,Latvia,251,0,5144,63
2020-10-29,Latvia,251,1,5395,64
2020-10-30,Latvia,284,5,5679,69
2020-10-31,Latvia,215,2,5894,71
2020-11-01,Latvia,242,3,6136,74
2020-11-02,Latvia,132,3,6268,77
2020-11-03,Latvia,171,2,6439,79
2020-11-04,Latvia,313,6,6752,85
2020-11-05,Latvia,367,3,7119,88
2020-11-06,Latvia,357,7,7476,95
2020-11-07,Latvia,404,1,7880,96
2020-11-08,Latvia,215,3,8095,99
2020-11-09,Latvia,92,2,8187,101
2020-11-10,Latvia,208,2,8395,103
2020-11-11,Latvia,453,2,8848,105
2020-11-12,Latvia,533,2,9381,107
2020-11-13,Latvia,455,9,9836,116
2020-11-14,Latvia,395,5,10231,121
2020-11-15,Latvia,316,2,10547,123
2020-11-16,Latvia,89,3,10636,126
2020-11-17,Latvia,278,6,10914,132
2020-11-18,Latvia,442,5,11356,137
2020-11-19,Latvia,366,4,11722,141
2020-11-20,Latvia,380,5,12102,146
2020-11-21,Latvia,642,7,12744,153
2020-11-22,Latvia,376,0,13120,153
2020-11-23,Latvia,116,9,13236,162
2020-11-24,Latvia,457,13,13693,175
2020-11-25,Latvia,580,9,14273,184
2020-11-26,Latvia,898,4,15171,188
2020-11-27,Latvia,637,2,15808,190
2020-11-28,Latvia,753,3,16561,193
2020-11-29,Latvia,414,4,16975,197
2020-11-30,Latvia,100,9,17075,206
2020-12-01,Latvia,612,4,17687,210
2020-12-02,Latvia,690,14,18377,224
2020-12-03,Latvia,930,11,19307,235
2020-12-04,Latvia,686,7,19993,242
2020-12-05,Latvia,794,11,20787,253
2020-12-06,Latvia,526,9,21313,262
2020-12-07,Latvia,207,10,21520,272
2020-12-08,Latvia,584,16,22104,288
2020-12-09,Latvia,712,5,22816,293
2020-12-10,Latvia,890,11,23706,304
2020-12-11,Latvia,680,15,24386,319
2020-12-12,Latvia,660,5,25046,324
2020-12-13,Latvia,629,25,25675,349
2020-12-14,Latvia,210,3,25885,352
2020-12-15,Latvia,587,5,26472,357
2020-12-16,Latvia,1023,25,27495,382
2020-12-17,Latvia,1040,12,28535,394
2020-12-18,Latvia,892,15,29427,409
2020-12-19,Latvia,870,18,30297,427
2020-12-20,Latvia,643,12,30940,439
2020-12-21,Latvia,395,4,31335,443
2020-12-22,Latvia,1004,16,32339,459
2020-12-23,Latvia,1145,20,33484,479
2020-12-24,Latvia,1270,7,34754,486
2020-12-25,Latvia,666,16,35420,502
2020-12-26,Latvia,399,13,35819,515
2020-12-27,Latvia,511,44,36330,559
2020-12-28,Latvia,508,19,36838,578
2020-12-29,Latvia,838,25,37676,603
2020-12-30,Latvia,1367,23,39043,626
2020-12-31,Latvia,1861,9,40904,635
2021-01-01,Latvia,711,9,41615,644
2021-01-02,Latvia,314,24,41929,668
2021-01-03,Latvia,568,12,42497,680
2021-01-04,Latvia,621,12,43118,692
2021-01-05,Latvia,824,30,43942,722
2021-01-06,Latvia,1229,32,45171,754
2021-01-07,Latvia,1374,36,46545,790
2021-01-08,Latvia,1237,11,47782,801
2021-01-09,Latvia,1170,17,48952,818
2021-01-10,Latvia,616,31,49568,849
2021-01-11,Latvia,331,15,49899,864
2021-01-12,Latvia,878,18,50777,882
2021-01-13,Latvia,1255,27,52032,909
2021-01-14,Latvia,950,11,52982,920
2021-01-15,Latvia,1084,15,54066,935
2021-01-16,Latvia,1031,26,55097,961
2021-01-17,Latvia,567,17,55664,978
2021-01-18,Latvia,244,5,55908,983
2021-01-19,Latvia,812,29,56720,1012
2021-01-20,Latvia,1088,20,57808,1032
2021-01-21,Latvia,902,25,58710,1057
2021-01-22,Latvia,876,19,59586,1076
2021-01-23,Latvia,910,21,60496,1097
2021-01-24,Latvia,512,14,61008,1111
2021-01-25,Latvia,223,3,61231,1114
2021-01-26,Latvia,693,12,61924,1126
2021-01-27,Latvia,1103,12,63027,1138
2021-01-28,Latvia,965,10,63992,1148
2021-01-29,Latvia,931,18,64923,1166
2021-01-30,Latvia,785,14,65708,1180
2021-01-31,Latvia,533,15,66241,1195
2021-02-01,Latvia,411,7,66652,1202
2021-02-02,Latvia,775,17,67427,1219
2021-02-03,Latvia,1231,31,68658,1250
2021-02-04,Latvia,742,31,69400,1281
2021-02-05,Latvia,876,28,70276,1309
2021-02-06,Latvia,1044,18,71320,1327
2021-02-07,Latvia,480,12,71800,1339
2021-02-08,Latvia,288,8,72088,1347
2021-02-09,Latvia,781,16,72869,1363
2021-02-10,Latvia,990,32,73859,1395
2021-02-11,Latvia,842,21,74701,1416
2021-02-12,Latvia,808,15,75509,1431
2021-02-13,Latvia,773,12,76282,1443
2021-02-14,Latvia,424,8,76706,1451
2021-02-15,Latvia,278,17,76984,1468
2021-02-16,Latvia,713,18,77697,1486
2021-02-17,Latvia,946,22,78643,1508
2021-02-18,Latvia,708,13,79351,1521
2021-02-19,Latvia,689,12,80040,1533
2021-02-20,Latvia,1069,5,81109,1538
2021-02-21,Latvia,410,4,81519,1542
2021-02-22,Latvia,274,4,81793,1546
2021-02-23,Latvia,669,24,82462,1570
2021-02-24,Latvia,983,17,83445,1587
2021-02-25,Latvia,813,6,84258,1593
2021-02-26,Latvia,725,8,84983,1601
2021-02-27,Latvia,827,13,85810,1614
2021-02-28,Latvia,376,4,86186,1618
2021-03-01,Latvia,272,3,86458,1621
2021-03-02,Latvia,645,17,87103,1638
2021-03-03,Latvia,919,16,88022,1654
2021-03-04,Latvia,646,12,88668,1666
2021-03-05,Latvia,746,14,89414,1680
2021-03-06,Latvia,595,7,90009,1687
2021-03-07,Latvia,322,8,90331,1695
2021-03-08,Latvia,194,4,90525,1699
2021-03-09,Latvia,472,6,90997,1705
2021-03-10,Latvia,639,21,91636,1726
2021-03-11,Latvia,638,11,92274,1737
2021-03-12,Latvia,632,9,92906,1746
2021-03-13,Latvia,578,11,93484,1757
2021-03-14,Latvia,297,10,93781,1767
2021-03-15,Latvia,178,2,93959,1769
2021-03-16,Latvia,643,8,94602,1777
2021-03-17,Latvia,818,12,95420,1789
2021-03-18,Latvia,482,12,95902,1801
2021-03-19,Latvia,622,10,96524,1811
2021-03-20,Latvia,625,10,97149,1821
2021-03-21,Latvia,260,5,97409,1826
2021-03-22,Latvia,177,2,97586,1828
2021-03-23,Latvia,508,12,98094,1840
2021-03-24,Latvia,776,11,98870,1851
2021-03-25,Latvia,606,13,99476,1864
2021-03-26,Latvia,638,3,100114,1867
2021-03-27,Latvia,602,5,100716,1872
2021-03-28,Latvia,324,6,101040,1878
2021-03-29,Latvia,167,5,101207,1883
2021-03-30,Latvia,526,10,101733,1893
2021-03-31,Latvia,630,6,102363,1899
2021-04-01,Latvia,638,14,103001,1913
2021-04-02,Latvia,587,9,103588,1922
2021-04-03,Latvia,279,1,103867,1923
2021-04-04,Latvia,238,8,104105,1931
2021-04-05,Latvia,119,3,104224,1934
2021-04-06,Latvia,309,3,104533,1937
2021-04-07,Latvia,643,9,105176,1946
2021-04-08,Latvia,740,17,105916,1963
2020-02-21,Lebanon,1,0,1,0
2020-02-22,Lebanon,0,0,1,0
2020-02-23,Lebanon,0,0,1,0
2020-02-24,Lebanon,0,0,1,0
2020-02-25,Lebanon,0,0,1,0
2020-02-26,Lebanon,1,0,2,0
2020-02-27,Lebanon,0,0,2,0
2020-02-28,Lebanon,0,0,2,0
2020-02-29,Lebanon,2,0,4,0
2020-03-01,Lebanon,6,0,10,0
2020-03-02,Lebanon,3,0,13,0
2020-03-03,Lebanon,0,0,13,0
2020-03-04,Lebanon,0,0,13,0
2020-03-05,Lebanon,3,0,16,0
2020-03-06,Lebanon,6,0,22,0
2020-03-07,Lebanon,0,0,22,0
2020-03-08,Lebanon,10,0,32,0
2020-03-09,Lebanon,0,0,32,0
2020-03-10,Lebanon,9,1,41,1
2020-03-11,Lebanon,20,2,61,3
2020-03-12,Lebanon,0,0,61,3
2020-03-13,Lebanon,16,0,77,3
2020-03-14,Lebanon,16,0,93,3
2020-03-15,Lebanon,17,0,110,3
2020-03-16,Lebanon,0,0,110,3
2020-03-17,Lebanon,10,0,120,3
2020-03-18,Lebanon,13,0,133,3
2020-03-19,Lebanon,24,1,157,4
2020-03-20,Lebanon,6,0,163,4
2020-03-21,Lebanon,24,0,187,4
2020-03-22,Lebanon,61,0,248,4
2020-03-23,Lebanon,19,0,267,4
2020-03-24,Lebanon,51,0,318,4
2020-03-25,Lebanon,15,2,333,6
2020-03-26,Lebanon,35,0,368,6
2020-03-27,Lebanon,23,2,391,8
2020-03-28,Lebanon,21,0,412,8
2020-03-29,Lebanon,26,2,438,10
2020-03-30,Lebanon,8,1,446,11
2020-03-31,Lebanon,24,1,470,12
2020-04-01,Lebanon,9,2,479,14
2020-04-02,Lebanon,15,2,494,16
2020-04-03,Lebanon,14,1,508,17
2020-04-04,Lebanon,12,0,520,17
2020-04-05,Lebanon,7,1,527,18
2020-04-06,Lebanon,14,1,541,19
2020-04-07,Lebanon,7,0,548,19
2020-04-08,Lebanon,28,0,576,19
2020-04-09,Lebanon,6,0,582,19
2020-04-10,Lebanon,27,1,609,20
2020-04-11,Lebanon,10,0,619,20
2020-04-12,Lebanon,11,0,630,20
2020-04-13,Lebanon,2,0,632,20
2020-04-14,Lebanon,9,1,641,21
2020-04-15,Lebanon,17,0,658,21
2020-04-16,Lebanon,5,0,663,21
2020-04-17,Lebanon,5,0,668,21
2020-04-18,Lebanon,4,0,672,21
2020-04-19,Lebanon,1,0,673,21
2020-04-20,Lebanon,4,0,677,21
2020-04-21,Lebanon,0,0,677,21
2020-04-22,Lebanon,5,1,682,22
2020-04-23,Lebanon,6,0,688,22
2020-04-24,Lebanon,8,0,696,22
2020-04-25,Lebanon,8,2,704,24
2020-04-26,Lebanon,3,0,707,24
2020-04-27,Lebanon,3,0,710,24
2020-04-28,Lebanon,7,0,717,24
2020-04-29,Lebanon,4,0,721,24
2020-04-30,Lebanon,4,0,725,24
2020-05-01,Lebanon,4,0,729,24
2020-05-02,Lebanon,4,1,733,25
2020-05-03,Lebanon,4,0,737,25
2020-05-04,Lebanon,3,0,740,25
2020-05-05,Lebanon,1,0,741,25
2020-05-06,Lebanon,9,0,750,25
2020-05-07,Lebanon,34,0,784,25
2020-05-08,Lebanon,12,1,796,26
2020-05-09,Lebanon,13,0,809,26
2020-05-10,Lebanon,36,0,845,26
2020-05-11,Lebanon,14,0,859,26
2020-05-12,Lebanon,11,0,870,26
2020-05-13,Lebanon,8,0,878,26
2020-05-14,Lebanon,8,0,886,26
2020-05-15,Lebanon,5,0,891,26
2020-05-16,Lebanon,11,0,902,26
2020-05-17,Lebanon,9,0,911,26
2020-05-18,Lebanon,20,0,931,26
2020-05-19,Lebanon,23,0,954,26
2020-05-20,Lebanon,7,0,961,26
2020-05-21,Lebanon,63,0,1024,26
2020-05-22,Lebanon,62,0,1086,26
2020-05-23,Lebanon,11,0,1097,26
2020-05-24,Lebanon,17,0,1114,26
2020-05-25,Lebanon,5,0,1119,26
2020-05-26,Lebanon,21,0,1140,26
2020-05-27,Lebanon,21,0,1161,26
2020-05-28,Lebanon,7,0,1168,26
2020-05-29,Lebanon,4,0,1172,26
2020-05-30,Lebanon,19,0,1191,26
2020-05-31,Lebanon,29,1,1220,27
2020-06-01,Lebanon,13,0,1233,27
2020-06-02,Lebanon,9,0,1242,27
2020-06-03,Lebanon,14,0,1256,27
2020-06-04,Lebanon,50,1,1306,28
2020-06-05,Lebanon,6,0,1312,28
2020-06-06,Lebanon,8,1,1320,29
2020-06-07,Lebanon,11,1,1331,30
2020-06-08,Lebanon,19,0,1350,30
2020-06-09,Lebanon,18,0,1368,30
2020-06-10,Lebanon,20,0,1388,30
2020-06-11,Lebanon,14,1,1402,31
2020-06-12,Lebanon,20,0,1422,31
2020-06-13,Lebanon,20,1,1442,32
2020-06-14,Lebanon,4,0,1446,32
2020-06-15,Lebanon,18,0,1464,32
2020-06-16,Lebanon,9,0,1473,32
2020-06-17,Lebanon,16,0,1489,32
2020-06-18,Lebanon,6,0,1495,32
2020-06-19,Lebanon,15,0,1510,32
2020-06-20,Lebanon,26,0,1536,32
2020-06-21,Lebanon,51,0,1587,32
2020-06-22,Lebanon,16,0,1603,32
2020-06-23,Lebanon,19,0,1622,32
2020-06-24,Lebanon,22,1,1644,33
2020-06-25,Lebanon,18,0,1662,33
2020-06-26,Lebanon,35,0,1697,33
2020-06-27,Lebanon,22,0,1719,33
2020-06-28,Lebanon,21,1,1740,34
2020-06-29,Lebanon,5,0,1745,34
2020-06-30,Lebanon,33,0,1778,34
2020-07-01,Lebanon,10,0,1788,34
2020-07-02,Lebanon,8,1,1796,35
2020-07-03,Lebanon,34,0,1830,35
2020-07-04,Lebanon,25,0,1855,35
2020-07-05,Lebanon,18,1,1873,36
2020-07-06,Lebanon,12,0,1885,36
2020-07-07,Lebanon,22,0,1907,36
2020-07-08,Lebanon,39,0,1946,36
2020-07-09,Lebanon,65,0,2011,36
2020-07-10,Lebanon,71,0,2082,36
2020-07-11,Lebanon,86,0,2168,36
2020-07-12,Lebanon,166,0,2334,36
2020-07-13,Lebanon,85,0,2419,36
2020-07-14,Lebanon,32,1,2451,37
2020-07-15,Lebanon,91,1,2542,38
2020-07-16,Lebanon,57,2,2599,40
2020-07-17,Lebanon,101,0,2700,40
2020-07-18,Lebanon,75,0,2775,40
2020-07-19,Lebanon,84,0,2859,40
2020-07-20,Lebanon,46,1,2905,41
2020-07-21,Lebanon,75,0,2980,41
2020-07-22,Lebanon,124,2,3104,43
2020-07-23,Lebanon,156,0,3260,43
2020-07-24,Lebanon,147,3,3407,46
2020-07-25,Lebanon,175,1,3582,47
2020-07-26,Lebanon,168,4,3750,51
2020-07-27,Lebanon,132,0,3882,51
2020-07-28,Lebanon,141,3,4023,54
2020-07-29,Lebanon,182,1,4205,55
2020-07-30,Lebanon,129,2,4334,57
2020-07-31,Lebanon,221,4,4555,61
2020-08-01,Lebanon,175,0,4730,61
2020-08-02,Lebanon,155,1,4885,62
2020-08-03,Lebanon,177,3,5062,65
2020-08-04,Lebanon,0,0,5062,65
2020-08-05,Lebanon,355,3,5417,68
2020-08-06,Lebanon,255,2,5672,70
2020-08-07,Lebanon,279,0,5951,70
2020-08-08,Lebanon,272,8,6223,78
2020-08-09,Lebanon,294,0,6517,78
2020-08-10,Lebanon,295,2,6812,80
2020-08-11,Lebanon,309,7,7121,87
2020-08-12,Lebanon,292,2,7413,89
2020-08-13,Lebanon,298,3,7711,92
2020-08-14,Lebanon,334,2,8045,94
2020-08-15,Lebanon,397,3,8442,97
2020-08-16,Lebanon,439,6,8881,103
2020-08-17,Lebanon,456,2,9337,105
2020-08-18,Lebanon,421,2,9758,107
2020-08-19,Lebanon,589,2,10347,109
2020-08-20,Lebanon,605,4,10952,113
2020-08-21,Lebanon,628,3,11580,116
2020-08-22,Lebanon,611,5,12191,121
2020-08-23,Lebanon,507,2,12698,123
2020-08-24,Lebanon,457,3,13155,126
2020-08-25,Lebanon,532,12,13687,138
2020-08-26,Lebanon,561,1,14248,139
2020-08-27,Lebanon,689,7,14937,146
2020-08-28,Lebanon,676,2,15613,148
2020-08-29,Lebanon,662,7,16275,155
2020-08-30,Lebanon,595,5,16870,160
2020-08-31,Lebanon,438,7,17308,167
2020-09-01,Lebanon,469,4,17777,171
2020-09-02,Lebanon,598,6,18375,177
2020-09-03,Lebanon,588,2,18963,179
2020-09-04,Lebanon,527,4,19490,183
2020-09-05,Lebanon,521,4,20011,187
2020-09-06,Lebanon,415,4,20426,191
2020-09-07,Lebanon,400,9,20826,200
2020-09-08,Lebanon,498,7,21324,207
2020-09-09,Lebanon,553,5,21877,212
2020-09-10,Lebanon,560,7,22437,219
2020-09-11,Lebanon,546,10,22983,229
2020-09-12,Lebanon,686,10,23669,239
2020-09-13,Lebanon,641,2,24310,241
2020-09-14,Lebanon,1091,5,25401,246
2020-09-15,Lebanon,48,6,25449,252
2020-09-16,Lebanon,634,7,26083,259
2020-09-17,Lebanon,685,4,26768,263
2020-09-18,Lebanon,750,18,27518,281
2020-09-19,Lebanon,779,5,28297,286
2020-09-20,Lebanon,1006,11,29303,297
2020-09-21,Lebanon,684,10,29987,307
2020-09-22,Lebanon,865,8,30852,315
2020-09-23,Lebanon,940,13,31792,328
2020-09-24,Lebanon,1027,1,32819,329
2020-09-25,Lebanon,1143,4,33962,333
2020-09-26,Lebanon,1280,7,35242,340
2020-09-27,Lebanon,1012,7,36254,347
2020-09-28,Lebanon,1018,4,37272,351
2020-09-29,Lebanon,1105,10,38377,361
2020-09-30,Lebanon,1257,6,39634,367
2020-10-01,Lebanon,1248,7,40882,374
2020-10-02,Lebanon,1291,12,42173,386
2020-10-03,Lebanon,1321,12,43494,398
2020-10-04,Lebanon,988,8,44482,406
2020-10-05,Lebanon,1175,8,45657,414
2020-10-06,Lebanon,1261,10,46918,424
2020-10-07,Lebanon,1459,9,48377,433
2020-10-08,Lebanon,1367,6,49744,439
2020-10-09,Lebanon,1426,11,51170,450
2020-10-10,Lebanon,1388,5,52558,455
2020-10-11,Lebanon,1010,4,53568,459
2020-10-12,Lebanon,1056,7,54624,466
2020-10-13,Lebanon,1245,13,55869,479
2020-10-14,Lebanon,1377,20,57246,499
2020-10-15,Lebanon,1499,2,58745,501
2020-10-16,Lebanon,1368,8,60113,509
2020-10-17,Lebanon,1171,8,61284,517
2020-10-18,Lebanon,1002,3,62286,520
2020-10-19,Lebanon,658,6,62944,526
2020-10-20,Lebanon,1392,5,64336,531
2020-10-21,Lebanon,1241,5,65577,536
2020-10-22,Lebanon,1450,16,67027,552
2020-10-23,Lebanon,1452,7,68479,559
2020-10-24,Lebanon,1427,3,69906,562
2020-10-25,Lebanon,1484,3,71390,565
2020-10-26,Lebanon,796,14,72186,579
2020-10-27,Lebanon,1809,11,73995,590
2020-10-28,Lebanon,1850,12,75845,602
2020-10-29,Lebanon,1933,8,77778,610
2020-10-30,Lebanon,1751,15,79529,625
2020-10-31,Lebanon,1699,12,81228,637
2020-11-01,Lebanon,1389,6,82617,643
2020-11-02,Lebanon,1080,9,83697,652
2020-11-03,Lebanon,1512,15,85209,667
2020-11-04,Lebanon,1888,9,87097,676
2020-11-05,Lebanon,2089,7,89186,683
2020-11-06,Lebanon,2142,17,91328,700
2020-11-07,Lebanon,1769,13,93097,713
2020-11-08,Lebanon,1139,10,94236,723
2020-11-09,Lebanon,1119,9,95355,732
2020-11-10,Lebanon,1552,17,96907,749
2020-11-11,Lebanon,1922,14,98829,763
2020-11-12,Lebanon,1874,12,100703,775
2020-11-13,Lebanon,1904,21,102607,796
2020-11-14,Lebanon,1660,10,104267,806
2020-11-15,Lebanon,1163,11,105430,817
2020-11-16,Lebanon,1016,10,106446,827
2020-11-17,Lebanon,1507,12,107953,839
2020-11-18,Lebanon,2084,13,110037,852
2020-11-19,Lebanon,1909,16,111946,868
2020-11-20,Lebanon,1709,16,113655,884
2020-11-21,Lebanon,1628,10,115283,894
2020-11-22,Lebanon,1193,6,116476,900
2020-11-23,Lebanon,1041,11,117517,911
2020-11-24,Lebanon,1188,23,118705,934
2020-11-25,Lebanon,1636,16,120341,950
2020-11-26,Lebanon,1859,24,122200,974
2020-11-27,Lebanon,1782,6,123982,980
2020-11-28,Lebanon,1696,11,125678,991
2020-11-29,Lebanon,1266,13,126944,1004
2020-11-30,Lebanon,1000,14,127944,1018
2020-12-01,Lebanon,1511,15,129455,1033
2020-12-02,Lebanon,1842,22,131297,1055
2020-12-03,Lebanon,1520,12,132817,1067
2020-12-04,Lebanon,1478,11,134295,1078
2020-12-05,Lebanon,0,0,134295,1078
2020-12-06,Lebanon,2817,21,137112,1099
2020-12-07,Lebanon,984,16,138096,1115
2020-12-08,Lebanon,1039,21,139135,1136
2020-12-09,Lebanon,1274,20,140409,1156
2020-12-10,Lebanon,1778,14,142187,1170
2020-12-11,Lebanon,1518,12,143705,1182
2020-12-12,Lebanon,1540,8,145245,1190
2020-12-13,Lebanon,1275,10,146520,1200
2020-12-14,Lebanon,1093,10,147613,1210
2020-12-15,Lebanon,1264,13,148877,1223
2020-12-16,Lebanon,2056,11,150933,1234
2020-12-17,Lebanon,2116,14,153049,1248
2020-12-18,Lebanon,1895,11,154944,1259
2020-12-19,Lebanon,1626,11,156570,1270
2020-12-20,Lebanon,1534,11,158104,1281
2020-12-21,Lebanon,1182,13,159286,1294
2020-12-22,Lebanon,1693,17,160979,1311
2020-12-23,Lebanon,2246,22,163225,1333
2020-12-24,Lebanon,2708,20,165933,1353
2020-12-25,Lebanon,2136,14,168069,1367
2020-12-26,Lebanon,1403,12,169472,1379
2020-12-27,Lebanon,1754,15,171226,1394
2020-12-28,Lebanon,1594,15,172820,1409
2020-12-29,Lebanon,2298,21,175118,1430
2020-12-30,Lebanon,2878,26,177996,1456
2020-12-31,Lebanon,3507,12,181503,1468
2021-01-01,Lebanon,2385,11,183888,1479
2021-01-02,Lebanon,2520,10,186408,1489
2021-01-03,Lebanon,2870,10,189278,1499
2021-01-04,Lebanon,2861,13,192139,1512
2021-01-05,Lebanon,3620,17,195759,1529
2021-01-06,Lebanon,4166,21,199925,1550
2021-01-07,Lebanon,4774,16,204699,1566
2021-01-08,Lebanon,5440,4,210139,1570
2021-01-09,Lebanon,5414,20,215553,1590
2021-01-10,Lebanon,3743,16,219296,1606
2021-01-11,Lebanon,3095,23,222391,1629
2021-01-12,Lebanon,4557,76,226948,1705
2021-01-13,Lebanon,4988,35,231936,1740
2021-01-14,Lebanon,5196,41,237132,1781
2021-01-15,Lebanon,6154,44,243286,1825
2021-01-16,Lebanon,5872,41,249158,1866
2021-01-17,Lebanon,3654,40,252812,1906
2021-01-18,Lebanon,3144,53,255956,1959
2021-01-19,Lebanon,4359,61,260315,2020
2021-01-20,Lebanon,4332,64,264647,2084
2021-01-21,Lebanon,4594,67,269241,2151
2021-01-22,Lebanon,3220,57,272461,2208
2021-01-23,Lebanon,4126,62,276587,2270
2021-01-24,Lebanon,3010,50,279597,2320
2021-01-25,Lebanon,2652,54,282249,2374
2021-01-26,Lebanon,3505,103,285754,2477
2021-01-27,Lebanon,3906,76,289660,2553
2021-01-28,Lebanon,3497,68,293157,2621
2021-01-29,Lebanon,3125,59,296282,2680
2021-01-30,Lebanon,2631,351,298913,3031
2021-01-31,Lebanon,2139,51,301052,3082
2021-02-01,Lebanon,2020,63,303072,3145
2021-02-02,Lebanon,2770,81,305842,3226
2021-02-03,Lebanon,3320,89,309162,3315
2021-02-04,Lebanon,3107,82,312269,3397
2021-02-05,Lebanon,3071,98,315340,3495
2021-02-06,Lebanon,2496,67,317836,3562
2021-02-07,Lebanon,2081,54,319917,3616
2021-02-08,Lebanon,2063,61,321980,3677
2021-02-09,Lebanon,2886,60,324866,3737
2021-02-10,Lebanon,3157,66,328023,3803
2021-02-11,Lebanon,3136,63,331159,3866
2021-02-12,Lebanon,2934,49,334093,3915
2021-02-13,Lebanon,2906,46,336999,3961
2021-02-14,Lebanon,2130,32,339129,3993
2021-02-15,Lebanon,1739,44,340868,4037
2021-02-16,Lebanon,2733,55,343601,4092
2021-02-17,Lebanon,2479,60,346080,4152
2021-02-18,Lebanon,2730,54,348810,4206
2021-02-19,Lebanon,2255,51,351065,4257
2021-02-20,Lebanon,2306,40,353371,4297
2021-02-21,Lebanon,1702,43,355073,4340
2021-02-22,Lebanon,1541,47,356614,4387
2021-02-23,Lebanon,2723,59,359337,4446
2021-02-24,Lebanon,3513,62,362850,4508
2021-02-25,Lebanon,3469,52,366319,4560
2021-02-26,Lebanon,3373,50,369692,4610
2021-02-27,Lebanon,3100,42,372792,4652
2021-02-28,Lebanon,2258,40,375050,4692
2021-03-01,Lebanon,1888,51,376938,4743
2021-03-02,Lebanon,3098,62,380036,4805
2021-03-03,Lebanon,3463,61,383499,4866
2021-03-04,Lebanon,3369,53,386868,4919
2021-03-05,Lebanon,3202,52,390070,4971
2021-03-06,Lebanon,3158,42,393228,5013
2021-03-07,Lebanon,2376,33,395604,5046
2021-03-08,Lebanon,2283,43,397887,5089
2021-03-09,Lebanon,3939,45,401826,5134
2021-03-10,Lebanon,3581,46,405407,5180
2021-03-11,Lebanon,3502,50,408909,5230
2021-03-12,Lebanon,2930,48,411839,5278
2021-03-13,Lebanon,3523,56,415362,5334
2021-03-14,Lebanon,3086,46,418448,5380
2021-03-15,Lebanon,1505,42,419953,5422
2021-03-16,Lebanon,3480,52,423433,5474
2021-03-17,Lebanon,3544,62,426977,5536
2021-03-18,Lebanon,3757,73,430734,5609
2021-03-19,Lebanon,3588,55,434322,5664
2021-03-20,Lebanon,2253,51,436575,5715
2021-03-21,Lebanon,2993,42,439568,5757
2021-03-22,Lebanon,1446,51,441014,5808
2021-03-23,Lebanon,3851,42,444865,5850
2021-03-24,Lebanon,3856,53,448721,5903
2021-03-25,Lebanon,3560,61,452281,5964
2021-03-26,Lebanon,3100,49,455381,6013
2021-03-27,Lebanon,2957,45,458338,6058
2021-03-28,Lebanon,2724,38,461062,6096
2021-03-29,Lebanon,1277,40,462339,6136
2021-03-30,Lebanon,2668,48,465007,6184
2021-03-31,Lebanon,3393,50,468400,6234
2021-04-01,Lebanon,3562,52,471962,6286
2021-04-02,Lebanon,2963,60,474925,6346
2021-04-03,Lebanon,2188,33,477113,6379
2021-04-04,Lebanon,2388,30,479501,6409
2021-04-05,Lebanon,1001,34,480502,6443
2021-04-06,Lebanon,2296,36,482798,6479
2021-04-07,Lebanon,3120,33,485918,6512
2021-04-08,Lebanon,3510,37,489428,6549
2020-05-13,Lesotho,1,0,1,0
2020-05-14,Lesotho,0,0,1,0
2020-05-15,Lesotho,0,0,1,0
2020-05-16,Lesotho,0,0,1,0
2020-05-17,Lesotho,0,0,1,0
2020-05-18,Lesotho,0,0,1,0
2020-05-19,Lesotho,0,0,1,0
2020-05-20,Lesotho,0,0,1,0
2020-05-21,Lesotho,0,0,1,0
2020-05-22,Lesotho,1,0,2,0
2020-05-23,Lesotho,0,0,2,0
2020-05-24,Lesotho,0,0,2,0
2020-05-25,Lesotho,0,0,2,0
2020-05-26,Lesotho,0,0,2,0
2020-05-27,Lesotho,0,0,2,0
2020-05-28,Lesotho,0,0,2,0
2020-05-29,Lesotho,0,0,2,0
2020-05-30,Lesotho,0,0,2,0
2020-05-31,Lesotho,0,0,2,0
2020-06-01,Lesotho,0,0,2,0
2020-06-02,Lesotho,0,0,2,0
2020-06-03,Lesotho,2,0,4,0
2020-06-04,Lesotho,0,0,4,0
2020-06-05,Lesotho,0,0,4,0
2020-06-06,Lesotho,0,0,4,0
2020-06-07,Lesotho,0,0,4,0
2020-06-08,Lesotho,0,0,4,0
2020-06-09,Lesotho,0,0,4,0
2020-06-10,Lesotho,0,0,4,0
2020-06-11,Lesotho,0,0,4,0
2020-06-12,Lesotho,0,0,4,0
2020-06-13,Lesotho,0,0,4,0
2020-06-14,Lesotho,0,0,4,0
2020-06-15,Lesotho,0,0,4,0
2020-06-16,Lesotho,0,0,4,0
2020-06-17,Lesotho,0,0,4,0
2020-06-18,Lesotho,0,0,4,0
2020-06-19,Lesotho,0,0,4,0
2020-06-20,Lesotho,0,0,4,0
2020-06-21,Lesotho,0,0,4,0
2020-06-22,Lesotho,8,0,12,0
2020-06-23,Lesotho,5,0,17,0
2020-06-24,Lesotho,0,0,17,0
2020-06-25,Lesotho,0,0,17,0
2020-06-26,Lesotho,7,0,24,0
2020-06-27,Lesotho,0,0,24,0
2020-06-28,Lesotho,3,0,27,0
2020-06-29,Lesotho,0,0,27,0
2020-06-30,Lesotho,0,0,27,0
2020-07-01,Lesotho,8,0,35,0
2020-07-02,Lesotho,0,0,35,0
2020-07-03,Lesotho,0,0,35,0
2020-07-04,Lesotho,0,0,35,0
2020-07-05,Lesotho,44,0,79,0
2020-07-06,Lesotho,12,0,91,0
2020-07-07,Lesotho,0,0,91,0
2020-07-08,Lesotho,0,0,91,0
2020-07-09,Lesotho,43,1,134,1
2020-07-10,Lesotho,50,0,184,1
2020-07-11,Lesotho,0,0,184,1
2020-07-12,Lesotho,49,1,233,2
2020-07-13,Lesotho,12,1,245,3
2020-07-14,Lesotho,11,0,256,3
2020-07-15,Lesotho,0,0,256,3
2020-07-16,Lesotho,0,0,256,3
2020-07-17,Lesotho,55,3,311,6
2020-07-18,Lesotho,48,0,359,6
2020-07-19,Lesotho,0,0,359,6
2020-07-20,Lesotho,0,0,359,6
2020-07-21,Lesotho,0,0,359,6
2020-07-22,Lesotho,0,0,359,6
2020-07-23,Lesotho,0,0,359,6
2020-07-24,Lesotho,0,0,359,6
2020-07-25,Lesotho,60,3,419,9
2020-07-26,Lesotho,86,3,505,12
2020-07-27,Lesotho,0,0,505,12
2020-07-28,Lesotho,0,0,505,12
2020-07-29,Lesotho,71,1,576,13
2020-07-30,Lesotho,28,0,604,13
2020-07-31,Lesotho,0,0,604,13
2020-08-01,Lesotho,98,1,702,14
2020-08-02,Lesotho,16,5,718,19
2020-08-03,Lesotho,0,0,718,19
2020-08-04,Lesotho,8,2,726,21
2020-08-05,Lesotho,0,0,726,21
2020-08-06,Lesotho,16,2,742,23
2020-08-07,Lesotho,0,0,742,23
2020-08-08,Lesotho,0,0,742,23
2020-08-09,Lesotho,0,0,742,23
2020-08-10,Lesotho,39,1,781,24
2020-08-11,Lesotho,0,0,781,24
2020-08-12,Lesotho,17,0,798,24
2020-08-13,Lesotho,86,1,884,25
2020-08-14,Lesotho,0,0,884,25
2020-08-15,Lesotho,19,0,903,25
2020-08-16,Lesotho,0,0,903,25
2020-08-17,Lesotho,43,5,946,30
2020-08-18,Lesotho,0,0,946,30
2020-08-19,Lesotho,0,0,946,30
2020-08-20,Lesotho,50,0,996,30
2020-08-21,Lesotho,19,0,1015,30
2020-08-22,Lesotho,0,0,1015,30
2020-08-23,Lesotho,0,0,1015,30
2020-08-24,Lesotho,0,0,1015,30
2020-08-25,Lesotho,34,0,1049,30
2020-08-26,Lesotho,2,1,1051,31
2020-08-27,Lesotho,0,0,1051,31
2020-08-28,Lesotho,0,0,1051,31
2020-08-29,Lesotho,0,0,1051,31
2020-08-30,Lesotho,34,0,1085,31
2020-08-31,Lesotho,0,0,1085,31
2020-09-01,Lesotho,0,0,1085,31
2020-09-02,Lesotho,0,0,1085,31
2020-09-03,Lesotho,0,0,1085,31
2020-09-04,Lesotho,63,0,1148,31
2020-09-05,Lesotho,0,0,1148,31
2020-09-06,Lesotho,0,0,1148,31
2020-09-07,Lesotho,0,0,1148,31
2020-09-08,Lesotho,0,0,1148,31
2020-09-09,Lesotho,16,0,1164,31
2020-09-10,Lesotho,0,0,1164,31
2020-09-11,Lesotho,81,2,1245,33
2020-09-12,Lesotho,0,0,1245,33
2020-09-13,Lesotho,0,0,1245,33
2020-09-14,Lesotho,0,0,1245,33
2020-09-15,Lesotho,82,0,1327,33
2020-09-16,Lesotho,0,0,1327,33
2020-09-17,Lesotho,0,0,1327,33
2020-09-18,Lesotho,63,0,1390,33
2020-09-19,Lesotho,0,0,1390,33
2020-09-20,Lesotho,34,0,1424,33
2020-09-21,Lesotho,0,0,1424,33
2020-09-22,Lesotho,0,0,1424,33
2020-09-23,Lesotho,83,2,1507,35
2020-09-24,Lesotho,47,0,1554,35
2020-09-25,Lesotho,4,0,1558,35
2020-09-26,Lesotho,0,0,1558,35
2020-09-27,Lesotho,0,0,1558,35
2020-09-28,Lesotho,7,0,1565,35
2020-09-29,Lesotho,11,0,1576,35
2020-09-30,Lesotho,19,1,1595,36
2020-10-01,Lesotho,44,2,1639,38
2020-10-02,Lesotho,41,1,1680,39
2020-10-03,Lesotho,0,0,1680,39
2020-10-04,Lesotho,3,0,1683,39
2020-10-05,Lesotho,0,0,1683,39
2020-10-06,Lesotho,0,0,1683,39
2020-10-07,Lesotho,84,1,1767,40
2020-10-08,Lesotho,19,1,1786,41
2020-10-09,Lesotho,14,1,1800,42
2020-10-10,Lesotho,0,0,1800,42
2020-10-11,Lesotho,5,0,1805,42
2020-10-12,Lesotho,0,0,1805,42
2020-10-13,Lesotho,17,0,1822,42
2020-10-14,Lesotho,11,0,1833,42
2020-10-15,Lesotho,0,0,1833,42
2020-10-16,Lesotho,0,0,1833,42
2020-10-17,Lesotho,0,0,1833,42
2020-10-18,Lesotho,0,0,1833,42
2020-10-19,Lesotho,0,0,1833,42
2020-10-20,Lesotho,85,1,1918,43
2020-10-21,Lesotho,0,0,1918,43
2020-10-22,Lesotho,5,0,1923,43
2020-10-23,Lesotho,11,0,1934,43
2020-10-24,Lesotho,6,0,1940,43
2020-10-25,Lesotho,0,0,1940,43
2020-10-26,Lesotho,3,0,1943,43
2020-10-27,Lesotho,4,0,1947,43
2020-10-28,Lesotho,0,0,1947,43
2020-10-29,Lesotho,0,0,1947,43
2020-10-30,Lesotho,6,1,1953,44
2020-10-31,Lesotho,0,0,1953,44
2020-11-01,Lesotho,0,0,1953,44
2020-11-02,Lesotho,8,0,1961,44
2020-11-03,Lesotho,0,0,1961,44
2020-11-04,Lesotho,2,0,1963,44
2020-11-05,Lesotho,0,0,1963,44
2020-11-06,Lesotho,4,0,1967,44
2020-11-07,Lesotho,0,0,1967,44
2020-11-08,Lesotho,0,0,1967,44
2020-11-09,Lesotho,0,0,1967,44
2020-11-10,Lesotho,59,0,2026,44
2020-11-11,Lesotho,0,0,2026,44
2020-11-12,Lesotho,0,0,2026,44
2020-11-13,Lesotho,15,0,2041,44
2020-11-14,Lesotho,0,0,2041,44
2020-11-15,Lesotho,0,0,2041,44
2020-11-16,Lesotho,0,0,2041,44
2020-11-17,Lesotho,11,0,2052,44
2020-11-18,Lesotho,6,0,2058,44
2020-11-19,Lesotho,7,0,2065,44
2020-11-20,Lesotho,1,0,2066,44
2020-11-21,Lesotho,19,0,2085,44
2020-11-22,Lesotho,1,0,2086,44
2020-11-23,Lesotho,0,0,2086,44
2020-11-24,Lesotho,6,0,2092,44
2020-11-25,Lesotho,0,0,2092,44
2020-11-26,Lesotho,17,0,2109,44
2020-11-27,Lesotho,0,0,2109,44
2020-11-28,Lesotho,0,0,2109,44
2020-11-29,Lesotho,0,0,2109,44
2020-11-30,Lesotho,0,0,2109,44
2020-12-01,Lesotho,28,0,2137,44
2020-12-02,Lesotho,5,0,2142,44
2020-12-03,Lesotho,3,0,2145,44
2020-12-04,Lesotho,5,0,2150,44
2020-12-05,Lesotho,0,0,2150,44
2020-12-06,Lesotho,0,0,2150,44
2020-12-07,Lesotho,0,0,2150,44
2020-12-08,Lesotho,0,0,2150,44
2020-12-09,Lesotho,14,0,2164,44
2020-12-10,Lesotho,14,0,2178,44
2020-12-11,Lesotho,36,0,2214,44
2020-12-12,Lesotho,36,0,2250,44
2020-12-13,Lesotho,0,0,2250,44
2020-12-14,Lesotho,27,0,2277,44
2020-12-15,Lesotho,30,0,2307,44
2020-12-16,Lesotho,58,2,2365,46
2020-12-17,Lesotho,35,0,2400,46
2020-12-18,Lesotho,146,2,2546,48
2020-12-19,Lesotho,0,0,2546,48
2020-12-20,Lesotho,0,0,2546,48
2020-12-21,Lesotho,0,0,2546,48
2020-12-22,Lesotho,0,0,2546,48
2020-12-23,Lesotho,179,3,2725,51
2020-12-24,Lesotho,0,0,2725,51
2020-12-25,Lesotho,0,0,2725,51
2020-12-26,Lesotho,0,0,2725,51
2020-12-27,Lesotho,0,0,2725,51
2020-12-28,Lesotho,231,0,2956,51
2020-12-29,Lesotho,49,0,3005,51
2020-12-30,Lesotho,89,0,3094,51
2020-12-31,Lesotho,0,0,3094,51
2021-01-01,Lesotho,112,0,3206,51
2021-01-02,Lesotho,0,14,3206,65
2021-01-03,Lesotho,0,0,3206,65
2021-01-04,Lesotho,0,0,3206,65
2021-01-05,Lesotho,0,0,3206,65
2021-01-06,Lesotho,931,8,4137,73
2021-01-07,Lesotho,214,3,4351,76
2021-01-08,Lesotho,819,3,5170,79
2021-01-09,Lesotho,33,5,5203,84
2021-01-10,Lesotho,734,1,5937,85
2021-01-11,Lesotho,0,0,5937,85
2021-01-12,Lesotho,0,0,5937,85
2021-01-13,Lesotho,304,2,6241,87
2021-01-14,Lesotho,115,2,6356,89
2021-01-15,Lesotho,15,4,6371,93
2021-01-16,Lesotho,0,0,6371,93
2021-01-17,Lesotho,0,0,6371,93
2021-01-18,Lesotho,647,8,7018,101
2021-01-19,Lesotho,0,0,7018,101
2021-01-20,Lesotho,17,1,7035,102
2021-01-21,Lesotho,469,1,7504,103
2021-01-22,Lesotho,51,10,7555,113
2021-01-23,Lesotho,101,10,7656,123
2021-01-24,Lesotho,0,0,7656,123
2021-01-25,Lesotho,388,11,8044,134
2021-01-26,Lesotho,3,12,8047,146
2021-01-27,Lesotho,0,0,8047,146
2021-01-28,Lesotho,231,14,8278,160
2021-01-29,Lesotho,332,3,8610,163
2021-01-30,Lesotho,39,1,8649,164
2021-01-31,Lesotho,15,8,8664,172
2021-02-01,Lesotho,236,0,8900,172
2021-02-02,Lesotho,0,0,8900,172
2021-02-03,Lesotho,69,6,8969,178
2021-02-04,Lesotho,0,0,8969,178
2021-02-05,Lesotho,247,2,9216,180
2021-02-06,Lesotho,164,3,9380,183
2021-02-07,Lesotho,0,0,9380,183
2021-02-08,Lesotho,0,0,9380,183
2021-02-09,Lesotho,338,24,9718,207
2021-02-10,Lesotho,86,3,9804,210
2021-02-11,Lesotho,15,2,9819,212
2021-02-12,Lesotho,33,13,9852,225
2021-02-13,Lesotho,0,0,9852,225
2021-02-14,Lesotho,113,5,9965,230
2021-02-15,Lesotho,289,13,10254,243
2021-02-16,Lesotho,96,11,10350,254
2021-02-17,Lesotho,25,25,10375,279
2021-02-18,Lesotho,80,6,10455,285
2021-02-19,Lesotho,0,0,10455,285
2021-02-20,Lesotho,6,0,10461,285
2021-02-21,Lesotho,0,0,10461,285
2021-02-22,Lesotho,5,3,10466,288
2021-02-23,Lesotho,1,3,10467,291
2021-02-24,Lesotho,0,0,10467,291
2021-02-25,Lesotho,1,1,10468,292
2021-02-26,Lesotho,23,0,10491,292
2021-02-27,Lesotho,0,0,10491,292
2021-02-28,Lesotho,0,0,10491,292
2021-03-01,Lesotho,4,3,10495,295
2021-03-02,Lesotho,2,0,10497,295
2021-03-03,Lesotho,24,10,10521,305
2021-03-04,Lesotho,1,2,10522,307
2021-03-05,Lesotho,1,0,10523,307
2021-03-06,Lesotho,0,0,10523,307
2021-03-07,Lesotho,0,0,10523,307
2021-03-08,Lesotho,0,1,10523,308
2021-03-09,Lesotho,2,1,10525,309
2021-03-10,Lesotho,0,0,10525,309
2021-03-11,Lesotho,3,0,10528,309
2021-03-12,Lesotho,0,0,10528,309
2021-03-13,Lesotho,2,0,10530,309
2021-03-14,Lesotho,0,0,10530,309
2021-03-15,Lesotho,0,0,10530,309
2021-03-16,Lesotho,0,0,10530,309
2021-03-17,Lesotho,0,0,10530,309
2021-03-18,Lesotho,0,0,10530,309
2021-03-19,Lesotho,5,0,10535,309
2021-03-20,Lesotho,0,0,10535,309
2021-03-21,Lesotho,0,0,10535,309
2021-03-22,Lesotho,3,0,10538,309
2021-03-23,Lesotho,147,5,10685,314
2021-03-24,Lesotho,1,1,10686,315
2021-03-25,Lesotho,0,0,10686,315
2021-03-26,Lesotho,0,0,10686,315
2021-03-27,Lesotho,0,0,10686,315
2021-03-28,Lesotho,0,0,10686,315
2021-03-29,Lesotho,0,0,10686,315
2021-03-30,Lesotho,0,0,10686,315
2021-03-31,Lesotho,20,0,10706,315
2021-04-01,Lesotho,0,0,10706,315
2021-04-02,Lesotho,0,0,10706,315
2021-04-03,Lesotho,1,0,10707,315
2021-04-04,Lesotho,0,0,10707,315
2021-04-05,Lesotho,0,0,10707,315
2021-04-06,Lesotho,0,0,10707,315
2021-04-07,Lesotho,0,0,10707,315
2021-04-08,Lesotho,0,0,10707,315
2020-03-16,Liberia,1,0,1,0
2020-03-17,Liberia,0,0,1,0
2020-03-18,Liberia,1,0,2,0
2020-03-19,Liberia,0,0,2,0
2020-03-20,Liberia,0,0,2,0
2020-03-21,Liberia,1,0,3,0
2020-03-22,Liberia,0,0,3,0
2020-03-23,Liberia,0,0,3,0
2020-03-24,Liberia,0,0,3,0
2020-03-25,Liberia,0,0,3,0
2020-03-26,Liberia,0,0,3,0
2020-03-27,Liberia,0,0,3,0
2020-03-28,Liberia,0,0,3,0
2020-03-29,Liberia,0,0,3,0
2020-03-30,Liberia,0,0,3,0
2020-03-31,Liberia,0,0,3,0
2020-04-01,Liberia,3,0,6,0
2020-04-02,Liberia,0,0,6,0
2020-04-03,Liberia,1,0,7,0
2020-04-04,Liberia,3,1,10,1
2020-04-05,Liberia,3,2,13,3
2020-04-06,Liberia,1,0,14,3
2020-04-07,Liberia,0,0,14,3
2020-04-08,Liberia,17,1,31,4
2020-04-09,Liberia,0,0,31,4
2020-04-10,Liberia,6,1,37,5
2020-04-11,Liberia,11,0,48,5
2020-04-12,Liberia,2,0,50,5
2020-04-13,Liberia,9,1,59,6
2020-04-14,Liberia,0,0,59,6
2020-04-15,Liberia,0,0,59,6
2020-04-16,Liberia,0,0,59,6
2020-04-17,Liberia,17,1,76,7
2020-04-18,Liberia,0,0,76,7
2020-04-19,Liberia,15,1,91,8
2020-04-20,Liberia,8,0,99,8
2020-04-21,Liberia,2,0,101,8
2020-04-22,Liberia,0,0,101,8
2020-04-23,Liberia,0,0,101,8
2020-04-24,Liberia,16,0,117,8
2020-04-25,Liberia,3,3,120,11
2020-04-26,Liberia,4,1,124,12
2020-04-27,Liberia,0,0,124,12
2020-04-28,Liberia,17,4,141,16
2020-04-29,Liberia,0,0,141,16
2020-04-30,Liberia,0,0,141,16
2020-05-01,Liberia,11,2,152,18
2020-05-02,Liberia,2,0,154,18
2020-05-03,Liberia,4,0,158,18
2020-05-04,Liberia,8,0,166,18
2020-05-05,Liberia,4,2,170,20
2020-05-06,Liberia,8,0,178,20
2020-05-07,Liberia,11,0,189,20
2020-05-08,Liberia,10,0,199,20
2020-05-09,Liberia,0,0,199,20
2020-05-10,Liberia,0,0,199,20
2020-05-11,Liberia,12,0,211,20
2020-05-12,Liberia,0,0,211,20
2020-05-13,Liberia,2,0,213,20
2020-05-14,Liberia,2,0,215,20
2020-05-15,Liberia,4,0,219,20
2020-05-16,Liberia,4,0,223,20
2020-05-17,Liberia,3,1,226,21
2020-05-18,Liberia,3,1,229,22
2020-05-19,Liberia,4,1,233,23
2020-05-20,Liberia,5,0,238,23
2020-05-21,Liberia,2,0,240,23
2020-05-22,Liberia,9,1,249,24
2020-05-23,Liberia,6,2,255,26
2020-05-24,Liberia,10,0,265,26
2020-05-25,Liberia,0,0,265,26
2020-05-26,Liberia,1,0,266,26
2020-05-27,Liberia,0,1,266,27
2020-05-28,Liberia,3,0,269,27
2020-05-29,Liberia,4,0,273,27
2020-05-30,Liberia,7,0,280,27
2020-05-31,Liberia,8,0,288,27
2020-06-01,Liberia,8,0,296,27
2020-06-02,Liberia,15,1,311,28
2020-06-03,Liberia,5,0,316,28
2020-06-04,Liberia,5,0,321,28
2020-06-05,Liberia,13,2,334,30
2020-06-06,Liberia,11,0,345,30
2020-06-07,Liberia,14,0,359,30
2020-06-08,Liberia,11,0,370,30
2020-06-09,Liberia,13,1,383,31
2020-06-10,Liberia,14,0,397,31
2020-06-11,Liberia,13,0,410,31
2020-06-12,Liberia,11,1,421,32
2020-06-13,Liberia,25,0,446,32
2020-06-14,Liberia,12,0,458,32
2020-06-15,Liberia,40,1,498,33
2020-06-16,Liberia,11,0,509,33
2020-06-17,Liberia,7,0,516,33
2020-06-18,Liberia,26,0,542,33
2020-06-19,Liberia,39,0,581,33
2020-06-20,Liberia,20,0,601,33
2020-06-21,Liberia,25,1,626,34
2020-06-22,Liberia,24,0,650,34
2020-06-23,Liberia,2,0,652,34
2020-06-24,Liberia,10,0,662,34
2020-06-25,Liberia,19,0,681,34
2020-06-26,Liberia,3,0,684,34
2020-06-27,Liberia,45,0,729,34
2020-06-28,Liberia,39,0,768,34
2020-06-29,Liberia,2,2,770,36
2020-06-30,Liberia,10,0,780,36
2020-07-01,Liberia,24,1,804,37
2020-07-02,Liberia,15,0,819,37
2020-07-03,Liberia,14,0,833,37
2020-07-04,Liberia,36,0,869,37
2020-07-05,Liberia,5,0,874,37
2020-07-06,Liberia,17,2,891,39
2020-07-07,Liberia,26,2,917,41
2020-07-08,Liberia,9,0,926,41
2020-07-09,Liberia,31,1,957,42
2020-07-10,Liberia,6,5,963,47
2020-07-11,Liberia,35,0,998,47
2020-07-12,Liberia,12,4,1010,51
2020-07-13,Liberia,14,0,1024,51
2020-07-14,Liberia,0,0,1024,51
2020-07-15,Liberia,32,0,1056,51
2020-07-16,Liberia,14,17,1070,68
2020-07-17,Liberia,15,1,1085,69
2020-07-18,Liberia,3,1,1088,70
2020-07-19,Liberia,3,0,1091,70
2020-07-20,Liberia,16,0,1107,70
2020-07-21,Liberia,1,0,1108,70
2020-07-22,Liberia,6,0,1114,70
2020-07-23,Liberia,3,1,1117,71
2020-07-24,Liberia,18,0,1135,71
2020-07-25,Liberia,20,0,1155,71
2020-07-26,Liberia,7,1,1162,72
2020-07-27,Liberia,5,0,1167,72
2020-07-28,Liberia,10,0,1177,72
2020-07-29,Liberia,2,0,1179,72
2020-07-30,Liberia,2,1,1181,73
2020-07-31,Liberia,5,2,1186,75
2020-08-01,Liberia,3,0,1189,75
2020-08-02,Liberia,18,2,1207,77
2020-08-03,Liberia,7,1,1214,78
2020-08-04,Liberia,2,0,1216,78
2020-08-05,Liberia,5,0,1221,78
2020-08-06,Liberia,3,0,1224,78
2020-08-07,Liberia,6,0,1230,78
2020-08-08,Liberia,4,1,1234,79
2020-08-09,Liberia,3,0,1237,79
2020-08-10,Liberia,3,0,1240,79
2020-08-11,Liberia,10,2,1250,81
2020-08-12,Liberia,2,1,1252,82
2020-08-13,Liberia,0,0,1252,82
2020-08-14,Liberia,0,0,1252,82
2020-08-15,Liberia,5,0,1257,82
2020-08-16,Liberia,0,0,1257,82
2020-08-17,Liberia,20,0,1277,82
2020-08-18,Liberia,5,0,1282,82
2020-08-19,Liberia,0,0,1282,82
2020-08-20,Liberia,2,0,1284,82
2020-08-21,Liberia,1,0,1285,82
2020-08-22,Liberia,1,0,1286,82
2020-08-23,Liberia,0,0,1286,82
2020-08-24,Liberia,4,0,1290,82
2020-08-25,Liberia,5,0,1295,82
2020-08-26,Liberia,3,0,1298,82
2020-08-27,Liberia,0,0,1298,82
2020-08-28,Liberia,0,0,1298,82
2020-08-29,Liberia,6,0,1304,82
2020-08-30,Liberia,0,0,1304,82
2020-08-31,Liberia,0,0,1304,82
2020-09-01,Liberia,1,0,1305,82
2020-09-02,Liberia,0,0,1305,82
2020-09-03,Liberia,1,0,1306,82
2020-09-04,Liberia,0,0,1306,82
2020-09-05,Liberia,0,0,1306,82
2020-09-06,Liberia,1,0,1307,82
2020-09-07,Liberia,4,0,1311,82
2020-09-08,Liberia,0,0,1311,82
2020-09-09,Liberia,2,0,1313,82
2020-09-10,Liberia,2,0,1315,82
2020-09-11,Liberia,0,0,1315,82
2020-09-12,Liberia,1,0,1316,82
2020-09-13,Liberia,3,0,1319,82
2020-09-14,Liberia,2,0,1321,82
2020-09-15,Liberia,6,0,1327,82
2020-09-16,Liberia,5,0,1332,82
2020-09-17,Liberia,1,0,1333,82
2020-09-18,Liberia,1,0,1334,82
2020-09-19,Liberia,1,0,1335,82
2020-09-20,Liberia,0,0,1335,82
2020-09-21,Liberia,1,0,1336,82
2020-09-22,Liberia,0,0,1336,82
2020-09-23,Liberia,1,0,1337,82
2020-09-24,Liberia,1,0,1338,82
2020-09-25,Liberia,0,0,1338,82
2020-09-26,Liberia,0,0,1338,82
2020-09-27,Liberia,1,0,1339,82
2020-09-28,Liberia,3,0,1342,82
2020-09-29,Liberia,1,0,1343,82
2020-09-30,Liberia,0,0,1343,82
2020-10-01,Liberia,0,0,1343,82
2020-10-02,Liberia,3,0,1346,82
2020-10-03,Liberia,1,0,1347,82
2020-10-04,Liberia,1,0,1348,82
2020-10-05,Liberia,6,0,1354,82
2020-10-06,Liberia,0,0,1354,82
2020-10-07,Liberia,1,0,1355,82
2020-10-08,Liberia,5,0,1360,82
2020-10-09,Liberia,0,0,1360,82
2020-10-10,Liberia,3,0,1363,82
2020-10-11,Liberia,0,0,1363,82
2020-10-12,Liberia,8,0,1371,82
2020-10-13,Liberia,0,0,1371,82
2020-10-14,Liberia,1,0,1372,82
2020-10-15,Liberia,2,0,1374,82
2020-10-16,Liberia,3,0,1377,82
2020-10-17,Liberia,0,0,1377,82
2020-10-18,Liberia,0,0,1377,82
2020-10-19,Liberia,4,0,1381,82
2020-10-20,Liberia,3,0,1384,82
2020-10-21,Liberia,1,0,1385,82
2020-10-22,Liberia,0,0,1385,82
2020-10-23,Liberia,8,0,1393,82
2020-10-24,Liberia,0,0,1393,82
2020-10-25,Liberia,0,0,1393,82
2020-10-26,Liberia,23,0,1416,82
2020-10-27,Liberia,3,0,1419,82
2020-10-28,Liberia,0,0,1419,82
2020-10-29,Liberia,7,0,1426,82
2020-10-30,Liberia,0,0,1426,82
2020-10-31,Liberia,0,0,1426,82
2020-11-01,Liberia,0,0,1426,82
2020-11-02,Liberia,10,0,1436,82
2020-11-03,Liberia,0,0,1436,82
2020-11-04,Liberia,2,0,1438,82
2020-11-05,Liberia,2,0,1440,82
2020-11-06,Liberia,2,0,1442,82
2020-11-07,Liberia,0,0,1442,82
2020-11-08,Liberia,0,0,1442,82
2020-11-09,Liberia,10,0,1452,82
2020-11-10,Liberia,9,0,1461,82
2020-11-11,Liberia,0,0,1461,82
2020-11-12,Liberia,7,0,1468,82
2020-11-13,Liberia,23,0,1491,82
2020-11-14,Liberia,7,0,1498,82
2020-11-15,Liberia,9,0,1507,82
2020-11-16,Liberia,5,0,1512,82
2020-11-17,Liberia,0,0,1512,82
2020-11-18,Liberia,16,0,1528,82
2020-11-19,Liberia,11,0,1539,82
2020-11-20,Liberia,12,0,1551,82
2020-11-21,Liberia,0,0,1551,82
2020-11-22,Liberia,0,0,1551,82
2020-11-23,Liberia,0,0,1551,82
2020-11-24,Liberia,0,0,1551,82
2020-11-25,Liberia,27,1,1578,83
2020-11-26,Liberia,13,0,1591,83
2020-11-27,Liberia,4,0,1595,83
2020-11-28,Liberia,0,0,1595,83
2020-11-29,Liberia,0,0,1595,83
2020-11-30,Liberia,0,0,1595,83
2020-12-01,Liberia,0,0,1595,83
2020-12-02,Liberia,0,0,1595,83
2020-12-03,Liberia,68,0,1663,83
2020-12-04,Liberia,13,0,1676,83
2020-12-05,Liberia,0,0,1676,83
2020-12-06,Liberia,0,0,1676,83
2020-12-07,Liberia,0,0,1676,83
2020-12-08,Liberia,0,0,1676,83
2020-12-09,Liberia,0,0,1676,83
2020-12-10,Liberia,0,0,1676,83
2020-12-11,Liberia,0,0,1676,83
2020-12-12,Liberia,0,0,1676,83
2020-12-13,Liberia,0,0,1676,83
2020-12-14,Liberia,0,0,1676,83
2020-12-15,Liberia,0,0,1676,83
2020-12-16,Liberia,97,0,1773,83
2020-12-17,Liberia,6,0,1779,83
2020-12-18,Liberia,0,0,1779,83
2020-12-19,Liberia,0,0,1779,83
2020-12-20,Liberia,0,0,1779,83
2020-12-21,Liberia,0,0,1779,83
2020-12-22,Liberia,0,0,1779,83
2020-12-23,Liberia,0,0,1779,83
2020-12-24,Liberia,0,0,1779,83
2020-12-25,Liberia,0,0,1779,83
2020-12-26,Liberia,0,0,1779,83
2020-12-27,Liberia,0,0,1779,83
2020-12-28,Liberia,0,0,1779,83
2020-12-29,Liberia,0,0,1779,83
2020-12-30,Liberia,0,0,1779,83
2020-12-31,Liberia,0,0,1779,83
2021-01-01,Liberia,0,0,1779,83
2021-01-02,Liberia,0,0,1779,83
2021-01-03,Liberia,0,0,1779,83
2021-01-04,Liberia,0,0,1779,83
2021-01-05,Liberia,0,0,1779,83
2021-01-06,Liberia,0,0,1779,83
2021-01-07,Liberia,0,0,1779,83
2021-01-08,Liberia,0,0,1779,83
2021-01-09,Liberia,0,0,1779,83
2021-01-10,Liberia,0,0,1779,83
2021-01-11,Liberia,0,0,1779,83
2021-01-12,Liberia,97,1,1876,84
2021-01-13,Liberia,1,0,1877,84
2021-01-14,Liberia,1,0,1878,84
2021-01-15,Liberia,4,0,1882,84
2021-01-16,Liberia,5,0,1887,84
2021-01-17,Liberia,0,0,1887,84
2021-01-18,Liberia,9,0,1896,84
2021-01-19,Liberia,2,0,1898,84
2021-01-20,Liberia,3,0,1901,84
2021-01-21,Liberia,0,0,1901,84
2021-01-22,Liberia,11,0,1912,84
2021-01-23,Liberia,2,0,1914,84
2021-01-24,Liberia,0,0,1914,84
2021-01-25,Liberia,13,0,1927,84
2021-01-26,Liberia,5,0,1932,84
2021-01-27,Liberia,4,0,1936,84
2021-01-28,Liberia,0,0,1936,84
2021-01-29,Liberia,3,0,1939,84
2021-01-30,Liberia,0,0,1939,84
2021-01-31,Liberia,0,0,1939,84
2021-02-01,Liberia,5,0,1944,84
2021-02-02,Liberia,0,0,1944,84
2021-02-03,Liberia,1,0,1945,84
2021-02-04,Liberia,0,0,1945,84
2021-02-05,Liberia,11,0,1956,84
2021-02-06,Liberia,0,0,1956,84
2021-02-07,Liberia,0,0,1956,84
2021-02-08,Liberia,0,0,1956,84
2021-02-09,Liberia,0,0,1956,84
2021-02-10,Liberia,0,0,1956,84
2021-02-11,Liberia,0,0,1956,84
2021-02-12,Liberia,0,0,1956,84
2021-02-13,Liberia,0,0,1956,84
2021-02-14,Liberia,0,0,1956,84
2021-02-15,Liberia,29,1,1985,85
2021-02-16,Liberia,0,0,1985,85
2021-02-17,Liberia,0,0,1985,85
2021-02-18,Liberia,0,0,1985,85
2021-02-19,Liberia,3,0,1988,85
2021-02-20,Liberia,0,0,1988,85
2021-02-21,Liberia,0,0,1988,85
2021-02-22,Liberia,8,0,1996,85
2021-02-23,Liberia,2,0,1998,85
2021-02-24,Liberia,4,0,2002,85
2021-02-25,Liberia,7,0,2009,85
2021-02-26,Liberia,1,0,2010,85
2021-02-27,Liberia,0,0,2010,85
2021-02-28,Liberia,4,0,2014,85
2021-03-01,Liberia,0,0,2014,85
2021-03-02,Liberia,0,0,2014,85
2021-03-03,Liberia,3,0,2017,85
2021-03-04,Liberia,0,0,2017,85
2021-03-05,Liberia,6,0,2023,85
2021-03-06,Liberia,1,0,2024,85
2021-03-07,Liberia,0,0,2024,85
2021-03-08,Liberia,0,0,2024,85
2021-03-09,Liberia,2,0,2026,85
2021-03-10,Liberia,0,0,2026,85
2021-03-11,Liberia,0,0,2026,85
2021-03-12,Liberia,4,0,2030,85
2021-03-13,Liberia,0,0,2030,85
2021-03-14,Liberia,0,0,2030,85
2021-03-15,Liberia,0,0,2030,85
2021-03-16,Liberia,0,0,2030,85
2021-03-17,Liberia,12,0,2042,85
2021-03-18,Liberia,0,0,2042,85
2021-03-19,Liberia,0,0,2042,85
2021-03-20,Liberia,0,0,2042,85
2021-03-21,Liberia,0,0,2042,85
2021-03-22,Liberia,0,0,2042,85
2021-03-23,Liberia,0,0,2042,85
2021-03-24,Liberia,0,0,2042,85
2021-03-25,Liberia,0,0,2042,85
2021-03-26,Liberia,0,0,2042,85
2021-03-27,Liberia,0,0,2042,85
2021-03-28,Liberia,0,0,2042,85
2021-03-29,Liberia,0,0,2042,85
2021-03-30,Liberia,0,0,2042,85
2021-03-31,Liberia,0,0,2042,85
2021-04-01,Liberia,0,0,2042,85
2021-04-02,Liberia,0,0,2042,85
2021-04-03,Liberia,0,0,2042,85
2021-04-04,Liberia,0,0,2042,85
2021-04-05,Liberia,0,0,2042,85
2021-04-06,Liberia,0,0,2042,85
2021-04-07,Liberia,0,0,2042,85
2021-04-08,Liberia,0,0,2042,85
2020-03-24,Libya,1,0,1,0
2020-03-25,Libya,0,0,1,0
2020-03-26,Libya,0,0,1,0
2020-03-27,Libya,0,0,1,0
2020-03-28,Libya,2,0,3,0
2020-03-29,Libya,5,0,8,0
2020-03-30,Libya,0,0,8,0
2020-03-31,Libya,2,0,10,0
2020-04-01,Libya,0,0,10,0
2020-04-02,Libya,1,1,11,1
2020-04-03,Libya,0,0,11,1
2020-04-04,Libya,7,0,18,1
2020-04-05,Libya,0,0,18,1
2020-04-06,Libya,1,0,19,1
2020-04-07,Libya,1,0,20,1
2020-04-08,Libya,1,0,21,1
2020-04-09,Libya,3,0,24,1
2020-04-10,Libya,0,0,24,1
2020-04-11,Libya,0,0,24,1
2020-04-12,Libya,1,0,25,1
2020-04-13,Libya,1,0,26,1
2020-04-14,Libya,9,0,35,1
2020-04-15,Libya,13,0,48,1
2020-04-16,Libya,1,0,49,1
2020-04-17,Libya,0,0,49,1
2020-04-18,Libya,0,0,49,1
2020-04-19,Libya,2,0,51,1
2020-04-20,Libya,0,0,51,1
2020-04-21,Libya,0,0,51,1
2020-04-22,Libya,8,0,59,1
2020-04-23,Libya,1,1,60,2
2020-04-24,Libya,1,0,61,2
2020-04-25,Libya,0,0,61,2
2020-04-26,Libya,0,0,61,2
2020-04-27,Libya,0,0,61,2
2020-04-28,Libya,0,0,61,2
2020-04-29,Libya,0,0,61,2
2020-04-30,Libya,0,1,61,3
2020-05-01,Libya,2,0,63,3
2020-05-02,Libya,0,0,63,3
2020-05-03,Libya,0,0,63,3
2020-05-04,Libya,0,0,63,3
2020-05-05,Libya,0,0,63,3
2020-05-06,Libya,1,0,64,3
2020-05-07,Libya,0,0,64,3
2020-05-08,Libya,0,0,64,3
2020-05-09,Libya,0,0,64,3
2020-05-10,Libya,0,0,64,3
2020-05-11,Libya,0,0,64,3
2020-05-12,Libya,0,0,64,3
2020-05-13,Libya,0,0,64,3
2020-05-14,Libya,0,0,64,3
2020-05-15,Libya,0,0,64,3
2020-05-16,Libya,1,0,65,3
2020-05-17,Libya,0,0,65,3
2020-05-18,Libya,0,0,65,3
2020-05-19,Libya,3,0,68,3
2020-05-20,Libya,1,0,69,3
2020-05-21,Libya,2,0,71,3
2020-05-22,Libya,1,0,72,3
2020-05-23,Libya,3,0,75,3
2020-05-24,Libya,0,0,75,3
2020-05-25,Libya,0,0,75,3
2020-05-26,Libya,2,0,77,3
2020-05-27,Libya,22,1,99,4
2020-05-28,Libya,6,1,105,5
2020-05-29,Libya,13,0,118,5
2020-05-30,Libya,12,0,130,5
2020-05-31,Libya,26,0,156,5
2020-06-01,Libya,12,0,168,5
2020-06-02,Libya,14,0,182,5
2020-06-03,Libya,14,0,196,5
2020-06-04,Libya,13,0,209,5
2020-06-05,Libya,30,0,239,5
2020-06-06,Libya,17,0,256,5
2020-06-07,Libya,0,0,256,5
2020-06-08,Libya,76,0,332,5
2020-06-09,Libya,27,0,359,5
2020-06-10,Libya,19,0,378,5
2020-06-11,Libya,15,0,393,5
2020-06-12,Libya,16,1,409,6
2020-06-13,Libya,9,2,418,8
2020-06-14,Libya,36,2,454,10
2020-06-15,Libya,13,0,467,10
2020-06-16,Libya,17,0,484,10
2020-06-17,Libya,16,0,500,10
2020-06-18,Libya,10,0,510,10
2020-06-19,Libya,10,0,520,10
2020-06-20,Libya,24,0,544,10
2020-06-21,Libya,27,0,571,10
2020-06-22,Libya,24,0,595,10
2020-06-23,Libya,44,7,639,17
2020-06-24,Libya,31,1,670,18
2020-06-25,Libya,28,0,698,18
2020-06-26,Libya,15,0,713,18
2020-06-27,Libya,14,0,727,18
2020-06-28,Libya,35,3,762,21
2020-06-29,Libya,40,2,802,23
2020-06-30,Libya,22,1,824,24
2020-07-01,Libya,50,1,874,25
2020-07-02,Libya,17,1,891,26
2020-07-03,Libya,27,1,918,27
2020-07-04,Libya,71,0,989,27
2020-07-05,Libya,57,5,1046,32
2020-07-06,Libya,71,2,1117,34
2020-07-07,Libya,65,1,1182,35
2020-07-08,Libya,86,1,1268,36
2020-07-09,Libya,74,2,1342,38
2020-07-10,Libya,0,0,1342,38
2020-07-11,Libya,47,0,1389,38
2020-07-12,Libya,44,1,1433,39
2020-07-13,Libya,79,1,1512,40
2020-07-14,Libya,51,2,1563,42
2020-07-15,Libya,26,1,1589,43
2020-07-16,Libya,63,3,1652,46
2020-07-17,Libya,52,1,1704,47
2020-07-18,Libya,87,1,1791,48
2020-07-19,Libya,75,0,1866,48
2020-07-20,Libya,114,1,1980,49
2020-07-21,Libya,108,1,2088,50
2020-07-22,Libya,88,3,2176,53
2020-07-23,Libya,138,3,2314,56
2020-07-24,Libya,110,1,2424,57
2020-07-25,Libya,123,1,2547,58
2020-07-26,Libya,122,2,2669,60
2020-07-27,Libya,158,4,2827,64
2020-07-28,Libya,190,3,3017,67
2020-07-29,Libya,205,9,3222,76
2020-07-30,Libya,216,-3,3438,73
2020-07-31,Libya,183,1,3621,74
2020-08-01,Libya,70,6,3691,80
2020-08-02,Libya,146,3,3837,83
2020-08-03,Libya,226,10,4063,93
2020-08-04,Libya,161,3,4224,96
2020-08-05,Libya,251,3,4475,99
2020-08-06,Libya,404,8,4879,107
2020-08-07,Libya,200,1,5079,108
2020-08-08,Libya,153,5,5232,113
2020-08-09,Libya,219,6,5451,119
2020-08-10,Libya,478,6,5929,125
2020-08-11,Libya,373,7,6302,132
2020-08-12,Libya,309,0,6611,132
2020-08-13,Libya,439,3,7050,135
2020-08-14,Libya,277,4,7327,139
2020-08-15,Libya,411,6,7738,145
2020-08-16,Libya,434,8,8172,153
2020-08-17,Libya,407,4,8579,157
2020-08-18,Libya,489,7,9068,164
2020-08-19,Libya,395,5,9463,169
2020-08-20,Libya,244,4,9707,173
2020-08-21,Libya,414,7,10121,180
2020-08-22,Libya,316,8,10437,188
2020-08-23,Libya,0,0,10437,188
2020-08-24,Libya,572,11,11009,199
2020-08-25,Libya,272,4,11281,203
2020-08-26,Libya,553,7,11834,210
2020-08-27,Libya,440,9,12274,219
2020-08-28,Libya,355,7,12629,226
2020-08-29,Libya,329,5,12958,231
2020-08-30,Libya,465,1,13423,232
2020-08-31,Libya,543,5,13966,237
2020-09-01,Libya,658,5,14624,242
2020-09-02,Libya,532,8,15156,250
2020-09-03,Libya,617,4,15773,254
2020-09-04,Libya,672,8,16445,262
2020-09-05,Libya,649,10,17094,272
2020-09-06,Libya,655,13,17749,285
2020-09-07,Libya,1085,11,18834,296
2020-09-08,Libya,749,18,19583,314
2020-09-09,Libya,879,10,20462,324
2020-09-10,Libya,477,15,20939,339
2020-09-11,Libya,969,13,21908,352
2020-09-12,Libya,440,2,22348,354
2020-09-13,Libya,433,8,22781,362
2020-09-14,Libya,734,6,23515,368
2020-09-15,Libya,629,15,24144,383
2020-09-16,Libya,792,11,24936,394
2020-09-17,Libya,886,15,25822,409
2020-09-18,Libya,616,9,26438,418
2020-09-19,Libya,796,18,27234,436
2020-09-20,Libya,715,8,27949,444
2020-09-21,Libya,847,6,28796,450
2020-09-22,Libya,650,10,29446,460
2020-09-23,Libya,651,9,30097,469
2020-09-24,Libya,535,5,30632,474
2020-09-25,Libya,658,17,31290,491
2020-09-26,Libya,538,8,31828,499
2020-09-27,Libya,536,21,32364,520
2020-09-28,Libya,849,7,33213,527
2020-09-29,Libya,801,13,34014,540
2020-09-30,Libya,511,11,34525,551
2020-10-01,Libya,683,8,35208,559
2020-10-02,Libya,509,11,35717,570
2020-10-03,Libya,370,8,36087,578
2020-10-04,Libya,722,14,36809,592
2020-10-05,Libya,628,4,37437,596
2020-10-06,Libya,1031,6,38468,602
2020-10-07,Libya,1045,6,39513,608
2020-10-08,Libya,779,8,40292,616
2020-10-09,Libya,1076,5,41368,621
2020-10-10,Libya,318,2,41686,623
2020-10-11,Libya,1026,8,42712,631
2020-10-12,Libya,1109,13,43821,644
2020-10-13,Libya,1164,12,44985,656
2020-10-14,Libya,836,13,45821,669
2020-10-15,Libya,855,12,46676,681
2020-10-16,Libya,1169,18,47845,699
2020-10-17,Libya,0,0,47845,699
2020-10-18,Libya,945,26,48790,725
2020-10-19,Libya,1159,7,49949,732
2020-10-20,Libya,957,14,50906,746
2020-10-21,Libya,719,19,51625,765
2020-10-22,Libya,995,3,52620,768
2020-10-23,Libya,764,6,53384,774
2020-10-24,Libya,990,16,54374,790
2020-10-25,Libya,1639,5,56013,795
2020-10-26,Libya,1210,6,57223,801
2020-10-27,Libya,752,11,57975,812
2020-10-28,Libya,899,11,58874,823
2020-10-29,Libya,782,8,59656,831
2020-10-30,Libya,972,16,60628,847
2020-10-31,Libya,467,10,61095,857
2020-11-01,Libya,950,14,62045,871
2020-11-02,Libya,862,9,62907,880
2020-11-03,Libya,781,13,63688,893
2020-11-04,Libya,899,7,64587,900
2020-11-05,Libya,853,7,65440,907
2020-11-06,Libya,1004,8,66444,915
2020-11-07,Libya,595,5,67039,920
2020-11-08,Libya,1078,9,68117,929
2020-11-09,Libya,923,15,69040,944
2020-11-10,Libya,970,13,70010,957
2020-11-11,Libya,875,13,70885,970
2020-11-12,Libya,919,15,71804,985
2020-11-13,Libya,824,10,72628,995
2020-11-14,Libya,0,0,72628,995
2020-11-15,Libya,974,22,73602,1017
2020-11-16,Libya,722,8,74324,1025
2020-11-17,Libya,612,16,74936,1041
2020-11-18,Libya,529,12,75465,1053
2020-11-19,Libya,541,9,76006,1062
2020-11-20,Libya,802,6,76808,1068
2020-11-21,Libya,0,0,76808,1068
2020-11-22,Libya,1015,21,77823,1089
2020-11-23,Libya,650,13,78473,1102
2020-11-24,Libya,707,8,79180,1110
2020-11-25,Libya,617,15,79797,1125
2020-11-26,Libya,610,15,80407,1140
2020-11-27,Libya,866,13,81273,1153
2020-11-28,Libya,0,0,81273,1153
2020-11-29,Libya,1157,13,82430,1166
2020-11-30,Libya,379,17,82809,1183
2020-12-01,Libya,608,13,83417,1196
2020-12-02,Libya,670,4,84087,1200
2020-12-03,Libya,762,12,84849,1212
2020-12-04,Libya,680,7,85529,1219
2020-12-05,Libya,0,0,85529,1219
2020-12-06,Libya,1051,12,86580,1231
2020-12-07,Libya,517,12,87097,1243
2020-12-08,Libya,889,12,87986,1255
2020-12-09,Libya,536,6,88522,1261
2020-12-10,Libya,661,12,89183,1273
2020-12-11,Libya,697,5,89880,1278
2020-12-12,Libya,0,0,89880,1278
2020-12-13,Libya,899,21,90779,1299
2020-12-14,Libya,578,15,91357,1314
2020-12-15,Libya,660,5,92017,1319
2020-12-16,Libya,560,5,92577,1324
2020-12-17,Libya,706,13,93283,1337
2020-12-18,Libya,489,9,93772,1346
2020-12-19,Libya,0,0,93772,1346
2020-12-20,Libya,788,7,94560,1353
2020-12-21,Libya,640,16,95200,1369
2020-12-22,Libya,506,16,95706,1385
2020-12-23,Libya,640,8,96346,1393
2020-12-24,Libya,846,6,97192,1399
2020-12-25,Libya,461,16,97653,1415
2020-12-26,Libya,0,0,97653,1415
2020-12-27,Libya,728,21,98381,1436
2020-12-28,Libya,532,4,98913,1440
2020-12-29,Libya,437,4,99350,1444
2020-12-30,Libya,585,15,99935,1459
2020-12-31,Libya,342,19,100277,1478
2021-01-01,Libya,467,9,100744,1487
2021-01-02,Libya,0,0,100744,1487
2021-01-03,Libya,670,23,101414,1510
2021-01-04,Libya,561,16,101975,1526
2021-01-05,Libya,481,10,102456,1536
2021-01-06,Libya,424,10,102880,1546
2021-01-07,Libya,635,12,103515,1558
2021-01-08,Libya,487,10,104002,1568
2021-01-09,Libya,0,0,104002,1568
2021-01-10,Libya,743,13,104745,1581
2021-01-11,Libya,633,8,105378,1589
2021-01-12,Libya,652,33,106030,1622
2021-01-13,Libya,640,7,106670,1629
2021-01-14,Libya,764,16,107434,1645
2021-01-15,Libya,583,6,108017,1651
2021-01-16,Libya,0,0,108017,1651
2021-01-17,Libya,1071,14,109088,1665
2021-01-18,Libya,781,33,109869,1698
2021-01-19,Libya,596,2,110465,1700
2021-01-20,Libya,659,15,111124,1715
2021-01-21,Libya,622,1,111746,1716
2021-01-22,Libya,794,21,112540,1737
2021-01-23,Libya,0,0,112540,1737
2021-01-24,Libya,1148,26,113688,1763
2021-01-25,Libya,741,19,114429,1782
2021-01-26,Libya,870,7,115299,1789
2021-01-27,Libya,765,13,116064,1802
2021-01-28,Libya,715,30,116779,1832
2021-01-29,Libya,871,10,117650,1842
2021-01-30,Libya,0,0,117650,1842
2021-01-31,Libya,981,35,118631,1877
2021-02-01,Libya,771,6,119402,1883
2021-02-02,Libya,1032,13,120434,1896
2021-02-03,Libya,809,18,121243,1914
2021-02-04,Libya,770,5,122013,1919
2021-02-05,Libya,881,17,122894,1936
2021-02-06,Libya,0,0,122894,1936
2021-02-07,Libya,1132,17,124026,1953
2021-02-08,Libya,856,21,124882,1974
2021-02-09,Libya,679,8,125561,1982
2021-02-10,Libya,467,7,126028,1989
2021-02-11,Libya,333,20,126361,2009
2021-02-12,Libya,520,5,126881,2014
2021-02-13,Libya,0,0,126881,2014
2021-02-14,Libya,473,4,127354,2018
2021-02-15,Libya,351,24,127705,2042
2021-02-16,Libya,331,9,128036,2051
2021-02-17,Libya,312,5,128348,2056
2021-02-18,Libya,392,5,128740,2061
2021-02-19,Libya,585,27,129325,2088
2021-02-20,Libya,0,0,129325,2088
2021-02-21,Libya,472,26,129797,2114
2021-02-22,Libya,415,2,130212,2116
2021-02-23,Libya,489,9,130701,2125
2021-02-24,Libya,561,26,131262,2151
2021-02-25,Libya,571,5,131833,2156
2021-02-26,Libya,625,18,132458,2174
2021-02-27,Libya,0,0,132458,2174
2021-02-28,Libya,880,5,133338,2179
2021-03-01,Libya,789,31,134127,2210
2021-03-02,Libya,840,6,134967,2216
2021-03-03,Libya,618,3,135585,2219
2021-03-04,Libya,1002,14,136587,2233
2021-03-05,Libya,895,3,137482,2236
2021-03-06,Libya,0,0,137482,2236
2021-03-07,Libya,1158,37,138640,2273
2021-03-08,Libya,1018,15,139658,2288
2021-03-09,Libya,1030,9,140688,2297
2021-03-10,Libya,910,33,141598,2330
2021-03-11,Libya,1073,10,142671,2340
2021-03-12,Libya,972,8,143643,2348
2021-03-13,Libya,0,0,143643,2348
2021-03-14,Libya,1350,38,144993,2386
2021-03-15,Libya,1087,16,146080,2402
2021-03-16,Libya,1041,4,147121,2406
2021-03-17,Libya,1054,16,148175,2422
2021-03-18,Libya,1032,13,149207,2435
2021-03-19,Libya,1134,52,150341,2487
2021-03-20,Libya,0,0,150341,2487
2021-03-21,Libya,1264,19,151605,2506
2021-03-22,Libya,905,7,152510,2513
2021-03-23,Libya,901,51,153411,2564
2021-03-24,Libya,909,18,154320,2582
2021-03-25,Libya,912,9,155232,2591
2021-03-26,Libya,884,11,156116,2602
2021-03-27,Libya,0,0,156116,2602
2021-03-28,Libya,733,16,156849,2618
2021-03-29,Libya,696,35,157545,2653
2021-03-30,Libya,706,5,158251,2658
2021-03-31,Libya,706,9,158957,2667
2021-04-01,Libya,1023,13,159980,2680
2021-04-02,Libya,1108,4,161088,2684
2021-04-03,Libya,0,0,161088,2684
2021-04-04,Libya,1206,53,162294,2737
2021-04-05,Libya,1148,20,163442,2757
2021-04-06,Libya,876,8,164318,2765
2021-04-07,Libya,969,7,165287,2772
2021-04-08,Libya,869,27,166156,2799
2020-03-04,Liechtenstein,1,0,1,0
2020-03-05,Liechtenstein,0,0,1,0
2020-03-06,Liechtenstein,0,0,1,0
2020-03-07,Liechtenstein,0,0,1,0
2020-03-08,Liechtenstein,0,0,1,0
2020-03-09,Liechtenstein,0,0,1,0
2020-03-10,Liechtenstein,0,0,1,0
2020-03-11,Liechtenstein,0,0,1,0
2020-03-12,Liechtenstein,0,0,1,0
2020-03-13,Liechtenstein,0,0,1,0
2020-03-14,Liechtenstein,3,0,4,0
2020-03-15,Liechtenstein,0,0,4,0
2020-03-16,Liechtenstein,0,0,4,0
2020-03-17,Liechtenstein,3,0,7,0
2020-03-18,Liechtenstein,21,0,28,0
2020-03-19,Liechtenstein,0,0,28,0
2020-03-20,Liechtenstein,0,0,28,0
2020-03-21,Liechtenstein,9,0,37,0
2020-03-22,Liechtenstein,0,0,37,0
2020-03-23,Liechtenstein,14,0,51,0
2020-03-24,Liechtenstein,0,0,51,0
2020-03-25,Liechtenstein,0,0,51,0
2020-03-26,Liechtenstein,5,0,56,0
2020-03-27,Liechtenstein,0,0,56,0
2020-03-28,Liechtenstein,0,0,56,0
2020-03-29,Liechtenstein,0,0,56,0
2020-03-30,Liechtenstein,6,0,62,0
2020-03-31,Liechtenstein,6,0,68,0
2020-04-01,Liechtenstein,0,0,68,0
2020-04-02,Liechtenstein,7,0,75,0
2020-04-03,Liechtenstein,1,0,76,0
2020-04-04,Liechtenstein,1,1,77,1
2020-04-05,Liechtenstein,0,0,77,1
2020-04-06,Liechtenstein,0,0,77,1
2020-04-07,Liechtenstein,1,0,78,1
2020-04-08,Liechtenstein,0,0,78,1
2020-04-09,Liechtenstein,0,0,78,1
2020-04-10,Liechtenstein,1,0,79,1
2020-04-11,Liechtenstein,0,0,79,1
2020-04-12,Liechtenstein,0,0,79,1
2020-04-13,Liechtenstein,0,0,79,1
2020-04-14,Liechtenstein,0,0,79,1
2020-04-15,Liechtenstein,0,0,79,1
2020-04-16,Liechtenstein,0,0,79,1
2020-04-17,Liechtenstein,0,0,79,1
2020-04-18,Liechtenstein,0,0,79,1
2020-04-19,Liechtenstein,2,0,81,1
2020-04-20,Liechtenstein,0,0,81,1
2020-04-21,Liechtenstein,0,0,81,1
2020-04-22,Liechtenstein,0,0,81,1
2020-04-23,Liechtenstein,0,0,81,1
2020-04-24,Liechtenstein,0,0,81,1
2020-04-25,Liechtenstein,0,0,81,1
2020-04-26,Liechtenstein,1,0,82,1
2020-04-27,Liechtenstein,0,0,82,1
2020-04-28,Liechtenstein,0,0,82,1
2020-04-29,Liechtenstein,0,0,82,1
2020-04-30,Liechtenstein,0,0,82,1
2020-05-01,Liechtenstein,0,0,82,1
2020-05-02,Liechtenstein,0,0,82,1
2020-05-03,Liechtenstein,0,0,82,1
2020-05-04,Liechtenstein,0,0,82,1
2020-05-05,Liechtenstein,0,0,82,1
2020-05-06,Liechtenstein,0,0,82,1
2020-05-07,Liechtenstein,0,0,82,1
2020-05-08,Liechtenstein,0,0,82,1
2020-05-09,Liechtenstein,0,0,82,1
2020-05-10,Liechtenstein,0,0,82,1
2020-05-11,Liechtenstein,0,0,82,1
2020-05-12,Liechtenstein,0,0,82,1
2020-05-13,Liechtenstein,0,0,82,1
2020-05-14,Liechtenstein,0,0,82,1
2020-05-15,Liechtenstein,0,0,82,1
2020-05-16,Liechtenstein,0,0,82,1
2020-05-17,Liechtenstein,0,0,82,1
2020-05-18,Liechtenstein,0,0,82,1
2020-05-19,Liechtenstein,0,0,82,1
2020-05-20,Liechtenstein,0,0,82,1
2020-05-21,Liechtenstein,0,0,82,1
2020-05-22,Liechtenstein,0,0,82,1
2020-05-23,Liechtenstein,0,0,82,1
2020-05-24,Liechtenstein,0,0,82,1
2020-05-25,Liechtenstein,0,0,82,1
2020-05-26,Liechtenstein,0,0,82,1
2020-05-27,Liechtenstein,0,0,82,1
2020-05-28,Liechtenstein,0,0,82,1
2020-05-29,Liechtenstein,0,0,82,1
2020-05-30,Liechtenstein,0,0,82,1
2020-05-31,Liechtenstein,0,0,82,1
2020-06-01,Liechtenstein,0,0,82,1
2020-06-02,Liechtenstein,0,0,82,1
2020-06-03,Liechtenstein,0,0,82,1
2020-06-04,Liechtenstein,0,0,82,1
2020-06-05,Liechtenstein,0,0,82,1
2020-06-06,Liechtenstein,0,0,82,1
2020-06-07,Liechtenstein,0,0,82,1
2020-06-08,Liechtenstein,0,0,82,1
2020-06-09,Liechtenstein,0,0,82,1
2020-06-10,Liechtenstein,0,0,82,1
2020-06-11,Liechtenstein,0,0,82,1
2020-06-12,Liechtenstein,0,0,82,1
2020-06-13,Liechtenstein,0,0,82,1
2020-06-14,Liechtenstein,0,0,82,1
2020-06-15,Liechtenstein,0,0,82,1
2020-06-16,Liechtenstein,0,0,82,1
2020-06-17,Liechtenstein,0,0,82,1
2020-06-18,Liechtenstein,0,0,82,1
2020-06-19,Liechtenstein,0,0,82,1
2020-06-20,Liechtenstein,0,0,82,1
2020-06-21,Liechtenstein,0,0,82,1
2020-06-22,Liechtenstein,0,0,82,1
2020-06-23,Liechtenstein,0,0,82,1
2020-06-24,Liechtenstein,0,0,82,1
2020-06-25,Liechtenstein,0,0,82,1
2020-06-26,Liechtenstein,0,0,82,1
2020-06-27,Liechtenstein,0,0,82,1
2020-06-28,Liechtenstein,0,0,82,1
2020-06-29,Liechtenstein,0,0,82,1
2020-06-30,Liechtenstein,0,0,82,1
2020-07-01,Liechtenstein,0,0,82,1
2020-07-02,Liechtenstein,1,0,83,1
2020-07-03,Liechtenstein,0,0,83,1
2020-07-04,Liechtenstein,0,0,83,1
2020-07-05,Liechtenstein,0,0,83,1
2020-07-06,Liechtenstein,1,0,84,1
2020-07-07,Liechtenstein,0,0,84,1
2020-07-08,Liechtenstein,0,0,84,1
2020-07-09,Liechtenstein,0,0,84,1
2020-07-10,Liechtenstein,0,0,84,1
2020-07-11,Liechtenstein,0,0,84,1
2020-07-12,Liechtenstein,0,0,84,1
2020-07-13,Liechtenstein,0,0,84,1
2020-07-14,Liechtenstein,0,0,84,1
2020-07-15,Liechtenstein,0,0,84,1
2020-07-16,Liechtenstein,0,0,84,1
2020-07-17,Liechtenstein,1,0,85,1
2020-07-18,Liechtenstein,1,0,86,1
2020-07-19,Liechtenstein,0,0,86,1
2020-07-20,Liechtenstein,0,0,86,1
2020-07-21,Liechtenstein,0,0,86,1
2020-07-22,Liechtenstein,0,0,86,1
2020-07-23,Liechtenstein,0,0,86,1
2020-07-24,Liechtenstein,0,0,86,1
2020-07-25,Liechtenstein,0,0,86,1
2020-07-26,Liechtenstein,0,0,86,1
2020-07-27,Liechtenstein,0,0,86,1
2020-07-28,Liechtenstein,1,0,87,1
2020-07-29,Liechtenstein,1,0,88,1
2020-07-30,Liechtenstein,0,0,88,1
2020-07-31,Liechtenstein,0,0,88,1
2020-08-01,Liechtenstein,0,0,88,1
2020-08-02,Liechtenstein,1,0,89,1
2020-08-03,Liechtenstein,0,0,89,1
2020-08-04,Liechtenstein,0,0,89,1
2020-08-05,Liechtenstein,0,0,89,1
2020-08-06,Liechtenstein,0,0,89,1
2020-08-07,Liechtenstein,0,0,89,1
2020-08-08,Liechtenstein,0,0,89,1
2020-08-09,Liechtenstein,0,0,89,1
2020-08-10,Liechtenstein,0,0,89,1
2020-08-11,Liechtenstein,0,0,89,1
2020-08-12,Liechtenstein,1,0,90,1
2020-08-13,Liechtenstein,0,0,90,1
2020-08-14,Liechtenstein,1,0,91,1
2020-08-15,Liechtenstein,0,0,91,1
2020-08-16,Liechtenstein,0,0,91,1
2020-08-17,Liechtenstein,3,0,94,1
2020-08-18,Liechtenstein,3,0,97,1
2020-08-19,Liechtenstein,1,0,98,1
2020-08-20,Liechtenstein,1,0,99,1
2020-08-21,Liechtenstein,0,0,99,1
2020-08-22,Liechtenstein,0,0,99,1
2020-08-23,Liechtenstein,0,0,99,1
2020-08-24,Liechtenstein,1,0,100,1
2020-08-25,Liechtenstein,2,0,102,1
2020-08-26,Liechtenstein,0,0,102,1
2020-08-27,Liechtenstein,3,0,105,1
2020-08-28,Liechtenstein,1,0,106,1
2020-08-29,Liechtenstein,1,0,107,1
2020-08-30,Liechtenstein,0,0,107,1
2020-08-31,Liechtenstein,0,0,107,1
2020-09-01,Liechtenstein,0,0,107,1
2020-09-02,Liechtenstein,0,0,107,1
2020-09-03,Liechtenstein,0,0,107,1
2020-09-04,Liechtenstein,0,0,107,1
2020-09-05,Liechtenstein,0,0,107,1
2020-09-06,Liechtenstein,0,0,107,1
2020-09-07,Liechtenstein,0,0,107,1
2020-09-08,Liechtenstein,0,0,107,1
2020-09-09,Liechtenstein,1,0,108,1
2020-09-10,Liechtenstein,1,0,109,1
2020-09-11,Liechtenstein,0,0,109,1
2020-09-12,Liechtenstein,2,0,111,1
2020-09-13,Liechtenstein,0,0,111,1
2020-09-14,Liechtenstein,0,0,111,1
2020-09-15,Liechtenstein,0,0,111,1
2020-09-16,Liechtenstein,0,0,111,1
2020-09-17,Liechtenstein,1,0,112,1
2020-09-18,Liechtenstein,0,0,112,1
2020-09-19,Liechtenstein,1,0,113,1
2020-09-20,Liechtenstein,0,0,113,1
2020-09-21,Liechtenstein,1,0,114,1
2020-09-22,Liechtenstein,1,0,115,1
2020-09-23,Liechtenstein,1,0,116,1
2020-09-24,Liechtenstein,0,0,116,1
2020-09-25,Liechtenstein,1,0,117,1
2020-09-26,Liechtenstein,0,0,117,1
2020-09-27,Liechtenstein,0,0,117,1
2020-09-28,Liechtenstein,0,0,117,1
2020-09-29,Liechtenstein,1,0,118,1
2020-09-30,Liechtenstein,0,0,118,1
2020-10-01,Liechtenstein,1,0,119,1
2020-10-02,Liechtenstein,1,0,120,1
2020-10-03,Liechtenstein,3,0,123,1
2020-10-04,Liechtenstein,3,0,126,1
2020-10-05,Liechtenstein,1,0,127,1
2020-10-06,Liechtenstein,3,0,130,1
2020-10-07,Liechtenstein,1,0,131,1
2020-10-08,Liechtenstein,4,0,135,1
2020-10-09,Liechtenstein,4,0,139,1
2020-10-10,Liechtenstein,3,0,142,1
2020-10-11,Liechtenstein,2,0,144,1
2020-10-12,Liechtenstein,4,0,148,1
2020-10-13,Liechtenstein,15,0,163,1
2020-10-14,Liechtenstein,11,0,174,1
2020-10-15,Liechtenstein,9,0,183,1
2020-10-16,Liechtenstein,9,0,192,1
2020-10-17,Liechtenstein,25,0,217,1
2020-10-18,Liechtenstein,7,0,224,1
2020-10-19,Liechtenstein,0,0,224,1
2020-10-20,Liechtenstein,11,0,235,1
2020-10-21,Liechtenstein,17,0,252,1
2020-10-22,Liechtenstein,30,0,282,1
2020-10-23,Liechtenstein,42,0,324,1
2020-10-24,Liechtenstein,16,0,340,1
2020-10-25,Liechtenstein,25,0,365,1
2020-10-26,Liechtenstein,37,0,402,1
2020-10-27,Liechtenstein,26,0,428,1
2020-10-28,Liechtenstein,22,0,450,1
2020-10-29,Liechtenstein,26,0,476,1
2020-10-30,Liechtenstein,37,1,513,2
2020-10-31,Liechtenstein,20,1,533,3
2020-11-01,Liechtenstein,18,0,551,3
2020-11-02,Liechtenstein,47,0,598,3
2020-11-03,Liechtenstein,33,0,631,3
2020-11-04,Liechtenstein,28,0,659,3
2020-11-05,Liechtenstein,33,0,692,3
2020-11-06,Liechtenstein,49,0,741,3
2020-11-07,Liechtenstein,24,0,765,3
2020-11-08,Liechtenstein,23,0,788,3
2020-11-09,Liechtenstein,13,1,801,4
2020-11-10,Liechtenstein,45,0,846,4
2020-11-11,Liechtenstein,31,0,877,4
2020-11-12,Liechtenstein,28,0,905,4
2020-11-13,Liechtenstein,23,1,928,5
2020-11-14,Liechtenstein,42,0,970,5
2020-11-15,Liechtenstein,15,0,985,5
2020-11-16,Liechtenstein,4,2,989,7
2020-11-17,Liechtenstein,13,1,1002,8
2020-11-18,Liechtenstein,49,0,1051,8
2020-11-19,Liechtenstein,21,0,1072,8
2020-11-20,Liechtenstein,22,0,1094,8
2020-11-21,Liechtenstein,15,0,1109,8
2020-11-22,Liechtenstein,3,0,1112,8
2020-11-23,Liechtenstein,44,4,1156,12
2020-11-24,Liechtenstein,2,1,1158,13
2020-11-25,Liechtenstein,25,1,1183,14
2020-11-26,Liechtenstein,25,0,1208,14
2020-11-27,Liechtenstein,23,1,1231,15
2020-11-28,Liechtenstein,22,0,1253,15
2020-11-29,Liechtenstein,0,0,1253,15
2020-11-30,Liechtenstein,17,1,1270,16
2020-12-01,Liechtenstein,16,0,1286,16
2020-12-02,Liechtenstein,32,0,1318,16
2020-12-03,Liechtenstein,21,1,1339,17
2020-12-04,Liechtenstein,12,0,1351,17
2020-12-05,Liechtenstein,27,0,1378,17
2020-12-06,Liechtenstein,18,0,1396,17
2020-12-07,Liechtenstein,1,2,1397,19
2020-12-08,Liechtenstein,7,0,1404,19
2020-12-09,Liechtenstein,28,0,1432,19
2020-12-10,Liechtenstein,9,0,1441,19
2020-12-11,Liechtenstein,25,1,1466,20
2020-12-12,Liechtenstein,16,0,1482,20
2020-12-13,Liechtenstein,32,0,1514,20
2020-12-14,Liechtenstein,52,0,1566,20
2020-12-15,Liechtenstein,13,1,1579,21
2020-12-16,Liechtenstein,21,0,1600,21
2020-12-17,Liechtenstein,35,0,1635,21
2020-12-18,Liechtenstein,41,2,1676,23
2020-12-19,Liechtenstein,35,2,1711,25
2020-12-20,Liechtenstein,47,0,1758,25
2020-12-21,Liechtenstein,26,2,1784,27
2020-12-22,Liechtenstein,42,1,1826,28
2020-12-23,Liechtenstein,32,2,1858,30
2020-12-24,Liechtenstein,62,0,1920,30
2020-12-25,Liechtenstein,60,0,1980,30
2020-12-26,Liechtenstein,20,1,2000,31
2020-12-27,Liechtenstein,18,0,2018,31
2020-12-28,Liechtenstein,20,4,2038,35
2020-12-29,Liechtenstein,31,3,2069,38
2020-12-30,Liechtenstein,35,1,2104,39
2020-12-31,Liechtenstein,32,0,2136,39
2021-01-01,Liechtenstein,39,0,2175,39
2021-01-02,Liechtenstein,27,0,2202,39
2021-01-03,Liechtenstein,20,0,2222,39
2021-01-04,Liechtenstein,2,2,2224,41
2021-01-05,Liechtenstein,22,4,2246,45
2021-01-06,Liechtenstein,49,3,2295,48
2021-01-07,Liechtenstein,14,0,2309,48
2021-01-08,Liechtenstein,2,0,2311,48
2021-01-09,Liechtenstein,18,1,2329,49
2021-01-10,Liechtenstein,11,0,2340,49
2021-01-11,Liechtenstein,6,0,2346,49
2021-01-12,Liechtenstein,9,0,2355,49
2021-01-13,Liechtenstein,15,0,2370,49
2021-01-14,Liechtenstein,5,0,2375,49
2021-01-15,Liechtenstein,3,0,2378,49
2021-01-16,Liechtenstein,5,0,2383,49
2021-01-17,Liechtenstein,6,0,2389,49
2021-01-18,Liechtenstein,6,1,2395,50
2021-01-19,Liechtenstein,3,0,2398,50
2021-01-20,Liechtenstein,7,0,2405,50
2021-01-21,Liechtenstein,10,1,2415,51
2021-01-22,Liechtenstein,17,1,2432,52
2021-01-23,Liechtenstein,5,0,2437,52
2021-01-24,Liechtenstein,4,0,2441,52
2021-01-25,Liechtenstein,13,0,2454,52
2021-01-26,Liechtenstein,1,0,2455,52
2021-01-27,Liechtenstein,3,0,2458,52
2021-01-28,Liechtenstein,17,0,2475,52
2021-01-29,Liechtenstein,9,0,2484,52
2021-01-30,Liechtenstein,9,0,2493,52
2021-01-31,Liechtenstein,0,0,2493,52
2021-02-01,Liechtenstein,4,0,2497,52
2021-02-02,Liechtenstein,0,0,2497,52
2021-02-03,Liechtenstein,12,0,2509,52
2021-02-04,Liechtenstein,4,0,2513,52
2021-02-05,Liechtenstein,5,0,2518,52
2021-02-06,Liechtenstein,0,0,2518,52
2021-02-07,Liechtenstein,5,0,2523,52
2021-02-08,Liechtenstein,3,0,2526,52
2021-02-09,Liechtenstein,1,0,2527,52
2021-02-10,Liechtenstein,5,0,2532,52
2021-02-11,Liechtenstein,2,0,2534,52
2021-02-12,Liechtenstein,3,0,2537,52
2021-02-13,Liechtenstein,1,0,2538,52
2021-02-14,Liechtenstein,1,0,2539,52
2021-02-15,Liechtenstein,1,1,2540,53
2021-02-16,Liechtenstein,0,0,2540,53
2021-02-17,Liechtenstein,0,1,2540,54
2021-02-18,Liechtenstein,2,0,2542,54
2021-02-19,Liechtenstein,1,0,2543,54
2021-02-20,Liechtenstein,2,0,2545,54
2021-02-21,Liechtenstein,1,0,2546,54
2021-02-22,Liechtenstein,4,0,2550,54
2021-02-23,Liechtenstein,3,0,2553,54
2021-02-24,Liechtenstein,0,0,2553,54
2021-02-25,Liechtenstein,5,0,2558,54
2021-02-26,Liechtenstein,6,0,2564,54
2021-02-27,Liechtenstein,2,0,2566,54
2021-02-28,Liechtenstein,1,0,2567,54
2021-03-01,Liechtenstein,8,0,2575,54
2021-03-02,Liechtenstein,1,0,2576,54
2021-03-03,Liechtenstein,1,0,2577,54
2021-03-04,Liechtenstein,5,0,2582,54
2021-03-05,Liechtenstein,6,0,2588,54
2021-03-06,Liechtenstein,1,0,2589,54
2021-03-07,Liechtenstein,1,0,2590,54
2021-03-08,Liechtenstein,2,0,2592,54
2021-03-09,Liechtenstein,2,1,2594,55
2021-03-10,Liechtenstein,0,0,2594,55
2021-03-11,Liechtenstein,2,0,2596,55
2021-03-12,Liechtenstein,5,0,2601,55
2021-03-13,Liechtenstein,1,0,2602,55
2021-03-14,Liechtenstein,10,0,2612,55
2021-03-15,Liechtenstein,0,0,2612,55
2021-03-16,Liechtenstein,3,1,2615,56
2021-03-17,Liechtenstein,1,0,2616,56
2021-03-18,Liechtenstein,4,0,2620,56
2021-03-19,Liechtenstein,2,0,2622,56
2021-03-20,Liechtenstein,5,0,2627,56
2021-03-21,Liechtenstein,1,0,2628,56
2021-03-22,Liechtenstein,4,0,2632,56
2021-03-23,Liechtenstein,2,0,2634,56
2021-03-24,Liechtenstein,2,0,2636,56
2021-03-25,Liechtenstein,6,0,2642,56
2021-03-26,Liechtenstein,3,0,2645,56
2021-03-27,Liechtenstein,4,0,2649,56
2021-03-28,Liechtenstein,9,0,2658,56
2021-03-29,Liechtenstein,6,0,2664,56
2021-03-30,Liechtenstein,0,0,2664,56
2021-03-31,Liechtenstein,6,0,2670,56
2021-04-01,Liechtenstein,5,0,2675,56
2021-04-02,Liechtenstein,3,0,2678,56
2021-04-03,Liechtenstein,1,0,2679,56
2021-04-04,Liechtenstein,6,0,2685,56
2021-04-05,Liechtenstein,12,0,2697,56
2021-04-06,Liechtenstein,0,0,2697,56
2021-04-07,Liechtenstein,5,0,2702,56
2021-04-08,Liechtenstein,12,0,2714,56
2020-02-29,Lithuania,1,0,1,0
2020-03-01,Lithuania,0,0,1,0
2020-03-02,Lithuania,0,0,1,0
2020-03-03,Lithuania,0,0,1,0
2020-03-04,Lithuania,0,0,1,0
2020-03-05,Lithuania,0,0,1,0
2020-03-06,Lithuania,0,0,1,0
2020-03-07,Lithuania,0,0,1,0
2020-03-08,Lithuania,0,0,1,0
2020-03-09,Lithuania,0,0,1,0
2020-03-10,Lithuania,0,0,1,0
2020-03-11,Lithuania,2,0,3,0
2020-03-12,Lithuania,0,0,3,0
2020-03-13,Lithuania,1,0,4,0
2020-03-14,Lithuania,2,0,6,0
2020-03-15,Lithuania,3,0,9,0
2020-03-16,Lithuania,3,0,12,0
2020-03-17,Lithuania,7,0,19,0
2020-03-18,Lithuania,8,0,27,0
2020-03-19,Lithuania,9,0,36,0
2020-03-20,Lithuania,11,0,47,0
2020-03-21,Lithuania,22,0,69,0
2020-03-22,Lithuania,42,0,111,0
2020-03-23,Lithuania,17,0,128,0
2020-03-24,Lithuania,38,1,166,1
2020-03-25,Lithuania,42,1,208,2
2020-03-26,Lithuania,55,1,263,3
2020-03-27,Lithuania,29,1,292,4
2020-03-28,Lithuania,47,0,339,4
2020-03-29,Lithuania,39,0,378,4
2020-03-30,Lithuania,46,0,424,4
2020-03-31,Lithuania,44,0,468,4
2020-04-01,Lithuania,44,2,512,6
2020-04-02,Lithuania,67,0,579,6
2020-04-03,Lithuania,52,0,631,6
2020-04-04,Lithuania,52,1,683,7
2020-04-05,Lithuania,33,1,716,8
2020-04-06,Lithuania,34,2,750,10
2020-04-07,Lithuania,33,1,783,11
2020-04-08,Lithuania,38,0,821,11
2020-04-09,Lithuania,37,0,858,11
2020-04-10,Lithuania,38,1,896,12
2020-04-11,Lithuania,30,1,926,13
2020-04-12,Lithuania,26,1,952,14
2020-04-13,Lithuania,18,1,970,15
2020-04-14,Lithuania,7,1,977,16
2020-04-15,Lithuania,18,4,995,20
2020-04-16,Lithuania,27,0,1022,20
2020-04-17,Lithuania,28,1,1050,21
2020-04-18,Lithuania,41,1,1091,22
2020-04-19,Lithuania,62,1,1153,23
2020-04-20,Lithuania,20,3,1173,26
2020-04-21,Lithuania,53,0,1226,26
2020-04-22,Lithuania,24,1,1250,27
2020-04-23,Lithuania,22,0,1272,27
2020-04-24,Lithuania,19,1,1291,28
2020-04-25,Lithuania,10,1,1301,29
2020-04-26,Lithuania,15,2,1316,31
2020-04-27,Lithuania,12,1,1328,32
2020-04-28,Lithuania,9,0,1337,32
2020-04-29,Lithuania,27,0,1364,32
2020-04-30,Lithuania,11,0,1375,32
2020-05-01,Lithuania,14,0,1389,32
2020-05-02,Lithuania,5,1,1394,33
2020-05-03,Lithuania,5,0,1399,33
2020-05-04,Lithuania,8,0,1407,33
2020-05-05,Lithuania,3,0,1410,33
2020-05-06,Lithuania,6,1,1416,34
2020-05-07,Lithuania,5,1,1421,35
2020-05-08,Lithuania,9,0,1430,35
2020-05-09,Lithuania,29,0,1459,35
2020-05-10,Lithuania,12,1,1471,36
2020-05-11,Lithuania,8,0,1479,36
2020-05-12,Lithuania,9,3,1488,39
2020-05-13,Lithuania,14,0,1502,39
2020-05-14,Lithuania,9,0,1511,39
2020-05-15,Lithuania,10,2,1521,41
2020-05-16,Lithuania,15,1,1536,42
2020-05-17,Lithuania,9,1,1545,43
2020-05-18,Lithuania,6,2,1551,45
2020-05-19,Lithuania,8,0,1559,45
2020-05-20,Lithuania,21,1,1580,46
2020-05-21,Lithuania,12,0,1592,46
2020-05-22,Lithuania,6,0,1598,46
2020-05-23,Lithuania,14,1,1612,47
2020-05-24,Lithuania,6,1,1618,48
2020-05-25,Lithuania,10,1,1628,49
2020-05-26,Lithuania,4,2,1632,51
2020-05-27,Lithuania,8,0,1640,51
2020-05-28,Lithuania,9,1,1649,52
2020-05-29,Lithuania,5,0,1654,52
2020-05-30,Lithuania,8,2,1662,54
2020-05-31,Lithuania,5,0,1667,54
2020-06-01,Lithuania,4,1,1671,55
2020-06-02,Lithuania,5,0,1676,55
2020-06-03,Lithuania,3,0,1679,55
2020-06-04,Lithuania,5,0,1684,55
2020-06-05,Lithuania,5,0,1689,55
2020-06-06,Lithuania,11,0,1700,55
2020-06-07,Lithuania,9,1,1709,56
2020-06-08,Lithuania,7,2,1716,58
2020-06-09,Lithuania,6,0,1722,58
2020-06-10,Lithuania,6,0,1728,58
2020-06-11,Lithuania,19,0,1747,58
2020-06-12,Lithuania,4,1,1751,59
2020-06-13,Lithuania,7,0,1758,59
2020-06-14,Lithuania,5,0,1763,59
2020-06-15,Lithuania,5,1,1768,60
2020-06-16,Lithuania,3,0,1771,60
2020-06-17,Lithuania,2,0,1773,60
2020-06-18,Lithuania,6,0,1779,60
2020-06-19,Lithuania,8,0,1787,60
2020-06-20,Lithuania,3,0,1790,60
2020-06-21,Lithuania,3,0,1793,60
2020-06-22,Lithuania,3,0,1796,60
2020-06-23,Lithuania,2,1,1798,61
2020-06-24,Lithuania,1,0,1799,61
2020-06-25,Lithuania,2,0,1801,61
2020-06-26,Lithuania,2,0,1803,61
2020-06-27,Lithuania,5,0,1808,61
2020-06-28,Lithuania,2,0,1810,61
2020-06-29,Lithuania,1,0,1811,61
2020-06-30,Lithuania,1,0,1812,61
2020-07-01,Lithuania,1,0,1813,61
2020-07-02,Lithuania,7,1,1820,62
2020-07-03,Lithuania,3,0,1823,62
2020-07-04,Lithuania,3,0,1826,62
2020-07-05,Lithuania,5,0,1831,62
2020-07-06,Lithuania,5,0,1836,62
2020-07-07,Lithuania,3,0,1839,62
2020-07-08,Lithuania,10,0,1849,62
2020-07-09,Lithuania,3,0,1852,62
2020-07-10,Lithuania,4,0,1856,62
2020-07-11,Lithuania,4,0,1860,62
2020-07-12,Lithuania,4,0,1864,62
2020-07-13,Lithuania,5,0,1869,62
2020-07-14,Lithuania,1,0,1870,62
2020-07-15,Lithuania,21,0,1891,62
2020-07-16,Lithuania,6,0,1897,62
2020-07-17,Lithuania,6,0,1903,62
2020-07-18,Lithuania,7,1,1910,63
2020-07-19,Lithuania,18,0,1928,63
2020-07-20,Lithuania,14,0,1942,63
2020-07-21,Lithuania,2,0,1944,63
2020-07-22,Lithuania,2,0,1946,63
2020-07-23,Lithuania,10,0,1956,63
2020-07-24,Lithuania,26,0,1982,63
2020-07-25,Lithuania,14,0,1996,63
2020-07-26,Lithuania,7,0,2003,63
2020-07-27,Lithuania,11,0,2014,63
2020-07-28,Lithuania,8,0,2022,63
2020-07-29,Lithuania,15,0,2037,63
2020-07-30,Lithuania,19,0,2056,63
2020-07-31,Lithuania,13,0,2069,63
2020-08-01,Lithuania,18,0,2087,63
2020-08-02,Lithuania,17,0,2104,63
2020-08-03,Lithuania,10,0,2114,63
2020-08-04,Lithuania,17,0,2131,63
2020-08-05,Lithuania,10,1,2141,64
2020-08-06,Lithuania,24,0,2165,64
2020-08-07,Lithuania,24,0,2189,64
2020-08-08,Lithuania,36,0,2225,64
2020-08-09,Lithuania,22,0,2247,64
2020-08-10,Lithuania,12,0,2259,64
2020-08-11,Lithuania,18,0,2277,64
2020-08-12,Lithuania,26,0,2303,64
2020-08-13,Lithuania,21,0,2324,64
2020-08-14,Lithuania,22,0,2346,64
2020-08-15,Lithuania,33,0,2379,64
2020-08-16,Lithuania,30,0,2409,64
2020-08-17,Lithuania,21,0,2430,64
2020-08-18,Lithuania,37,0,2467,64
2020-08-19,Lithuania,22,0,2489,64
2020-08-20,Lithuania,32,1,2521,65
2020-08-21,Lithuania,37,1,2558,66
2020-08-22,Lithuania,30,1,2588,67
2020-08-23,Lithuania,41,0,2629,67
2020-08-24,Lithuania,38,1,2667,68
2020-08-25,Lithuania,21,0,2688,68
2020-08-26,Lithuania,32,0,2720,68
2020-08-27,Lithuania,36,0,2756,68
2020-08-28,Lithuania,48,1,2804,69
2020-08-29,Lithuania,29,0,2833,69
2020-08-30,Lithuania,35,0,2868,69
2020-08-31,Lithuania,32,0,2900,69
2020-09-01,Lithuania,23,0,2923,69
2020-09-02,Lithuania,29,0,2952,69
2020-09-03,Lithuania,20,0,2972,69
2020-09-04,Lithuania,26,0,2998,69
2020-09-05,Lithuania,36,0,3034,69
2020-09-06,Lithuania,43,0,3077,69
2020-09-07,Lithuania,17,0,3094,69
2020-09-08,Lithuania,32,0,3126,69
2020-09-09,Lithuania,32,0,3158,69
2020-09-10,Lithuania,36,0,3194,69
2020-09-11,Lithuania,44,1,3238,70
2020-09-12,Lithuania,53,0,3291,70
2020-09-13,Lithuania,39,1,3330,71
2020-09-14,Lithuania,51,0,3381,71
2020-09-15,Lithuania,11,0,3392,71
2020-09-16,Lithuania,45,0,3437,71
2020-09-17,Lithuania,62,0,3499,71
2020-09-18,Lithuania,61,0,3560,71
2020-09-19,Lithuania,99,0,3659,71
2020-09-20,Lithuania,80,0,3739,71
2020-09-21,Lithuania,70,0,3809,71
2020-09-22,Lithuania,45,0,3854,71
2020-09-23,Lithuania,73,1,3927,72
2020-09-24,Lithuania,138,2,4065,74
2020-09-25,Lithuania,114,0,4179,74
2020-09-26,Lithuania,111,0,4290,74
2020-09-27,Lithuania,91,2,4381,76
2020-09-28,Lithuania,104,1,4485,77
2020-09-29,Lithuania,88,0,4573,77
2020-09-30,Lithuania,115,0,4688,77
2020-10-01,Lithuania,91,0,4779,77
2020-10-02,Lithuania,171,1,4950,78
2020-10-03,Lithuania,125,2,5075,80
2020-10-04,Lithuania,105,1,5180,81
2020-10-05,Lithuania,99,1,5279,82
2020-10-06,Lithuania,80,2,5359,84
2020-10-07,Lithuania,115,1,5474,85
2020-10-08,Lithuania,142,1,5616,86
2020-10-09,Lithuania,133,1,5749,87
2020-10-10,Lithuania,204,0,5953,87
2020-10-11,Lithuania,160,2,6113,89
2020-10-12,Lithuania,126,0,6239,89
2020-10-13,Lithuania,118,1,6357,90
2020-10-14,Lithuania,137,4,6494,94
2020-10-15,Lithuania,255,0,6749,94
2020-10-16,Lithuania,281,3,7030,97
2020-10-17,Lithuania,228,1,7258,98
2020-10-18,Lithuania,253,2,7511,100
2020-10-19,Lithuania,207,2,7718,102
2020-10-20,Lithuania,203,3,7921,105
2020-10-21,Lithuania,313,3,8234,108
2020-10-22,Lithuania,427,4,8661,112
2020-10-23,Lithuania,445,3,9106,115
2020-10-24,Lithuania,480,1,9586,116
2020-10-25,Lithuania,597,6,10183,122
2020-10-26,Lithuania,765,2,10948,124
2020-10-27,Lithuania,423,5,11371,129
2020-10-28,Lithuania,771,5,12142,134
2020-10-29,Lithuania,948,4,13090,138
2020-10-30,Lithuania,725,6,13815,144
2020-10-31,Lithuania,1000,8,14815,152
2020-11-01,Lithuania,883,3,15698,155
2020-11-02,Lithuania,834,4,16532,159
2020-11-03,Lithuania,893,11,17425,170
2020-11-04,Lithuania,653,6,18078,176
2020-11-05,Lithuania,992,2,19070,178
2020-11-06,Lithuania,1650,7,20720,185
2020-11-07,Lithuania,1940,10,22660,195
2020-11-08,Lithuania,1976,9,24636,204
2020-11-09,Lithuania,1038,8,25674,212
2020-11-10,Lithuania,1108,17,26782,229
2020-11-11,Lithuania,1433,10,28215,239
2020-11-12,Lithuania,1554,11,29769,250
2020-11-13,Lithuania,2057,14,31826,264
2020-11-14,Lithuania,1525,17,33351,281
2020-11-15,Lithuania,1377,14,34728,295
2020-11-16,Lithuania,1148,14,35876,309
2020-11-17,Lithuania,966,20,36842,329
2020-11-18,Lithuania,1941,21,38783,350
2020-11-19,Lithuania,1669,23,40452,373
2020-11-20,Lithuania,2269,19,42721,392
2020-11-21,Lithuania,1978,20,44699,412
2020-11-22,Lithuania,2309,27,47008,439
2020-11-23,Lithuania,1189,20,48197,459
2020-11-24,Lithuania,1171,18,49368,477
2020-11-25,Lithuania,2288,22,51656,499
2020-11-26,Lithuania,2099,27,53755,526
2020-11-27,Lithuania,2330,23,56085,549
2020-11-28,Lithuania,2126,22,58211,571
2020-11-29,Lithuania,1965,22,60176,593
2020-11-30,Lithuania,1135,27,61311,620
2020-12-01,Lithuania,1200,21,62511,641
2020-12-02,Lithuania,2110,34,64621,675
2020-12-03,Lithuania,2460,19,67081,694
2020-12-04,Lithuania,2519,38,69600,732
2020-12-05,Lithuania,2863,34,72463,766
2020-12-06,Lithuania,2217,24,74680,790
2020-12-07,Lithuania,1391,44,76071,834
2020-12-08,Lithuania,1405,25,77476,859
2020-12-09,Lithuania,3139,27,80615,886
2020-12-10,Lithuania,3344,17,83959,903
2020-12-11,Lithuania,3107,35,87066,938
2020-12-12,Lithuania,3346,47,90412,985
2020-12-13,Lithuania,2843,54,93255,1039
2020-12-14,Lithuania,1923,28,95178,1067
2020-12-15,Lithuania,1516,45,96694,1112
2020-12-16,Lithuania,3479,25,100173,1137
2020-12-17,Lithuania,3225,43,103398,1180
2020-12-18,Lithuania,3247,39,106645,1219
2020-12-19,Lithuania,3344,46,109989,1265
2020-12-20,Lithuania,2923,28,112912,1293
2020-12-21,Lithuania,2135,46,115047,1339
2020-12-22,Lithuania,2039,56,117086,1395
2020-12-23,Lithuania,3804,35,120890,1430
2020-12-24,Lithuania,3966,36,124856,1466
2020-12-25,Lithuania,2691,44,127547,1510
2020-12-26,Lithuania,2367,61,129914,1571
2020-12-27,Lithuania,1687,42,131601,1613
2020-12-28,Lithuania,1794,39,133395,1652
2020-12-29,Lithuania,2108,43,135503,1695
2020-12-30,Lithuania,3984,45,139487,1740
2020-12-31,Lithuania,2468,56,141955,1796
2021-01-01,Lithuania,3475,41,145430,1837
2021-01-02,Lithuania,1507,51,146937,1888
2021-01-03,Lithuania,1265,50,148202,1938
2021-01-04,Lithuania,1377,37,149579,1975
2021-01-05,Lithuania,1641,40,151220,2015
2021-01-06,Lithuania,2787,34,154007,2049
2021-01-07,Lithuania,2409,43,156416,2092
2021-01-08,Lithuania,2058,41,158474,2133
2021-01-09,Lithuania,1764,41,160238,2174
2021-01-10,Lithuania,1503,29,161741,2203
2021-01-11,Lithuania,774,43,162515,2246
2021-01-12,Lithuania,1012,34,163527,2280
2021-01-13,Lithuania,1764,37,165291,2317
2021-01-14,Lithuania,1445,33,166736,2350
2021-01-15,Lithuania,1224,35,167960,2385
2021-01-16,Lithuania,1234,34,169194,2419
2021-01-17,Lithuania,842,31,170036,2450
2021-01-18,Lithuania,477,26,170513,2476
2021-01-19,Lithuania,867,22,171380,2498
2021-01-20,Lithuania,1232,25,172612,2523
2021-01-21,Lithuania,1277,38,173889,2561
2021-01-22,Lithuania,1033,36,174922,2597
2021-01-23,Lithuania,1007,34,175929,2631
2021-01-24,Lithuania,773,23,176702,2654
2021-01-25,Lithuania,541,20,177243,2674
2021-01-26,Lithuania,691,17,177934,2691
2021-01-27,Lithuania,1283,29,179217,2720
2021-01-28,Lithuania,943,29,180160,2749
2021-01-29,Lithuania,859,17,181019,2766
2021-01-30,Lithuania,721,25,181740,2791
2021-01-31,Lithuania,803,17,182543,2808
2021-02-01,Lithuania,355,22,182898,2830
2021-02-02,Lithuania,546,17,183444,2847
2021-02-03,Lithuania,764,20,184208,2867
2021-02-04,Lithuania,740,18,184948,2885
2021-02-05,Lithuania,653,23,185601,2908
2021-02-06,Lithuania,677,19,186278,2927
2021-02-07,Lithuania,492,10,186770,2937
2021-02-08,Lithuania,269,18,187039,2955
2021-02-09,Lithuania,382,17,187421,2972
2021-02-10,Lithuania,570,16,187991,2988
2021-02-11,Lithuania,1067,25,189058,3013
2021-02-12,Lithuania,607,25,189665,3038
2021-02-13,Lithuania,576,19,190241,3057
2021-02-14,Lithuania,483,13,190724,3070
2021-02-15,Lithuania,213,10,190937,3080
2021-02-16,Lithuania,327,15,191264,3095
2021-02-17,Lithuania,557,18,191821,3113
2021-02-18,Lithuania,372,16,192193,3129
2021-02-19,Lithuania,793,16,192986,3145
2021-02-20,Lithuania,576,17,193562,3162
2021-02-21,Lithuania,489,9,194051,3171
2021-02-22,Lithuania,282,7,194333,3178
2021-02-23,Lithuania,500,11,194833,3189
2021-02-24,Lithuania,648,11,195481,3200
2021-02-25,Lithuania,568,9,196049,3209
2021-02-26,Lithuania,641,16,196690,3225
2021-02-27,Lithuania,653,9,197343,3234
2021-02-28,Lithuania,1802,10,199145,3244
2021-03-01,Lithuania,253,9,199398,3253
2021-03-02,Lithuania,427,10,199825,3263
2021-03-03,Lithuania,526,18,200351,3281
2021-03-04,Lithuania,547,13,200898,3294
2021-03-05,Lithuania,437,9,201335,3303
2021-03-06,Lithuania,464,18,201799,3321
2021-03-07,Lithuania,415,7,202214,3328
2021-03-08,Lithuania,216,8,202430,3336
2021-03-09,Lithuania,470,5,202900,3341
2021-03-10,Lithuania,486,10,203386,3351
2021-03-11,Lithuania,606,12,203992,3363
2021-03-12,Lithuania,364,10,204356,3373
2021-03-13,Lithuania,598,16,204954,3389
2021-03-14,Lithuania,431,7,205385,3396
2021-03-15,Lithuania,259,14,205644,3410
2021-03-16,Lithuania,646,6,206290,3416
2021-03-17,Lithuania,599,11,206889,3427
2021-03-18,Lithuania,580,15,207469,3442
2021-03-19,Lithuania,579,10,208048,3452
2021-03-20,Lithuania,602,12,208650,3464
2021-03-21,Lithuania,361,12,209011,3476
2021-03-22,Lithuania,329,10,209340,3486
2021-03-23,Lithuania,862,15,210202,3501
2021-03-24,Lithuania,809,9,211011,3510
2021-03-25,Lithuania,793,11,211804,3521
2021-03-26,Lithuania,872,8,212676,3529
2021-03-27,Lithuania,771,10,213447,3539
2021-03-28,Lithuania,494,12,213941,3551
2021-03-29,Lithuania,424,9,214365,3560
2021-03-30,Lithuania,851,6,215216,3566
2021-03-31,Lithuania,903,8,216119,3574
2021-04-01,Lithuania,886,9,217005,3583
2021-04-02,Lithuania,860,11,217865,3594
2021-04-03,Lithuania,1013,8,218878,3602
2021-04-04,Lithuania,729,8,219607,3610
2021-04-05,Lithuania,605,5,220212,3615
2021-04-06,Lithuania,688,8,220900,3623
2021-04-07,Lithuania,1120,12,222020,3635
2021-04-08,Lithuania,1107,12,223127,3647
2020-02-29,Luxembourg,1,0,1,0
2020-03-01,Luxembourg,0,0,1,0
2020-03-02,Luxembourg,0,0,1,0
2020-03-03,Luxembourg,0,0,1,0
2020-03-04,Luxembourg,0,0,1,0
2020-03-05,Luxembourg,0,0,1,0
2020-03-06,Luxembourg,1,0,2,0
2020-03-07,Luxembourg,0,0,2,0
2020-03-08,Luxembourg,1,0,3,0
2020-03-09,Luxembourg,0,0,3,0
2020-03-10,Luxembourg,2,0,5,0
2020-03-11,Luxembourg,2,0,7,0
2020-03-12,Luxembourg,12,0,19,0
2020-03-13,Luxembourg,15,0,34,0
2020-03-14,Luxembourg,17,1,51,1
2020-03-15,Luxembourg,8,0,59,1
2020-03-16,Luxembourg,18,0,77,1
2020-03-17,Luxembourg,63,0,140,1
2020-03-18,Luxembourg,63,1,203,2
2020-03-19,Luxembourg,132,2,335,4
2020-03-20,Luxembourg,149,0,484,4
2020-03-21,Luxembourg,186,4,670,8
2020-03-22,Luxembourg,128,0,798,8
2020-03-23,Luxembourg,77,0,875,8
2020-03-24,Luxembourg,224,0,1099,8
2020-03-25,Luxembourg,234,0,1333,8
2020-03-26,Luxembourg,120,1,1453,9
2020-03-27,Luxembourg,152,6,1605,15
2020-03-28,Luxembourg,226,3,1831,18
2020-03-29,Luxembourg,119,3,1950,21
2020-03-30,Luxembourg,38,1,1988,22
2020-03-31,Luxembourg,190,1,2178,23
2020-04-01,Luxembourg,141,6,2319,29
2020-04-02,Luxembourg,168,1,2487,30
2020-04-03,Luxembourg,125,1,2612,31
2020-04-04,Luxembourg,117,0,2729,31
2020-04-05,Luxembourg,75,5,2804,36
2020-04-06,Luxembourg,39,5,2843,41
2020-04-07,Luxembourg,127,3,2970,44
2020-04-08,Luxembourg,64,2,3034,46
2020-04-09,Luxembourg,81,6,3115,52
2020-04-10,Luxembourg,108,2,3223,54
2020-04-11,Luxembourg,47,8,3270,62
2020-04-12,Luxembourg,11,4,3281,66
2020-04-13,Luxembourg,11,3,3292,69
2020-04-14,Luxembourg,15,-2,3307,67
2020-04-15,Luxembourg,66,2,3373,69
2020-04-16,Luxembourg,71,0,3444,69
2020-04-17,Luxembourg,36,3,3480,72
2020-04-18,Luxembourg,57,0,3537,72
2020-04-19,Luxembourg,13,1,3550,73
2020-04-20,Luxembourg,8,2,3558,75
2020-04-21,Luxembourg,60,3,3618,78
2020-04-22,Luxembourg,36,2,3654,80
2020-04-23,Luxembourg,11,3,3665,83
2020-04-24,Luxembourg,30,2,3695,85
2020-04-25,Luxembourg,16,0,3711,85
2020-04-26,Luxembourg,12,3,3723,88
2020-04-27,Luxembourg,6,0,3729,88
2020-04-28,Luxembourg,12,1,3741,89
2020-04-29,Luxembourg,28,0,3769,89
2020-04-30,Luxembourg,15,1,3784,90
2020-05-01,Luxembourg,18,2,3802,92
2020-05-02,Luxembourg,10,0,3812,92
2020-05-03,Luxembourg,12,4,3824,96
2020-05-04,Luxembourg,4,0,3828,96
2020-05-05,Luxembourg,12,0,3840,96
2020-05-06,Luxembourg,11,2,3851,98
2020-05-07,Luxembourg,8,2,3859,100
2020-05-08,Luxembourg,12,0,3871,100
2020-05-09,Luxembourg,6,1,3877,101
2020-05-10,Luxembourg,9,0,3886,101
2020-05-11,Luxembourg,2,0,3888,101
2020-05-12,Luxembourg,6,1,3894,102
2020-05-13,Luxembourg,10,1,3904,103
2020-05-14,Luxembourg,11,0,3915,103
2020-05-15,Luxembourg,8,1,3923,104
2020-05-16,Luxembourg,7,0,3930,104
2020-05-17,Luxembourg,15,3,3945,107
2020-05-18,Luxembourg,2,0,3947,107
2020-05-19,Luxembourg,11,2,3958,109
2020-05-20,Luxembourg,13,0,3971,109
2020-05-21,Luxembourg,9,0,3980,109
2020-05-22,Luxembourg,1,0,3981,109
2020-05-23,Luxembourg,9,0,3990,109
2020-05-24,Luxembourg,2,1,3992,110
2020-05-25,Luxembourg,1,0,3993,110
2020-05-26,Luxembourg,2,0,3995,110
2020-05-27,Luxembourg,6,0,4001,110
2020-05-28,Luxembourg,7,0,4008,110
2020-05-29,Luxembourg,4,0,4012,110
2020-05-30,Luxembourg,4,0,4016,110
2020-05-31,Luxembourg,2,0,4018,110
2020-06-01,Luxembourg,1,0,4019,110
2020-06-02,Luxembourg,1,0,4020,110
2020-06-03,Luxembourg,4,0,4024,110
2020-06-04,Luxembourg,3,0,4027,110
2020-06-05,Luxembourg,5,0,4032,110
2020-06-06,Luxembourg,3,0,4035,110
2020-06-07,Luxembourg,4,0,4039,110
2020-06-08,Luxembourg,1,0,4040,110
2020-06-09,Luxembourg,6,0,4046,110
2020-06-10,Luxembourg,3,0,4049,110
2020-06-11,Luxembourg,3,0,4052,110
2020-06-12,Luxembourg,3,0,4055,110
2020-06-13,Luxembourg,8,0,4063,110
2020-06-14,Luxembourg,7,0,4070,110
2020-06-15,Luxembourg,2,0,4072,110
2020-06-16,Luxembourg,3,0,4075,110
2020-06-17,Luxembourg,10,0,4085,110
2020-06-18,Luxembourg,6,0,4091,110
2020-06-19,Luxembourg,8,0,4099,110
2020-06-20,Luxembourg,6,0,4105,110
2020-06-21,Luxembourg,15,0,4120,110
2020-06-22,Luxembourg,1,0,4121,110
2020-06-23,Luxembourg,12,0,4133,110
2020-06-24,Luxembourg,7,0,4140,110
2020-06-25,Luxembourg,11,0,4151,110
2020-06-26,Luxembourg,22,0,4173,110
2020-06-27,Luxembourg,44,0,4217,110
2020-06-28,Luxembourg,25,0,4242,110
2020-06-29,Luxembourg,14,0,4256,110
2020-06-30,Luxembourg,43,0,4299,110
2020-07-01,Luxembourg,46,0,4345,110
2020-07-02,Luxembourg,50,0,4395,110
2020-07-03,Luxembourg,52,0,4447,110
2020-07-04,Luxembourg,29,0,4476,110
2020-07-05,Luxembourg,46,0,4522,110
2020-07-06,Luxembourg,20,0,4542,110
2020-07-07,Luxembourg,61,0,4603,110
2020-07-08,Luxembourg,47,0,4650,110
2020-07-09,Luxembourg,69,0,4719,110
2020-07-10,Luxembourg,58,0,4777,110
2020-07-11,Luxembourg,65,0,4842,110
2020-07-12,Luxembourg,83,1,4925,111
2020-07-13,Luxembourg,31,0,4956,111
2020-07-14,Luxembourg,100,0,5056,111
2020-07-15,Luxembourg,66,0,5122,111
2020-07-16,Luxembourg,163,0,5285,111
2020-07-17,Luxembourg,124,0,5409,111
2020-07-18,Luxembourg,74,0,5483,111
2020-07-19,Luxembourg,122,0,5605,111
2020-07-20,Luxembourg,34,0,5639,111
2020-07-21,Luxembourg,86,0,5725,111
2020-07-22,Luxembourg,129,0,5854,111
2020-07-23,Luxembourg,98,1,5952,112
2020-07-24,Luxembourg,104,0,6056,112
2020-07-25,Luxembourg,133,0,6189,112
2020-07-26,Luxembourg,83,0,6272,112
2020-07-27,Luxembourg,49,0,6321,112
2020-07-28,Luxembourg,54,1,6375,113
2020-07-29,Luxembourg,158,1,6533,114
2020-07-30,Luxembourg,83,0,6616,114
2020-07-31,Luxembourg,79,0,6695,114
2020-08-01,Luxembourg,98,2,6793,116
2020-08-02,Luxembourg,62,1,6855,117
2020-08-03,Luxembourg,9,1,6864,118
2020-08-04,Luxembourg,53,0,6917,118
2020-08-05,Luxembourg,90,0,7007,118
2020-08-06,Luxembourg,66,1,7073,119
2020-08-07,Luxembourg,40,0,7113,119
2020-08-08,Luxembourg,56,1,7169,120
2020-08-09,Luxembourg,36,0,7205,120
2020-08-10,Luxembourg,11,1,7216,121
2020-08-11,Luxembourg,26,1,7242,122
2020-08-12,Luxembourg,58,0,7300,122
2020-08-13,Luxembourg,68,0,7368,122
2020-08-14,Luxembourg,37,0,7405,122
2020-08-15,Luxembourg,34,1,7439,123
2020-08-16,Luxembourg,19,0,7458,123
2020-08-17,Luxembourg,11,1,7469,124
2020-08-18,Luxembourg,30,0,7499,124
2020-08-19,Luxembourg,67,0,7566,124
2020-08-20,Luxembourg,71,0,7637,124
2020-08-21,Luxembourg,67,0,7704,124
2020-08-22,Luxembourg,58,0,7762,124
2020-08-23,Luxembourg,13,0,7775,124
2020-08-24,Luxembourg,19,0,7794,124
2020-08-25,Luxembourg,44,0,7838,124
2020-08-26,Luxembourg,90,0,7928,124
2020-08-27,Luxembourg,0,0,7928,124
2020-08-28,Luxembourg,-1348,0,6580,124
2020-08-29,Luxembourg,45,0,6625,124
2020-08-30,Luxembourg,0,0,6625,124
2020-08-31,Luxembourg,0,0,6625,124
2020-09-01,Luxembourg,0,0,6625,124
2020-09-02,Luxembourg,120,0,6745,124
2020-09-03,Luxembourg,66,0,6811,124
2020-09-04,Luxembourg,43,0,6854,124
2020-09-05,Luxembourg,42,0,6896,124
2020-09-06,Luxembourg,54,0,6950,124
2020-09-07,Luxembourg,10,0,6960,124
2020-09-08,Luxembourg,14,0,6974,124
2020-09-09,Luxembourg,49,0,7023,124
2020-09-10,Luxembourg,65,0,7088,124
2020-09-11,Luxembourg,0,0,7088,124
2020-09-12,Luxembourg,71,0,7159,124
2020-09-13,Luxembourg,0,0,7159,124
2020-09-14,Luxembourg,85,0,7244,124
2020-09-15,Luxembourg,40,0,7284,124
2020-09-16,Luxembourg,110,0,7394,124
2020-09-17,Luxembourg,147,0,7541,124
2020-09-18,Luxembourg,177,0,7718,124
2020-09-19,Luxembourg,0,0,7718,124
2020-09-20,Luxembourg,0,0,7718,124
2020-09-21,Luxembourg,198,0,7916,124
2020-09-22,Luxembourg,100,0,8016,124
2020-09-23,Luxembourg,74,0,8090,124
2020-09-24,Luxembourg,68,0,8158,124
2020-09-25,Luxembourg,75,0,8233,124
2020-09-26,Luxembourg,0,0,8233,124
2020-09-27,Luxembourg,0,0,8233,124
2020-09-28,Luxembourg,143,0,8376,124
2020-09-29,Luxembourg,55,0,8431,124
2020-09-30,Luxembourg,78,0,8509,124
2020-10-01,Luxembourg,86,1,8595,125
2020-10-02,Luxembourg,114,0,8709,125
2020-10-03,Luxembourg,0,0,8709,125
2020-10-04,Luxembourg,0,0,8709,125
2020-10-05,Luxembourg,216,2,8925,127
2020-10-06,Luxembourg,54,1,8979,128
2020-10-07,Luxembourg,140,0,9119,128
2020-10-08,Luxembourg,100,1,9219,129
2020-10-09,Luxembourg,141,1,9360,130
2020-10-10,Luxembourg,154,1,9514,131
2020-10-11,Luxembourg,208,1,9722,132
2020-10-12,Luxembourg,9,1,9731,133
2020-10-13,Luxembourg,109,0,9840,133
2020-10-14,Luxembourg,190,0,10030,133
2020-10-15,Luxembourg,214,0,10244,133
2020-10-16,Luxembourg,227,0,10471,133
2020-10-17,Luxembourg,0,0,10471,133
2020-10-18,Luxembourg,417,0,10888,133
2020-10-19,Luxembourg,122,2,11010,135
2020-10-20,Luxembourg,231,1,11241,136
2020-10-21,Luxembourg,430,2,11671,138
2020-10-22,Luxembourg,662,2,12333,140
2020-10-23,Luxembourg,518,1,12851,141
2020-10-24,Luxembourg,0,0,12851,141
2020-10-25,Luxembourg,0,0,12851,141
2020-10-26,Luxembourg,1548,6,14399,147
2020-10-27,Luxembourg,485,0,14884,147
2020-10-28,Luxembourg,775,0,15659,147
2020-10-29,Luxembourg,697,3,16356,150
2020-10-30,Luxembourg,778,2,17134,152
2020-10-31,Luxembourg,0,0,17134,152
2020-11-01,Luxembourg,0,0,17134,152
2020-11-02,Luxembourg,1967,8,19101,160
2020-11-03,Luxembourg,533,7,19634,167
2020-11-04,Luxembourg,710,4,20344,171
2020-11-05,Luxembourg,803,6,21147,177
2020-11-06,Luxembourg,659,3,21806,180
2020-11-07,Luxembourg,0,0,21806,180
2020-11-08,Luxembourg,0,0,21806,180
2020-11-09,Luxembourg,1421,13,23227,193
2020-11-10,Luxembourg,483,5,23710,198
2020-11-11,Luxembourg,0,0,23710,198
2020-11-12,Luxembourg,1508,13,25218,211
2020-11-13,Luxembourg,713,8,25931,219
2020-11-14,Luxembourg,0,0,25931,219
2020-11-15,Luxembourg,0,0,25931,219
2020-11-16,Luxembourg,1325,17,27256,236
2020-11-17,Luxembourg,425,4,27681,240
2020-11-18,Luxembourg,892,8,28573,248
2020-11-19,Luxembourg,670,6,29243,254
2020-11-20,Luxembourg,519,6,29762,260
2020-11-21,Luxembourg,0,0,29762,260
2020-11-22,Luxembourg,0,0,29762,260
2020-11-23,Luxembourg,1349,13,31111,273
2020-11-24,Luxembourg,373,10,31484,283
2020-11-25,Luxembourg,616,5,32100,288
2020-11-26,Luxembourg,773,6,32873,294
2020-11-27,Luxembourg,536,6,33409,300
2020-11-28,Luxembourg,0,0,33409,300
2020-11-29,Luxembourg,0,0,33409,300
2020-11-30,Luxembourg,1269,21,34678,321
2020-12-01,Luxembourg,451,9,35129,330
2020-12-02,Luxembourg,673,4,35802,334
2020-12-03,Luxembourg,627,5,36429,339
2020-12-04,Luxembourg,588,6,37017,345
2020-12-05,Luxembourg,0,0,37017,345
2020-12-06,Luxembourg,0,0,37017,345
2020-12-07,Luxembourg,1459,15,38476,360
2020-12-08,Luxembourg,0,0,38476,360
2020-12-09,Luxembourg,0,0,38476,360
2020-12-10,Luxembourg,1561,24,40037,384
2020-12-11,Luxembourg,718,8,40755,392
2020-12-12,Luxembourg,0,0,40755,392
2020-12-13,Luxembourg,0,0,40755,392
2020-12-14,Luxembourg,1145,18,41900,410
2020-12-15,Luxembourg,350,8,42250,418
2020-12-16,Luxembourg,595,3,42845,421
2020-12-17,Luxembourg,434,7,43279,428
2020-12-18,Luxembourg,449,6,43728,434
2020-12-19,Luxembourg,0,0,43728,434
2020-12-20,Luxembourg,0,0,43728,434
2020-12-21,Luxembourg,854,16,44582,450
2020-12-22,Luxembourg,227,3,44809,453
2020-12-23,Luxembourg,400,5,45209,458
2020-12-24,Luxembourg,0,0,45209,458
2020-12-25,Luxembourg,0,0,45209,458
2020-12-26,Luxembourg,0,0,45209,458
2020-12-27,Luxembourg,0,0,45209,458
2020-12-28,Luxembourg,640,29,45849,487
2020-12-29,Luxembourg,239,2,46088,489
2020-12-30,Luxembourg,327,6,46415,495
2020-12-31,Luxembourg,0,0,46415,495
2021-01-01,Luxembourg,0,0,46415,495
2021-01-02,Luxembourg,0,0,46415,495
2021-01-03,Luxembourg,0,0,46415,495
2021-01-04,Luxembourg,571,13,46986,508
2021-01-05,Luxembourg,163,6,47149,514
2021-01-06,Luxembourg,281,3,47430,517
2021-01-07,Luxembourg,162,4,47592,521
2021-01-08,Luxembourg,152,6,47744,527
2021-01-09,Luxembourg,0,0,47744,527
2021-01-10,Luxembourg,0,0,47744,527
2021-01-11,Luxembourg,283,8,48027,535
2021-01-12,Luxembourg,154,3,48181,538
2021-01-13,Luxembourg,191,4,48372,542
2021-01-14,Luxembourg,114,3,48486,545
2021-01-15,Luxembourg,144,4,48630,549
2021-01-16,Luxembourg,0,0,48630,549
2021-01-17,Luxembourg,0,0,48630,549
2021-01-18,Luxembourg,260,8,48890,557
2021-01-19,Luxembourg,85,3,48975,560
2021-01-20,Luxembourg,229,2,49204,562
2021-01-21,Luxembourg,115,0,49319,562
2021-01-22,Luxembourg,119,0,49438,562
2021-01-23,Luxembourg,0,0,49438,562
2021-01-24,Luxembourg,0,0,49438,562
2021-01-25,Luxembourg,295,4,49733,566
2021-01-26,Luxembourg,119,4,49852,570
2021-01-27,Luxembourg,237,1,50089,571
2021-01-28,Luxembourg,139,3,50228,574
2021-01-29,Luxembourg,160,3,50388,577
2021-01-30,Luxembourg,0,0,50388,577
2021-01-31,Luxembourg,0,0,50388,577
2021-02-01,Luxembourg,345,7,50733,584
2021-02-02,Luxembourg,190,2,50923,586
2021-02-03,Luxembourg,205,1,51128,587
2021-02-04,Luxembourg,202,1,51330,588
2021-02-05,Luxembourg,182,2,51512,590
2021-02-06,Luxembourg,0,0,51512,590
2021-02-07,Luxembourg,0,0,51512,590
2021-02-08,Luxembourg,367,7,51879,597
2021-02-09,Luxembourg,143,3,52022,600
2021-02-10,Luxembourg,225,2,52247,602
2021-02-11,Luxembourg,145,2,52392,604
2021-02-12,Luxembourg,147,2,52539,606
2021-02-13,Luxembourg,0,0,52539,606
2021-02-14,Luxembourg,0,0,52539,606
2021-02-15,Luxembourg,384,5,52923,611
2021-02-16,Luxembourg,139,1,53062,612
2021-02-17,Luxembourg,267,4,53329,616
2021-02-18,Luxembourg,233,3,53562,619
2021-02-19,Luxembourg,220,3,53782,622
2021-02-20,Luxembourg,0,0,53782,622
2021-02-21,Luxembourg,0,0,53782,622
2021-02-22,Luxembourg,390,6,54172,628
2021-02-23,Luxembourg,182,1,54354,629
2021-02-24,Luxembourg,324,3,54678,632
2021-02-25,Luxembourg,193,2,54871,634
2021-02-26,Luxembourg,239,3,55110,637
2021-02-27,Luxembourg,0,0,55110,637
2021-02-28,Luxembourg,0,0,55110,637
2021-03-01,Luxembourg,370,2,55480,639
2021-03-02,Luxembourg,152,2,55632,641
2021-03-03,Luxembourg,270,2,55902,643
2021-03-04,Luxembourg,208,4,56110,647
2021-03-05,Luxembourg,186,5,56296,652
2021-03-06,Luxembourg,0,0,56296,652
2021-03-07,Luxembourg,0,0,56296,652
2021-03-08,Luxembourg,381,11,56677,663
2021-03-09,Luxembourg,145,5,56822,668
2021-03-10,Luxembourg,234,5,57056,673
2021-03-11,Luxembourg,265,2,57321,675
2021-03-12,Luxembourg,182,6,57503,681
2021-03-13,Luxembourg,0,0,57503,681
2021-03-14,Luxembourg,0,0,57503,681
2021-03-15,Luxembourg,423,12,57926,693
2021-03-16,Luxembourg,185,4,58111,697
2021-03-17,Luxembourg,297,7,58408,704
2021-03-18,Luxembourg,266,1,58674,705
2021-03-19,Luxembourg,281,9,58955,714
2021-03-20,Luxembourg,0,0,58955,714
2021-03-21,Luxembourg,0,0,58955,714
2021-03-22,Luxembourg,542,5,59497,719
2021-03-23,Luxembourg,165,7,59662,726
2021-03-24,Luxembourg,245,2,59907,728
2021-03-25,Luxembourg,298,8,60205,736
2021-03-26,Luxembourg,260,2,60465,738
2021-03-27,Luxembourg,0,0,60465,738
2021-03-28,Luxembourg,0,0,60465,738
2021-03-29,Luxembourg,608,3,61073,741
2021-03-30,Luxembourg,182,2,61255,743
2021-03-31,Luxembourg,387,3,61642,746
2021-04-01,Luxembourg,239,3,61881,749
2021-04-02,Luxembourg,224,1,62105,750
2021-04-03,Luxembourg,0,0,62105,750
2021-04-04,Luxembourg,0,0,62105,750
2021-04-05,Luxembourg,0,0,62105,750
2021-04-06,Luxembourg,520,11,62625,761
2021-04-07,Luxembourg,168,1,62793,762
2021-04-08,Luxembourg,387,0,63180,762
2020-03-20,Madagascar,3,0,3,0
2020-03-21,Madagascar,0,0,3,0
2020-03-22,Madagascar,0,0,3,0
2020-03-23,Madagascar,9,0,12,0
2020-03-24,Madagascar,5,0,17,0
2020-03-25,Madagascar,2,0,19,0
2020-03-26,Madagascar,4,0,23,0
2020-03-27,Madagascar,3,0,26,0
2020-03-28,Madagascar,0,0,26,0
2020-03-29,Madagascar,13,0,39,0
2020-03-30,Madagascar,4,0,43,0
2020-03-31,Madagascar,14,0,57,0
2020-04-01,Madagascar,0,0,57,0
2020-04-02,Madagascar,2,0,59,0
2020-04-03,Madagascar,11,0,70,0
2020-04-04,Madagascar,0,0,70,0
2020-04-05,Madagascar,2,0,72,0
2020-04-06,Madagascar,10,0,82,0
2020-04-07,Madagascar,6,0,88,0
2020-04-08,Madagascar,5,0,93,0
2020-04-09,Madagascar,0,0,93,0
2020-04-10,Madagascar,0,0,93,0
2020-04-11,Madagascar,9,0,102,0
2020-04-12,Madagascar,4,0,106,0
2020-04-13,Madagascar,0,0,106,0
2020-04-14,Madagascar,2,0,108,0
2020-04-15,Madagascar,2,0,110,0
2020-04-16,Madagascar,1,0,111,0
2020-04-17,Madagascar,6,0,117,0
2020-04-18,Madagascar,3,0,120,0
2020-04-19,Madagascar,1,0,121,0
2020-04-20,Madagascar,0,0,121,0
2020-04-21,Madagascar,0,0,121,0
2020-04-22,Madagascar,0,0,121,0
2020-04-23,Madagascar,0,0,121,0
2020-04-24,Madagascar,1,0,122,0
2020-04-25,Madagascar,1,0,123,0
2020-04-26,Madagascar,1,0,124,0
2020-04-27,Madagascar,4,0,128,0
2020-04-28,Madagascar,0,0,128,0
2020-04-29,Madagascar,0,0,128,0
2020-04-30,Madagascar,0,0,128,0
2020-05-01,Madagascar,4,0,132,0
2020-05-02,Madagascar,3,0,135,0
2020-05-03,Madagascar,14,0,149,0
2020-05-04,Madagascar,0,0,149,0
2020-05-05,Madagascar,2,0,151,0
2020-05-06,Madagascar,7,0,158,0
2020-05-07,Madagascar,35,0,193,0
2020-05-08,Madagascar,0,0,193,0
2020-05-09,Madagascar,0,0,193,0
2020-05-10,Madagascar,0,0,193,0
2020-05-11,Madagascar,-7,0,186,0
2020-05-12,Madagascar,0,0,186,0
2020-05-13,Madagascar,26,0,212,0
2020-05-14,Madagascar,18,0,230,0
2020-05-15,Madagascar,8,0,238,0
2020-05-16,Madagascar,45,0,283,0
2020-05-17,Madagascar,21,1,304,1
2020-05-18,Madagascar,18,0,322,1
2020-05-19,Madagascar,4,1,326,2
2020-05-20,Madagascar,45,0,371,2
2020-05-21,Madagascar,34,0,405,2
2020-05-22,Madagascar,43,0,448,2
2020-05-23,Madagascar,40,0,488,2
2020-05-24,Madagascar,39,0,527,2
2020-05-25,Madagascar,15,0,542,2
2020-05-26,Madagascar,44,0,586,2
2020-05-27,Madagascar,26,0,612,2
2020-05-28,Madagascar,44,0,656,2
2020-05-29,Madagascar,42,3,698,5
2020-05-30,Madagascar,60,1,758,6
2020-05-31,Madagascar,13,0,771,6
2020-06-01,Madagascar,55,0,826,6
2020-06-02,Madagascar,19,0,845,6
2020-06-03,Madagascar,63,0,908,6
2020-06-04,Madagascar,49,1,957,7
2020-06-05,Madagascar,18,0,975,7
2020-06-06,Madagascar,51,1,1026,8
2020-06-07,Madagascar,26,1,1052,9
2020-06-08,Madagascar,42,0,1094,9
2020-06-09,Madagascar,44,0,1138,9
2020-06-10,Madagascar,24,1,1162,10
2020-06-11,Madagascar,41,0,1203,10
2020-06-12,Madagascar,37,0,1240,10
2020-06-13,Madagascar,12,0,1252,10
2020-06-14,Madagascar,20,0,1272,10
2020-06-15,Madagascar,18,0,1290,10
2020-06-16,Madagascar,27,2,1317,12
2020-06-17,Madagascar,61,0,1378,12
2020-06-18,Madagascar,25,1,1403,13
2020-06-19,Madagascar,40,0,1443,13
2020-06-20,Madagascar,60,0,1503,13
2020-06-21,Madagascar,93,1,1596,14
2020-06-22,Madagascar,44,1,1640,15
2020-06-23,Madagascar,84,0,1724,15
2020-06-24,Madagascar,63,1,1787,16
2020-06-25,Madagascar,42,0,1829,16
2020-06-26,Madagascar,93,0,1922,16
2020-06-27,Madagascar,83,0,2005,16
2020-06-28,Madagascar,73,2,2078,18
2020-06-29,Madagascar,60,2,2138,20
2020-06-30,Madagascar,76,0,2214,20
2020-07-01,Madagascar,89,2,2303,22
2020-07-02,Madagascar,100,2,2403,24
2020-07-03,Madagascar,109,2,2512,26
2020-07-04,Madagascar,216,3,2728,29
2020-07-05,Madagascar,213,3,2941,32
2020-07-06,Madagascar,309,1,3250,33
2020-07-07,Madagascar,222,0,3472,33
2020-07-08,Madagascar,101,0,3573,33
2020-07-09,Madagascar,209,0,3782,33
2020-07-10,Madagascar,361,1,4143,34
2020-07-11,Madagascar,435,0,4578,34
2020-07-12,Madagascar,289,1,4867,35
2020-07-13,Madagascar,213,2,5080,37
2020-07-14,Madagascar,263,2,5343,39
2020-07-15,Madagascar,262,4,5605,43
2020-07-16,Madagascar,484,10,6089,53
2020-07-17,Madagascar,378,1,6467,54
2020-07-18,Madagascar,382,1,6849,55
2020-07-19,Madagascar,200,4,7049,59
2020-07-20,Madagascar,104,3,7153,62
2020-07-21,Madagascar,395,3,7548,65
2020-07-22,Madagascar,614,4,8162,69
2020-07-23,Madagascar,219,1,8381,70
2020-07-24,Madagascar,360,6,8741,76
2020-07-25,Madagascar,125,2,8866,78
2020-07-26,Madagascar,429,7,9295,85
2020-07-27,Madagascar,395,6,9690,91
2020-07-28,Madagascar,414,2,10104,93
2020-07-29,Madagascar,213,6,10317,99
2020-07-30,Madagascar,431,6,10748,105
2020-07-31,Madagascar,120,1,10868,106
2020-08-01,Madagascar,405,1,11273,107
2020-08-02,Madagascar,255,7,11528,114
2020-08-03,Madagascar,132,4,11660,118
2020-08-04,Madagascar,235,5,11895,123
2020-08-05,Madagascar,327,4,12222,127
2020-08-06,Madagascar,304,7,12526,134
2020-08-07,Madagascar,182,1,12708,135
2020-08-08,Madagascar,214,6,12922,141
2020-08-09,Madagascar,164,7,13086,148
2020-08-10,Madagascar,116,3,13202,151
2020-08-11,Madagascar,115,1,13317,152
2020-08-12,Madagascar,80,4,13397,156
2020-08-13,Madagascar,125,6,13522,162
2020-08-14,Madagascar,121,2,13643,164
2020-08-15,Madagascar,81,2,13724,166
2020-08-16,Madagascar,103,4,13827,170
2020-08-17,Madagascar,59,1,13886,171
2020-08-18,Madagascar,123,2,14009,173
2020-08-19,Madagascar,65,0,14074,173
2020-08-20,Madagascar,80,4,14154,177
2020-08-21,Madagascar,64,1,14218,178
2020-08-22,Madagascar,59,0,14277,178
2020-08-23,Madagascar,50,0,14327,178
2020-08-24,Madagascar,75,0,14402,178
2020-08-25,Madagascar,73,0,14475,178
2020-08-26,Madagascar,79,3,14554,181
2020-08-27,Madagascar,38,3,14592,184
2020-08-28,Madagascar,104,3,14696,187
2020-08-29,Madagascar,95,3,14791,190
2020-08-30,Madagascar,52,1,14843,191
2020-08-31,Madagascar,20,1,14863,192
2020-09-01,Madagascar,94,3,14957,195
2020-09-02,Madagascar,66,1,15023,196
2020-09-03,Madagascar,83,1,15106,197
2020-09-04,Madagascar,81,1,15187,198
2020-09-05,Madagascar,82,1,15269,199
2020-09-06,Madagascar,50,1,15319,200
2020-09-07,Madagascar,33,2,15352,202
2020-09-08,Madagascar,83,4,15435,206
2020-09-09,Madagascar,85,0,15520,206
2020-09-10,Madagascar,104,2,15624,208
2020-09-11,Madagascar,45,1,15669,209
2020-09-12,Madagascar,68,1,15737,210
2020-09-13,Madagascar,20,1,15757,211
2020-09-14,Madagascar,12,2,15769,213
2020-09-15,Madagascar,34,1,15803,214
2020-09-16,Madagascar,68,1,15871,215
2020-09-17,Madagascar,54,1,15925,216
2020-09-18,Madagascar,46,1,15971,217
2020-09-19,Madagascar,49,2,16020,219
2020-09-20,Madagascar,33,4,16053,223
2020-09-21,Madagascar,20,2,16073,225
2020-09-22,Madagascar,63,1,16136,226
2020-09-23,Madagascar,31,0,16167,226
2020-09-24,Madagascar,24,1,16191,227
2020-09-25,Madagascar,30,1,16221,228
2020-09-26,Madagascar,36,1,16257,229
2020-09-27,Madagascar,28,0,16285,229
2020-09-28,Madagascar,63,0,16348,229
2020-09-29,Madagascar,29,0,16377,229
2020-09-30,Madagascar,31,1,16408,230
2020-10-01,Madagascar,46,2,16454,232
2020-10-02,Madagascar,39,0,16493,232
2020-10-03,Madagascar,36,0,16529,232
2020-10-04,Madagascar,29,0,16558,232
2020-10-05,Madagascar,12,1,16570,233
2020-10-06,Madagascar,30,1,16600,234
2020-10-07,Madagascar,33,1,16633,235
2020-10-08,Madagascar,21,0,16654,235
2020-10-09,Madagascar,22,2,16676,237
2020-10-10,Madagascar,26,0,16702,237
2020-10-11,Madagascar,16,0,16718,237
2020-10-12,Madagascar,8,0,16726,237
2020-10-13,Madagascar,28,0,16754,237
2020-10-14,Madagascar,0,0,16754,237
2020-10-15,Madagascar,0,0,16754,237
2020-10-16,Madagascar,0,0,16754,237
2020-10-17,Madagascar,56,1,16810,238
2020-10-18,Madagascar,0,0,16810,238
2020-10-19,Madagascar,0,0,16810,238
2020-10-20,Madagascar,0,0,16810,238
2020-10-21,Madagascar,0,0,16810,238
2020-10-22,Madagascar,0,0,16810,238
2020-10-23,Madagascar,0,0,16810,238
2020-10-24,Madagascar,158,6,16968,244
2020-10-25,Madagascar,0,0,16968,244
2020-10-26,Madagascar,0,0,16968,244
2020-10-27,Madagascar,0,0,16968,244
2020-10-28,Madagascar,0,0,16968,244
2020-10-29,Madagascar,0,0,16968,244
2020-10-30,Madagascar,0,0,16968,244
2020-10-31,Madagascar,143,0,17111,244
2020-11-01,Madagascar,0,0,17111,244
2020-11-02,Madagascar,0,0,17111,244
2020-11-03,Madagascar,0,0,17111,244
2020-11-04,Madagascar,0,0,17111,244
2020-11-05,Madagascar,0,0,17111,244
2020-11-06,Madagascar,0,0,17111,244
2020-11-07,Madagascar,0,0,17111,244
2020-11-08,Madagascar,112,5,17223,249
2020-11-09,Madagascar,0,0,17223,249
2020-11-10,Madagascar,0,0,17223,249
2020-11-11,Madagascar,0,0,17223,249
2020-11-12,Madagascar,0,0,17223,249
2020-11-13,Madagascar,0,0,17223,249
2020-11-14,Madagascar,0,0,17223,249
2020-11-15,Madagascar,87,1,17310,250
2020-11-16,Madagascar,0,0,17310,250
2020-11-17,Madagascar,0,0,17310,250
2020-11-18,Madagascar,0,0,17310,250
2020-11-19,Madagascar,0,0,17310,250
2020-11-20,Madagascar,0,0,17310,250
2020-11-21,Madagascar,0,0,17310,250
2020-11-22,Madagascar,31,1,17341,251
2020-11-23,Madagascar,0,0,17341,251
2020-11-24,Madagascar,0,0,17341,251
2020-11-25,Madagascar,0,0,17341,251
2020-11-26,Madagascar,0,0,17341,251
2020-11-27,Madagascar,0,0,17341,251
2020-11-28,Madagascar,0,0,17341,251
2020-11-29,Madagascar,0,0,17341,251
2020-11-30,Madagascar,0,0,17341,251
2020-12-01,Madagascar,0,0,17341,251
2020-12-02,Madagascar,0,0,17341,251
2020-12-03,Madagascar,0,4,17341,255
2020-12-04,Madagascar,0,0,17341,255
2020-12-05,Madagascar,132,0,17473,255
2020-12-06,Madagascar,0,0,17473,255
2020-12-07,Madagascar,0,0,17473,255
2020-12-08,Madagascar,0,0,17473,255
2020-12-09,Madagascar,0,0,17473,255
2020-12-10,Madagascar,0,0,17473,255
2020-12-11,Madagascar,0,0,17473,255
2020-12-12,Madagascar,114,4,17587,259
2020-12-13,Madagascar,0,0,17587,259
2020-12-14,Madagascar,0,0,17587,259
2020-12-15,Madagascar,0,0,17587,259
2020-12-16,Madagascar,0,0,17587,259
2020-12-17,Madagascar,0,0,17587,259
2020-12-18,Madagascar,0,0,17587,259
2020-12-19,Madagascar,0,0,17587,259
2020-12-20,Madagascar,46,1,17633,260
2020-12-21,Madagascar,0,0,17633,260
2020-12-22,Madagascar,0,0,17633,260
2020-12-23,Madagascar,0,0,17633,260
2020-12-24,Madagascar,0,0,17633,260
2020-12-25,Madagascar,0,0,17633,260
2020-12-26,Madagascar,0,0,17633,260
2020-12-27,Madagascar,81,1,17714,261
2020-12-28,Madagascar,0,0,17714,261
2020-12-29,Madagascar,0,0,17714,261
2020-12-30,Madagascar,0,0,17714,261
2020-12-31,Madagascar,0,0,17714,261
2021-01-01,Madagascar,0,0,17714,261
2021-01-02,Madagascar,53,1,17767,262
2021-01-03,Madagascar,0,0,17767,262
2021-01-04,Madagascar,0,0,17767,262
2021-01-05,Madagascar,0,0,17767,262
2021-01-06,Madagascar,0,0,17767,262
2021-01-07,Madagascar,0,0,17767,262
2021-01-08,Madagascar,0,0,17767,262
2021-01-09,Madagascar,0,0,17767,262
2021-01-10,Madagascar,234,5,18001,267
2021-01-11,Madagascar,0,0,18001,267
2021-01-12,Madagascar,0,0,18001,267
2021-01-13,Madagascar,0,0,18001,267
2021-01-14,Madagascar,0,0,18001,267
2021-01-15,Madagascar,0,0,18001,267
2021-01-16,Madagascar,0,0,18001,267
2021-01-17,Madagascar,300,6,18301,273
2021-01-18,Madagascar,0,0,18301,273
2021-01-19,Madagascar,0,0,18301,273
2021-01-20,Madagascar,0,0,18301,273
2021-01-21,Madagascar,0,0,18301,273
2021-01-22,Madagascar,0,0,18301,273
2021-01-23,Madagascar,0,0,18301,273
2021-01-24,Madagascar,442,6,18743,279
2021-01-25,Madagascar,0,0,18743,279
2021-01-26,Madagascar,0,0,18743,279
2021-01-27,Madagascar,0,0,18743,279
2021-01-28,Madagascar,0,0,18743,279
2021-01-29,Madagascar,0,0,18743,279
2021-01-30,Madagascar,0,0,18743,279
2021-01-31,Madagascar,322,2,19065,281
2021-02-01,Madagascar,0,0,19065,281
2021-02-02,Madagascar,0,0,19065,281
2021-02-03,Madagascar,0,0,19065,281
2021-02-04,Madagascar,0,0,19065,281
2021-02-05,Madagascar,0,0,19065,281
2021-02-06,Madagascar,0,0,19065,281
2021-02-07,Madagascar,295,4,19360,285
2021-02-08,Madagascar,0,0,19360,285
2021-02-09,Madagascar,0,0,19360,285
2021-02-10,Madagascar,0,0,19360,285
2021-02-11,Madagascar,0,0,19360,285
2021-02-12,Madagascar,0,0,19360,285
2021-02-13,Madagascar,0,0,19360,285
2021-02-14,Madagascar,238,7,19598,292
2021-02-15,Madagascar,0,0,19598,292
2021-02-16,Madagascar,0,0,19598,292
2021-02-17,Madagascar,0,0,19598,292
2021-02-18,Madagascar,0,0,19598,292
2021-02-19,Madagascar,0,0,19598,292
2021-02-20,Madagascar,0,0,19598,292
2021-02-21,Madagascar,233,5,19831,297
2021-02-22,Madagascar,0,0,19831,297
2021-02-23,Madagascar,0,0,19831,297
2021-02-24,Madagascar,0,0,19831,297
2021-02-25,Madagascar,0,0,19831,297
2021-02-26,Madagascar,0,0,19831,297
2021-02-27,Madagascar,0,0,19831,297
2021-02-28,Madagascar,0,0,19831,297
2021-03-01,Madagascar,0,0,19831,297
2021-03-02,Madagascar,0,0,19831,297
2021-03-03,Madagascar,0,0,19831,297
2021-03-04,Madagascar,0,0,19831,297
2021-03-05,Madagascar,0,0,19831,297
2021-03-06,Madagascar,324,3,20155,300
2021-03-07,Madagascar,0,0,20155,300
2021-03-08,Madagascar,0,0,20155,300
2021-03-09,Madagascar,0,0,20155,300
2021-03-10,Madagascar,0,0,20155,300
2021-03-11,Madagascar,0,0,20155,300
2021-03-12,Madagascar,0,0,20155,300
2021-03-13,Madagascar,1201,26,21356,326
2021-03-14,Madagascar,0,0,21356,326
2021-03-15,Madagascar,231,8,21587,334
2021-03-16,Madagascar,101,1,21688,335
2021-03-17,Madagascar,138,2,21826,337
2021-03-18,Madagascar,173,1,21999,338
2021-03-19,Madagascar,114,2,22113,340
2021-03-20,Madagascar,162,5,22275,345
2021-03-21,Madagascar,209,6,22484,351
2021-03-22,Madagascar,132,4,22616,355
2021-03-23,Madagascar,66,6,22682,361
2021-03-24,Madagascar,162,2,22844,363
2021-03-25,Madagascar,196,6,23040,369
2021-03-26,Madagascar,190,9,23230,378
2021-03-27,Madagascar,194,3,23424,381
2021-03-28,Madagascar,161,6,23585,387
2021-03-29,Madagascar,384,7,23969,394
2021-03-30,Madagascar,295,9,24264,403
2021-03-31,Madagascar,162,15,24426,418
2021-04-01,Madagascar,270,15,24696,433
2021-04-02,Madagascar,272,11,24968,444
2021-04-03,Madagascar,294,5,25262,449
2021-04-04,Madagascar,310,5,25572,454
2021-04-05,Madagascar,137,5,25709,459
2021-04-06,Madagascar,165,3,25874,462
2021-04-07,Madagascar,253,7,26127,469
2021-04-08,Madagascar,348,6,26475,475
2020-04-02,Malawi,3,0,3,0
2020-04-03,Malawi,0,0,3,0
2020-04-04,Malawi,1,0,4,0
2020-04-05,Malawi,0,0,4,0
2020-04-06,Malawi,1,0,5,0
2020-04-07,Malawi,3,1,8,1
2020-04-08,Malawi,0,0,8,1
2020-04-09,Malawi,0,0,8,1
2020-04-10,Malawi,1,0,9,1
2020-04-11,Malawi,3,1,12,2
2020-04-12,Malawi,1,0,13,2
2020-04-13,Malawi,3,0,16,2
2020-04-14,Malawi,0,0,16,2
2020-04-15,Malawi,0,0,16,2
2020-04-16,Malawi,0,0,16,2
2020-04-17,Malawi,1,0,17,2
2020-04-18,Malawi,0,0,17,2
2020-04-19,Malawi,0,0,17,2
2020-04-20,Malawi,0,0,17,2
2020-04-21,Malawi,1,0,18,2
2020-04-22,Malawi,5,1,23,3
2020-04-23,Malawi,10,0,33,3
2020-04-24,Malawi,0,0,33,3
2020-04-25,Malawi,0,0,33,3
2020-04-26,Malawi,1,0,34,3
2020-04-27,Malawi,2,0,36,3
2020-04-28,Malawi,0,0,36,3
2020-04-29,Malawi,0,0,36,3
2020-04-30,Malawi,1,0,37,3
2020-05-01,Malawi,0,0,37,3
2020-05-02,Malawi,1,0,38,3
2020-05-03,Malawi,1,0,39,3
2020-05-04,Malawi,2,0,41,3
2020-05-05,Malawi,0,0,41,3
2020-05-06,Malawi,2,0,43,3
2020-05-07,Malawi,0,0,43,3
2020-05-08,Malawi,0,0,43,3
2020-05-09,Malawi,13,0,56,3
2020-05-10,Malawi,0,0,56,3
2020-05-11,Malawi,1,0,57,3
2020-05-12,Malawi,0,0,57,3
2020-05-13,Malawi,6,0,63,3
2020-05-14,Malawi,0,0,63,3
2020-05-15,Malawi,0,0,63,3
2020-05-16,Malawi,2,0,65,3
2020-05-17,Malawi,5,0,70,3
2020-05-18,Malawi,0,0,70,3
2020-05-19,Malawi,0,0,70,3
2020-05-20,Malawi,1,0,71,3
2020-05-21,Malawi,1,0,72,3
2020-05-22,Malawi,10,0,82,3
2020-05-23,Malawi,0,0,82,3
2020-05-24,Malawi,1,1,83,4
2020-05-25,Malawi,18,0,101,4
2020-05-26,Malawi,0,0,101,4
2020-05-27,Malawi,0,0,101,4
2020-05-28,Malawi,102,0,203,4
2020-05-29,Malawi,70,0,273,4
2020-05-30,Malawi,6,0,279,4
2020-05-31,Malawi,5,0,284,4
2020-06-01,Malawi,52,0,336,4
2020-06-02,Malawi,22,0,358,4
2020-06-03,Malawi,11,0,369,4
2020-06-04,Malawi,24,0,393,4
2020-06-05,Malawi,16,0,409,4
2020-06-06,Malawi,0,0,409,4
2020-06-07,Malawi,29,0,438,4
2020-06-08,Malawi,5,0,443,4
2020-06-09,Malawi,12,0,455,4
2020-06-10,Malawi,0,0,455,4
2020-06-11,Malawi,26,0,481,4
2020-06-12,Malawi,0,0,481,4
2020-06-13,Malawi,48,1,529,5
2020-06-14,Malawi,18,1,547,6
2020-06-15,Malawi,8,0,555,6
2020-06-16,Malawi,9,0,564,6
2020-06-17,Malawi,8,0,572,6
2020-06-18,Malawi,20,2,592,8
2020-06-19,Malawi,28,0,620,8
2020-06-20,Malawi,0,0,620,8
2020-06-21,Malawi,110,3,730,11
2020-06-22,Malawi,19,0,749,11
2020-06-23,Malawi,54,0,803,11
2020-06-24,Malawi,138,0,941,11
2020-06-25,Malawi,19,1,960,12
2020-06-26,Malawi,45,1,1005,13
2020-06-27,Malawi,33,0,1038,13
2020-06-28,Malawi,108,0,1146,13
2020-06-29,Malawi,6,0,1152,13
2020-06-30,Malawi,72,1,1224,14
2020-07-01,Malawi,41,2,1265,16
2020-07-02,Malawi,77,0,1342,16
2020-07-03,Malawi,156,0,1498,16
2020-07-04,Malawi,115,1,1613,17
2020-07-05,Malawi,0,0,1613,17
2020-07-06,Malawi,129,2,1742,19
2020-07-07,Malawi,76,0,1818,19
2020-07-08,Malawi,46,5,1864,24
2020-07-09,Malawi,78,1,1942,25
2020-07-10,Malawi,127,6,2069,31
2020-07-11,Malawi,192,2,2261,33
2020-07-12,Malawi,103,5,2364,38
2020-07-13,Malawi,66,1,2430,39
2020-07-14,Malawi,67,1,2497,40
2020-07-15,Malawi,117,3,2614,43
2020-07-16,Malawi,98,8,2712,51
2020-07-17,Malawi,93,4,2805,55
2020-07-18,Malawi,5,0,2810,55
2020-07-19,Malawi,97,4,2907,59
2020-07-20,Malawi,85,3,2992,62
2020-07-21,Malawi,53,2,3045,64
2020-07-22,Malawi,257,12,3302,76
2020-07-23,Malawi,0,0,3302,76
2020-07-24,Malawi,151,11,3453,87
2020-07-25,Malawi,0,0,3453,87
2020-07-26,Malawi,187,12,3640,99
2020-07-27,Malawi,24,0,3664,99
2020-07-28,Malawi,45,4,3709,103
2020-07-29,Malawi,29,0,3738,103
2020-07-30,Malawi,120,4,3858,107
2020-07-31,Malawi,220,7,4078,114
2020-08-01,Malawi,108,6,4186,120
2020-08-02,Malawi,45,3,4231,123
2020-08-03,Malawi,41,0,4272,123
2020-08-04,Malawi,89,5,4361,128
2020-08-05,Malawi,65,8,4426,136
2020-08-06,Malawi,65,1,4491,137
2020-08-07,Malawi,84,0,4575,137
2020-08-08,Malawi,49,6,4624,143
2020-08-09,Malawi,34,3,4658,146
2020-08-10,Malawi,16,0,4674,146
2020-08-11,Malawi,40,6,4714,152
2020-08-12,Malawi,38,0,4752,152
2020-08-13,Malawi,160,1,4912,153
2020-08-14,Malawi,76,3,4988,156
2020-08-15,Malawi,38,1,5026,157
2020-08-16,Malawi,46,4,5072,161
2020-08-17,Malawi,53,1,5125,162
2020-08-18,Malawi,68,1,5193,163
2020-08-19,Malawi,47,1,5240,164
2020-08-20,Malawi,42,1,5282,165
2020-08-21,Malawi,40,1,5322,166
2020-08-22,Malawi,60,2,5382,168
2020-08-23,Malawi,32,0,5414,168
2020-08-24,Malawi,5,1,5419,169
2020-08-25,Malawi,4,1,5423,170
2020-08-26,Malawi,51,3,5474,173
2020-08-27,Malawi,22,0,5496,173
2020-08-28,Malawi,27,1,5523,174
2020-08-29,Malawi,5,0,5528,174
2020-08-30,Malawi,8,0,5536,174
2020-08-31,Malawi,30,1,5566,175
2020-09-01,Malawi,10,0,5576,175
2020-09-02,Malawi,3,0,5579,175
2020-09-03,Malawi,14,0,5593,175
2020-09-04,Malawi,15,0,5608,175
2020-09-05,Malawi,3,0,5611,175
2020-09-06,Malawi,3,0,5614,175
2020-09-07,Malawi,7,1,5621,176
2020-09-08,Malawi,9,0,5630,176
2020-09-09,Malawi,23,0,5653,176
2020-09-10,Malawi,2,0,5655,176
2020-09-11,Malawi,14,1,5669,177
2020-09-12,Malawi,9,0,5678,177
2020-09-13,Malawi,12,0,5690,177
2020-09-14,Malawi,7,1,5697,178
2020-09-15,Malawi,4,0,5701,178
2020-09-16,Malawi,3,0,5704,178
2020-09-17,Malawi,7,1,5711,179
2020-09-18,Malawi,5,0,5716,179
2020-09-19,Malawi,2,0,5718,179
2020-09-20,Malawi,13,0,5731,179
2020-09-21,Malawi,2,0,5733,179
2020-09-22,Malawi,6,0,5739,179
2020-09-23,Malawi,7,0,5746,179
2020-09-24,Malawi,1,0,5747,179
2020-09-25,Malawi,17,0,5764,179
2020-09-26,Malawi,2,0,5766,179
2020-09-27,Malawi,2,0,5768,179
2020-09-28,Malawi,2,0,5770,179
2020-09-29,Malawi,2,0,5772,179
2020-09-30,Malawi,1,0,5773,179
2020-10-01,Malawi,6,0,5779,179
2020-10-02,Malawi,4,0,5783,179
2020-10-03,Malawi,0,0,5783,179
2020-10-04,Malawi,3,0,5786,179
2020-10-05,Malawi,8,1,5794,180
2020-10-06,Malawi,2,0,5796,180
2020-10-07,Malawi,7,0,5803,180
2020-10-08,Malawi,6,0,5809,180
2020-10-09,Malawi,4,0,5813,180
2020-10-10,Malawi,8,0,5821,180
2020-10-11,Malawi,0,0,5821,180
2020-10-12,Malawi,3,0,5824,180
2020-10-13,Malawi,3,1,5827,181
2020-10-14,Malawi,2,0,5829,181
2020-10-15,Malawi,7,0,5836,181
2020-10-16,Malawi,6,0,5842,181
2020-10-17,Malawi,10,0,5852,181
2020-10-18,Malawi,5,0,5857,181
2020-10-19,Malawi,3,0,5860,181
2020-10-20,Malawi,1,1,5861,182
2020-10-21,Malawi,3,1,5864,183
2020-10-22,Malawi,10,0,5874,183
2020-10-23,Malawi,11,0,5885,183
2020-10-24,Malawi,2,0,5887,183
2020-10-25,Malawi,3,0,5890,183
2020-10-26,Malawi,4,0,5894,183
2020-10-27,Malawi,3,0,5897,183
2020-10-28,Malawi,7,1,5904,184
2020-10-29,Malawi,12,0,5916,184
2020-10-30,Malawi,7,0,5923,184
2020-10-31,Malawi,7,0,5930,184
2020-11-01,Malawi,2,0,5932,184
2020-11-02,Malawi,1,0,5933,184
2020-11-03,Malawi,1,0,5934,184
2020-11-04,Malawi,0,0,5934,184
2020-11-05,Malawi,6,0,5940,184
2020-11-06,Malawi,2,0,5942,184
2020-11-07,Malawi,6,0,5948,184
2020-11-08,Malawi,3,0,5951,184
2020-11-09,Malawi,2,1,5953,185
2020-11-10,Malawi,0,0,5953,185
2020-11-11,Malawi,2,0,5955,185
2020-11-12,Malawi,3,0,5958,185
2020-11-13,Malawi,4,0,5962,185
2020-11-14,Malawi,2,0,5964,185
2020-11-15,Malawi,1,0,5965,185
2020-11-16,Malawi,6,0,5971,185
2020-11-17,Malawi,0,0,5971,185
2020-11-18,Malawi,28,0,5999,185
2020-11-19,Malawi,3,0,6002,185
2020-11-20,Malawi,1,0,6003,185
2020-11-21,Malawi,0,0,6003,185
2020-11-22,Malawi,0,0,6003,185
2020-11-23,Malawi,6,0,6009,185
2020-11-24,Malawi,8,0,6017,185
2020-11-25,Malawi,1,0,6018,185
2020-11-26,Malawi,2,0,6020,185
2020-11-27,Malawi,4,0,6024,185
2020-11-28,Malawi,1,0,6025,185
2020-11-29,Malawi,0,0,6025,185
2020-11-30,Malawi,3,0,6028,185
2020-12-01,Malawi,0,0,6028,185
2020-12-02,Malawi,12,0,6040,185
2020-12-03,Malawi,3,0,6043,185
2020-12-04,Malawi,4,0,6047,185
2020-12-05,Malawi,2,0,6049,185
2020-12-06,Malawi,2,0,6051,185
2020-12-07,Malawi,0,0,6051,185
2020-12-08,Malawi,0,1,6051,186
2020-12-09,Malawi,0,0,6051,186
2020-12-10,Malawi,0,0,6051,186
2020-12-11,Malawi,4,0,6055,186
2020-12-12,Malawi,8,0,6063,186
2020-12-13,Malawi,3,1,6066,187
2020-12-14,Malawi,4,0,6070,187
2020-12-15,Malawi,10,0,6080,187
2020-12-16,Malawi,11,0,6091,187
2020-12-17,Malawi,47,0,6138,187
2020-12-18,Malawi,10,0,6148,187
2020-12-19,Malawi,5,0,6153,187
2020-12-20,Malawi,8,0,6161,187
2020-12-21,Malawi,41,0,6202,187
2020-12-22,Malawi,46,0,6248,187
2020-12-23,Malawi,13,0,6261,187
2020-12-24,Malawi,16,0,6277,187
2020-12-25,Malawi,62,0,6339,187
2020-12-26,Malawi,4,1,6343,188
2020-12-27,Malawi,11,0,6354,188
2020-12-28,Malawi,23,0,6377,188
2020-12-29,Malawi,11,0,6388,188
2020-12-30,Malawi,83,1,6471,189
2020-12-31,Malawi,112,0,6583,189
2021-01-01,Malawi,101,2,6684,191
2021-01-02,Malawi,28,1,6712,192
2021-01-03,Malawi,132,3,6844,195
2021-01-04,Malawi,91,1,6935,196
2021-01-05,Malawi,175,3,7110,199
2021-01-06,Malawi,227,0,7337,199
2021-01-07,Malawi,274,4,7611,203
2021-01-08,Malawi,314,5,7925,208
2021-01-09,Malawi,381,12,8306,220
2021-01-10,Malawi,269,5,8575,225
2021-01-11,Malawi,452,10,9027,235
2021-01-12,Malawi,0,0,9027,235
2021-01-13,Malawi,373,19,9400,254
2021-01-14,Malawi,591,21,9991,275
2021-01-15,Malawi,1232,16,11223,291
2021-01-16,Malawi,562,9,11785,300
2021-01-17,Malawi,685,14,12470,314
2021-01-18,Malawi,557,7,13027,321
2021-01-19,Malawi,853,15,13880,336
2021-01-20,Malawi,971,17,14851,353
2021-01-21,Malawi,1198,43,16049,396
2021-01-22,Malawi,1316,49,17365,445
2021-01-23,Malawi,1074,25,18439,470
2021-01-24,Malawi,956,38,19395,508
2021-01-25,Malawi,592,10,19987,518
2021-01-26,Malawi,843,22,20830,540
2021-01-27,Malawi,830,15,21660,555
2021-01-28,Malawi,644,73,22304,628
2021-01-29,Malawi,716,15,23020,643
2021-01-30,Malawi,477,44,23497,687
2021-01-31,Malawi,466,15,23963,702
2021-02-01,Malawi,402,10,24365,712
2021-02-02,Malawi,538,14,24903,726
2021-02-03,Malawi,546,35,25449,761
2021-02-04,Malawi,435,18,25884,779
2021-02-05,Malawi,476,0,26360,779
2021-02-06,Malawi,515,58,26875,837
2021-02-07,Malawi,320,19,27195,856
2021-02-08,Malawi,227,18,27422,874
2021-02-09,Malawi,300,9,27722,883
2021-02-10,Malawi,328,17,28050,900
2021-02-11,Malawi,220,14,28270,914
2021-02-12,Malawi,360,12,28630,926
2021-02-13,Malawi,246,11,28876,937
2021-02-14,Malawi,159,15,29035,952
2021-02-15,Malawi,146,6,29181,958
2021-02-16,Malawi,240,10,29421,968
2021-02-17,Malawi,213,8,29634,976
2021-02-18,Malawi,203,8,29837,984
2021-02-19,Malawi,440,13,30277,997
2021-02-20,Malawi,251,7,30528,1004
2021-02-21,Malawi,214,9,30742,1013
2021-02-22,Malawi,200,8,30942,1021
2021-02-23,Malawi,164,3,31106,1024
2021-02-24,Malawi,189,5,31295,1029
2021-02-25,Malawi,207,4,31502,1033
2021-02-26,Malawi,173,4,31675,1037
2021-02-27,Malawi,123,4,31798,1041
2021-02-28,Malawi,147,3,31945,1044
2021-03-01,Malawi,63,4,32008,1048
2021-03-02,Malawi,140,5,32148,1053
2021-03-03,Malawi,81,3,32229,1056
2021-03-04,Malawi,54,2,32283,1058
2021-03-05,Malawi,0,0,32283,1058
2021-03-06,Malawi,115,9,32398,1067
2021-03-07,Malawi,44,2,32442,1069
2021-03-08,Malawi,27,1,32469,1070
2021-03-09,Malawi,59,4,32528,1074
2021-03-10,Malawi,86,3,32614,1077
2021-03-11,Malawi,59,1,32673,1078
2021-03-12,Malawi,73,1,32746,1079
2021-03-13,Malawi,43,3,32789,1082
2021-03-14,Malawi,0,0,32789,1082
2021-03-15,Malawi,75,2,32864,1084
2021-03-16,Malawi,30,4,32894,1088
2021-03-17,Malawi,76,0,32970,1088
2021-03-18,Malawi,75,3,33045,1091
2021-03-19,Malawi,129,1,33174,1092
2021-03-20,Malawi,42,1,33216,1093
2021-03-21,Malawi,21,3,33237,1096
2021-03-22,Malawi,33,2,33270,1098
2021-03-23,Malawi,53,1,33323,1099
2021-03-24,Malawi,31,6,33354,1105
2021-03-25,Malawi,33,3,33387,1108
2021-03-26,Malawi,28,4,33415,1112
2021-03-27,Malawi,43,1,33458,1113
2021-03-28,Malawi,23,1,33481,1114
2021-03-29,Malawi,24,0,33505,1114
2021-03-30,Malawi,20,2,33525,1116
2021-03-31,Malawi,26,1,33551,1117
2021-04-01,Malawi,33,1,33584,1118
2021-04-02,Malawi,55,1,33639,1119
2021-04-03,Malawi,8,1,33647,1120
2021-04-04,Malawi,14,3,33661,1123
2021-04-05,Malawi,12,1,33673,1124
2021-04-06,Malawi,12,0,33685,1124
2021-04-07,Malawi,33,1,33718,1125
2021-04-08,Malawi,20,0,33738,1125
2020-01-25,Malaysia,3,0,3,0
2020-01-26,Malaysia,1,0,4,0
2020-01-27,Malaysia,0,0,4,0
2020-01-28,Malaysia,0,0,4,0
2020-01-29,Malaysia,3,0,7,0
2020-01-30,Malaysia,1,0,8,0
2020-01-31,Malaysia,0,0,8,0
2020-02-01,Malaysia,0,0,8,0
2020-02-02,Malaysia,0,0,8,0
2020-02-03,Malaysia,0,0,8,0
2020-02-04,Malaysia,2,0,10,0
2020-02-05,Malaysia,2,0,12,0
2020-02-06,Malaysia,0,0,12,0
2020-02-07,Malaysia,0,0,12,0
2020-02-08,Malaysia,4,0,16,0
2020-02-09,Malaysia,0,0,16,0
2020-02-10,Malaysia,2,0,18,0
2020-02-11,Malaysia,0,0,18,0
2020-02-12,Malaysia,0,0,18,0
2020-02-13,Malaysia,1,0,19,0
2020-02-14,Malaysia,0,0,19,0
2020-02-15,Malaysia,3,0,22,0
2020-02-16,Malaysia,0,0,22,0
2020-02-17,Malaysia,0,0,22,0
2020-02-18,Malaysia,0,0,22,0
2020-02-19,Malaysia,0,0,22,0
2020-02-20,Malaysia,0,0,22,0
2020-02-21,Malaysia,0,0,22,0
2020-02-22,Malaysia,0,0,22,0
2020-02-23,Malaysia,0,0,22,0
2020-02-24,Malaysia,0,0,22,0
2020-02-25,Malaysia,0,0,22,0
2020-02-26,Malaysia,0,0,22,0
2020-02-27,Malaysia,1,0,23,0
2020-02-28,Malaysia,0,0,23,0
2020-02-29,Malaysia,2,0,25,0
2020-03-01,Malaysia,4,0,29,0
2020-03-02,Malaysia,0,0,29,0
2020-03-03,Malaysia,7,0,36,0
2020-03-04,Malaysia,14,0,50,0
2020-03-05,Malaysia,0,0,50,0
2020-03-06,Malaysia,33,0,83,0
2020-03-07,Malaysia,10,0,93,0
2020-03-08,Malaysia,6,0,99,0
2020-03-09,Malaysia,18,0,117,0
2020-03-10,Malaysia,12,0,129,0
2020-03-11,Malaysia,20,0,149,0
2020-03-12,Malaysia,0,0,149,0
2020-03-13,Malaysia,48,0,197,0
2020-03-14,Malaysia,41,0,238,0
2020-03-15,Malaysia,190,0,428,0
2020-03-16,Malaysia,138,0,566,0
2020-03-17,Malaysia,107,2,673,2
2020-03-18,Malaysia,117,0,790,2
2020-03-19,Malaysia,110,0,900,2
2020-03-20,Malaysia,130,1,1030,3
2020-03-21,Malaysia,153,1,1183,4
2020-03-22,Malaysia,123,6,1306,10
2020-03-23,Malaysia,212,4,1518,14
2020-03-24,Malaysia,106,2,1624,16
2020-03-25,Malaysia,172,4,1796,20
2020-03-26,Malaysia,235,3,2031,23
2020-03-27,Malaysia,130,3,2161,26
2020-03-28,Malaysia,159,1,2320,27
2020-03-29,Malaysia,150,8,2470,35
2020-03-30,Malaysia,156,2,2626,37
2020-03-31,Malaysia,140,6,2766,43
2020-04-01,Malaysia,142,2,2908,45
2020-04-02,Malaysia,208,5,3116,50
2020-04-03,Malaysia,217,3,3333,53
2020-04-04,Malaysia,150,4,3483,57
2020-04-05,Malaysia,179,4,3662,61
2020-04-06,Malaysia,131,1,3793,62
2020-04-07,Malaysia,170,1,3963,63
2020-04-08,Malaysia,156,2,4119,65
2020-04-09,Malaysia,109,2,4228,67
2020-04-10,Malaysia,118,3,4346,70
2020-04-11,Malaysia,184,3,4530,73
2020-04-12,Malaysia,153,3,4683,76
2020-04-13,Malaysia,134,1,4817,77
2020-04-14,Malaysia,170,5,4987,82
2020-04-15,Malaysia,85,1,5072,83
2020-04-16,Malaysia,110,1,5182,84
2020-04-17,Malaysia,69,2,5251,86
2020-04-18,Malaysia,54,2,5305,88
2020-04-19,Malaysia,84,1,5389,89
2020-04-20,Malaysia,36,0,5425,89
2020-04-21,Malaysia,57,3,5482,92
2020-04-22,Malaysia,50,1,5532,93
2020-04-23,Malaysia,71,2,5603,95
2020-04-24,Malaysia,88,1,5691,96
2020-04-25,Malaysia,51,2,5742,98
2020-04-26,Malaysia,38,0,5780,98
2020-04-27,Malaysia,40,1,5820,99
2020-04-28,Malaysia,31,1,5851,100
2020-04-29,Malaysia,94,0,5945,100
2020-04-30,Malaysia,57,2,6002,102
2020-05-01,Malaysia,69,1,6071,103
2020-05-02,Malaysia,105,0,6176,103
2020-05-03,Malaysia,122,2,6298,105
2020-05-04,Malaysia,55,0,6353,105
2020-05-05,Malaysia,30,1,6383,106
2020-05-06,Malaysia,45,1,6428,107
2020-05-07,Malaysia,39,0,6467,107
2020-05-08,Malaysia,68,0,6535,107
2020-05-09,Malaysia,54,1,6589,108
2020-05-10,Malaysia,67,0,6656,108
2020-05-11,Malaysia,70,1,6726,109
2020-05-12,Malaysia,16,0,6742,109
2020-05-13,Malaysia,37,2,6779,111
2020-05-14,Malaysia,40,1,6819,112
2020-05-15,Malaysia,36,0,6855,112
2020-05-16,Malaysia,17,1,6872,113
2020-05-17,Malaysia,22,0,6894,113
2020-05-18,Malaysia,47,0,6941,113
2020-05-19,Malaysia,37,1,6978,114
2020-05-20,Malaysia,31,0,7009,114
2020-05-21,Malaysia,50,0,7059,114
2020-05-22,Malaysia,78,1,7137,115
2020-05-23,Malaysia,48,0,7185,115
2020-05-24,Malaysia,60,0,7245,115
2020-05-25,Malaysia,172,0,7417,115
2020-05-26,Malaysia,187,0,7604,115
2020-05-27,Malaysia,15,0,7619,115
2020-05-28,Malaysia,10,0,7629,115
2020-05-29,Malaysia,103,0,7732,115
2020-05-30,Malaysia,30,0,7762,115
2020-05-31,Malaysia,57,0,7819,115
2020-06-01,Malaysia,38,0,7857,115
2020-06-02,Malaysia,20,0,7877,115
2020-06-03,Malaysia,93,0,7970,115
2020-06-04,Malaysia,277,0,8247,115
2020-06-05,Malaysia,19,1,8266,116
2020-06-06,Malaysia,37,1,8303,117
2020-06-07,Malaysia,19,0,8322,117
2020-06-08,Malaysia,7,0,8329,117
2020-06-09,Malaysia,7,0,8336,117
2020-06-10,Malaysia,2,1,8338,118
2020-06-11,Malaysia,31,0,8369,118
2020-06-12,Malaysia,33,1,8402,119
2020-06-13,Malaysia,43,1,8445,120
2020-06-14,Malaysia,8,1,8453,121
2020-06-15,Malaysia,41,0,8494,121
2020-06-16,Malaysia,11,0,8505,121
2020-06-17,Malaysia,10,0,8515,121
2020-06-18,Malaysia,14,0,8529,121
2020-06-19,Malaysia,6,0,8535,121
2020-06-20,Malaysia,21,0,8556,121
2020-06-21,Malaysia,16,0,8572,121
2020-06-22,Malaysia,15,0,8587,121
2020-06-23,Malaysia,3,0,8590,121
2020-06-24,Malaysia,6,0,8596,121
2020-06-25,Malaysia,4,0,8600,121
2020-06-26,Malaysia,6,0,8606,121
2020-06-27,Malaysia,10,0,8616,121
2020-06-28,Malaysia,18,0,8634,121
2020-06-29,Malaysia,3,0,8637,121
2020-06-30,Malaysia,2,0,8639,121
2020-07-01,Malaysia,1,0,8640,121
2020-07-02,Malaysia,3,0,8643,121
2020-07-03,Malaysia,5,0,8648,121
2020-07-04,Malaysia,10,0,8658,121
2020-07-05,Malaysia,5,0,8663,121
2020-07-06,Malaysia,5,0,8668,121
2020-07-07,Malaysia,6,0,8674,121
2020-07-08,Malaysia,3,0,8677,121
2020-07-09,Malaysia,6,0,8683,121
2020-07-10,Malaysia,13,0,8696,121
2020-07-11,Malaysia,8,1,8704,122
2020-07-12,Malaysia,14,0,8718,122
2020-07-13,Malaysia,7,0,8725,122
2020-07-14,Malaysia,4,0,8729,122
2020-07-15,Malaysia,5,0,8734,122
2020-07-16,Malaysia,3,0,8737,122
2020-07-17,Malaysia,18,0,8755,122
2020-07-18,Malaysia,9,0,8764,122
2020-07-19,Malaysia,15,1,8779,123
2020-07-20,Malaysia,21,0,8800,123
2020-07-21,Malaysia,15,0,8815,123
2020-07-22,Malaysia,16,0,8831,123
2020-07-23,Malaysia,9,0,8840,123
2020-07-24,Malaysia,21,0,8861,123
2020-07-25,Malaysia,23,0,8884,123
2020-07-26,Malaysia,13,1,8897,124
2020-07-27,Malaysia,7,0,8904,124
2020-07-28,Malaysia,39,0,8943,124
2020-07-29,Malaysia,13,0,8956,124
2020-07-30,Malaysia,8,0,8964,124
2020-07-31,Malaysia,12,1,8976,125
2020-08-01,Malaysia,9,0,8985,125
2020-08-02,Malaysia,14,0,8999,125
2020-08-03,Malaysia,2,0,9001,125
2020-08-04,Malaysia,1,0,9002,125
2020-08-05,Malaysia,21,0,9023,125
2020-08-06,Malaysia,15,0,9038,125
2020-08-07,Malaysia,25,0,9063,125
2020-08-08,Malaysia,7,0,9070,125
2020-08-09,Malaysia,13,0,9083,125
2020-08-10,Malaysia,11,0,9094,125
2020-08-11,Malaysia,9,0,9103,125
2020-08-12,Malaysia,11,0,9114,125
2020-08-13,Malaysia,15,0,9129,125
2020-08-14,Malaysia,20,0,9149,125
2020-08-15,Malaysia,26,0,9175,125
2020-08-16,Malaysia,25,0,9200,125
2020-08-17,Malaysia,12,0,9212,125
2020-08-18,Malaysia,7,0,9219,125
2020-08-19,Malaysia,16,0,9235,125
2020-08-20,Malaysia,5,0,9240,125
2020-08-21,Malaysia,9,0,9249,125
2020-08-22,Malaysia,8,0,9257,125
2020-08-23,Malaysia,10,0,9267,125
2020-08-24,Malaysia,7,0,9274,125
2020-08-25,Malaysia,11,0,9285,125
2020-08-26,Malaysia,6,0,9291,125
2020-08-27,Malaysia,5,0,9296,125
2020-08-28,Malaysia,10,0,9306,125
2020-08-29,Malaysia,11,0,9317,125
2020-08-30,Malaysia,17,1,9334,126
2020-08-31,Malaysia,6,1,9340,127
2020-09-01,Malaysia,14,1,9354,128
2020-09-02,Malaysia,6,0,9360,128
2020-09-03,Malaysia,14,0,9374,128
2020-09-04,Malaysia,11,0,9385,128
2020-09-05,Malaysia,6,0,9391,128
2020-09-06,Malaysia,6,0,9397,128
2020-09-07,Malaysia,62,0,9459,128
2020-09-08,Malaysia,100,0,9559,128
2020-09-09,Malaysia,24,0,9583,128
2020-09-10,Malaysia,45,0,9628,128
2020-09-11,Malaysia,182,0,9810,128
2020-09-12,Malaysia,58,0,9868,128
2020-09-13,Malaysia,47,0,9915,128
2020-09-14,Malaysia,31,0,9946,128
2020-09-15,Malaysia,23,0,9969,128
2020-09-16,Malaysia,62,0,10031,128
2020-09-17,Malaysia,21,0,10052,128
2020-09-18,Malaysia,95,1,10147,129
2020-09-19,Malaysia,20,1,10167,130
2020-09-20,Malaysia,52,0,10219,130
2020-09-21,Malaysia,57,0,10276,130
2020-09-22,Malaysia,82,0,10358,130
2020-09-23,Malaysia,147,3,10505,133
2020-09-24,Malaysia,71,0,10576,133
2020-09-25,Malaysia,111,0,10687,133
2020-09-26,Malaysia,82,0,10769,133
2020-09-27,Malaysia,150,1,10919,134
2020-09-28,Malaysia,115,0,11034,134
2020-09-29,Malaysia,101,0,11135,134
2020-09-30,Malaysia,89,2,11224,136
2020-10-01,Malaysia,260,0,11484,136
2020-10-02,Malaysia,287,0,11771,136
2020-10-03,Malaysia,317,1,12088,137
2020-10-04,Malaysia,293,0,12381,137
2020-10-05,Malaysia,432,0,12813,137
2020-10-06,Malaysia,691,4,13504,141
2020-10-07,Malaysia,489,0,13993,141
2020-10-08,Malaysia,375,5,14368,146
2020-10-09,Malaysia,354,6,14722,152
2020-10-10,Malaysia,374,3,15096,155
2020-10-11,Malaysia,561,2,15657,157
2020-10-12,Malaysia,563,2,16220,159
2020-10-13,Malaysia,660,4,16880,163
2020-10-14,Malaysia,660,4,17540,167
2020-10-15,Malaysia,589,3,18129,170
2020-10-16,Malaysia,629,6,18758,176
2020-10-17,Malaysia,869,4,19627,180
2020-10-18,Malaysia,871,7,20498,187
2020-10-19,Malaysia,865,3,21363,190
2020-10-20,Malaysia,862,3,22225,193
2020-10-21,Malaysia,732,6,22957,199
2020-10-22,Malaysia,847,5,23804,204
2020-10-23,Malaysia,710,10,24514,214
2020-10-24,Malaysia,1228,7,25742,221
2020-10-25,Malaysia,823,8,26565,229
2020-10-26,Malaysia,1240,7,27805,236
2020-10-27,Malaysia,835,2,28640,238
2020-10-28,Malaysia,801,8,29441,246
2020-10-29,Malaysia,649,0,30090,246
2020-10-30,Malaysia,799,3,30889,249
2020-10-31,Malaysia,659,0,31548,249
2020-11-01,Malaysia,957,0,32505,249
2020-11-02,Malaysia,834,2,33339,251
2020-11-03,Malaysia,1054,12,34393,263
2020-11-04,Malaysia,1032,8,35425,271
2020-11-05,Malaysia,1009,6,36434,277
2020-11-06,Malaysia,1755,2,38189,279
2020-11-07,Malaysia,1168,3,39357,282
2020-11-08,Malaysia,852,4,40209,286
2020-11-09,Malaysia,972,8,41181,294
2020-11-10,Malaysia,869,6,42050,300
2020-11-11,Malaysia,822,2,42872,302
2020-11-12,Malaysia,919,1,43791,303
2020-11-13,Malaysia,1304,1,45095,304
2020-11-14,Malaysia,1114,2,46209,306
2020-11-15,Malaysia,1208,3,47417,309
2020-11-16,Malaysia,1103,4,48520,313
2020-11-17,Malaysia,1210,5,49730,318
2020-11-18,Malaysia,660,4,50390,322
2020-11-19,Malaysia,1290,4,51680,326
2020-11-20,Malaysia,958,3,52638,329
2020-11-21,Malaysia,1041,3,53679,332
2020-11-22,Malaysia,1096,3,54775,335
2020-11-23,Malaysia,1884,2,56659,337
2020-11-24,Malaysia,2188,4,58847,341
2020-11-25,Malaysia,970,4,59817,345
2020-11-26,Malaysia,935,3,60752,348
2020-11-27,Malaysia,1109,2,61861,350
2020-11-28,Malaysia,1315,4,63176,354
2020-11-29,Malaysia,1309,3,64485,357
2020-11-30,Malaysia,1212,3,65697,360
2020-12-01,Malaysia,1472,3,67169,363
2020-12-02,Malaysia,851,2,68020,365
2020-12-03,Malaysia,1075,11,69095,376
2020-12-04,Malaysia,1141,0,70236,376
2020-12-05,Malaysia,1123,4,71359,380
2020-12-06,Malaysia,1335,2,72694,382
2020-12-07,Malaysia,1600,2,74294,384
2020-12-08,Malaysia,1012,4,75306,388
2020-12-09,Malaysia,959,5,76265,393
2020-12-10,Malaysia,2234,3,78499,396
2020-12-11,Malaysia,1810,6,80309,402
2020-12-12,Malaysia,1937,9,82246,411
2020-12-13,Malaysia,1229,4,83475,415
2020-12-14,Malaysia,1371,4,84846,419
2020-12-15,Malaysia,1772,3,86618,422
2020-12-16,Malaysia,1295,7,87913,429
2020-12-17,Malaysia,1220,3,89133,432
2020-12-18,Malaysia,1683,0,90816,432
2020-12-19,Malaysia,1153,1,91969,433
2020-12-20,Malaysia,1340,4,93309,437
2020-12-21,Malaysia,2018,1,95327,438
2020-12-22,Malaysia,2062,1,97389,439
2020-12-23,Malaysia,1348,5,98737,444
2020-12-24,Malaysia,1581,2,100318,446
2020-12-25,Malaysia,1247,3,101565,449
2020-12-26,Malaysia,2335,2,103900,451
2020-12-27,Malaysia,1196,1,105096,452
2020-12-28,Malaysia,1594,3,106690,455
2020-12-29,Malaysia,1925,2,108615,457
2020-12-30,Malaysia,1870,6,110485,463
2020-12-31,Malaysia,2525,8,113010,471
2021-01-01,Malaysia,2068,3,115078,474
2021-01-02,Malaysia,2295,9,117373,483
2021-01-03,Malaysia,1704,11,119077,494
2021-01-04,Malaysia,1741,7,120818,501
2021-01-05,Malaysia,2027,8,122845,509
2021-01-06,Malaysia,2593,4,125438,513
2021-01-07,Malaysia,3027,8,128465,521
2021-01-08,Malaysia,2643,16,131108,537
2021-01-09,Malaysia,2451,5,133559,542
2021-01-10,Malaysia,2433,9,135992,551
2021-01-11,Malaysia,2232,4,138224,555
2021-01-12,Malaysia,3309,4,141533,559
2021-01-13,Malaysia,2985,4,144518,563
2021-01-14,Malaysia,3337,15,147855,578
2021-01-15,Malaysia,3211,8,151066,586
2021-01-16,Malaysia,4029,8,155095,594
2021-01-17,Malaysia,3339,7,158434,601
2021-01-18,Malaysia,3306,4,161740,605
2021-01-19,Malaysia,3631,14,165371,619
2021-01-20,Malaysia,4008,11,169379,630
2021-01-21,Malaysia,3170,12,172549,642
2021-01-22,Malaysia,3631,18,176180,660
2021-01-23,Malaysia,4275,7,180455,667
2021-01-24,Malaysia,3346,11,183801,678
2021-01-25,Malaysia,3048,11,186849,689
2021-01-26,Malaysia,3585,11,190434,700
2021-01-27,Malaysia,3680,7,194114,707
2021-01-28,Malaysia,4094,10,198208,717
2021-01-29,Malaysia,5725,16,203933,733
2021-01-30,Malaysia,5728,13,209661,746
2021-01-31,Malaysia,5298,14,214959,760
2021-02-01,Malaysia,4214,10,219173,770
2021-02-02,Malaysia,3455,21,222628,791
2021-02-03,Malaysia,4284,18,226912,809
2021-02-04,Malaysia,4571,17,231483,826
2021-02-05,Malaysia,3391,19,234874,845
2021-02-06,Malaysia,3847,12,238721,857
2021-02-07,Malaysia,3731,15,242452,872
2021-02-08,Malaysia,3100,24,245552,896
2021-02-09,Malaysia,2764,13,248316,909
2021-02-10,Malaysia,3288,14,251604,923
2021-02-11,Malaysia,3384,13,254988,936
2021-02-12,Malaysia,3318,17,258306,953
2021-02-13,Malaysia,3499,5,261805,958
2021-02-14,Malaysia,2464,7,264269,965
2021-02-15,Malaysia,2176,10,266445,975
2021-02-16,Malaysia,2720,8,269165,983
2021-02-17,Malaysia,2998,22,272163,1005
2021-02-18,Malaysia,2712,25,274875,1030
2021-02-19,Malaysia,2936,13,277811,1043
2021-02-20,Malaysia,2461,8,280272,1051
2021-02-21,Malaysia,3297,5,283569,1056
2021-02-22,Malaysia,2192,6,285761,1062
2021-02-23,Malaysia,2468,14,288229,1076
2021-02-24,Malaysia,3545,12,291774,1088
2021-02-25,Malaysia,1924,12,293698,1100
2021-02-26,Malaysia,2253,11,295951,1111
2021-02-27,Malaysia,2364,10,298315,1121
2021-02-28,Malaysia,2437,9,300752,1130
2021-03-01,Malaysia,1828,5,302580,1135
2021-03-02,Malaysia,1555,6,304135,1141
2021-03-03,Malaysia,1745,7,305880,1148
2021-03-04,Malaysia,2063,5,307943,1153
2021-03-05,Malaysia,2154,6,310097,1159
2021-03-06,Malaysia,1680,7,311777,1166
2021-03-07,Malaysia,1683,3,313460,1169
2021-03-08,Malaysia,1529,8,314989,1177
2021-03-09,Malaysia,1280,9,316269,1186
2021-03-10,Malaysia,1448,5,317717,1191
2021-03-11,Malaysia,1647,9,319364,1200
2021-03-12,Malaysia,1575,3,320939,1203
2021-03-13,Malaysia,1470,3,322409,1206
2021-03-14,Malaysia,1354,4,323763,1210
2021-03-15,Malaysia,1208,3,324971,1213
2021-03-16,Malaysia,1063,5,326034,1218
2021-03-17,Malaysia,1219,2,327253,1220
2021-03-18,Malaysia,1213,3,328466,1223
2021-03-19,Malaysia,1576,2,330042,1225
2021-03-20,Malaysia,1671,4,331713,1229
2021-03-21,Malaysia,1327,4,333040,1233
2021-03-22,Malaysia,1116,5,334156,1238
2021-03-23,Malaysia,1384,6,335540,1244
2021-03-24,Malaysia,1268,2,336808,1246
2021-03-25,Malaysia,1360,2,338168,1248
2021-03-26,Malaysia,1275,1,339443,1249
2021-03-27,Malaysia,1199,2,340642,1251
2021-03-28,Malaysia,1302,4,341944,1255
2021-03-29,Malaysia,941,5,342885,1260
2021-03-30,Malaysia,1133,5,344018,1265
2021-03-31,Malaysia,1482,7,345500,1272
2021-04-01,Malaysia,1178,6,346678,1278
2021-04-02,Malaysia,1294,5,347972,1283
2021-04-03,Malaysia,1638,3,349610,1286
2021-04-04,Malaysia,1349,2,350959,1288
2021-04-05,Malaysia,1070,7,352029,1295
2021-04-06,Malaysia,1300,5,353329,1300
2021-04-07,Malaysia,1139,4,354468,1304
2021-04-08,Malaysia,1285,4,355753,1308
2020-03-08,Maldives,4,0,4,0
2020-03-09,Maldives,0,0,4,0
2020-03-10,Maldives,2,0,6,0
2020-03-11,Maldives,2,0,8,0
2020-03-12,Maldives,0,0,8,0
2020-03-13,Maldives,1,0,9,0
2020-03-14,Maldives,1,0,10,0
2020-03-15,Maldives,3,0,13,0
2020-03-16,Maldives,0,0,13,0
2020-03-17,Maldives,0,0,13,0
2020-03-18,Maldives,0,0,13,0
2020-03-19,Maldives,0,0,13,0
2020-03-20,Maldives,0,0,13,0
2020-03-21,Maldives,0,0,13,0
2020-03-22,Maldives,0,0,13,0
2020-03-23,Maldives,0,0,13,0
2020-03-24,Maldives,0,0,13,0
2020-03-25,Maldives,0,0,13,0
2020-03-26,Maldives,0,0,13,0
2020-03-27,Maldives,3,0,16,0
2020-03-28,Maldives,0,0,16,0
2020-03-29,Maldives,1,0,17,0
2020-03-30,Maldives,0,0,17,0
2020-03-31,Maldives,1,0,18,0
2020-04-01,Maldives,1,0,19,0
2020-04-02,Maldives,0,0,19,0
2020-04-03,Maldives,0,0,19,0
2020-04-04,Maldives,0,0,19,0
2020-04-05,Maldives,0,0,19,0
2020-04-06,Maldives,0,0,19,0
2020-04-07,Maldives,0,0,19,0
2020-04-08,Maldives,0,0,19,0
2020-04-09,Maldives,0,0,19,0
2020-04-10,Maldives,0,0,19,0
2020-04-11,Maldives,0,0,19,0
2020-04-12,Maldives,1,0,20,0
2020-04-13,Maldives,0,0,20,0
2020-04-14,Maldives,0,0,20,0
2020-04-15,Maldives,2,0,22,0
2020-04-16,Maldives,3,0,25,0
2020-04-17,Maldives,3,0,28,0
2020-04-18,Maldives,7,0,35,0
2020-04-19,Maldives,17,0,52,0
2020-04-20,Maldives,17,0,69,0
2020-04-21,Maldives,14,0,83,0
2020-04-22,Maldives,3,0,86,0
2020-04-23,Maldives,22,0,108,0
2020-04-24,Maldives,21,0,129,0
2020-04-25,Maldives,48,0,177,0
2020-04-26,Maldives,37,0,214,0
2020-04-27,Maldives,12,0,226,0
2020-04-28,Maldives,24,0,250,0
2020-04-29,Maldives,28,1,278,1
2020-04-30,Maldives,190,0,468,1
2020-05-01,Maldives,23,0,491,1
2020-05-02,Maldives,28,0,519,1
2020-05-03,Maldives,8,0,527,1
2020-05-04,Maldives,14,0,541,1
2020-05-05,Maldives,32,1,573,2
2020-05-06,Maldives,44,0,617,2
2020-05-07,Maldives,31,1,648,3
2020-05-08,Maldives,96,0,744,3
2020-05-09,Maldives,46,0,790,3
2020-05-10,Maldives,45,0,835,3
2020-05-11,Maldives,62,0,897,3
2020-05-12,Maldives,7,0,904,3
2020-05-13,Maldives,51,1,955,4
2020-05-14,Maldives,27,0,982,4
2020-05-15,Maldives,49,0,1031,4
2020-05-16,Maldives,47,0,1078,4
2020-05-17,Maldives,16,0,1094,4
2020-05-18,Maldives,12,0,1106,4
2020-05-19,Maldives,37,0,1143,4
2020-05-20,Maldives,43,0,1186,4
2020-05-21,Maldives,30,0,1216,4
2020-05-22,Maldives,58,0,1274,4
2020-05-23,Maldives,39,0,1313,4
2020-05-24,Maldives,58,0,1371,4
2020-05-25,Maldives,24,0,1395,4
2020-05-26,Maldives,43,1,1438,5
2020-05-27,Maldives,19,0,1457,5
2020-05-28,Maldives,56,0,1513,5
2020-05-29,Maldives,78,0,1591,5
2020-05-30,Maldives,81,0,1672,5
2020-05-31,Maldives,101,0,1773,5
2020-06-01,Maldives,56,1,1829,6
2020-06-02,Maldives,12,1,1841,7
2020-06-03,Maldives,9,0,1850,7
2020-06-04,Maldives,22,0,1872,7
2020-06-05,Maldives,11,0,1883,7
2020-06-06,Maldives,18,1,1901,8
2020-06-07,Maldives,2,0,1903,8
2020-06-08,Maldives,13,0,1916,8
2020-06-09,Maldives,26,0,1942,8
2020-06-10,Maldives,20,0,1962,8
2020-06-11,Maldives,14,0,1976,8
2020-06-12,Maldives,27,0,2003,8
2020-06-13,Maldives,10,0,2013,8
2020-06-14,Maldives,22,0,2035,8
2020-06-15,Maldives,30,0,2065,8
2020-06-16,Maldives,29,0,2094,8
2020-06-17,Maldives,26,0,2120,8
2020-06-18,Maldives,17,0,2137,8
2020-06-19,Maldives,13,0,2150,8
2020-06-20,Maldives,37,0,2187,8
2020-06-21,Maldives,16,0,2203,8
2020-06-22,Maldives,14,0,2217,8
2020-06-23,Maldives,21,0,2238,8
2020-06-24,Maldives,23,0,2261,8
2020-06-25,Maldives,16,0,2277,8
2020-06-26,Maldives,6,0,2283,8
2020-06-27,Maldives,22,0,2305,8
2020-06-28,Maldives,19,0,2324,8
2020-06-29,Maldives,13,0,2337,8
2020-06-30,Maldives,24,1,2361,9
2020-07-01,Maldives,21,0,2382,9
2020-07-02,Maldives,18,1,2400,10
2020-07-03,Maldives,10,0,2410,10
2020-07-04,Maldives,25,0,2435,10
2020-07-05,Maldives,33,1,2468,11
2020-07-06,Maldives,23,1,2491,12
2020-07-07,Maldives,10,0,2501,12
2020-07-08,Maldives,16,1,2517,13
2020-07-09,Maldives,36,0,2553,13
2020-07-10,Maldives,64,0,2617,13
2020-07-11,Maldives,47,0,2664,13
2020-07-12,Maldives,67,0,2731,13
2020-07-13,Maldives,31,0,2762,13
2020-07-14,Maldives,39,1,2801,14
2020-07-15,Maldives,30,0,2831,14
2020-07-16,Maldives,68,1,2899,15
2020-07-17,Maldives,14,0,2913,15
2020-07-18,Maldives,17,0,2930,15
2020-07-19,Maldives,36,0,2966,15
2020-07-20,Maldives,33,0,2999,15
2020-07-21,Maldives,45,0,3044,15
2020-07-22,Maldives,59,0,3103,15
2020-07-23,Maldives,17,0,3120,15
2020-07-24,Maldives,55,0,3175,15
2020-07-25,Maldives,77,0,3252,15
2020-07-26,Maldives,50,0,3302,15
2020-07-27,Maldives,67,0,3369,15
2020-07-28,Maldives,137,0,3506,15
2020-07-29,Maldives,61,0,3567,15
2020-07-30,Maldives,152,1,3719,16
2020-07-31,Maldives,74,0,3793,16
2020-08-01,Maldives,156,1,3949,17
2020-08-02,Maldives,215,1,4164,18
2020-08-03,Maldives,129,0,4293,18
2020-08-04,Maldives,153,1,4446,19
2020-08-05,Maldives,148,0,4594,19
2020-08-06,Maldives,86,0,4680,19
2020-08-07,Maldives,89,0,4769,19
2020-08-08,Maldives,129,0,4898,19
2020-08-09,Maldives,143,0,5041,19
2020-08-10,Maldives,116,0,5157,19
2020-08-11,Maldives,66,1,5223,20
2020-08-12,Maldives,143,1,5366,21
2020-08-13,Maldives,128,0,5494,21
2020-08-14,Maldives,78,1,5572,22
2020-08-15,Maldives,107,0,5679,22
2020-08-16,Maldives,106,0,5785,22
2020-08-17,Maldives,124,1,5909,23
2020-08-18,Maldives,170,1,6079,24
2020-08-19,Maldives,146,0,6225,24
2020-08-20,Maldives,145,0,6370,24
2020-08-21,Maldives,194,2,6564,26
2020-08-22,Maldives,96,0,6660,26
2020-08-23,Maldives,119,0,6779,26
2020-08-24,Maldives,133,1,6912,27
2020-08-25,Maldives,135,1,7047,28
2020-08-26,Maldives,178,0,7225,28
2020-08-27,Maldives,104,0,7329,28
2020-08-28,Maldives,140,0,7469,28
2020-08-29,Maldives,109,0,7578,28
2020-08-30,Maldives,89,0,7667,28
2020-08-31,Maldives,137,0,7804,28
2020-09-01,Maldives,199,1,8003,29
2020-09-02,Maldives,137,0,8140,29
2020-09-03,Maldives,141,0,8281,29
2020-09-04,Maldives,80,0,8361,29
2020-09-05,Maldives,125,0,8486,29
2020-09-06,Maldives,98,0,8584,29
2020-09-07,Maldives,83,0,8667,29
2020-09-08,Maldives,74,0,8741,29
2020-09-09,Maldives,93,2,8834,31
2020-09-10,Maldives,66,0,8900,31
2020-09-11,Maldives,90,0,8990,31
2020-09-12,Maldives,62,0,9052,31
2020-09-13,Maldives,121,1,9173,32
2020-09-14,Maldives,70,1,9243,33
2020-09-15,Maldives,85,0,9328,33
2020-09-16,Maldives,99,0,9427,33
2020-09-17,Maldives,67,0,9494,33
2020-09-18,Maldives,74,0,9568,33
2020-09-19,Maldives,81,0,9649,33
2020-09-20,Maldives,75,0,9724,33
2020-09-21,Maldives,46,1,9770,34
2020-09-22,Maldives,48,0,9818,34
2020-09-23,Maldives,67,0,9885,34
2020-09-24,Maldives,54,0,9939,34
2020-09-25,Maldives,75,0,10014,34
2020-09-26,Maldives,31,0,10045,34
2020-09-27,Maldives,53,0,10098,34
2020-09-28,Maldives,59,0,10157,34
2020-09-29,Maldives,37,0,10194,34
2020-09-30,Maldives,97,0,10291,34
2020-10-01,Maldives,63,0,10354,34
2020-10-02,Maldives,44,0,10398,34
2020-10-03,Maldives,67,0,10465,34
2020-10-04,Maldives,65,0,10530,34
2020-10-05,Maldives,37,0,10567,34
2020-10-06,Maldives,54,0,10621,34
2020-10-07,Maldives,35,0,10656,34
2020-10-08,Maldives,86,0,10742,34
2020-10-09,Maldives,66,0,10808,34
2020-10-10,Maldives,51,0,10859,34
2020-10-11,Maldives,35,1,10894,35
2020-10-12,Maldives,49,0,10943,35
2020-10-13,Maldives,50,0,10993,35
2020-10-14,Maldives,69,0,11062,35
2020-10-15,Maldives,51,0,11113,35
2020-10-16,Maldives,41,0,11154,35
2020-10-17,Maldives,24,1,11178,36
2020-10-18,Maldives,32,1,11210,37
2020-10-19,Maldives,22,0,11232,37
2020-10-20,Maldives,39,0,11271,37
2020-10-21,Maldives,45,0,11316,37
2020-10-22,Maldives,42,0,11358,37
2020-10-23,Maldives,33,0,11391,37
2020-10-24,Maldives,30,0,11421,37
2020-10-25,Maldives,84,0,11505,37
2020-10-26,Maldives,27,0,11532,37
2020-10-27,Maldives,35,0,11567,37
2020-10-28,Maldives,24,0,11591,37
2020-10-29,Maldives,25,0,11616,37
2020-10-30,Maldives,27,0,11643,37
2020-10-31,Maldives,16,1,11659,38
2020-11-01,Maldives,42,0,11701,38
2020-11-02,Maldives,36,0,11737,38
2020-11-03,Maldives,59,0,11796,38
2020-11-04,Maldives,26,0,11822,38
2020-11-05,Maldives,71,0,11893,38
2020-11-06,Maldives,39,1,11932,39
2020-11-07,Maldives,30,0,11962,39
2020-11-08,Maldives,24,0,11986,39
2020-11-09,Maldives,23,1,12009,40
2020-11-10,Maldives,21,1,12030,41
2020-11-11,Maldives,29,0,12059,41
2020-11-12,Maldives,26,0,12085,41
2020-11-13,Maldives,27,0,12112,41
2020-11-14,Maldives,42,1,12154,42
2020-11-15,Maldives,50,1,12204,43
2020-11-16,Maldives,110,1,12314,44
2020-11-17,Maldives,41,1,12355,45
2020-11-18,Maldives,29,0,12384,45
2020-11-19,Maldives,68,0,12452,45
2020-11-20,Maldives,94,0,12546,45
2020-11-21,Maldives,32,0,12578,45
2020-11-22,Maldives,30,1,12608,46
2020-11-23,Maldives,150,0,12758,46
2020-11-24,Maldives,52,0,12810,46
2020-11-25,Maldives,44,0,12854,46
2020-11-26,Maldives,35,0,12889,46
2020-11-27,Maldives,44,0,12933,46
2020-11-28,Maldives,14,0,12947,46
2020-11-29,Maldives,47,0,12994,46
2020-11-30,Maldives,17,0,13011,46
2020-12-01,Maldives,38,1,13049,47
2020-12-02,Maldives,21,0,13070,47
2020-12-03,Maldives,36,0,13106,47
2020-12-04,Maldives,37,0,13143,47
2020-12-05,Maldives,16,0,13159,47
2020-12-06,Maldives,39,0,13198,47
2020-12-07,Maldives,15,0,13213,47
2020-12-08,Maldives,35,0,13248,47
2020-12-09,Maldives,26,0,13274,47
2020-12-10,Maldives,34,0,13308,47
2020-12-11,Maldives,18,1,13326,48
2020-12-12,Maldives,22,0,13348,48
2020-12-13,Maldives,20,0,13368,48
2020-12-14,Maldives,11,0,13379,48
2020-12-15,Maldives,13,0,13392,48
2020-12-16,Maldives,10,0,13402,48
2020-12-17,Maldives,16,0,13418,48
2020-12-18,Maldives,26,0,13444,48
2020-12-19,Maldives,30,0,13474,48
2020-12-20,Maldives,19,0,13493,48
2020-12-21,Maldives,8,0,13501,48
2020-12-22,Maldives,23,0,13524,48
2020-12-23,Maldives,13,0,13537,48
2020-12-24,Maldives,21,0,13558,48
2020-12-25,Maldives,25,0,13583,48
2020-12-26,Maldives,35,0,13618,48
2020-12-27,Maldives,26,0,13644,48
2020-12-28,Maldives,16,0,13660,48
2020-12-29,Maldives,31,0,13691,48
2020-12-30,Maldives,47,0,13738,48
2020-12-31,Maldives,19,0,13757,48
2021-01-01,Maldives,47,0,13804,48
2021-01-02,Maldives,30,0,13834,48
2021-01-03,Maldives,33,0,13867,48
2021-01-04,Maldives,26,0,13893,48
2021-01-05,Maldives,37,0,13930,48
2021-01-06,Maldives,37,0,13967,48
2021-01-07,Maldives,21,1,13988,49
2021-01-08,Maldives,52,0,14040,49
2021-01-09,Maldives,25,0,14065,49
2021-01-10,Maldives,44,0,14109,49
2021-01-11,Maldives,50,0,14159,49
2021-01-12,Maldives,59,0,14218,49
2021-01-13,Maldives,59,0,14277,49
2021-01-14,Maldives,48,0,14325,49
2021-01-15,Maldives,50,0,14375,49
2021-01-16,Maldives,51,0,14426,49
2021-01-17,Maldives,87,0,14513,49
2021-01-18,Maldives,69,0,14582,49
2021-01-19,Maldives,51,0,14633,49
2021-01-20,Maldives,79,0,14712,49
2021-01-21,Maldives,53,1,14765,50
2021-01-22,Maldives,65,0,14830,50
2021-01-23,Maldives,55,0,14885,50
2021-01-24,Maldives,108,1,14993,51
2021-01-25,Maldives,109,0,15102,51
2021-01-26,Maldives,145,0,15247,51
2021-01-27,Maldives,143,0,15390,51
2021-01-28,Maldives,106,0,15496,51
2021-01-29,Maldives,118,0,15614,51
2021-01-30,Maldives,122,0,15736,51
2021-01-31,Maldives,105,1,15841,52
2021-02-01,Maldives,215,0,16056,52
2021-02-02,Maldives,99,0,16155,52
2021-02-03,Maldives,121,1,16276,53
2021-02-04,Maldives,134,1,16410,54
2021-02-05,Maldives,137,0,16547,54
2021-02-06,Maldives,109,0,16656,54
2021-02-07,Maldives,127,1,16783,55
2021-02-08,Maldives,126,0,16909,55
2021-02-09,Maldives,192,1,17101,56
2021-02-10,Maldives,100,0,17201,56
2021-02-11,Maldives,186,0,17387,56
2021-02-12,Maldives,120,1,17507,57
2021-02-13,Maldives,209,1,17716,58
2021-02-14,Maldives,112,0,17828,58
2021-02-15,Maldives,125,0,17953,58
2021-02-16,Maldives,129,0,18082,58
2021-02-17,Maldives,142,0,18224,58
2021-02-18,Maldives,116,0,18340,58
2021-02-19,Maldives,127,0,18467,58
2021-02-20,Maldives,145,2,18612,60
2021-02-21,Maldives,157,0,18769,60
2021-02-22,Maldives,161,0,18930,60
2021-02-23,Maldives,108,0,19038,60
2021-02-24,Maldives,124,0,19162,60
2021-02-25,Maldives,184,0,19346,60
2021-02-26,Maldives,133,0,19479,60
2021-02-27,Maldives,118,1,19597,61
2021-02-28,Maldives,196,1,19793,62
2021-03-01,Maldives,186,0,19979,62
2021-03-02,Maldives,165,0,20144,62
2021-03-03,Maldives,136,1,20280,63
2021-03-04,Maldives,167,1,20447,64
2021-03-05,Maldives,118,0,20565,64
2021-03-06,Maldives,98,0,20663,64
2021-03-07,Maldives,131,0,20794,64
2021-03-08,Maldives,125,0,20919,64
2021-03-09,Maldives,115,0,21034,64
2021-03-10,Maldives,110,0,21144,64
2021-03-11,Maldives,124,0,21268,64
2021-03-12,Maldives,114,0,21382,64
2021-03-13,Maldives,94,0,21476,64
2021-03-14,Maldives,96,0,21572,64
2021-03-15,Maldives,94,0,21666,64
2021-03-16,Maldives,153,0,21819,64
2021-03-17,Maldives,142,0,21961,64
2021-03-18,Maldives,186,0,22147,64
2021-03-19,Maldives,145,1,22292,65
2021-03-20,Maldives,81,0,22373,65
2021-03-21,Maldives,140,1,22513,66
2021-03-22,Maldives,149,0,22662,66
2021-03-23,Maldives,128,0,22790,66
2021-03-24,Maldives,139,0,22929,66
2021-03-25,Maldives,162,0,23091,66
2021-03-26,Maldives,146,0,23237,66
2021-03-27,Maldives,166,0,23403,66
2021-03-28,Maldives,121,0,23524,66
2021-03-29,Maldives,147,0,23671,66
2021-03-30,Maldives,167,0,23838,66
2021-03-31,Maldives,241,1,24079,67
2021-04-01,Maldives,300,0,24379,67
2021-04-02,Maldives,169,0,24548,67
2021-04-03,Maldives,103,0,24651,67
2021-04-04,Maldives,132,0,24783,67
2021-04-05,Maldives,125,0,24908,67
2021-04-06,Maldives,145,0,25053,67
2021-04-07,Maldives,138,0,25191,67
2021-04-08,Maldives,113,0,25304,67
2020-03-25,Mali,2,0,2,0
2020-03-26,Mali,2,0,4,0
2020-03-27,Mali,7,0,11,0
2020-03-28,Mali,7,0,18,0
2020-03-29,Mali,0,1,18,1
2020-03-30,Mali,7,1,25,2
2020-03-31,Mali,3,0,28,2
2020-04-01,Mali,3,1,31,3
2020-04-02,Mali,5,0,36,3
2020-04-03,Mali,3,0,39,3
2020-04-04,Mali,2,0,41,3
2020-04-05,Mali,4,2,45,5
2020-04-06,Mali,2,0,47,5
2020-04-07,Mali,9,0,56,5
2020-04-08,Mali,3,2,59,7
2020-04-09,Mali,15,0,74,7
2020-04-10,Mali,13,0,87,7
2020-04-11,Mali,0,0,87,7
2020-04-12,Mali,18,2,105,9
2020-04-13,Mali,18,1,123,10
2020-04-14,Mali,21,3,144,13
2020-04-15,Mali,4,0,148,13
2020-04-16,Mali,23,0,171,13
2020-04-17,Mali,0,0,171,13
2020-04-18,Mali,45,0,216,13
2020-04-19,Mali,8,1,224,14
2020-04-20,Mali,22,0,246,14
2020-04-21,Mali,12,0,258,14
2020-04-22,Mali,35,3,293,17
2020-04-23,Mali,16,4,309,21
2020-04-24,Mali,16,0,325,21
2020-04-25,Mali,45,0,370,21
2020-04-26,Mali,19,2,389,23
2020-04-27,Mali,19,0,408,23
2020-04-28,Mali,16,1,424,24
2020-04-29,Mali,58,1,482,25
2020-04-30,Mali,8,1,490,26
2020-05-01,Mali,18,0,508,26
2020-05-02,Mali,36,0,544,26
2020-05-03,Mali,19,1,563,27
2020-05-04,Mali,17,2,580,29
2020-05-05,Mali,32,3,612,32
2020-05-06,Mali,19,0,631,32
2020-05-07,Mali,19,0,650,32
2020-05-08,Mali,18,3,668,35
2020-05-09,Mali,24,2,692,37
2020-05-10,Mali,12,1,704,38
2020-05-11,Mali,8,1,712,39
2020-05-12,Mali,18,1,730,40
2020-05-13,Mali,28,4,758,44
2020-05-14,Mali,21,2,779,46
2020-05-15,Mali,27,0,806,46
2020-05-16,Mali,29,2,835,48
2020-05-17,Mali,25,4,860,52
2020-05-18,Mali,14,0,874,52
2020-05-19,Mali,27,1,901,53
2020-05-20,Mali,30,2,931,55
2020-05-21,Mali,16,5,947,60
2020-05-22,Mali,22,2,969,62
2020-05-23,Mali,46,1,1015,63
2020-05-24,Mali,15,2,1030,65
2020-05-25,Mali,29,2,1059,67
2020-05-26,Mali,18,3,1077,70
2020-05-27,Mali,39,0,1116,70
2020-05-28,Mali,78,2,1194,72
2020-05-29,Mali,32,1,1226,73
2020-05-30,Mali,24,3,1250,76
2020-05-31,Mali,15,1,1265,77
2020-06-01,Mali,50,1,1315,78
2020-06-02,Mali,36,0,1351,78
2020-06-03,Mali,35,1,1386,79
2020-06-04,Mali,75,6,1461,85
2020-06-05,Mali,24,2,1485,87
2020-06-06,Mali,38,3,1523,90
2020-06-07,Mali,10,0,1533,90
2020-06-08,Mali,14,2,1547,92
2020-06-09,Mali,39,2,1586,94
2020-06-10,Mali,81,2,1667,96
2020-06-11,Mali,55,1,1722,97
2020-06-12,Mali,30,4,1752,101
2020-06-13,Mali,24,3,1776,104
2020-06-14,Mali,33,0,1809,104
2020-06-15,Mali,51,0,1860,104
2020-06-16,Mali,25,0,1885,104
2020-06-17,Mali,5,3,1890,107
2020-06-18,Mali,16,0,1906,107
2020-06-19,Mali,17,1,1923,108
2020-06-20,Mali,10,1,1933,109
2020-06-21,Mali,0,0,1933,109
2020-06-22,Mali,28,2,1961,111
2020-06-23,Mali,17,0,1978,111
2020-06-24,Mali,27,1,2005,112
2020-06-25,Mali,34,1,2039,113
2020-06-26,Mali,21,0,2060,113
2020-06-27,Mali,58,0,2118,113
2020-06-28,Mali,29,1,2147,114
2020-06-29,Mali,26,1,2173,115
2020-06-30,Mali,8,1,2181,116
2020-07-01,Mali,21,0,2202,116
2020-07-02,Mali,58,1,2260,117
2020-07-03,Mali,25,0,2285,117
2020-07-04,Mali,18,1,2303,118
2020-07-05,Mali,27,1,2330,119
2020-07-06,Mali,1,0,2331,119
2020-07-07,Mali,17,0,2348,119
2020-07-08,Mali,10,1,2358,120
2020-07-09,Mali,12,0,2370,120
2020-07-10,Mali,34,1,2404,121
2020-07-11,Mali,2,0,2406,121
2020-07-12,Mali,5,0,2411,121
2020-07-13,Mali,1,0,2412,121
2020-07-14,Mali,11,0,2423,121
2020-07-15,Mali,10,0,2433,121
2020-07-16,Mali,7,0,2440,121
2020-07-17,Mali,27,0,2467,121
2020-07-18,Mali,5,0,2472,121
2020-07-19,Mali,3,0,2475,121
2020-07-20,Mali,0,0,2475,121
2020-07-21,Mali,2,1,2477,122
2020-07-22,Mali,17,1,2494,123
2020-07-23,Mali,0,0,2494,123
2020-07-24,Mali,9,0,2503,123
2020-07-25,Mali,0,0,2503,123
2020-07-26,Mali,7,0,2510,123
2020-07-27,Mali,3,1,2513,124
2020-07-28,Mali,7,0,2520,124
2020-07-29,Mali,1,0,2521,124
2020-07-30,Mali,1,0,2522,124
2020-07-31,Mali,13,0,2535,124
2020-08-01,Mali,0,0,2535,124
2020-08-02,Mali,6,0,2541,124
2020-08-03,Mali,2,0,2543,124
2020-08-04,Mali,0,0,2543,124
2020-08-05,Mali,3,0,2546,124
2020-08-06,Mali,6,0,2552,124
2020-08-07,Mali,9,1,2561,125
2020-08-08,Mali,4,0,2565,125
2020-08-09,Mali,2,0,2567,125
2020-08-10,Mali,6,0,2573,125
2020-08-11,Mali,4,0,2577,125
2020-08-12,Mali,5,0,2582,125
2020-08-13,Mali,15,0,2597,125
2020-08-14,Mali,0,0,2597,125
2020-08-15,Mali,17,0,2614,125
2020-08-16,Mali,26,0,2640,125
2020-08-17,Mali,0,0,2640,125
2020-08-18,Mali,26,0,2666,125
2020-08-19,Mali,1,0,2667,125
2020-08-20,Mali,0,0,2667,125
2020-08-21,Mali,21,0,2688,125
2020-08-22,Mali,11,0,2699,125
2020-08-23,Mali,6,0,2705,125
2020-08-24,Mali,3,0,2708,125
2020-08-25,Mali,5,0,2713,125
2020-08-26,Mali,4,1,2717,126
2020-08-27,Mali,13,0,2730,126
2020-08-28,Mali,6,0,2736,126
2020-08-29,Mali,21,0,2757,126
2020-08-30,Mali,16,0,2773,126
2020-08-31,Mali,3,0,2776,126
2020-09-01,Mali,1,0,2777,126
2020-09-02,Mali,25,0,2802,126
2020-09-03,Mali,5,0,2807,126
2020-09-04,Mali,7,0,2814,126
2020-09-05,Mali,19,0,2833,126
2020-09-06,Mali,9,1,2842,127
2020-09-07,Mali,28,0,2870,127
2020-09-08,Mali,12,0,2882,127
2020-09-09,Mali,16,1,2898,128
2020-09-10,Mali,11,0,2909,128
2020-09-11,Mali,3,0,2912,128
2020-09-12,Mali,4,0,2916,128
2020-09-13,Mali,8,0,2924,128
2020-09-14,Mali,11,0,2935,128
2020-09-15,Mali,5,0,2940,128
2020-09-16,Mali,26,0,2966,128
2020-09-17,Mali,0,0,2966,128
2020-09-18,Mali,25,0,2991,128
2020-09-19,Mali,15,0,3006,128
2020-09-20,Mali,7,0,3013,128
2020-09-21,Mali,11,0,3024,128
2020-09-22,Mali,6,1,3030,129
2020-09-23,Mali,4,1,3034,130
2020-09-24,Mali,7,0,3041,130
2020-09-25,Mali,23,0,3064,130
2020-09-26,Mali,16,0,3080,130
2020-09-27,Mali,6,0,3086,130
2020-09-28,Mali,4,0,3090,130
2020-09-29,Mali,11,1,3101,131
2020-09-30,Mali,17,0,3118,131
2020-10-01,Mali,13,0,3131,131
2020-10-02,Mali,25,0,3156,131
2020-10-03,Mali,14,0,3170,131
2020-10-04,Mali,14,0,3184,131
2020-10-05,Mali,5,0,3189,131
2020-10-06,Mali,6,0,3195,131
2020-10-07,Mali,15,0,3210,131
2020-10-08,Mali,25,0,3235,131
2020-10-09,Mali,13,0,3248,131
2020-10-10,Mali,25,1,3273,132
2020-10-11,Mali,13,0,3286,132
2020-10-12,Mali,10,0,3296,132
2020-10-13,Mali,1,0,3297,132
2020-10-14,Mali,55,0,3352,132
2020-10-15,Mali,16,0,3368,132
2020-10-16,Mali,10,0,3378,132
2020-10-17,Mali,1,0,3379,132
2020-10-18,Mali,9,0,3388,132
2020-10-19,Mali,19,0,3407,132
2020-10-20,Mali,4,0,3411,132
2020-10-21,Mali,17,0,3428,132
2020-10-22,Mali,12,0,3440,132
2020-10-23,Mali,4,0,3444,132
2020-10-24,Mali,28,0,3472,132
2020-10-25,Mali,18,0,3490,132
2020-10-26,Mali,9,1,3499,133
2020-10-27,Mali,16,3,3515,136
2020-10-28,Mali,15,0,3530,136
2020-10-29,Mali,7,0,3537,136
2020-10-30,Mali,8,0,3545,136
2020-10-31,Mali,9,0,3554,136
2020-11-01,Mali,11,0,3565,136
2020-11-02,Mali,8,0,3573,136
2020-11-03,Mali,11,0,3584,136
2020-11-04,Mali,25,1,3609,137
2020-11-05,Mali,24,0,3633,137
2020-11-06,Mali,24,0,3657,137
2020-11-07,Mali,19,0,3676,137
2020-11-08,Mali,30,0,3706,137
2020-11-09,Mali,6,0,3712,137
2020-11-10,Mali,33,0,3745,137
2020-11-11,Mali,8,1,3753,138
2020-11-12,Mali,39,0,3792,138
2020-11-13,Mali,14,1,3806,139
2020-11-14,Mali,62,0,3868,139
2020-11-15,Mali,32,2,3900,141
2020-11-16,Mali,48,0,3948,141
2020-11-17,Mali,32,0,3980,141
2020-11-18,Mali,53,0,4033,141
2020-11-19,Mali,60,1,4093,142
2020-11-20,Mali,76,1,4169,143
2020-11-21,Mali,37,0,4206,143
2020-11-22,Mali,49,2,4255,145
2020-11-23,Mali,71,1,4326,146
2020-11-24,Mali,91,2,4417,148
2020-11-25,Mali,44,0,4461,148
2020-11-26,Mali,44,0,4505,148
2020-11-27,Mali,62,1,4567,149
2020-11-28,Mali,92,0,4659,149
2020-11-29,Mali,29,3,4688,152
2020-11-30,Mali,22,4,4710,156
2020-12-01,Mali,52,4,4762,160
2020-12-02,Mali,75,1,4837,161
2020-12-03,Mali,43,1,4880,162
2020-12-04,Mali,58,1,4938,163
2020-12-05,Mali,124,0,5062,163
2020-12-06,Mali,73,1,5135,164
2020-12-07,Mali,155,11,5290,175
2020-12-08,Mali,152,5,5442,180
2020-12-09,Mali,27,1,5469,181
2020-12-10,Mali,107,3,5576,184
2020-12-11,Mali,73,1,5649,185
2020-12-12,Mali,72,4,5721,189
2020-12-13,Mali,93,5,5814,194
2020-12-14,Mali,22,7,5836,201
2020-12-15,Mali,42,4,5878,205
2020-12-16,Mali,91,4,5969,209
2020-12-17,Mali,80,2,6049,211
2020-12-18,Mali,71,4,6120,215
2020-12-19,Mali,44,5,6164,220
2020-12-20,Mali,27,2,6191,222
2020-12-21,Mali,41,3,6232,225
2020-12-22,Mali,59,0,6291,225
2020-12-23,Mali,56,4,6347,229
2020-12-24,Mali,94,6,6441,235
2020-12-25,Mali,47,10,6488,245
2020-12-26,Mali,86,4,6574,249
2020-12-27,Mali,55,4,6629,253
2020-12-28,Mali,74,3,6703,256
2020-12-29,Mali,93,6,6796,262
2020-12-30,Mali,233,7,7029,269
2020-12-31,Mali,61,0,7090,269
2021-01-01,Mali,113,2,7203,271
2021-01-02,Mali,23,5,7226,276
2021-01-03,Mali,27,2,7253,278
2021-01-04,Mali,7,1,7260,279
2021-01-05,Mali,89,5,7349,284
2021-01-06,Mali,46,1,7395,285
2021-01-07,Mali,32,1,7427,286
2021-01-08,Mali,85,4,7512,290
2021-01-09,Mali,53,5,7565,295
2021-01-10,Mali,35,3,7600,298
2021-01-11,Mali,64,1,7664,299
2021-01-12,Mali,23,4,7687,303
2021-01-13,Mali,51,0,7738,303
2021-01-14,Mali,21,2,7759,305
2021-01-15,Mali,41,3,7800,308
2021-01-16,Mali,23,0,7823,308
2021-01-17,Mali,16,2,7839,310
2021-01-18,Mali,16,1,7855,311
2021-01-19,Mali,25,6,7880,317
2021-01-20,Mali,17,1,7897,318
2021-01-21,Mali,14,2,7911,320
2021-01-22,Mali,26,1,7937,321
2021-01-23,Mali,28,2,7965,323
2021-01-24,Mali,18,0,7983,323
2021-01-25,Mali,12,1,7995,324
2021-01-26,Mali,11,3,8006,327
2021-01-27,Mali,31,0,8037,327
2021-01-28,Mali,19,1,8056,328
2021-01-29,Mali,7,1,8063,329
2021-01-30,Mali,6,1,8069,330
2021-01-31,Mali,22,0,8091,330
2021-02-01,Mali,9,0,8100,330
2021-02-02,Mali,11,3,8111,333
2021-02-03,Mali,8,0,8119,333
2021-02-04,Mali,11,0,8130,333
2021-02-05,Mali,15,3,8145,336
2021-02-06,Mali,15,2,8160,338
2021-02-07,Mali,16,0,8176,338
2021-02-08,Mali,5,1,8181,339
2021-02-09,Mali,11,0,8192,339
2021-02-10,Mali,11,0,8203,339
2021-02-11,Mali,15,1,8218,340
2021-02-12,Mali,4,0,8222,340
2021-02-13,Mali,4,2,8226,342
2021-02-14,Mali,3,0,8229,342
2021-02-15,Mali,6,0,8235,342
2021-02-16,Mali,6,0,8241,342
2021-02-17,Mali,15,0,8256,342
2021-02-18,Mali,0,0,8256,342
2021-02-19,Mali,4,2,8260,344
2021-02-20,Mali,32,3,8292,347
2021-02-21,Mali,7,1,8299,348
2021-02-22,Mali,7,0,8306,348
2021-02-23,Mali,18,0,8324,348
2021-02-24,Mali,8,0,8332,348
2021-02-25,Mali,17,1,8349,349
2021-02-26,Mali,9,1,8358,350
2021-02-27,Mali,7,2,8365,352
2021-02-28,Mali,11,1,8376,353
2021-03-01,Mali,14,2,8390,355
2021-03-02,Mali,30,0,8420,355
2021-03-03,Mali,26,2,8446,357
2021-03-04,Mali,24,0,8470,357
2021-03-05,Mali,39,1,8509,358
2021-03-06,Mali,51,0,8560,358
2021-03-07,Mali,20,0,8580,358
2021-03-08,Mali,33,0,8613,358
2021-03-09,Mali,0,0,8613,358
2021-03-10,Mali,97,0,8710,358
2021-03-11,Mali,72,1,8782,359
2021-03-12,Mali,31,1,8813,360
2021-03-13,Mali,49,0,8862,360
2021-03-14,Mali,51,0,8913,360
2021-03-15,Mali,20,3,8933,363
2021-03-16,Mali,85,1,9018,364
2021-03-17,Mali,48,1,9066,365
2021-03-18,Mali,52,1,9118,366
2021-03-19,Mali,73,1,9191,367
2021-03-20,Mali,79,0,9270,367
2021-03-21,Mali,60,1,9330,368
2021-03-22,Mali,50,3,9380,371
2021-03-23,Mali,94,1,9474,372
2021-03-24,Mali,103,0,9577,372
2021-03-25,Mali,70,3,9647,375
2021-03-26,Mali,72,1,9719,376
2021-03-27,Mali,54,0,9773,376
2021-03-28,Mali,98,3,9871,379
2021-03-29,Mali,50,5,9921,384
2021-03-30,Mali,77,0,9998,384
2021-03-31,Mali,44,1,10042,385
2021-04-01,Mali,157,1,10199,386
2021-04-02,Mali,86,4,10285,390
2021-04-03,Mali,147,1,10432,391
2021-04-04,Mali,148,1,10580,392
2021-04-05,Mali,40,1,10620,393
2021-04-06,Mali,138,3,10758,396
2021-04-07,Mali,83,4,10841,400
2021-04-08,Mali,413,2,11254,402
2020-03-07,Malta,3,0,3,0
2020-03-08,Malta,0,0,3,0
2020-03-09,Malta,0,0,3,0
2020-03-10,Malta,2,0,5,0
2020-03-11,Malta,1,0,6,0
2020-03-12,Malta,0,0,6,0
2020-03-13,Malta,6,0,12,0
2020-03-14,Malta,6,0,18,0
2020-03-15,Malta,3,0,21,0
2020-03-16,Malta,9,0,30,0
2020-03-17,Malta,8,0,38,0
2020-03-18,Malta,0,0,38,0
2020-03-19,Malta,15,0,53,0
2020-03-20,Malta,11,0,64,0
2020-03-21,Malta,9,0,73,0
2020-03-22,Malta,17,0,90,0
2020-03-23,Malta,17,0,107,0
2020-03-24,Malta,3,0,110,0
2020-03-25,Malta,19,0,129,0
2020-03-26,Malta,5,0,134,0
2020-03-27,Malta,5,0,139,0
2020-03-28,Malta,10,0,149,0
2020-03-29,Malta,2,0,151,0
2020-03-30,Malta,5,0,156,0
2020-03-31,Malta,13,0,169,0
2020-04-01,Malta,19,0,188,0
2020-04-02,Malta,8,0,196,0
2020-04-03,Malta,6,0,202,0
2020-04-04,Malta,11,0,213,0
2020-04-05,Malta,14,0,227,0
2020-04-06,Malta,14,0,241,0
2020-04-07,Malta,52,0,293,0
2020-04-08,Malta,6,1,299,1
2020-04-09,Malta,38,1,337,2
2020-04-10,Malta,13,0,350,2
2020-04-11,Malta,20,1,370,3
2020-04-12,Malta,8,0,378,3
2020-04-13,Malta,6,0,384,3
2020-04-14,Malta,9,0,393,3
2020-04-15,Malta,6,0,399,3
2020-04-16,Malta,13,0,412,3
2020-04-17,Malta,10,0,422,3
2020-04-18,Malta,4,0,426,3
2020-04-19,Malta,1,0,427,3
2020-04-20,Malta,4,0,431,3
2020-04-21,Malta,12,0,443,3
2020-04-22,Malta,1,0,444,3
2020-04-23,Malta,1,0,445,3
2020-04-24,Malta,2,0,447,3
2020-04-25,Malta,1,1,448,4
2020-04-26,Malta,0,0,448,4
2020-04-27,Malta,2,0,450,4
2020-04-28,Malta,8,0,458,4
2020-04-29,Malta,5,0,463,4
2020-04-30,Malta,2,0,465,4
2020-05-01,Malta,2,0,467,4
2020-05-02,Malta,1,0,468,4
2020-05-03,Malta,9,0,477,4
2020-05-04,Malta,3,0,480,4
2020-05-05,Malta,2,1,482,5
2020-05-06,Malta,2,0,484,5
2020-05-07,Malta,2,0,486,5
2020-05-08,Malta,3,0,489,5
2020-05-09,Malta,1,0,490,5
2020-05-10,Malta,6,0,496,5
2020-05-11,Malta,7,0,503,5
2020-05-12,Malta,3,0,506,5
2020-05-13,Malta,2,1,508,6
2020-05-14,Malta,14,0,522,6
2020-05-15,Malta,10,0,532,6
2020-05-16,Malta,14,0,546,6
2020-05-17,Malta,7,0,553,6
2020-05-18,Malta,5,0,558,6
2020-05-19,Malta,11,0,569,6
2020-05-20,Malta,15,0,584,6
2020-05-21,Malta,15,0,599,6
2020-05-22,Malta,1,0,600,6
2020-05-23,Malta,9,0,609,6
2020-05-24,Malta,1,0,610,6
2020-05-25,Malta,1,0,611,6
2020-05-26,Malta,0,0,611,6
2020-05-27,Malta,1,1,612,7
2020-05-28,Malta,4,0,616,7
2020-05-29,Malta,0,2,616,9
2020-05-30,Malta,2,0,618,9
2020-05-31,Malta,0,0,618,9
2020-06-01,Malta,1,0,619,9
2020-06-02,Malta,1,0,620,9
2020-06-03,Malta,2,0,622,9
2020-06-04,Malta,0,0,622,9
2020-06-05,Malta,3,0,625,9
2020-06-06,Malta,2,0,627,9
2020-06-07,Malta,2,0,629,9
2020-06-08,Malta,1,0,630,9
2020-06-09,Malta,2,0,632,9
2020-06-10,Malta,3,0,635,9
2020-06-11,Malta,5,0,640,9
2020-06-12,Malta,5,0,645,9
2020-06-13,Malta,1,0,646,9
2020-06-14,Malta,3,0,649,9
2020-06-15,Malta,1,0,650,9
2020-06-16,Malta,6,0,656,9
2020-06-17,Malta,6,0,662,9
2020-06-18,Malta,1,0,663,9
2020-06-19,Malta,0,0,663,9
2020-06-20,Malta,1,0,664,9
2020-06-21,Malta,1,0,665,9
2020-06-22,Malta,0,0,665,9
2020-06-23,Malta,0,0,665,9
2020-06-24,Malta,0,0,665,9
2020-06-25,Malta,3,0,668,9
2020-06-26,Malta,2,0,670,9
2020-06-27,Malta,0,0,670,9
2020-06-28,Malta,0,0,670,9
2020-06-29,Malta,0,0,670,9
2020-06-30,Malta,0,0,670,9
2020-07-01,Malta,1,0,671,9
2020-07-02,Malta,0,0,671,9
2020-07-03,Malta,1,0,672,9
2020-07-04,Malta,0,0,672,9
2020-07-05,Malta,0,0,672,9
2020-07-06,Malta,0,0,672,9
2020-07-07,Malta,1,0,673,9
2020-07-08,Malta,0,0,673,9
2020-07-09,Malta,1,0,674,9
2020-07-10,Malta,0,0,674,9
2020-07-11,Malta,0,0,674,9
2020-07-12,Malta,0,0,674,9
2020-07-13,Malta,0,0,674,9
2020-07-14,Malta,0,0,674,9
2020-07-15,Malta,0,0,674,9
2020-07-16,Malta,0,0,674,9
2020-07-17,Malta,0,0,674,9
2020-07-18,Malta,1,0,675,9
2020-07-19,Malta,2,0,677,9
2020-07-20,Malta,0,0,677,9
2020-07-21,Malta,0,0,677,9
2020-07-22,Malta,2,0,679,9
2020-07-23,Malta,1,0,680,9
2020-07-24,Malta,6,0,686,9
2020-07-25,Malta,0,0,686,9
2020-07-26,Malta,14,0,700,9
2020-07-27,Malta,1,0,701,9
2020-07-28,Malta,7,0,708,9
2020-07-29,Malta,12,0,720,9
2020-07-30,Malta,94,0,814,9
2020-07-31,Malta,10,0,824,9
2020-08-01,Malta,21,0,845,9
2020-08-02,Malta,15,0,860,9
2020-08-03,Malta,14,0,874,9
2020-08-04,Malta,16,0,890,9
2020-08-05,Malta,36,0,926,9
2020-08-06,Malta,20,0,946,9
2020-08-07,Malta,49,0,995,9
2020-08-08,Malta,40,0,1035,9
2020-08-09,Malta,54,0,1089,9
2020-08-10,Malta,23,0,1112,9
2020-08-11,Malta,29,0,1141,9
2020-08-12,Malta,49,0,1190,9
2020-08-13,Malta,55,0,1245,9
2020-08-14,Malta,31,0,1276,9
2020-08-15,Malta,72,0,1348,9
2020-08-16,Malta,-42,0,1306,9
2020-08-17,Malta,69,0,1375,9
2020-08-18,Malta,48,0,1423,9
2020-08-19,Malta,47,0,1470,9
2020-08-20,Malta,40,0,1510,9
2020-08-21,Malta,36,1,1546,10
2020-08-22,Malta,31,0,1577,10
2020-08-23,Malta,35,0,1612,10
2020-08-24,Malta,55,0,1667,10
2020-08-25,Malta,38,0,1705,10
2020-08-26,Malta,46,0,1751,10
2020-08-27,Malta,37,0,1788,10
2020-08-28,Malta,32,0,1820,10
2020-08-29,Malta,27,0,1847,10
2020-08-30,Malta,15,2,1862,12
2020-08-31,Malta,21,0,1883,12
2020-09-01,Malta,26,0,1909,12
2020-09-02,Malta,22,1,1931,13
2020-09-03,Malta,34,0,1965,13
2020-09-04,Malta,19,0,1984,13
2020-09-05,Malta,30,1,2014,14
2020-09-06,Malta,25,0,2039,14
2020-09-07,Malta,37,0,2076,14
2020-09-08,Malta,23,0,2099,14
2020-09-09,Malta,63,0,2162,14
2020-09-10,Malta,42,0,2204,14
2020-09-11,Malta,43,1,2247,15
2020-09-12,Malta,27,0,2274,15
2020-09-13,Malta,78,0,2352,15
2020-09-14,Malta,53,1,2405,16
2020-09-15,Malta,49,0,2454,16
2020-09-16,Malta,106,0,2560,16
2020-09-17,Malta,35,0,2595,16
2020-09-18,Malta,39,1,2634,17
2020-09-19,Malta,65,2,2699,19
2020-09-20,Malta,32,1,2731,20
2020-09-21,Malta,45,3,2776,23
2020-09-22,Malta,38,0,2814,23
2020-09-23,Malta,42,2,2856,25
2020-09-24,Malta,42,2,2898,27
2020-09-25,Malta,31,2,2929,29
2020-09-26,Malta,29,2,2958,31
2020-09-27,Malta,21,0,2979,31
2020-09-28,Malta,27,1,3006,32
2020-09-29,Malta,29,2,3035,34
2020-09-30,Malta,23,1,3058,35
2020-10-01,Malta,37,0,3095,35
2020-10-02,Malta,44,2,3139,37
2020-10-03,Malta,65,1,3204,38
2020-10-04,Malta,66,1,3270,39
2020-10-05,Malta,57,0,3327,39
2020-10-06,Malta,47,1,3374,40
2020-10-07,Malta,68,1,3442,41
2020-10-08,Malta,64,0,3506,41
2020-10-09,Malta,75,0,3581,41
2020-10-10,Malta,100,0,3681,41
2020-10-11,Malta,95,0,3776,41
2020-10-12,Malta,68,2,3844,43
2020-10-13,Malta,93,1,3937,44
2020-10-14,Malta,111,0,4048,44
2020-10-15,Malta,112,1,4160,45
2020-10-16,Malta,122,0,4282,45
2020-10-17,Malta,204,0,4486,45
2020-10-18,Malta,142,0,4628,45
2020-10-19,Malta,109,0,4737,45
2020-10-20,Malta,134,1,4871,46
2020-10-21,Malta,155,0,5026,46
2020-10-22,Malta,111,3,5137,49
2020-10-23,Malta,121,0,5258,49
2020-10-24,Malta,115,1,5373,50
2020-10-25,Malta,125,1,5498,51
2020-10-26,Malta,80,2,5578,53
2020-10-27,Malta,107,2,5685,55
2020-10-28,Malta,75,1,5760,56
2020-10-29,Malta,106,3,5866,59
2020-10-30,Malta,76,2,5942,61
2020-10-31,Malta,100,1,6042,62
2020-11-01,Malta,140,2,6182,64
2020-11-02,Malta,218,2,6400,66
2020-11-03,Malta,106,-2,6506,64
2020-11-04,Malta,84,1,6590,65
2020-11-05,Malta,174,5,6764,70
2020-11-06,Malta,129,3,6893,73
2020-11-07,Malta,146,1,7039,74
2020-11-08,Malta,102,2,7141,76
2020-11-09,Malta,102,2,7243,78
2020-11-10,Malta,153,3,7396,81
2020-11-11,Malta,141,7,7537,88
2020-11-12,Malta,109,0,7646,88
2020-11-13,Malta,150,4,7796,92
2020-11-14,Malta,121,3,7917,95
2020-11-15,Malta,117,2,8034,97
2020-11-16,Malta,103,1,8137,98
2020-11-17,Malta,110,3,8247,101
2020-11-18,Malta,173,2,8420,103
2020-11-19,Malta,140,1,8560,104
2020-11-20,Malta,121,4,8681,108
2020-11-21,Malta,141,3,8822,111
2020-11-22,Malta,102,0,8924,111
2020-11-23,Malta,80,2,9004,113
2020-11-24,Malta,133,4,9137,117
2020-11-25,Malta,116,5,9253,122
2020-11-26,Malta,152,3,9405,125
2020-11-27,Malta,96,3,9501,128
2020-11-28,Malta,108,4,9609,132
2020-11-29,Malta,143,1,9752,133
2020-11-30,Malta,121,4,9873,137
2020-12-01,Malta,102,4,9975,141
2020-12-02,Malta,126,5,10101,146
2020-12-03,Malta,96,2,10197,148
2020-12-04,Malta,123,1,10320,149
2020-12-05,Malta,103,0,10423,149
2020-12-06,Malta,97,2,10520,151
2020-12-07,Malta,139,4,10659,155
2020-12-08,Malta,40,2,10699,157
2020-12-09,Malta,79,3,10778,160
2020-12-10,Malta,106,4,10884,164
2020-12-11,Malta,96,2,10980,166
2020-12-12,Malta,121,0,11101,166
2020-12-13,Malta,52,3,11153,169
2020-12-14,Malta,101,5,11254,174
2020-12-15,Malta,49,3,11303,177
2020-12-16,Malta,112,3,11415,180
2020-12-17,Malta,60,2,11475,182
2020-12-18,Malta,94,1,11569,183
2020-12-19,Malta,52,4,11621,187
2020-12-20,Malta,93,3,11714,190
2020-12-21,Malta,88,4,11802,194
2020-12-22,Malta,108,2,11910,196
2020-12-23,Malta,82,5,11992,201
2020-12-24,Malta,70,2,12062,203
2020-12-25,Malta,50,0,12112,203
2020-12-26,Malta,129,3,12241,206
2020-12-27,Malta,84,4,12325,210
2020-12-28,Malta,101,5,12426,215
2020-12-29,Malta,115,0,12541,215
2020-12-30,Malta,124,1,12665,216
2020-12-31,Malta,109,3,12774,219
2021-01-01,Malta,135,0,12909,219
2021-01-02,Malta,88,1,12997,220
2021-01-03,Malta,85,0,13082,220
2021-01-04,Malta,148,2,13230,222
2021-01-05,Malta,158,4,13388,226
2021-01-06,Malta,224,1,13612,227
2021-01-07,Malta,164,1,13776,228
2021-01-08,Malta,191,2,13967,230
2021-01-09,Malta,245,2,14212,232
2021-01-10,Malta,184,1,14396,233
2021-01-11,Malta,133,0,14529,233
2021-01-12,Malta,240,1,14769,234
2021-01-13,Malta,189,0,14958,234
2021-01-14,Malta,121,1,15079,235
2021-01-15,Malta,193,1,15272,236
2021-01-16,Malta,175,2,15447,238
2021-01-17,Malta,141,1,15588,239
2021-01-18,Malta,154,2,15742,241
2021-01-19,Malta,200,1,15942,242
2021-01-20,Malta,187,2,16129,244
2021-01-21,Malta,151,1,16280,245
2021-01-22,Malta,143,3,16423,248
2021-01-23,Malta,119,2,16542,250
2021-01-24,Malta,116,1,16658,251
2021-01-25,Malta,203,2,16861,253
2021-01-26,Malta,138,2,16999,255
2021-01-27,Malta,193,3,17192,258
2021-01-28,Malta,208,3,17400,261
2021-01-29,Malta,185,3,17585,264
2021-01-30,Malta,136,1,17721,265
2021-01-31,Malta,182,2,17903,267
2021-02-01,Malta,124,2,18027,269
2021-02-02,Malta,141,1,18168,270
2021-02-03,Malta,138,3,18306,273
2021-02-04,Malta,79,0,18385,273
2021-02-05,Malta,57,4,18442,277
2021-02-06,Malta,134,2,18576,279
2021-02-07,Malta,100,3,18676,282
2021-02-08,Malta,137,0,18813,282
2021-02-09,Malta,202,2,19015,284
2021-02-10,Malta,167,2,19182,286
2021-02-11,Malta,151,0,19333,286
2021-02-12,Malta,164,2,19497,288
2021-02-13,Malta,154,2,19651,290
2021-02-14,Malta,138,3,19789,293
2021-02-15,Malta,156,2,19945,295
2021-02-16,Malta,102,2,20047,297
2021-02-17,Malta,199,1,20246,298
2021-02-18,Malta,163,3,20409,301
2021-02-19,Malta,154,0,20563,301
2021-02-20,Malta,199,2,20762,303
2021-02-21,Malta,130,1,20892,304
2021-02-22,Malta,193,1,21085,305
2021-02-23,Malta,221,1,21306,306
2021-02-24,Malta,226,2,21532,308
2021-02-25,Malta,192,3,21724,311
2021-02-26,Malta,258,2,21982,313
2021-02-27,Malta,237,0,22219,313
2021-02-28,Malta,263,2,22482,315
2021-03-01,Malta,175,1,22657,316
2021-03-02,Malta,336,3,22993,319
2021-03-03,Malta,233,2,23226,321
2021-03-04,Malta,362,4,23588,325
2021-03-05,Malta,283,3,23871,328
2021-03-06,Malta,345,1,24216,329
2021-03-07,Malta,182,5,24398,334
2021-03-08,Malta,201,0,24599,334
2021-03-09,Malta,248,1,24847,335
2021-03-10,Malta,510,2,25357,337
2021-03-11,Malta,283,4,25640,341
2021-03-12,Malta,329,5,25969,346
2021-03-13,Malta,298,4,26267,350
2021-03-14,Malta,268,1,26535,351
2021-03-15,Malta,213,3,26748,354
2021-03-16,Malta,313,3,27061,357
2021-03-17,Malta,211,4,27272,361
2021-03-18,Malta,243,2,27515,363
2021-03-19,Malta,179,1,27694,364
2021-03-20,Malta,210,5,27904,369
2021-03-21,Malta,224,3,28128,372
2021-03-22,Malta,191,1,28319,373
2021-03-23,Malta,90,2,28409,375
2021-03-24,Malta,101,2,28510,377
2021-03-25,Malta,102,1,28612,378
2021-03-26,Malta,103,4,28715,382
2021-03-27,Malta,93,3,28808,385
2021-03-28,Malta,67,2,28875,387
2021-03-29,Malta,63,1,28938,388
2021-03-30,Malta,55,2,28993,390
2021-03-31,Malta,40,2,29033,392
2021-04-01,Malta,52,2,29085,394
2021-04-02,Malta,42,1,29127,395
2021-04-03,Malta,62,2,29189,397
2021-04-04,Malta,34,1,29223,398
2021-04-05,Malta,56,1,29279,399
2021-04-06,Malta,64,0,29343,399
2021-04-07,Malta,65,1,29408,400
2021-04-08,Malta,55,1,29463,401
2020-10-28,Marshall Islands,2,0,2,0
2020-10-29,Marshall Islands,0,0,2,0
2020-10-30,Marshall Islands,0,0,2,0
2020-10-31,Marshall Islands,0,0,2,0
2020-11-01,Marshall Islands,0,0,2,0
2020-11-02,Marshall Islands,0,0,2,0
2020-11-03,Marshall Islands,0,0,2,0
2020-11-04,Marshall Islands,0,0,2,0
2020-11-05,Marshall Islands,-1,0,1,0
2020-11-06,Marshall Islands,0,0,1,0
2020-11-07,Marshall Islands,0,0,1,0
2020-11-08,Marshall Islands,0,0,1,0
2020-11-09,Marshall Islands,0,0,1,0
2020-11-10,Marshall Islands,0,0,1,0
2020-11-11,Marshall Islands,0,0,1,0
2020-11-12,Marshall Islands,0,0,1,0
2020-11-13,Marshall Islands,0,0,1,0
2020-11-14,Marshall Islands,0,0,1,0
2020-11-15,Marshall Islands,0,0,1,0
2020-11-16,Marshall Islands,0,0,1,0
2020-11-17,Marshall Islands,3,0,4,0
2020-11-18,Marshall Islands,0,0,4,0
2020-11-19,Marshall Islands,0,0,4,0
2020-11-20,Marshall Islands,0,0,4,0
2020-11-21,Marshall Islands,0,0,4,0
2020-11-22,Marshall Islands,0,0,4,0
2020-11-23,Marshall Islands,0,0,4,0
2020-11-24,Marshall Islands,0,0,4,0
2020-11-25,Marshall Islands,0,0,4,0
2020-11-26,Marshall Islands,0,0,4,0
2020-11-27,Marshall Islands,0,0,4,0
2020-11-28,Marshall Islands,0,0,4,0
2020-11-29,Marshall Islands,0,0,4,0
2020-11-30,Marshall Islands,0,0,4,0
2020-12-01,Marshall Islands,0,0,4,0
2020-12-02,Marshall Islands,0,0,4,0
2020-12-03,Marshall Islands,0,0,4,0
2020-12-04,Marshall Islands,0,0,4,0
2020-12-05,Marshall Islands,0,0,4,0
2020-12-06,Marshall Islands,0,0,4,0
2020-12-07,Marshall Islands,0,0,4,0
2020-12-08,Marshall Islands,0,0,4,0
2020-12-09,Marshall Islands,0,0,4,0
2020-12-10,Marshall Islands,0,0,4,0
2020-12-11,Marshall Islands,0,0,4,0
2020-12-12,Marshall Islands,0,0,4,0
2020-12-13,Marshall Islands,0,0,4,0
2020-12-14,Marshall Islands,0,0,4,0
2020-12-15,Marshall Islands,0,0,4,0
2020-12-16,Marshall Islands,0,0,4,0
2020-12-17,Marshall Islands,0,0,4,0
2020-12-18,Marshall Islands,0,0,4,0
2020-12-19,Marshall Islands,0,0,4,0
2020-12-20,Marshall Islands,0,0,4,0
2020-12-21,Marshall Islands,0,0,4,0
2020-12-22,Marshall Islands,0,0,4,0
2020-12-23,Marshall Islands,0,0,4,0
2020-12-24,Marshall Islands,0,0,4,0
2020-12-25,Marshall Islands,0,0,4,0
2020-12-26,Marshall Islands,0,0,4,0
2020-12-27,Marshall Islands,0,0,4,0
2020-12-28,Marshall Islands,0,0,4,0
2020-12-29,Marshall Islands,0,0,4,0
2020-12-30,Marshall Islands,0,0,4,0
2020-12-31,Marshall Islands,0,0,4,0
2021-01-01,Marshall Islands,0,0,4,0
2021-01-02,Marshall Islands,0,0,4,0
2021-01-03,Marshall Islands,0,0,4,0
2021-01-04,Marshall Islands,0,0,4,0
2021-01-05,Marshall Islands,0,0,4,0
2021-01-06,Marshall Islands,0,0,4,0
2021-01-07,Marshall Islands,0,0,4,0
2021-01-08,Marshall Islands,0,0,4,0
2021-01-09,Marshall Islands,0,0,4,0
2021-01-10,Marshall Islands,0,0,4,0
2021-01-11,Marshall Islands,0,0,4,0
2021-01-12,Marshall Islands,0,0,4,0
2021-01-13,Marshall Islands,0,0,4,0
2021-01-14,Marshall Islands,0,0,4,0
2021-01-15,Marshall Islands,0,0,4,0
2021-01-16,Marshall Islands,0,0,4,0
2021-01-17,Marshall Islands,0,0,4,0
2021-01-18,Marshall Islands,0,0,4,0
2021-01-19,Marshall Islands,0,0,4,0
2021-01-20,Marshall Islands,0,0,4,0
2021-01-21,Marshall Islands,0,0,4,0
2021-01-22,Marshall Islands,0,0,4,0
2021-01-23,Marshall Islands,0,0,4,0
2021-01-24,Marshall Islands,0,0,4,0
2021-01-25,Marshall Islands,0,0,4,0
2021-01-26,Marshall Islands,0,0,4,0
2021-01-27,Marshall Islands,0,0,4,0
2021-01-28,Marshall Islands,0,0,4,0
2021-01-29,Marshall Islands,0,0,4,0
2021-01-30,Marshall Islands,0,0,4,0
2021-01-31,Marshall Islands,0,0,4,0
2021-02-01,Marshall Islands,0,0,4,0
2021-02-02,Marshall Islands,0,0,4,0
2021-02-03,Marshall Islands,0,0,4,0
2021-02-04,Marshall Islands,0,0,4,0
2021-02-05,Marshall Islands,0,0,4,0
2021-02-06,Marshall Islands,0,0,4,0
2021-02-07,Marshall Islands,0,0,4,0
2021-02-08,Marshall Islands,0,0,4,0
2021-02-09,Marshall Islands,0,0,4,0
2021-02-10,Marshall Islands,0,0,4,0
2021-02-11,Marshall Islands,0,0,4,0
2021-02-12,Marshall Islands,0,0,4,0
2021-02-13,Marshall Islands,0,0,4,0
2021-02-14,Marshall Islands,0,0,4,0
2021-02-15,Marshall Islands,0,0,4,0
2021-02-16,Marshall Islands,0,0,4,0
2021-02-17,Marshall Islands,0,0,4,0
2021-02-18,Marshall Islands,0,0,4,0
2021-02-19,Marshall Islands,0,0,4,0
2021-02-20,Marshall Islands,0,0,4,0
2021-02-21,Marshall Islands,0,0,4,0
2021-02-22,Marshall Islands,0,0,4,0
2021-02-23,Marshall Islands,0,0,4,0
2021-02-24,Marshall Islands,0,0,4,0
2021-02-25,Marshall Islands,0,0,4,0
2021-02-26,Marshall Islands,0,0,4,0
2021-02-27,Marshall Islands,0,0,4,0
2021-02-28,Marshall Islands,0,0,4,0
2021-03-01,Marshall Islands,0,0,4,0
2021-03-02,Marshall Islands,0,0,4,0
2021-03-03,Marshall Islands,0,0,4,0
2021-03-04,Marshall Islands,0,0,4,0
2021-03-05,Marshall Islands,0,0,4,0
2021-03-06,Marshall Islands,0,0,4,0
2021-03-07,Marshall Islands,0,0,4,0
2021-03-08,Marshall Islands,0,0,4,0
2021-03-09,Marshall Islands,0,0,4,0
2021-03-10,Marshall Islands,0,0,4,0
2021-03-11,Marshall Islands,0,0,4,0
2021-03-12,Marshall Islands,0,0,4,0
2021-03-13,Marshall Islands,0,0,4,0
2021-03-14,Marshall Islands,0,0,4,0
2021-03-15,Marshall Islands,0,0,4,0
2021-03-16,Marshall Islands,0,0,4,0
2021-03-17,Marshall Islands,0,0,4,0
2021-03-18,Marshall Islands,0,0,4,0
2021-03-19,Marshall Islands,0,0,4,0
2021-03-20,Marshall Islands,0,0,4,0
2021-03-21,Marshall Islands,0,0,4,0
2021-03-22,Marshall Islands,0,0,4,0
2021-03-23,Marshall Islands,0,0,4,0
2021-03-24,Marshall Islands,0,0,4,0
2021-03-25,Marshall Islands,0,0,4,0
2021-03-26,Marshall Islands,0,0,4,0
2021-03-27,Marshall Islands,0,0,4,0
2021-03-28,Marshall Islands,0,0,4,0
2021-03-29,Marshall Islands,0,0,4,0
2021-03-30,Marshall Islands,0,0,4,0
2021-03-31,Marshall Islands,0,0,4,0
2021-04-01,Marshall Islands,0,0,4,0
2021-04-02,Marshall Islands,0,0,4,0
2021-04-03,Marshall Islands,0,0,4,0
2021-04-04,Marshall Islands,0,0,4,0
2021-04-05,Marshall Islands,0,0,4,0
2021-04-06,Marshall Islands,0,0,4,0
2021-04-07,Marshall Islands,0,0,4,0
2021-04-08,Marshall Islands,0,0,4,0
2020-03-14,Mauritania,1,0,1,0
2020-03-15,Mauritania,0,0,1,0
2020-03-16,Mauritania,0,0,1,0
2020-03-17,Mauritania,0,0,1,0
2020-03-18,Mauritania,0,0,1,0
2020-03-19,Mauritania,1,0,2,0
2020-03-20,Mauritania,0,0,2,0
2020-03-21,Mauritania,0,0,2,0
2020-03-22,Mauritania,0,0,2,0
2020-03-23,Mauritania,0,0,2,0
2020-03-24,Mauritania,0,0,2,0
2020-03-25,Mauritania,0,0,2,0
2020-03-26,Mauritania,1,0,3,0
2020-03-27,Mauritania,0,0,3,0
2020-03-28,Mauritania,2,0,5,0
2020-03-29,Mauritania,0,0,5,0
2020-03-30,Mauritania,0,1,5,1
2020-03-31,Mauritania,1,0,6,1
2020-04-01,Mauritania,0,0,6,1
2020-04-02,Mauritania,0,0,6,1
2020-04-03,Mauritania,0,0,6,1
2020-04-04,Mauritania,0,0,6,1
2020-04-05,Mauritania,0,0,6,1
2020-04-06,Mauritania,0,0,6,1
2020-04-07,Mauritania,0,0,6,1
2020-04-08,Mauritania,0,0,6,1
2020-04-09,Mauritania,1,0,7,1
2020-04-10,Mauritania,0,0,7,1
2020-04-11,Mauritania,0,0,7,1
2020-04-12,Mauritania,0,0,7,1
2020-04-13,Mauritania,0,0,7,1
2020-04-14,Mauritania,0,0,7,1
2020-04-15,Mauritania,0,0,7,1
2020-04-16,Mauritania,0,0,7,1
2020-04-17,Mauritania,0,0,7,1
2020-04-18,Mauritania,0,0,7,1
2020-04-19,Mauritania,0,0,7,1
2020-04-20,Mauritania,0,0,7,1
2020-04-21,Mauritania,0,0,7,1
2020-04-22,Mauritania,0,0,7,1
2020-04-23,Mauritania,0,0,7,1
2020-04-24,Mauritania,0,0,7,1
2020-04-25,Mauritania,0,0,7,1
2020-04-26,Mauritania,0,0,7,1
2020-04-27,Mauritania,0,0,7,1
2020-04-28,Mauritania,0,0,7,1
2020-04-29,Mauritania,1,0,8,1
2020-04-30,Mauritania,0,0,8,1
2020-05-01,Mauritania,0,0,8,1
2020-05-02,Mauritania,0,0,8,1
2020-05-03,Mauritania,0,0,8,1
2020-05-04,Mauritania,0,0,8,1
2020-05-05,Mauritania,0,0,8,1
2020-05-06,Mauritania,0,0,8,1
2020-05-07,Mauritania,0,0,8,1
2020-05-08,Mauritania,0,0,8,1
2020-05-09,Mauritania,0,0,8,1
2020-05-10,Mauritania,0,0,8,1
2020-05-11,Mauritania,0,0,8,1
2020-05-12,Mauritania,1,0,9,1
2020-05-13,Mauritania,6,1,15,2
2020-05-14,Mauritania,5,0,20,2
2020-05-15,Mauritania,9,1,29,3
2020-05-16,Mauritania,11,1,40,4
2020-05-17,Mauritania,22,0,62,4
2020-05-18,Mauritania,19,0,81,4
2020-05-19,Mauritania,50,0,131,4
2020-05-20,Mauritania,10,0,141,4
2020-05-21,Mauritania,32,1,173,5
2020-05-22,Mauritania,27,1,200,6
2020-05-23,Mauritania,27,0,227,6
2020-05-24,Mauritania,10,0,237,6
2020-05-25,Mauritania,25,3,262,9
2020-05-26,Mauritania,6,4,268,13
2020-05-27,Mauritania,24,3,292,16
2020-05-28,Mauritania,54,3,346,19
2020-05-29,Mauritania,77,1,423,20
2020-05-30,Mauritania,60,0,483,20
2020-05-31,Mauritania,47,3,530,23
2020-06-01,Mauritania,58,0,588,23
2020-06-02,Mauritania,80,8,668,31
2020-06-03,Mauritania,77,3,745,34
2020-06-04,Mauritania,39,5,784,39
2020-06-05,Mauritania,99,4,883,43
2020-06-06,Mauritania,64,6,947,49
2020-06-07,Mauritania,102,6,1049,55
2020-06-08,Mauritania,55,4,1104,59
2020-06-09,Mauritania,58,2,1162,61
2020-06-10,Mauritania,121,10,1283,71
2020-06-11,Mauritania,156,3,1439,74
2020-06-12,Mauritania,133,7,1572,81
2020-06-13,Mauritania,110,2,1682,83
2020-06-14,Mauritania,101,4,1783,87
2020-06-15,Mauritania,104,4,1887,91
2020-06-16,Mauritania,170,2,2057,93
2020-06-17,Mauritania,166,2,2223,95
2020-06-18,Mauritania,201,2,2424,97
2020-06-19,Mauritania,197,5,2621,102
2020-06-20,Mauritania,192,6,2813,108
2020-06-21,Mauritania,171,3,2984,111
2020-06-22,Mauritania,137,1,3121,112
2020-06-23,Mauritania,171,2,3292,114
2020-06-24,Mauritania,227,2,3519,116
2020-06-25,Mauritania,220,3,3739,119
2020-06-26,Mauritania,168,1,3907,120
2020-06-27,Mauritania,118,1,4025,121
2020-06-28,Mauritania,124,5,4149,126
2020-06-29,Mauritania,88,2,4237,128
2020-06-30,Mauritania,126,1,4363,129
2020-07-01,Mauritania,109,0,4472,129
2020-07-02,Mauritania,134,0,4606,129
2020-07-03,Mauritania,99,0,4705,129
2020-07-04,Mauritania,122,0,4827,129
2020-07-05,Mauritania,52,1,4879,130
2020-07-06,Mauritania,69,3,4948,133
2020-07-07,Mauritania,76,2,5024,135
2020-07-08,Mauritania,63,4,5087,139
2020-07-09,Mauritania,39,5,5126,144
2020-07-10,Mauritania,77,2,5203,146
2020-07-11,Mauritania,72,1,5275,147
2020-07-12,Mauritania,80,0,5355,147
2020-07-13,Mauritania,91,0,5446,147
2020-07-14,Mauritania,72,0,5518,147
2020-07-15,Mauritania,46,2,5564,149
2020-07-16,Mauritania,95,1,5659,150
2020-07-17,Mauritania,51,1,5710,151
2020-07-18,Mauritania,103,2,5813,153
2020-07-19,Mauritania,60,2,5873,155
2020-07-20,Mauritania,50,0,5923,155
2020-07-21,Mauritania,62,0,5985,155
2020-07-22,Mauritania,42,0,6027,155
2020-07-23,Mauritania,40,1,6067,156
2020-07-24,Mauritania,49,0,6116,156
2020-07-25,Mauritania,35,0,6151,156
2020-07-26,Mauritania,20,0,6171,156
2020-07-27,Mauritania,37,0,6208,156
2020-07-28,Mauritania,41,0,6249,156
2020-07-29,Mauritania,24,0,6273,156
2020-07-30,Mauritania,22,1,6295,157
2020-07-31,Mauritania,15,0,6310,157
2020-08-01,Mauritania,9,0,6319,157
2020-08-02,Mauritania,4,0,6323,157
2020-08-03,Mauritania,59,0,6382,157
2020-08-04,Mauritania,36,0,6418,157
2020-08-05,Mauritania,26,0,6444,157
2020-08-06,Mauritania,0,0,6444,157
2020-08-07,Mauritania,54,0,6498,157
2020-08-08,Mauritania,12,0,6510,157
2020-08-09,Mauritania,13,0,6523,157
2020-08-10,Mauritania,32,0,6555,157
2020-08-11,Mauritania,43,0,6598,157
2020-08-12,Mauritania,24,0,6622,157
2020-08-13,Mauritania,31,0,6653,157
2020-08-14,Mauritania,23,0,6676,157
2020-08-15,Mauritania,17,0,6693,157
2020-08-16,Mauritania,8,0,6701,157
2020-08-17,Mauritania,61,0,6762,157
2020-08-18,Mauritania,27,0,6789,157
2020-08-19,Mauritania,40,1,6829,158
2020-08-20,Mauritania,19,0,6848,158
2020-08-21,Mauritania,37,0,6885,158
2020-08-22,Mauritania,9,0,6894,158
2020-08-23,Mauritania,11,0,6905,158
2020-08-24,Mauritania,23,0,6928,158
2020-08-25,Mauritania,32,0,6960,158
2020-08-26,Mauritania,17,0,6977,158
2020-08-27,Mauritania,16,0,6993,158
2020-08-28,Mauritania,19,0,7012,158
2020-08-29,Mauritania,0,0,7012,158
2020-08-30,Mauritania,4,1,7016,159
2020-08-31,Mauritania,32,0,7048,159
2020-09-01,Mauritania,27,0,7075,159
2020-09-02,Mauritania,14,1,7089,160
2020-09-03,Mauritania,17,0,7106,160
2020-09-04,Mauritania,20,0,7126,160
2020-09-05,Mauritania,8,0,7134,160
2020-09-06,Mauritania,8,0,7142,160
2020-09-07,Mauritania,23,0,7165,160
2020-09-08,Mauritania,0,0,7165,160
2020-09-09,Mauritania,26,1,7191,161
2020-09-10,Mauritania,31,0,7222,161
2020-09-11,Mauritania,44,0,7266,161
2020-09-12,Mauritania,8,0,7274,161
2020-09-13,Mauritania,2,0,7276,161
2020-09-14,Mauritania,19,0,7295,161
2020-09-15,Mauritania,24,0,7319,161
2020-09-16,Mauritania,13,0,7332,161
2020-09-17,Mauritania,14,0,7346,161
2020-09-18,Mauritania,15,0,7361,161
2020-09-19,Mauritania,4,0,7365,161
2020-09-20,Mauritania,3,0,7368,161
2020-09-21,Mauritania,16,0,7384,161
2020-09-22,Mauritania,19,0,7403,161
2020-09-23,Mauritania,22,0,7425,161
2020-09-24,Mauritania,8,0,7433,161
2020-09-25,Mauritania,24,0,7457,161
2020-09-26,Mauritania,5,0,7462,161
2020-09-27,Mauritania,2,0,7464,161
2020-09-28,Mauritania,10,0,7474,161
2020-09-29,Mauritania,14,0,7488,161
2020-09-30,Mauritania,14,0,7502,161
2020-10-01,Mauritania,3,0,7505,161
2020-10-02,Mauritania,6,1,7511,162
2020-10-03,Mauritania,6,0,7517,162
2020-10-04,Mauritania,3,0,7520,162
2020-10-05,Mauritania,3,0,7523,162
2020-10-06,Mauritania,6,0,7529,162
2020-10-07,Mauritania,6,0,7535,162
2020-10-08,Mauritania,5,0,7540,162
2020-10-09,Mauritania,8,1,7548,163
2020-10-10,Mauritania,2,0,7550,163
2020-10-11,Mauritania,0,0,7550,163
2020-10-12,Mauritania,4,0,7554,163
2020-10-13,Mauritania,11,0,7565,163
2020-10-14,Mauritania,7,0,7572,163
2020-10-15,Mauritania,13,0,7585,163
2020-10-16,Mauritania,18,0,7603,163
2020-10-17,Mauritania,4,0,7607,163
2020-10-18,Mauritania,1,0,7608,163
2020-10-19,Mauritania,13,0,7621,163
2020-10-20,Mauritania,13,0,7634,163
2020-10-21,Mauritania,4,0,7638,163
2020-10-22,Mauritania,12,0,7650,163
2020-10-23,Mauritania,12,0,7662,163
2020-10-24,Mauritania,1,0,7663,163
2020-10-25,Mauritania,1,0,7664,163
2020-10-26,Mauritania,13,0,7677,163
2020-10-27,Mauritania,3,0,7680,163
2020-10-28,Mauritania,8,0,7688,163
2020-10-29,Mauritania,12,0,7700,163
2020-10-30,Mauritania,0,0,7700,163
2020-10-31,Mauritania,3,0,7703,163
2020-11-01,Mauritania,1,0,7704,163
2020-11-02,Mauritania,0,0,7704,163
2020-11-03,Mauritania,20,1,7724,164
2020-11-04,Mauritania,20,0,7744,164
2020-11-05,Mauritania,33,1,7777,165
2020-11-06,Mauritania,27,0,7804,165
2020-11-07,Mauritania,10,0,7814,165
2020-11-08,Mauritania,6,0,7820,165
2020-11-09,Mauritania,13,0,7833,165
2020-11-10,Mauritania,15,0,7848,165
2020-11-11,Mauritania,37,0,7885,165
2020-11-12,Mauritania,15,0,7900,165
2020-11-13,Mauritania,32,0,7932,165
2020-11-14,Mauritania,16,0,7948,165
2020-11-15,Mauritania,4,0,7952,165
2020-11-16,Mauritania,27,0,7979,165
2020-11-17,Mauritania,15,0,7994,165
2020-11-18,Mauritania,16,2,8010,167
2020-11-19,Mauritania,24,1,8034,168
2020-11-20,Mauritania,41,1,8075,169
2020-11-21,Mauritania,21,0,8096,169
2020-11-22,Mauritania,32,0,8128,169
2020-11-23,Mauritania,39,0,8167,169
2020-11-24,Mauritania,26,0,8193,169
2020-11-25,Mauritania,53,2,8246,171
2020-11-26,Mauritania,42,0,8288,171
2020-11-27,Mauritania,136,1,8424,172
2020-11-28,Mauritania,34,0,8458,172
2020-11-29,Mauritania,89,3,8547,175
2020-11-30,Mauritania,54,2,8601,177
2020-12-01,Mauritania,109,0,8710,177
2020-12-02,Mauritania,153,2,8863,179
2020-12-03,Mauritania,142,2,9005,181
2020-12-04,Mauritania,176,1,9181,182
2020-12-05,Mauritania,178,2,9359,184
2020-12-06,Mauritania,157,4,9516,188
2020-12-07,Mauritania,163,6,9679,194
2020-12-08,Mauritania,197,3,9876,197
2020-12-09,Mauritania,229,5,10105,202
2020-12-10,Mauritania,163,8,10268,210
2020-12-11,Mauritania,233,0,10501,210
2020-12-12,Mauritania,279,12,10780,222
2020-12-13,Mauritania,191,3,10971,225
2020-12-14,Mauritania,164,3,11135,228
2020-12-15,Mauritania,296,8,11431,236
2020-12-16,Mauritania,198,8,11629,244
2020-12-17,Mauritania,176,10,11805,254
2020-12-18,Mauritania,241,10,12046,264
2020-12-19,Mauritania,232,9,12278,273
2020-12-20,Mauritania,140,8,12418,281
2020-12-21,Mauritania,149,5,12567,286
2020-12-22,Mauritania,178,4,12745,290
2020-12-23,Mauritania,199,7,12944,297
2020-12-24,Mauritania,174,4,13118,301
2020-12-25,Mauritania,146,13,13264,314
2020-12-26,Mauritania,252,7,13516,321
2020-12-27,Mauritania,126,3,13642,324
2020-12-28,Mauritania,136,6,13778,330
2020-12-29,Mauritania,211,4,13989,334
2020-12-30,Mauritania,202,5,14191,339
2020-12-31,Mauritania,173,8,14364,347
2021-01-01,Mauritania,217,2,14581,349
2021-01-02,Mauritania,96,4,14677,353
2021-01-03,Mauritania,117,5,14794,358
2021-01-04,Mauritania,81,2,14875,360
2021-01-05,Mauritania,106,7,14981,367
2021-01-06,Mauritania,130,6,15111,373
2021-01-07,Mauritania,103,5,15214,378
2021-01-08,Mauritania,138,4,15352,382
2021-01-09,Mauritania,77,1,15429,383
2021-01-10,Mauritania,83,1,15512,384
2021-01-11,Mauritania,99,3,15611,387
2021-01-12,Mauritania,96,5,15707,392
2021-01-13,Mauritania,87,3,15794,395
2021-01-14,Mauritania,99,1,15893,396
2021-01-15,Mauritania,70,4,15963,400
2021-01-16,Mauritania,36,1,15999,401
2021-01-17,Mauritania,40,1,16039,402
2021-01-18,Mauritania,42,1,16081,403
2021-01-19,Mauritania,66,2,16147,405
2021-01-20,Mauritania,65,2,16212,407
2021-01-21,Mauritania,54,3,16266,410
2021-01-22,Mauritania,56,3,16322,413
2021-01-23,Mauritania,35,3,16357,416
2021-01-24,Mauritania,40,0,16397,416
2021-01-25,Mauritania,24,1,16421,417
2021-01-26,Mauritania,39,1,16460,418
2021-01-27,Mauritania,46,1,16506,419
2021-01-28,Mauritania,37,2,16543,421
2021-01-29,Mauritania,33,0,16576,421
2021-01-30,Mauritania,32,1,16608,422
2021-01-31,Mauritania,27,0,16635,422
2021-02-01,Mauritania,27,0,16662,422
2021-02-02,Mauritania,27,1,16689,423
2021-02-03,Mauritania,31,1,16720,424
2021-02-04,Mauritania,20,1,16740,425
2021-02-05,Mauritania,37,0,16777,425
2021-02-06,Mauritania,15,0,16792,425
2021-02-07,Mauritania,15,1,16807,426
2021-02-08,Mauritania,20,1,16827,427
2021-02-09,Mauritania,41,0,16868,427
2021-02-10,Mauritania,34,0,16902,427
2021-02-11,Mauritania,23,0,16925,427
2021-02-12,Mauritania,29,0,16954,427
2021-02-13,Mauritania,11,1,16965,428
2021-02-14,Mauritania,9,2,16974,430
2021-02-15,Mauritania,22,0,16996,430
2021-02-16,Mauritania,20,1,17016,431
2021-02-17,Mauritania,25,1,17041,432
2021-02-18,Mauritania,17,1,17058,433
2021-02-19,Mauritania,13,0,17071,433
2021-02-20,Mauritania,12,1,17083,434
2021-02-21,Mauritania,12,0,17095,434
2021-02-22,Mauritania,15,1,17110,435
2021-02-23,Mauritania,20,2,17130,437
2021-02-24,Mauritania,28,2,17158,439
2021-02-25,Mauritania,21,0,17179,439
2021-02-26,Mauritania,8,0,17187,439
2021-02-27,Mauritania,9,1,17196,440
2021-02-28,Mauritania,11,1,17207,441
2021-03-01,Mauritania,10,0,17217,441
2021-03-02,Mauritania,18,0,17235,441
2021-03-03,Mauritania,17,1,17252,442
2021-03-04,Mauritania,15,0,17267,442
2021-03-05,Mauritania,18,0,17285,442
2021-03-06,Mauritania,24,0,17309,442
2021-03-07,Mauritania,13,0,17322,442
2021-03-08,Mauritania,18,0,17340,442
2021-03-09,Mauritania,25,0,17365,442
2021-03-10,Mauritania,20,0,17385,442
2021-03-11,Mauritania,9,0,17394,442
2021-03-12,Mauritania,16,0,17410,442
2021-03-13,Mauritania,14,1,17424,443
2021-03-14,Mauritania,14,1,17438,444
2021-03-15,Mauritania,19,0,17457,444
2021-03-16,Mauritania,30,0,17487,444
2021-03-17,Mauritania,34,1,17521,445
2021-03-18,Mauritania,21,0,17542,445
2021-03-19,Mauritania,28,1,17570,446
2021-03-20,Mauritania,17,0,17587,446
2021-03-21,Mauritania,14,0,17601,446
2021-03-22,Mauritania,29,1,17630,447
2021-03-23,Mauritania,28,0,17658,447
2021-03-24,Mauritania,32,0,17690,447
2021-03-25,Mauritania,22,0,17712,447
2021-03-26,Mauritania,33,1,17745,448
2021-03-27,Mauritania,11,0,17756,448
2021-03-28,Mauritania,15,0,17771,448
2021-03-29,Mauritania,25,1,17796,449
2021-03-30,Mauritania,28,0,17824,449
2021-03-31,Mauritania,23,0,17847,449
2021-04-01,Mauritania,31,0,17878,449
2021-04-02,Mauritania,26,0,17904,449
2021-04-03,Mauritania,13,0,17917,449
2021-04-04,Mauritania,10,0,17927,449
2021-04-05,Mauritania,12,0,17939,449
2021-04-06,Mauritania,16,1,17955,450
2021-04-07,Mauritania,19,0,17974,450
2021-04-08,Mauritania,21,0,17995,450
2020-03-18,Mauritius,3,0,3,0
2020-03-19,Mauritius,0,0,3,0
2020-03-20,Mauritius,9,0,12,0
2020-03-21,Mauritius,2,1,14,1
2020-03-22,Mauritius,14,1,28,2
2020-03-23,Mauritius,8,0,36,2
2020-03-24,Mauritius,6,0,42,2
2020-03-25,Mauritius,6,0,48,2
2020-03-26,Mauritius,33,0,81,2
2020-03-27,Mauritius,13,0,94,2
2020-03-28,Mauritius,8,0,102,2
2020-03-29,Mauritius,5,1,107,3
2020-03-30,Mauritius,21,0,128,3
2020-03-31,Mauritius,15,2,143,5
2020-04-01,Mauritius,18,1,161,6
2020-04-02,Mauritius,8,1,169,7
2020-04-03,Mauritius,17,0,186,7
2020-04-04,Mauritius,10,0,196,7
2020-04-05,Mauritius,31,0,227,7
2020-04-06,Mauritius,17,0,244,7
2020-04-07,Mauritius,24,0,268,7
2020-04-08,Mauritius,5,0,273,7
2020-04-09,Mauritius,41,0,314,7
2020-04-10,Mauritius,4,2,318,9
2020-04-11,Mauritius,1,0,319,9
2020-04-12,Mauritius,5,0,324,9
2020-04-13,Mauritius,0,0,324,9
2020-04-14,Mauritius,0,0,324,9
2020-04-15,Mauritius,0,0,324,9
2020-04-16,Mauritius,0,0,324,9
2020-04-17,Mauritius,0,0,324,9
2020-04-18,Mauritius,1,0,325,9
2020-04-19,Mauritius,3,0,328,9
2020-04-20,Mauritius,0,0,328,9
2020-04-21,Mauritius,0,0,328,9
2020-04-22,Mauritius,1,0,329,9
2020-04-23,Mauritius,2,0,331,9
2020-04-24,Mauritius,0,0,331,9
2020-04-25,Mauritius,0,0,331,9
2020-04-26,Mauritius,1,0,332,9
2020-04-27,Mauritius,2,1,334,10
2020-04-28,Mauritius,0,0,334,10
2020-04-29,Mauritius,-2,0,332,10
2020-04-30,Mauritius,0,0,332,10
2020-05-01,Mauritius,0,0,332,10
2020-05-02,Mauritius,0,0,332,10
2020-05-03,Mauritius,0,0,332,10
2020-05-04,Mauritius,0,0,332,10
2020-05-05,Mauritius,0,0,332,10
2020-05-06,Mauritius,0,0,332,10
2020-05-07,Mauritius,0,0,332,10
2020-05-08,Mauritius,0,0,332,10
2020-05-09,Mauritius,0,0,332,10
2020-05-10,Mauritius,0,0,332,10
2020-05-11,Mauritius,0,0,332,10
2020-05-12,Mauritius,0,0,332,10
2020-05-13,Mauritius,0,0,332,10
2020-05-14,Mauritius,0,0,332,10
2020-05-15,Mauritius,0,0,332,10
2020-05-16,Mauritius,0,0,332,10
2020-05-17,Mauritius,0,0,332,10
2020-05-18,Mauritius,0,0,332,10
2020-05-19,Mauritius,0,0,332,10
2020-05-20,Mauritius,0,0,332,10
2020-05-21,Mauritius,0,0,332,10
2020-05-22,Mauritius,0,0,332,10
2020-05-23,Mauritius,0,0,332,10
2020-05-24,Mauritius,2,0,334,10
2020-05-25,Mauritius,0,0,334,10
2020-05-26,Mauritius,0,0,334,10
2020-05-27,Mauritius,0,0,334,10
2020-05-28,Mauritius,0,0,334,10
2020-05-29,Mauritius,1,0,335,10
2020-05-30,Mauritius,0,0,335,10
2020-05-31,Mauritius,0,0,335,10
2020-06-01,Mauritius,0,0,335,10
2020-06-02,Mauritius,0,0,335,10
2020-06-03,Mauritius,0,0,335,10
2020-06-04,Mauritius,0,0,335,10
2020-06-05,Mauritius,2,0,337,10
2020-06-06,Mauritius,0,0,337,10
2020-06-07,Mauritius,0,0,337,10
2020-06-08,Mauritius,0,0,337,10
2020-06-09,Mauritius,0,0,337,10
2020-06-10,Mauritius,0,0,337,10
2020-06-11,Mauritius,0,0,337,10
2020-06-12,Mauritius,0,0,337,10
2020-06-13,Mauritius,0,0,337,10
2020-06-14,Mauritius,0,0,337,10
2020-06-15,Mauritius,0,0,337,10
2020-06-16,Mauritius,0,0,337,10
2020-06-17,Mauritius,0,0,337,10
2020-06-18,Mauritius,0,0,337,10
2020-06-19,Mauritius,0,0,337,10
2020-06-20,Mauritius,0,0,337,10
2020-06-21,Mauritius,0,0,337,10
2020-06-22,Mauritius,3,0,340,10
2020-06-23,Mauritius,0,0,340,10
2020-06-24,Mauritius,1,0,341,10
2020-06-25,Mauritius,0,0,341,10
2020-06-26,Mauritius,0,0,341,10
2020-06-27,Mauritius,0,0,341,10
2020-06-28,Mauritius,0,0,341,10
2020-06-29,Mauritius,0,0,341,10
2020-06-30,Mauritius,0,0,341,10
2020-07-01,Mauritius,0,0,341,10
2020-07-02,Mauritius,0,0,341,10
2020-07-03,Mauritius,0,0,341,10
2020-07-04,Mauritius,0,0,341,10
2020-07-05,Mauritius,0,0,341,10
2020-07-06,Mauritius,1,0,342,10
2020-07-07,Mauritius,0,0,342,10
2020-07-08,Mauritius,0,0,342,10
2020-07-09,Mauritius,0,0,342,10
2020-07-10,Mauritius,0,0,342,10
2020-07-11,Mauritius,0,0,342,10
2020-07-12,Mauritius,0,0,342,10
2020-07-13,Mauritius,0,0,342,10
2020-07-14,Mauritius,0,0,342,10
2020-07-15,Mauritius,1,0,343,10
2020-07-16,Mauritius,0,0,343,10
2020-07-17,Mauritius,0,0,343,10
2020-07-18,Mauritius,0,0,343,10
2020-07-19,Mauritius,0,0,343,10
2020-07-20,Mauritius,0,0,343,10
2020-07-21,Mauritius,0,0,343,10
2020-07-22,Mauritius,0,0,343,10
2020-07-23,Mauritius,0,0,343,10
2020-07-24,Mauritius,1,0,344,10
2020-07-25,Mauritius,0,0,344,10
2020-07-26,Mauritius,0,0,344,10
2020-07-27,Mauritius,0,0,344,10
2020-07-28,Mauritius,0,0,344,10
2020-07-29,Mauritius,0,0,344,10
2020-07-30,Mauritius,0,0,344,10
2020-07-31,Mauritius,0,0,344,10
2020-08-01,Mauritius,0,0,344,10
2020-08-02,Mauritius,0,0,344,10
2020-08-03,Mauritius,0,0,344,10
2020-08-04,Mauritius,0,0,344,10
2020-08-05,Mauritius,0,0,344,10
2020-08-06,Mauritius,0,0,344,10
2020-08-07,Mauritius,0,0,344,10
2020-08-08,Mauritius,0,0,344,10
2020-08-09,Mauritius,0,0,344,10
2020-08-10,Mauritius,0,0,344,10
2020-08-11,Mauritius,0,0,344,10
2020-08-12,Mauritius,0,0,344,10
2020-08-13,Mauritius,0,0,344,10
2020-08-14,Mauritius,1,0,345,10
2020-08-15,Mauritius,1,0,346,10
2020-08-16,Mauritius,0,0,346,10
2020-08-17,Mauritius,0,0,346,10
2020-08-18,Mauritius,0,0,346,10
2020-08-19,Mauritius,0,0,346,10
2020-08-20,Mauritius,0,0,346,10
2020-08-21,Mauritius,0,0,346,10
2020-08-22,Mauritius,0,0,346,10
2020-08-23,Mauritius,0,0,346,10
2020-08-24,Mauritius,1,0,347,10
2020-08-25,Mauritius,1,0,348,10
2020-08-26,Mauritius,0,0,348,10
2020-08-27,Mauritius,7,0,355,10
2020-08-28,Mauritius,0,0,355,10
2020-08-29,Mauritius,0,0,355,10
2020-08-30,Mauritius,0,0,355,10
2020-08-31,Mauritius,1,0,356,10
2020-09-01,Mauritius,0,0,356,10
2020-09-02,Mauritius,0,0,356,10
2020-09-03,Mauritius,0,0,356,10
2020-09-04,Mauritius,0,0,356,10
2020-09-05,Mauritius,0,0,356,10
2020-09-06,Mauritius,0,0,356,10
2020-09-07,Mauritius,0,0,356,10
2020-09-08,Mauritius,5,0,361,10
2020-09-09,Mauritius,0,0,361,10
2020-09-10,Mauritius,0,0,361,10
2020-09-11,Mauritius,0,0,361,10
2020-09-12,Mauritius,0,0,361,10
2020-09-13,Mauritius,0,0,361,10
2020-09-14,Mauritius,0,0,361,10
2020-09-15,Mauritius,4,0,365,10
2020-09-16,Mauritius,0,0,365,10
2020-09-17,Mauritius,1,0,366,10
2020-09-18,Mauritius,0,0,366,10
2020-09-19,Mauritius,0,0,366,10
2020-09-20,Mauritius,0,0,366,10
2020-09-21,Mauritius,0,0,366,10
2020-09-22,Mauritius,1,0,367,10
2020-09-23,Mauritius,0,0,367,10
2020-09-24,Mauritius,0,0,367,10
2020-09-25,Mauritius,0,0,367,10
2020-09-26,Mauritius,0,0,367,10
2020-09-27,Mauritius,0,0,367,10
2020-09-28,Mauritius,0,0,367,10
2020-09-29,Mauritius,0,0,367,10
2020-09-30,Mauritius,14,0,381,10
2020-10-01,Mauritius,0,0,381,10
2020-10-02,Mauritius,4,0,385,10
2020-10-03,Mauritius,0,0,385,10
2020-10-04,Mauritius,0,0,385,10
2020-10-05,Mauritius,2,0,387,10
2020-10-06,Mauritius,8,0,395,10
2020-10-07,Mauritius,0,0,395,10
2020-10-08,Mauritius,0,0,395,10
2020-10-09,Mauritius,0,0,395,10
2020-10-10,Mauritius,0,0,395,10
2020-10-11,Mauritius,0,0,395,10
2020-10-12,Mauritius,9,0,404,10
2020-10-13,Mauritius,3,0,407,10
2020-10-14,Mauritius,0,0,407,10
2020-10-15,Mauritius,8,0,415,10
2020-10-16,Mauritius,2,0,417,10
2020-10-17,Mauritius,0,0,417,10
2020-10-18,Mauritius,0,0,417,10
2020-10-19,Mauritius,2,0,419,10
2020-10-20,Mauritius,0,0,419,10
2020-10-21,Mauritius,0,0,419,10
2020-10-22,Mauritius,6,0,425,10
2020-10-23,Mauritius,10,0,435,10
2020-10-24,Mauritius,0,0,435,10
2020-10-25,Mauritius,0,0,435,10
2020-10-26,Mauritius,4,0,439,10
2020-10-27,Mauritius,0,0,439,10
2020-10-28,Mauritius,0,0,439,10
2020-10-29,Mauritius,0,0,439,10
2020-10-30,Mauritius,2,0,441,10
2020-10-31,Mauritius,0,0,441,10
2020-11-01,Mauritius,5,0,446,10
2020-11-02,Mauritius,5,0,451,10
2020-11-03,Mauritius,0,0,451,10
2020-11-04,Mauritius,1,0,452,10
2020-11-05,Mauritius,1,0,453,10
2020-11-06,Mauritius,0,0,453,10
2020-11-07,Mauritius,0,0,453,10
2020-11-08,Mauritius,0,0,453,10
2020-11-09,Mauritius,0,0,453,10
2020-11-10,Mauritius,0,0,453,10
2020-11-11,Mauritius,0,0,453,10
2020-11-12,Mauritius,15,0,468,10
2020-11-13,Mauritius,2,0,470,10
2020-11-14,Mauritius,0,0,470,10
2020-11-15,Mauritius,8,0,478,10
2020-11-16,Mauritius,13,0,491,10
2020-11-17,Mauritius,0,0,491,10
2020-11-18,Mauritius,3,0,494,10
2020-11-19,Mauritius,0,0,494,10
2020-11-20,Mauritius,0,0,494,10
2020-11-21,Mauritius,0,0,494,10
2020-11-22,Mauritius,0,0,494,10
2020-11-23,Mauritius,0,0,494,10
2020-11-24,Mauritius,0,0,494,10
2020-11-25,Mauritius,3,0,497,10
2020-11-26,Mauritius,1,0,498,10
2020-11-27,Mauritius,3,0,501,10
2020-11-28,Mauritius,0,0,501,10
2020-11-29,Mauritius,0,0,501,10
2020-11-30,Mauritius,3,0,504,10
2020-12-01,Mauritius,1,0,505,10
2020-12-02,Mauritius,3,0,508,10
2020-12-03,Mauritius,0,0,508,10
2020-12-04,Mauritius,0,0,508,10
2020-12-05,Mauritius,0,0,508,10
2020-12-06,Mauritius,0,0,508,10
2020-12-07,Mauritius,3,0,511,10
2020-12-08,Mauritius,4,0,515,10
2020-12-09,Mauritius,0,0,515,10
2020-12-10,Mauritius,0,0,515,10
2020-12-11,Mauritius,0,0,515,10
2020-12-12,Mauritius,0,0,515,10
2020-12-13,Mauritius,0,0,515,10
2020-12-14,Mauritius,8,0,523,10
2020-12-15,Mauritius,1,0,524,10
2020-12-16,Mauritius,0,0,524,10
2020-12-17,Mauritius,0,0,524,10
2020-12-18,Mauritius,0,0,524,10
2020-12-19,Mauritius,0,0,524,10
2020-12-20,Mauritius,0,0,524,10
2020-12-21,Mauritius,0,0,524,10
2020-12-22,Mauritius,2,0,526,10
2020-12-23,Mauritius,1,0,527,10
2020-12-24,Mauritius,0,0,527,10
2020-12-25,Mauritius,0,0,527,10
2020-12-26,Mauritius,0,0,527,10
2020-12-27,Mauritius,0,0,527,10
2020-12-28,Mauritius,0,0,527,10
2020-12-29,Mauritius,0,0,527,10
2020-12-30,Mauritius,0,0,527,10
2020-12-31,Mauritius,0,0,527,10
2021-01-01,Mauritius,0,0,527,10
2021-01-02,Mauritius,0,0,527,10
2021-01-03,Mauritius,0,0,527,10
2021-01-04,Mauritius,4,0,531,10
2021-01-05,Mauritius,0,0,531,10
2021-01-06,Mauritius,8,0,539,10
2021-01-07,Mauritius,0,0,539,10
2021-01-08,Mauritius,0,0,539,10
2021-01-09,Mauritius,0,0,539,10
2021-01-10,Mauritius,0,0,539,10
2021-01-11,Mauritius,6,0,545,10
2021-01-12,Mauritius,1,0,546,10
2021-01-13,Mauritius,1,0,547,10
2021-01-14,Mauritius,0,0,547,10
2021-01-15,Mauritius,0,0,547,10
2021-01-16,Mauritius,0,0,547,10
2021-01-17,Mauritius,0,0,547,10
2021-01-18,Mauritius,9,0,556,10
2021-01-19,Mauritius,0,0,556,10
2021-01-20,Mauritius,0,0,556,10
2021-01-21,Mauritius,0,0,556,10
2021-01-22,Mauritius,0,0,556,10
2021-01-23,Mauritius,0,0,556,10
2021-01-24,Mauritius,0,0,556,10
2021-01-25,Mauritius,12,0,568,10
2021-01-26,Mauritius,0,0,568,10
2021-01-27,Mauritius,1,0,569,10
2021-01-28,Mauritius,0,0,569,10
2021-01-29,Mauritius,0,0,569,10
2021-01-30,Mauritius,0,0,569,10
2021-01-31,Mauritius,0,0,569,10
2021-02-01,Mauritius,13,0,582,10
2021-02-02,Mauritius,1,0,583,10
2021-02-03,Mauritius,1,0,584,10
2021-02-04,Mauritius,0,0,584,10
2021-02-05,Mauritius,0,0,584,10
2021-02-06,Mauritius,0,0,584,10
2021-02-07,Mauritius,0,0,584,10
2021-02-08,Mauritius,9,0,593,10
2021-02-09,Mauritius,1,0,594,10
2021-02-10,Mauritius,1,0,595,10
2021-02-11,Mauritius,0,0,595,10
2021-02-12,Mauritius,0,0,595,10
2021-02-13,Mauritius,0,0,595,10
2021-02-14,Mauritius,0,0,595,10
2021-02-15,Mauritius,6,0,601,10
2021-02-16,Mauritius,2,0,603,10
2021-02-17,Mauritius,0,0,603,10
2021-02-18,Mauritius,0,0,603,10
2021-02-19,Mauritius,0,0,603,10
2021-02-20,Mauritius,0,0,603,10
2021-02-21,Mauritius,0,0,603,10
2021-02-22,Mauritius,0,0,603,10
2021-02-23,Mauritius,7,0,610,10
2021-02-24,Mauritius,0,0,610,10
2021-02-25,Mauritius,0,0,610,10
2021-02-26,Mauritius,0,0,610,10
2021-02-27,Mauritius,0,0,610,10
2021-02-28,Mauritius,0,0,610,10
2021-03-01,Mauritius,9,0,619,10
2021-03-02,Mauritius,0,0,619,10
2021-03-03,Mauritius,0,0,619,10
2021-03-04,Mauritius,1,0,620,10
2021-03-05,Mauritius,5,0,625,10
2021-03-06,Mauritius,14,0,639,10
2021-03-07,Mauritius,2,0,641,10
2021-03-08,Mauritius,0,0,641,10
2021-03-09,Mauritius,0,0,641,10
2021-03-10,Mauritius,0,0,641,10
2021-03-11,Mauritius,23,0,664,10
2021-03-12,Mauritius,47,0,711,10
2021-03-13,Mauritius,28,0,739,10
2021-03-14,Mauritius,3,0,742,10
2021-03-15,Mauritius,5,0,747,10
2021-03-16,Mauritius,11,0,758,10
2021-03-17,Mauritius,4,0,762,10
2021-03-18,Mauritius,6,0,768,10
2021-03-19,Mauritius,25,0,793,10
2021-03-20,Mauritius,3,0,796,10
2021-03-21,Mauritius,9,0,805,10
2021-03-22,Mauritius,4,0,809,10
2021-03-23,Mauritius,17,0,826,10
2021-03-24,Mauritius,24,0,850,10
2021-03-25,Mauritius,3,0,853,10
2021-03-26,Mauritius,18,0,871,10
2021-03-27,Mauritius,0,0,871,10
2021-03-28,Mauritius,62,0,933,10
2021-03-29,Mauritius,25,0,958,10
2021-03-30,Mauritius,38,0,996,10
2021-03-31,Mauritius,32,2,1028,12
2021-04-01,Mauritius,11,0,1039,12
2021-04-02,Mauritius,56,0,1095,12
2021-04-03,Mauritius,9,0,1104,12
2021-04-04,Mauritius,8,0,1112,12
2021-04-05,Mauritius,9,0,1121,12
2021-04-06,Mauritius,9,0,1130,12
2021-04-07,Mauritius,37,0,1167,12
2021-04-08,Mauritius,4,0,1171,12
2020-02-28,Mexico,1,0,1,0
2020-02-29,Mexico,3,0,4,0
2020-03-01,Mexico,1,0,5,0
2020-03-02,Mexico,0,0,5,0
2020-03-03,Mexico,0,0,5,0
2020-03-04,Mexico,0,0,5,0
2020-03-05,Mexico,0,0,5,0
2020-03-06,Mexico,1,0,6,0
2020-03-07,Mexico,0,0,6,0
2020-03-08,Mexico,1,0,7,0
2020-03-09,Mexico,0,0,7,0
2020-03-10,Mexico,0,0,7,0
2020-03-11,Mexico,1,0,8,0
2020-03-12,Mexico,4,0,12,0
2020-03-13,Mexico,14,0,26,0
2020-03-14,Mexico,15,0,41,0
2020-03-15,Mexico,12,0,53,0
2020-03-16,Mexico,29,0,82,0
2020-03-17,Mexico,11,0,93,0
2020-03-18,Mexico,25,0,118,0
2020-03-19,Mexico,46,1,164,1
2020-03-20,Mexico,39,1,203,2
2020-03-21,Mexico,48,0,251,2
2020-03-22,Mexico,65,1,316,3
2020-03-23,Mexico,51,1,367,4
2020-03-24,Mexico,38,1,405,5
2020-03-25,Mexico,70,1,475,6
2020-03-26,Mexico,110,2,585,8
2020-03-27,Mexico,132,4,717,12
2020-03-28,Mexico,131,4,848,16
2020-03-29,Mexico,145,4,993,20
2020-03-30,Mexico,101,8,1094,28
2020-03-31,Mexico,121,1,1215,29
2020-04-01,Mexico,163,8,1378,37
2020-04-02,Mexico,132,13,1510,50
2020-04-03,Mexico,178,10,1688,60
2020-04-04,Mexico,202,19,1890,79
2020-04-05,Mexico,253,15,2143,94
2020-04-06,Mexico,296,31,2439,125
2020-04-07,Mexico,346,16,2785,141
2020-04-08,Mexico,396,33,3181,174
2020-04-09,Mexico,260,20,3441,194
2020-04-10,Mexico,403,39,3844,233
2020-04-11,Mexico,375,40,4219,273
2020-04-12,Mexico,442,23,4661,296
2020-04-13,Mexico,353,36,5014,332
2020-04-14,Mexico,385,74,5399,406
2020-04-15,Mexico,448,43,5847,449
2020-04-16,Mexico,450,37,6297,486
2020-04-17,Mexico,578,60,6875,546
2020-04-18,Mexico,622,104,7497,650
2020-04-19,Mexico,764,36,8261,686
2020-04-20,Mexico,511,26,8772,712
2020-04-21,Mexico,729,145,9501,857
2020-04-22,Mexico,1043,113,10544,970
2020-04-23,Mexico,1089,99,11633,1069
2020-04-24,Mexico,1239,152,12872,1221
2020-04-25,Mexico,970,84,13842,1305
2020-04-26,Mexico,835,46,14677,1351
2020-04-27,Mexico,852,83,15529,1434
2020-04-28,Mexico,1223,135,16752,1569
2020-04-29,Mexico,1047,163,17799,1732
2020-04-30,Mexico,1425,127,19224,1859
2020-05-01,Mexico,1515,113,20739,1972
2020-05-02,Mexico,1349,89,22088,2061
2020-05-03,Mexico,1383,93,23471,2154
2020-05-04,Mexico,1434,117,24905,2271
2020-05-05,Mexico,1120,236,26025,2507
2020-05-06,Mexico,1609,197,27634,2704
2020-05-07,Mexico,1982,257,29616,2961
2020-05-08,Mexico,1906,199,31522,3160
2020-05-09,Mexico,1938,193,33460,3353
2020-05-10,Mexico,1562,112,35022,3465
2020-05-11,Mexico,1305,108,36327,3573
2020-05-12,Mexico,1997,353,38324,3926
2020-05-13,Mexico,1862,294,40186,4220
2020-05-14,Mexico,2409,257,42595,4477
2020-05-15,Mexico,2437,290,45032,4767
2020-05-16,Mexico,2112,278,47144,5045
2020-05-17,Mexico,2075,132,49219,5177
2020-05-18,Mexico,2414,155,51633,5332
2020-05-19,Mexico,2713,334,54346,5666
2020-05-20,Mexico,2248,424,56594,6090
2020-05-21,Mexico,2973,420,59567,6510
2020-05-22,Mexico,2960,479,62527,6989
2020-05-23,Mexico,3329,190,65856,7179
2020-05-24,Mexico,2764,215,68620,7394
2020-05-25,Mexico,2485,239,71105,7633
2020-05-26,Mexico,3455,501,74560,8134
2020-05-27,Mexico,3463,463,78023,8597
2020-05-28,Mexico,3377,447,81400,9044
2020-05-29,Mexico,3227,371,84627,9415
2020-05-30,Mexico,2885,364,87512,9779
2020-05-31,Mexico,3152,151,90664,9930
2020-06-01,Mexico,2771,237,93435,10167
2020-06-02,Mexico,3891,470,97326,10637
2020-06-03,Mexico,3912,1092,101238,11729
2020-06-04,Mexico,4442,816,105680,12545
2020-06-05,Mexico,4346,625,110026,13170
2020-06-06,Mexico,3593,341,113619,13511
2020-06-07,Mexico,3484,188,117103,13699
2020-06-08,Mexico,2999,354,120102,14053
2020-06-09,Mexico,4199,596,124301,14649
2020-06-10,Mexico,4883,708,129184,15357
2020-06-11,Mexico,4790,587,133974,15944
2020-06-12,Mexico,5222,504,139196,16448
2020-06-13,Mexico,3494,424,142690,16872
2020-06-14,Mexico,4147,269,146837,17141
2020-06-15,Mexico,3427,439,150264,17580
2020-06-16,Mexico,4599,730,154863,18310
2020-06-17,Mexico,4930,770,159793,19080
2020-06-18,Mexico,5662,667,165455,19747
2020-06-19,Mexico,5030,647,170485,20394
2020-06-20,Mexico,4717,387,175202,20781
2020-06-21,Mexico,5343,1044,180545,21825
2020-06-22,Mexico,4577,759,185122,22584
2020-06-23,Mexico,6288,793,191410,23377
2020-06-24,Mexico,5437,947,196847,24324
2020-06-25,Mexico,6104,736,202951,25060
2020-06-26,Mexico,5441,719,208392,25779
2020-06-27,Mexico,4410,602,212802,26381
2020-06-28,Mexico,4050,267,216852,26648
2020-06-29,Mexico,3805,473,220657,27121
2020-06-30,Mexico,5432,648,226089,27769
2020-07-01,Mexico,5681,741,231770,28510
2020-07-02,Mexico,6741,679,238511,29189
2020-07-03,Mexico,6740,654,245251,29843
2020-07-04,Mexico,6914,523,252165,30366
2020-07-05,Mexico,4683,273,256848,30639
2020-07-06,Mexico,4902,480,261750,31119
2020-07-07,Mexico,6258,895,268008,32014
2020-07-08,Mexico,6995,782,275003,32796
2020-07-09,Mexico,7280,730,282283,33526
2020-07-10,Mexico,6891,665,289174,34191
2020-07-11,Mexico,6094,539,295268,34730
2020-07-12,Mexico,4482,276,299750,35006
2020-07-13,Mexico,4685,485,304435,35491
2020-07-14,Mexico,7051,836,311486,36327
2020-07-15,Mexico,6149,579,317635,36906
2020-07-16,Mexico,6406,668,324041,37574
2020-07-17,Mexico,7257,736,331298,38310
2020-07-18,Mexico,7615,578,338913,38888
2020-07-19,Mexico,5311,296,344224,39184
2020-07-20,Mexico,5172,301,349396,39485
2020-07-21,Mexico,6859,915,356255,40400
2020-07-22,Mexico,6019,790,362274,41190
2020-07-23,Mexico,8438,718,370712,41908
2020-07-24,Mexico,7573,737,378285,42645
2020-07-25,Mexico,6751,729,385036,43374
2020-07-26,Mexico,5480,306,390516,43680
2020-07-27,Mexico,4973,342,395489,44022
2020-07-28,Mexico,7208,854,402697,44876
2020-07-29,Mexico,5752,485,408449,45361
2020-07-30,Mexico,7730,639,416179,46000
2020-07-31,Mexico,8458,688,424637,46688
2020-08-01,Mexico,9556,784,434193,47472
2020-08-02,Mexico,4853,274,439046,47746
2020-08-03,Mexico,4767,266,443813,48012
2020-08-04,Mexico,6148,857,449961,48869
2020-08-05,Mexico,6139,829,456100,49698
2020-08-06,Mexico,6590,819,462690,50517
2020-08-07,Mexico,6717,794,469407,51311
2020-08-08,Mexico,6495,695,475902,52006
2020-08-09,Mexico,4376,292,480278,52298
2020-08-10,Mexico,5558,705,485836,53003
2020-08-11,Mexico,6686,926,492522,53929
2020-08-12,Mexico,5858,737,498380,54666
2020-08-13,Mexico,7371,627,505751,55293
2020-08-14,Mexico,5618,615,511369,55908
2020-08-15,Mexico,6345,635,517714,56543
2020-08-16,Mexico,4448,214,522162,56757
2020-08-17,Mexico,3571,266,525733,57023
2020-08-18,Mexico,5506,751,531239,57774
2020-08-19,Mexico,5792,707,537031,58481
2020-08-20,Mexico,6775,625,543806,59106
2020-08-21,Mexico,5928,504,549734,59610
2020-08-22,Mexico,6482,644,556216,60254
2020-08-23,Mexico,3948,226,560164,60480
2020-08-24,Mexico,3541,320,563705,60800
2020-08-25,Mexico,4916,650,568621,61450
2020-08-26,Mexico,5267,626,573888,62076
2020-08-27,Mexico,6026,518,579914,62594
2020-08-28,Mexico,5824,552,585738,63146
2020-08-29,Mexico,5974,673,591712,63819
2020-08-30,Mexico,4129,339,595841,64158
2020-08-31,Mexico,3719,256,599560,64414
2020-09-01,Mexico,6476,827,606036,65241
2020-09-02,Mexico,4921,575,610957,65816
2020-09-03,Mexico,5937,513,616894,66329
2020-09-04,Mexico,6196,522,623090,66851
2020-09-05,Mexico,6319,475,629409,67326
2020-09-06,Mexico,4614,232,634023,67558
2020-09-07,Mexico,3486,223,637509,67781
2020-09-08,Mexico,5351,703,642860,68484
2020-09-09,Mexico,4461,565,647321,69049
2020-09-10,Mexico,5043,600,652364,69649
2020-09-11,Mexico,5935,534,658299,70183
2020-09-12,Mexico,5674,421,663973,70604
2020-09-13,Mexico,4408,217,668381,70821
2020-09-14,Mexico,3335,228,671716,71049
2020-09-15,Mexico,4771,629,676487,71678
2020-09-16,Mexico,4444,300,680931,71978
2020-09-17,Mexico,3182,201,684113,72179
2020-09-18,Mexico,4841,624,688954,72803
2020-09-19,Mexico,5167,455,694121,73258
2020-09-20,Mexico,3542,235,697663,73493
2020-09-21,Mexico,2917,204,700580,73697
2020-09-22,Mexico,4683,651,705263,74348
2020-09-23,Mexico,4786,601,710049,74949
2020-09-24,Mexico,5408,490,715457,75439
2020-09-25,Mexico,5401,405,720858,75844
2020-09-26,Mexico,5573,399,726431,76243
2020-09-27,Mexico,3886,187,730317,76430
2020-09-28,Mexico,3400,173,733717,76603
2020-09-29,Mexico,4446,560,738163,77163
2020-09-30,Mexico,5053,483,743216,77646
2020-10-01,Mexico,5099,432,748315,78078
2020-10-02,Mexico,4775,414,753090,78492
2020-10-03,Mexico,4863,388,757953,78880
2020-10-04,Mexico,3712,208,761665,79088
2020-10-05,Mexico,28115,2789,789780,81877
2020-10-06,Mexico,4828,471,794608,82348
2020-10-07,Mexico,4580,378,799188,82726
2020-10-08,Mexico,5300,370,804488,83096
2020-10-09,Mexico,5532,401,810020,83497
2020-10-10,Mexico,4308,145,814328,83642
2020-10-11,Mexico,3175,139,817503,83781
2020-10-12,Mexico,3542,164,821045,83945
2020-10-13,Mexico,4295,475,825340,84420
2020-10-14,Mexico,4056,478,829396,84898
2020-10-15,Mexico,5514,387,834910,85285
2020-10-16,Mexico,6751,419,841661,85704
2020-10-17,Mexico,5447,355,847108,86059
2020-10-18,Mexico,4119,108,851227,86167
2020-10-19,Mexico,3699,171,854926,86338
2020-10-20,Mexico,5788,555,860714,86893
2020-10-21,Mexico,6845,522,867559,87415
2020-10-22,Mexico,6612,0,874171,87415
2020-10-23,Mexico,6604,897,880775,88312
2020-10-24,Mexico,6025,431,886800,88743
2020-10-25,Mexico,4360,181,891160,88924
2020-10-26,Mexico,4166,247,895326,89171
2020-10-27,Mexico,5942,643,901268,89814
2020-10-28,Mexico,5595,495,906863,90309
2020-10-29,Mexico,5948,464,912811,90773
2020-10-30,Mexico,6000,516,918811,91289
2020-10-31,Mexico,6151,464,924962,91753
2020-11-01,Mexico,4430,142,929392,91895
2020-11-02,Mexico,3763,205,933155,92100
2020-11-03,Mexico,5250,493,938405,92593
2020-11-04,Mexico,5225,635,943630,93228
2020-11-05,Mexico,5567,544,949197,93772
2020-11-06,Mexico,5931,551,955128,94323
2020-11-07,Mexico,6810,485,961938,94808
2020-11-08,Mexico,5887,219,967825,95027
2020-11-09,Mexico,4960,198,972785,95225
2020-11-10,Mexico,5746,617,978531,95842
2020-11-11,Mexico,7646,588,986177,96430
2020-11-12,Mexico,5658,626,991835,97056
2020-11-13,Mexico,5558,568,997393,97624
2020-11-14,Mexico,5860,635,1003253,98259
2020-11-15,Mexico,3269,283,1006522,98542
2020-11-16,Mexico,2874,319,1009396,98861
2020-11-17,Mexico,1757,165,1011153,99026
2020-11-18,Mexico,3918,502,1015071,99528
2020-11-19,Mexico,4472,576,1019543,100104
2020-11-20,Mexico,6426,719,1025969,100823
2020-11-21,Mexico,6719,550,1032688,101373
2020-11-22,Mexico,9187,303,1041875,101676
2020-11-23,Mexico,7483,250,1049358,101926
2020-11-24,Mexico,10794,813,1060152,102739
2020-11-25,Mexico,10335,858,1070487,103597
2020-11-26,Mexico,8107,645,1078594,104242
2020-11-27,Mexico,12081,631,1090675,104873
2020-11-28,Mexico,10728,586,1101403,105459
2020-11-29,Mexico,5668,196,1107071,105655
2020-11-30,Mexico,6472,285,1113543,105940
2020-12-01,Mexico,8819,825,1122362,106765
2020-12-02,Mexico,11251,800,1133613,107565
2020-12-03,Mexico,11030,608,1144643,108173
2020-12-04,Mexico,12127,690,1156770,108863
2020-12-05,Mexico,11625,593,1168395,109456
2020-12-06,Mexico,7455,261,1175850,109717
2020-12-07,Mexico,6399,357,1182249,110074
2020-12-08,Mexico,11006,800,1193255,110874
2020-12-09,Mexico,11974,781,1205229,111655
2020-12-10,Mexico,11897,671,1217126,112326
2020-12-11,Mexico,12253,693,1229379,113019
2020-12-12,Mexico,12057,685,1241436,113704
2020-12-13,Mexico,8608,249,1250044,113953
2020-12-14,Mexico,5930,345,1255974,114298
2020-12-15,Mexico,11228,801,1267202,115099
2020-12-16,Mexico,10297,670,1277499,115769
2020-12-17,Mexico,11799,718,1289298,116487
2020-12-18,Mexico,12248,762,1301546,117249
2020-12-19,Mexico,12129,627,1313675,117876
2020-12-20,Mexico,6870,326,1320545,118202
2020-12-21,Mexico,5370,396,1325915,118598
2020-12-22,Mexico,12511,897,1338426,119495
2020-12-23,Mexico,11653,816,1350079,120311
2020-12-24,Mexico,12485,861,1362564,121172
2020-12-25,Mexico,9679,665,1372243,121837
2020-12-26,Mexico,4974,189,1377217,122026
2020-12-27,Mexico,6217,400,1383434,122426
2020-12-28,Mexico,5996,429,1389430,122855
2020-12-29,Mexico,12099,990,1401529,123845
2020-12-30,Mexico,12406,1052,1413935,124897
2020-12-31,Mexico,12159,910,1426094,125807
2021-01-01,Mexico,11091,700,1437185,126507
2021-01-02,Mexico,6359,344,1443544,126851
2021-01-03,Mexico,5211,362,1448755,127213
2021-01-04,Mexico,6464,544,1455219,127757
2021-01-05,Mexico,11271,1065,1466490,128822
2021-01-06,Mexico,13345,1165,1479835,129987
2021-01-07,Mexico,13734,1044,1493569,131031
2021-01-08,Mexico,14362,1038,1507931,132069
2021-01-09,Mexico,16105,1135,1524036,133204
2021-01-10,Mexico,10003,502,1534039,133706
2021-01-11,Mexico,7594,662,1541633,134368
2021-01-12,Mexico,14395,1314,1556028,135682
2021-01-13,Mexico,15873,1235,1571901,136917
2021-01-14,Mexico,16468,999,1588369,137916
2021-01-15,Mexico,21366,1106,1609735,139022
2021-01-16,Mexico,20523,1219,1630258,140241
2021-01-17,Mexico,11170,463,1641428,140704
2021-01-18,Mexico,8074,544,1649502,141248
2021-01-19,Mexico,18894,1584,1668396,142832
2021-01-20,Mexico,20548,1539,1688944,144371
2021-01-21,Mexico,22339,1803,1711283,146174
2021-01-22,Mexico,21007,1440,1732290,147614
2021-01-23,Mexico,20057,1470,1752347,149084
2021-01-24,Mexico,10872,530,1763219,149614
2021-01-25,Mexico,8521,659,1771740,150273
2021-01-26,Mexico,17165,1743,1788905,152016
2021-01-27,Mexico,17944,1623,1806849,153639
2021-01-28,Mexico,18670,1506,1825519,155145
2021-01-29,Mexico,16374,1434,1841893,156579
2021-01-30,Mexico,15337,1495,1857230,158074
2021-01-31,Mexico,7030,462,1864260,158536
2021-02-01,Mexico,5448,564,1869708,159100
2021-02-02,Mexico,4384,433,1874092,159533
2021-02-03,Mexico,12153,1707,1886245,161240
2021-02-04,Mexico,0,0,1886245,161240
2021-02-05,Mexico,26626,3050,1912871,164290
2021-02-06,Mexico,13209,1496,1926080,165786
2021-02-07,Mexico,6065,414,1932145,166200
2021-02-08,Mexico,3868,531,1936013,166731
2021-02-09,Mexico,10738,1701,1946751,168432
2021-02-10,Mexico,11138,1328,1957889,169760
2021-02-11,Mexico,10677,1474,1968566,171234
2021-02-12,Mexico,10388,1323,1978954,172557
2021-02-13,Mexico,9741,1214,1988695,173771
2021-02-14,Mexico,4099,436,1992794,174207
2021-02-15,Mexico,3098,450,1995892,174657
2021-02-16,Mexico,8683,1329,2004575,175986
2021-02-17,Mexico,8988,1075,2013563,177061
2021-02-18,Mexico,9099,1047,2022662,178108
2021-02-19,Mexico,7829,857,2030491,178965
2021-02-20,Mexico,7785,832,2038276,179797
2021-02-21,Mexico,3104,310,2041380,180107
2021-02-22,Mexico,2252,429,2043632,180536
2021-02-23,Mexico,8634,1273,2052266,181809
2021-02-24,Mexico,8642,1006,2060908,182815
2021-02-25,Mexico,8462,877,2069370,183692
2021-02-26,Mexico,7512,782,2076882,184474
2021-02-27,Mexico,7246,783,2084128,185257
2021-02-28,Mexico,2810,458,2086938,185715
2021-03-01,Mexico,2343,437,2089281,186152
2021-03-02,Mexico,7913,1035,2097194,187187
2021-03-03,Mexico,7793,857,2104987,188044
2021-03-04,Mexico,7521,822,2112508,188866
2021-03-05,Mexico,6797,712,2119305,189578
2021-03-06,Mexico,6561,779,2125866,190357
2021-03-07,Mexico,2734,247,2128600,190604
2021-03-08,Mexico,1877,319,2130477,190923
2021-03-09,Mexico,7407,866,2137884,191789
2021-03-10,Mexico,6602,702,2144486,192491
2021-03-11,Mexico,6469,661,2150955,193152
2021-03-12,Mexico,6816,699,2157771,193851
2021-03-13,Mexico,6104,639,2163875,194490
2021-03-14,Mexico,2415,220,2166290,194710
2021-03-15,Mexico,1439,234,2167729,194944
2021-03-16,Mexico,1278,175,2169007,195119
2021-03-17,Mexico,6455,789,2175462,195908
2021-03-18,Mexico,6726,698,2182188,196606
2021-03-19,Mexico,5722,613,2187910,197219
2021-03-20,Mexico,5729,608,2193639,197827
2021-03-21,Mexico,2133,209,2195772,198036
2021-03-22,Mexico,1388,203,2197160,198239
2021-03-23,Mexico,5881,809,2203041,199048
2021-03-24,Mexico,5714,579,2208755,199627
2021-03-25,Mexico,5787,584,2214542,200211
2021-03-26,Mexico,5303,651,2219845,200862
2021-03-27,Mexico,5059,567,2224904,201429
2021-03-28,Mexico,1646,194,2226550,201623
2021-03-29,Mexico,1293,209,2227843,201832
2021-03-30,Mexico,5067,801,2232910,202633
2021-03-31,Mexico,5977,577,2238887,203210
2021-04-01,Mexico,5381,454,2244268,203664
2021-04-02,Mexico,3089,190,2247357,203854
2021-04-03,Mexico,1838,157,2249195,204011
2021-04-04,Mexico,1263,136,2250458,204147
2021-04-05,Mexico,1247,252,2251705,204399
2021-04-06,Mexico,4804,586,2256509,204985
2021-04-07,Mexico,5370,613,2261879,205598
2021-04-08,Mexico,5140,548,2267019,206146
2021-01-21,Micronesia (country),1,0,1,0
2021-01-22,Micronesia (country),0,0,1,0
2021-01-23,Micronesia (country),0,0,1,0
2021-01-24,Micronesia (country),0,0,1,0
2021-01-25,Micronesia (country),0,0,1,0
2021-01-26,Micronesia (country),0,0,1,0
2021-01-27,Micronesia (country),0,0,1,0
2021-01-28,Micronesia (country),0,0,1,0
2021-01-29,Micronesia (country),0,0,1,0
2021-01-30,Micronesia (country),0,0,1,0
2021-01-31,Micronesia (country),0,0,1,0
2021-02-01,Micronesia (country),0,0,1,0
2021-02-02,Micronesia (country),0,0,1,0
2021-02-03,Micronesia (country),0,0,1,0
2021-02-04,Micronesia (country),0,0,1,0
2021-02-05,Micronesia (country),0,0,1,0
2021-02-06,Micronesia (country),0,0,1,0
2021-02-07,Micronesia (country),0,0,1,0
2021-02-08,Micronesia (country),0,0,1,0
2021-02-09,Micronesia (country),0,0,1,0
2021-02-10,Micronesia (country),0,0,1,0
2021-02-11,Micronesia (country),0,0,1,0
2021-02-12,Micronesia (country),0,0,1,0
2021-02-13,Micronesia (country),0,0,1,0
2021-02-14,Micronesia (country),0,0,1,0
2021-02-15,Micronesia (country),0,0,1,0
2021-02-16,Micronesia (country),0,0,1,0
2021-02-17,Micronesia (country),0,0,1,0
2021-02-18,Micronesia (country),0,0,1,0
2021-02-19,Micronesia (country),0,0,1,0
2021-02-20,Micronesia (country),0,0,1,0
2021-02-21,Micronesia (country),0,0,1,0
2021-02-22,Micronesia (country),0,0,1,0
2021-02-23,Micronesia (country),0,0,1,0
2021-02-24,Micronesia (country),0,0,1,0
2021-02-25,Micronesia (country),0,0,1,0
2021-02-26,Micronesia (country),0,0,1,0
2021-02-27,Micronesia (country),0,0,1,0
2021-02-28,Micronesia (country),0,0,1,0
2021-03-01,Micronesia (country),0,0,1,0
2021-03-02,Micronesia (country),0,0,1,0
2021-03-03,Micronesia (country),0,0,1,0
2021-03-04,Micronesia (country),0,0,1,0
2021-03-05,Micronesia (country),0,0,1,0
2021-03-06,Micronesia (country),0,0,1,0
2021-03-07,Micronesia (country),0,0,1,0
2021-03-08,Micronesia (country),0,0,1,0
2021-03-09,Micronesia (country),0,0,1,0
2021-03-10,Micronesia (country),0,0,1,0
2021-03-11,Micronesia (country),0,0,1,0
2021-03-12,Micronesia (country),0,0,1,0
2021-03-13,Micronesia (country),0,0,1,0
2021-03-14,Micronesia (country),0,0,1,0
2021-03-15,Micronesia (country),0,0,1,0
2021-03-16,Micronesia (country),0,0,1,0
2021-03-17,Micronesia (country),0,0,1,0
2021-03-18,Micronesia (country),0,0,1,0
2021-03-19,Micronesia (country),0,0,1,0
2021-03-20,Micronesia (country),0,0,1,0
2021-03-21,Micronesia (country),0,0,1,0
2021-03-22,Micronesia (country),0,0,1,0
2021-03-23,Micronesia (country),0,0,1,0
2021-03-24,Micronesia (country),0,0,1,0
2021-03-25,Micronesia (country),0,0,1,0
2021-03-26,Micronesia (country),0,0,1,0
2021-03-27,Micronesia (country),0,0,1,0
2021-03-28,Micronesia (country),0,0,1,0
2021-03-29,Micronesia (country),0,0,1,0
2021-03-30,Micronesia (country),0,0,1,0
2021-03-31,Micronesia (country),0,0,1,0
2021-04-01,Micronesia (country),0,0,1,0
2021-04-02,Micronesia (country),0,0,1,0
2021-04-03,Micronesia (country),0,0,1,0
2021-04-04,Micronesia (country),0,0,1,0
2021-04-05,Micronesia (country),0,0,1,0
2021-04-06,Micronesia (country),0,0,1,0
2021-04-07,Micronesia (country),0,0,1,0
2021-04-08,Micronesia (country),0,0,1,0
2020-03-08,Moldova,1,0,1,0
2020-03-09,Moldova,0,0,1,0
2020-03-10,Moldova,2,0,3,0
2020-03-11,Moldova,0,0,3,0
2020-03-12,Moldova,0,0,3,0
2020-03-13,Moldova,3,0,6,0
2020-03-14,Moldova,6,0,12,0
2020-03-15,Moldova,11,0,23,0
2020-03-16,Moldova,0,0,23,0
2020-03-17,Moldova,7,0,30,0
2020-03-18,Moldova,0,1,30,1
2020-03-19,Moldova,19,0,49,1
2020-03-20,Moldova,17,0,66,1
2020-03-21,Moldova,14,0,80,1
2020-03-22,Moldova,14,0,94,1
2020-03-23,Moldova,15,0,109,1
2020-03-24,Moldova,16,0,125,1
2020-03-25,Moldova,24,0,149,1
2020-03-26,Moldova,28,0,177,1
2020-03-27,Moldova,22,1,199,2
2020-03-28,Moldova,32,0,231,2
2020-03-29,Moldova,32,0,263,2
2020-03-30,Moldova,35,0,298,2
2020-03-31,Moldova,55,2,353,4
2020-04-01,Moldova,70,1,423,5
2020-04-02,Moldova,82,1,505,6
2020-04-03,Moldova,86,2,591,8
2020-04-04,Moldova,161,4,752,12
2020-04-05,Moldova,112,3,864,15
2020-04-06,Moldova,101,4,965,19
2020-04-07,Moldova,91,3,1056,22
2020-04-08,Moldova,118,5,1174,27
2020-04-09,Moldova,115,2,1289,29
2020-04-10,Moldova,149,0,1438,29
2020-04-11,Moldova,122,1,1560,30
2020-04-12,Moldova,102,1,1662,31
2020-04-13,Moldova,50,4,1712,35
2020-04-14,Moldova,222,5,1934,40
2020-04-15,Moldova,115,6,2049,46
2020-04-16,Moldova,105,8,2154,54
2020-04-17,Moldova,110,2,2264,56
2020-04-18,Moldova,114,1,2378,57
2020-04-19,Moldova,94,10,2472,67
2020-04-20,Moldova,76,3,2548,70
2020-04-21,Moldova,66,2,2614,72
2020-04-22,Moldova,164,3,2778,75
2020-04-23,Moldova,148,5,2926,80
2020-04-24,Moldova,184,4,3110,84
2020-04-25,Moldova,194,10,3304,94
2020-04-26,Moldova,104,2,3408,96
2020-04-27,Moldova,73,6,3481,102
2020-04-28,Moldova,157,1,3638,103
2020-04-29,Moldova,133,8,3771,111
2020-04-30,Moldova,126,5,3897,116
2020-05-01,Moldova,83,6,3980,122
2020-05-02,Moldova,72,2,4052,124
2020-05-03,Moldova,69,1,4121,125
2020-05-04,Moldova,127,7,4248,132
2020-05-05,Moldova,115,4,4363,136
2020-05-06,Moldova,113,7,4476,143
2020-05-07,Moldova,129,2,4605,145
2020-05-08,Moldova,123,5,4728,150
2020-05-09,Moldova,139,11,4867,161
2020-05-10,Moldova,60,8,4927,169
2020-05-11,Moldova,68,6,4995,175
2020-05-12,Moldova,159,7,5154,182
2020-05-13,Moldova,252,3,5406,185
2020-05-14,Moldova,147,9,5553,194
2020-05-15,Moldova,192,8,5745,202
2020-05-16,Moldova,189,5,5934,207
2020-05-17,Moldova,126,4,6060,211
2020-05-18,Moldova,78,6,6138,217
2020-05-19,Moldova,202,4,6340,221
2020-05-20,Moldova,213,7,6553,228
2020-05-21,Moldova,151,5,6704,233
2020-05-22,Moldova,143,4,6847,237
2020-05-23,Moldova,147,5,6994,242
2020-05-24,Moldova,99,8,7093,250
2020-05-25,Moldova,54,11,7147,261
2020-05-26,Moldova,158,6,7305,267
2020-05-27,Moldova,232,7,7537,274
2020-05-28,Moldova,188,8,7725,282
2020-05-29,Moldova,171,6,7896,288
2020-05-30,Moldova,202,3,8098,291
2020-05-31,Moldova,153,4,8251,295
2020-06-01,Moldova,109,10,8360,305
2020-06-02,Moldova,188,2,8548,307
2020-06-03,Moldova,247,3,8795,310
2020-06-04,Moldova,223,5,9018,315
2020-06-05,Moldova,229,8,9247,323
2020-06-06,Moldova,264,8,9511,331
2020-06-07,Moldova,189,10,9700,341
2020-06-08,Moldova,107,12,9807,353
2020-06-09,Moldova,218,12,10025,365
2020-06-10,Moldova,296,6,10321,371
2020-06-11,Moldova,406,4,10727,375
2020-06-12,Moldova,366,10,11093,385
2020-06-13,Moldova,366,13,11459,398
2020-06-14,Moldova,281,8,11740,406
2020-06-15,Moldova,139,5,11879,411
2020-06-16,Moldova,375,12,12254,423
2020-06-17,Moldova,478,10,12732,433
2020-06-18,Moldova,374,11,13106,444
2020-06-19,Moldova,450,6,13556,450
2020-06-20,Moldova,397,14,13953,464
2020-06-21,Moldova,247,9,14200,473
2020-06-22,Moldova,163,7,14363,480
2020-06-23,Moldova,351,10,14714,490
2020-06-24,Moldova,364,5,15078,495
2020-06-25,Moldova,375,7,15453,502
2020-06-26,Moldova,323,13,15776,515
2020-06-27,Moldova,304,6,16080,521
2020-06-28,Moldova,170,9,16250,530
2020-06-29,Moldova,107,6,16357,536
2020-06-30,Moldova,256,9,16613,545
2020-07-01,Moldova,285,4,16898,549
2020-07-02,Moldova,252,11,17150,560
2020-07-03,Moldova,295,12,17445,572
2020-07-04,Moldova,227,8,17672,580
2020-07-05,Moldova,142,5,17814,585
2020-07-06,Moldova,92,7,17906,592
2020-07-07,Moldova,235,11,18141,603
2020-07-08,Moldova,330,11,18471,614
2020-07-09,Moldova,195,10,18666,624
2020-07-10,Moldova,258,11,18924,635
2020-07-11,Moldova,284,5,19208,640
2020-07-12,Moldova,174,2,19382,642
2020-07-13,Moldova,57,7,19439,649
2020-07-14,Moldova,269,6,19708,655
2020-07-15,Moldova,332,4,20040,659
2020-07-16,Moldova,224,7,20264,666
2020-07-17,Moldova,230,9,20494,675
2020-07-18,Moldova,300,5,20794,680
2020-07-19,Moldova,186,4,20980,684
2020-07-20,Moldova,135,11,21115,695
2020-07-21,Moldova,327,12,21442,707
2020-07-22,Moldova,356,5,21798,712
2020-07-23,Moldova,307,7,22105,719
2020-07-24,Moldova,378,7,22483,726
2020-07-25,Moldova,345,6,22828,732
2020-07-26,Moldova,206,3,23034,735
2020-07-27,Moldova,120,13,23154,748
2020-07-28,Moldova,367,5,23521,753
2020-07-29,Moldova,426,6,23947,759
2020-07-30,Moldova,396,12,24343,771
2020-07-31,Moldova,390,7,24733,778
2020-08-01,Moldova,380,10,25113,788
2020-08-02,Moldova,249,3,25362,791
2020-08-03,Moldova,120,9,25482,800
2020-08-04,Moldova,332,10,25814,810
2020-08-05,Moldova,408,13,26222,823
2020-08-06,Moldova,406,5,26628,828
2020-08-07,Moldova,362,7,26990,835
2020-08-08,Moldova,453,6,27443,841
2020-08-09,Moldova,217,4,27660,845
2020-08-10,Moldova,181,5,27841,850
2020-08-11,Moldova,382,7,28223,857
2020-08-12,Moldova,474,6,28697,863
2020-08-13,Moldova,390,15,29087,878
2020-08-14,Moldova,396,6,29483,884
2020-08-15,Moldova,422,11,29905,895
2020-08-16,Moldova,278,1,30183,896
2020-08-17,Moldova,194,12,30377,908
2020-08-18,Moldova,412,0,30789,908
2020-08-19,Moldova,626,6,31415,914
2020-08-20,Moldova,522,7,31937,921
2020-08-21,Moldova,547,8,32484,929
2020-08-22,Moldova,588,6,33072,935
2020-08-23,Moldova,406,5,33478,940
2020-08-24,Moldova,350,5,33828,945
2020-08-25,Moldova,530,15,34358,960
2020-08-26,Moldova,624,7,34982,967
2020-08-27,Moldova,564,10,35546,977
2020-08-28,Moldova,358,4,35904,981
2020-08-29,Moldova,500,9,36404,990
2020-08-30,Moldova,296,2,36700,992
2020-08-31,Moldova,220,3,36920,995
2020-09-01,Moldova,288,13,37208,1008
2020-09-02,Moldova,532,16,37740,1024
2020-09-03,Moldova,632,12,38372,1036
2020-09-04,Moldova,534,11,38906,1047
2020-09-05,Moldova,567,16,39473,1063
2020-09-06,Moldova,324,0,39797,1063
2020-09-07,Moldova,258,11,40055,1074
2020-09-08,Moldova,501,13,40556,1087
2020-09-09,Moldova,588,9,41144,1096
2020-09-10,Moldova,560,10,41704,1106
2020-09-11,Moldova,479,8,42183,1114
2020-09-12,Moldova,531,3,42714,1117
2020-09-13,Moldova,264,6,42978,1123
2020-09-14,Moldova,229,6,43207,1129
2020-09-15,Moldova,527,14,43734,1143
2020-09-16,Moldova,627,16,44361,1159
2020-09-17,Moldova,622,11,44983,1170
2020-09-18,Moldova,665,16,45648,1186
2020-09-19,Moldova,688,15,46336,1201
2020-09-20,Moldova,260,2,46596,1203
2020-09-21,Moldova,200,8,46796,1211
2020-09-22,Moldova,650,19,47446,1230
2020-09-23,Moldova,786,14,48232,1244
2020-09-24,Moldova,721,8,48953,1252
2020-09-25,Moldova,713,12,49666,1264
2020-09-26,Moldova,868,15,50534,1279
2020-09-27,Moldova,341,8,50875,1287
2020-09-28,Moldova,319,14,51194,1301
2020-09-29,Moldova,835,9,52029,1310
2020-09-30,Moldova,1013,10,53042,1320
2020-10-01,Moldova,1022,16,54064,1336
2020-10-02,Moldova,952,8,55016,1344
2020-10-03,Moldova,872,9,55888,1353
2020-10-04,Moldova,691,13,56579,1366
2020-10-05,Moldova,322,9,56901,1375
2020-10-06,Moldova,831,14,57732,1389
2020-10-07,Moldova,1062,17,58794,1406
2020-10-08,Moldova,1121,18,59915,1424
2020-10-09,Moldova,918,18,60833,1442
2020-10-10,Moldova,929,16,61762,1458
2020-10-11,Moldova,389,3,62151,1461
2020-10-12,Moldova,467,17,62618,1478
2020-10-13,Moldova,657,17,63275,1495
2020-10-14,Moldova,1149,19,64424,1514
2020-10-15,Moldova,652,16,65076,1530
2020-10-16,Moldova,784,19,65860,1549
2020-10-17,Moldova,792,20,66652,1569
2020-10-18,Moldova,398,15,67050,1584
2020-10-19,Moldova,252,16,67302,1600
2020-10-20,Moldova,656,17,67958,1617
2020-10-21,Moldova,833,13,68791,1630
2020-10-22,Moldova,777,11,69568,1641
2020-10-23,Moldova,688,13,70256,1654
2020-10-24,Moldova,833,15,71089,1669
2020-10-25,Moldova,414,16,71503,1685
2020-10-26,Moldova,308,15,71811,1700
2020-10-27,Moldova,649,10,72460,1710
2020-10-28,Moldova,861,19,73321,1729
2020-10-29,Moldova,912,18,74233,1747
2020-10-30,Moldova,968,19,75201,1766
2020-10-31,Moldova,839,19,76040,1785
2020-11-01,Moldova,542,15,76582,1800
2020-11-02,Moldova,195,18,76777,1818
2020-11-03,Moldova,710,20,77487,1838
2020-11-04,Moldova,1020,13,78507,1851
2020-11-05,Moldova,1059,15,79566,1866
2020-11-06,Moldova,935,16,80501,1882
2020-11-07,Moldova,1174,9,81675,1891
2020-11-08,Moldova,671,2,82346,1893
2020-11-09,Moldova,331,19,82677,1912
2020-11-10,Moldova,915,18,83592,1930
2020-11-11,Moldova,1115,20,84707,1950
2020-11-12,Moldova,1331,19,86038,1969
2020-11-13,Moldova,1323,18,87361,1987
2020-11-14,Moldova,1411,19,88772,2006
2020-11-15,Moldova,507,13,89279,2019
2020-11-16,Moldova,564,16,89843,2035
2020-11-17,Moldova,1069,19,90912,2054
2020-11-18,Moldova,1607,18,92519,2072
2020-11-19,Moldova,1442,19,93961,2091
2020-11-20,Moldova,1422,20,95383,2111
2020-11-21,Moldova,1306,19,96689,2130
2020-11-22,Moldova,1252,19,97941,2149
2020-11-23,Moldova,477,20,98418,2169
2020-11-24,Moldova,1215,19,99633,2188
2020-11-25,Moldova,1570,21,101203,2209
2020-11-26,Moldova,1691,20,102894,2229
2020-11-27,Moldova,1246,21,104140,2250
2020-11-28,Moldova,1712,19,105852,2269
2020-11-29,Moldova,1165,21,107017,2290
2020-11-30,Moldova,347,14,107364,2304
2020-12-01,Moldova,1499,19,108863,2323
2020-12-02,Moldova,1717,20,110580,2343
2020-12-03,Moldova,1727,20,112307,2363
2020-12-04,Moldova,1522,21,113829,2384
2020-12-05,Moldova,1728,19,115557,2403
2020-12-06,Moldova,808,16,116365,2419
2020-12-07,Moldova,1130,19,117495,2438
2020-12-08,Moldova,1709,22,119204,2460
2020-12-09,Moldova,1766,21,120970,2481
2020-12-10,Moldova,1715,19,122685,2500
2020-12-11,Moldova,1579,21,124264,2521
2020-12-12,Moldova,1459,26,125723,2547
2020-12-13,Moldova,795,25,126518,2572
2020-12-14,Moldova,735,26,127253,2598
2020-12-15,Moldova,1403,27,128656,2625
2020-12-16,Moldova,1673,25,130329,2650
2020-12-17,Moldova,1590,24,131919,2674
2020-12-18,Moldova,1441,26,133360,2700
2020-12-19,Moldova,1218,27,134578,2727
2020-12-20,Moldova,629,25,135207,2752
2020-12-21,Moldova,703,25,135910,2777
2020-12-22,Moldova,1021,26,136931,2803
2020-12-23,Moldova,1282,22,138213,2825
2020-12-24,Moldova,1222,23,139435,2848
2020-12-25,Moldova,815,23,140250,2871
2020-12-26,Moldova,746,12,140996,2883
2020-12-27,Moldova,359,8,141355,2891
2020-12-28,Moldova,569,18,141924,2909
2020-12-29,Moldova,927,25,142851,2934
2020-12-30,Moldova,990,26,143841,2960
2020-12-31,Moldova,977,25,144818,2985
2021-01-01,Moldova,440,19,145258,3004
2021-01-02,Moldova,436,16,145694,3020
2021-01-03,Moldova,179,17,145873,3037
2021-01-04,Moldova,436,17,146309,3054
2021-01-05,Moldova,612,16,146921,3070
2021-01-06,Moldova,950,18,147871,3088
2021-01-07,Moldova,423,18,148294,3106
2021-01-08,Moldova,375,16,148669,3122
2021-01-09,Moldova,424,8,149093,3130
2021-01-10,Moldova,298,9,149391,3139
2021-01-11,Moldova,271,17,149662,3156
2021-01-12,Moldova,476,20,150138,3176
2021-01-13,Moldova,808,17,150946,3193
2021-01-14,Moldova,741,18,151687,3211
2021-01-15,Moldova,576,17,152263,3228
2021-01-16,Moldova,377,17,152640,3245
2021-01-17,Moldova,214,5,152854,3250
2021-01-18,Moldova,258,17,153112,3267
2021-01-19,Moldova,394,15,153506,3282
2021-01-20,Moldova,612,17,154118,3299
2021-01-21,Moldova,670,16,154788,3315
2021-01-22,Moldova,514,17,155302,3332
2021-01-23,Moldova,635,15,155937,3347
2021-01-24,Moldova,265,14,156202,3361
2021-01-25,Moldova,224,7,156426,3368
2021-01-26,Moldova,546,13,156972,3381
2021-01-27,Moldova,654,15,157626,3396
2021-01-28,Moldova,683,17,158309,3413
2021-01-29,Moldova,551,11,158860,3424
2021-01-30,Moldova,653,10,159513,3434
2021-01-31,Moldova,291,4,159804,3438
2021-02-01,Moldova,282,8,160086,3446
2021-02-02,Moldova,639,16,160725,3462
2021-02-03,Moldova,917,18,161642,3480
2021-02-04,Moldova,982,17,162624,3497
2021-02-05,Moldova,776,18,163400,3515
2021-02-06,Moldova,843,15,164243,3530
2021-02-07,Moldova,326,13,164569,3543
2021-02-08,Moldova,289,14,164858,3557
2021-02-09,Moldova,805,16,165663,3573
2021-02-10,Moldova,890,16,166553,3589
2021-02-11,Moldova,993,18,167546,3607
2021-02-12,Moldova,1280,19,168826,3626
2021-02-13,Moldova,979,14,169805,3640
2021-02-14,Moldova,381,11,170186,3651
2021-02-15,Moldova,363,10,170549,3661
2021-02-16,Moldova,965,17,171514,3678
2021-02-17,Moldova,1301,19,172815,3697
2021-02-18,Moldova,1340,20,174155,3717
2021-02-19,Moldova,1028,22,175183,3739
2021-02-20,Moldova,1062,21,176245,3760
2021-02-21,Moldova,507,20,176752,3780
2021-02-22,Moldova,655,19,177407,3799
2021-02-23,Moldova,1133,24,178540,3823
2021-02-24,Moldova,1610,23,180150,3846
2021-02-25,Moldova,1736,25,181886,3871
2021-02-26,Moldova,1452,28,183338,3899
2021-02-27,Moldova,1518,25,184856,3924
2021-02-28,Moldova,597,25,185453,3949
2021-03-01,Moldova,994,26,186447,3975
2021-03-02,Moldova,1400,27,187847,4002
2021-03-03,Moldova,1550,24,189397,4026
2021-03-04,Moldova,1800,23,191197,4049
2021-03-05,Moldova,1788,22,192985,4071
2021-03-06,Moldova,1620,20,194605,4091
2021-03-07,Moldova,647,20,195252,4111
2021-03-08,Moldova,350,18,195602,4129
2021-03-09,Moldova,873,21,196475,4150
2021-03-10,Moldova,1753,33,198228,4183
2021-03-11,Moldova,1896,37,200124,4220
2021-03-12,Moldova,1785,38,201909,4258
2021-03-13,Moldova,1801,36,203710,4294
2021-03-14,Moldova,753,36,204463,4330
2021-03-15,Moldova,861,39,205324,4369
2021-03-16,Moldova,1688,33,207012,4402
2021-03-17,Moldova,1916,34,208928,4436
2021-03-18,Moldova,1797,36,210725,4472
2021-03-19,Moldova,1843,29,212568,4501
2021-03-20,Moldova,1635,30,214203,4531
2021-03-21,Moldova,831,28,215034,4559
2021-03-22,Moldova,1060,31,216094,4590
2021-03-23,Moldova,1621,33,217715,4623
2021-03-24,Moldova,2273,38,219988,4661
2021-03-25,Moldova,2132,41,222120,4702
2021-03-26,Moldova,1866,43,223986,4745
2021-03-27,Moldova,1674,40,225660,4785
2021-03-28,Moldova,861,42,226521,4827
2021-03-29,Moldova,932,42,227453,4869
2021-03-30,Moldova,917,46,228370,4915
2021-03-31,Moldova,1871,45,230241,4960
2021-04-01,Moldova,1515,43,231756,5003
2021-04-02,Moldova,1380,45,233136,5048
2021-04-03,Moldova,1258,44,234394,5092
2021-04-04,Moldova,693,44,235087,5136
2021-04-05,Moldova,703,42,235790,5178
2021-04-06,Moldova,773,46,236563,5224
2021-04-07,Moldova,1155,44,237718,5268
2021-04-08,Moldova,1428,39,239146,5307
2020-02-29,Monaco,1,0,1,0
2020-03-01,Monaco,0,0,1,0
2020-03-02,Monaco,0,0,1,0
2020-03-03,Monaco,0,0,1,0
2020-03-04,Monaco,0,0,1,0
2020-03-05,Monaco,0,0,1,0
2020-03-06,Monaco,0,0,1,0
2020-03-07,Monaco,0,0,1,0
2020-03-08,Monaco,0,0,1,0
2020-03-09,Monaco,0,0,1,0
2020-03-10,Monaco,0,0,1,0
2020-03-11,Monaco,0,0,1,0
2020-03-12,Monaco,1,0,2,0
2020-03-13,Monaco,0,0,2,0
2020-03-14,Monaco,0,0,2,0
2020-03-15,Monaco,0,0,2,0
2020-03-16,Monaco,5,0,7,0
2020-03-17,Monaco,0,0,7,0
2020-03-18,Monaco,0,0,7,0
2020-03-19,Monaco,0,0,7,0
2020-03-20,Monaco,4,0,11,0
2020-03-21,Monaco,0,0,11,0
2020-03-22,Monaco,12,0,23,0
2020-03-23,Monaco,0,0,23,0
2020-03-24,Monaco,0,0,23,0
2020-03-25,Monaco,8,0,31,0
2020-03-26,Monaco,2,0,33,0
2020-03-27,Monaco,9,0,42,0
2020-03-28,Monaco,0,0,42,0
2020-03-29,Monaco,4,1,46,1
2020-03-30,Monaco,3,0,49,1
2020-03-31,Monaco,3,0,52,1
2020-04-01,Monaco,3,0,55,1
2020-04-02,Monaco,5,0,60,1
2020-04-03,Monaco,4,0,64,1
2020-04-04,Monaco,2,0,66,1
2020-04-05,Monaco,7,0,73,1
2020-04-06,Monaco,4,0,77,1
2020-04-07,Monaco,2,0,79,1
2020-04-08,Monaco,2,0,81,1
2020-04-09,Monaco,3,0,84,1
2020-04-10,Monaco,6,0,90,1
2020-04-11,Monaco,2,0,92,1
2020-04-12,Monaco,1,0,93,1
2020-04-13,Monaco,0,0,93,1
2020-04-14,Monaco,0,0,93,1
2020-04-15,Monaco,0,2,93,3
2020-04-16,Monaco,0,0,93,3
2020-04-17,Monaco,1,0,94,3
2020-04-18,Monaco,0,0,94,3
2020-04-19,Monaco,0,0,94,3
2020-04-20,Monaco,0,0,94,3
2020-04-21,Monaco,0,0,94,3
2020-04-22,Monaco,0,0,94,3
2020-04-23,Monaco,0,1,94,4
2020-04-24,Monaco,0,0,94,4
2020-04-25,Monaco,0,0,94,4
2020-04-26,Monaco,0,0,94,4
2020-04-27,Monaco,1,0,95,4
2020-04-28,Monaco,0,0,95,4
2020-04-29,Monaco,0,0,95,4
2020-04-30,Monaco,0,0,95,4
2020-05-01,Monaco,0,0,95,4
2020-05-02,Monaco,0,0,95,4
2020-05-03,Monaco,0,0,95,4
2020-05-04,Monaco,0,0,95,4
2020-05-05,Monaco,0,0,95,4
2020-05-06,Monaco,0,0,95,4
2020-05-07,Monaco,0,0,95,4
2020-05-08,Monaco,0,0,95,4
2020-05-09,Monaco,1,0,96,4
2020-05-10,Monaco,0,0,96,4
2020-05-11,Monaco,0,0,96,4
2020-05-12,Monaco,0,0,96,4
2020-05-13,Monaco,0,0,96,4
2020-05-14,Monaco,0,0,96,4
2020-05-15,Monaco,0,0,96,4
2020-05-16,Monaco,0,0,96,4
2020-05-17,Monaco,0,0,96,4
2020-05-18,Monaco,1,0,97,4
2020-05-19,Monaco,0,0,97,4
2020-05-20,Monaco,0,0,97,4
2020-05-21,Monaco,0,0,97,4
2020-05-22,Monaco,0,0,97,4
2020-05-23,Monaco,1,0,98,4
2020-05-24,Monaco,0,0,98,4
2020-05-25,Monaco,0,0,98,4
2020-05-26,Monaco,0,0,98,4
2020-05-27,Monaco,0,0,98,4
2020-05-28,Monaco,0,0,98,4
2020-05-29,Monaco,0,0,98,4
2020-05-30,Monaco,1,0,99,4
2020-05-31,Monaco,0,0,99,4
2020-06-01,Monaco,0,0,99,4
2020-06-02,Monaco,0,0,99,4
2020-06-03,Monaco,0,0,99,4
2020-06-04,Monaco,0,0,99,4
2020-06-05,Monaco,0,0,99,4
2020-06-06,Monaco,0,0,99,4
2020-06-07,Monaco,0,0,99,4
2020-06-08,Monaco,0,0,99,4
2020-06-09,Monaco,0,0,99,4
2020-06-10,Monaco,0,0,99,4
2020-06-11,Monaco,0,0,99,4
2020-06-12,Monaco,0,0,99,4
2020-06-13,Monaco,0,0,99,4
2020-06-14,Monaco,0,0,99,4
2020-06-15,Monaco,0,0,99,4
2020-06-16,Monaco,0,0,99,4
2020-06-17,Monaco,0,0,99,4
2020-06-18,Monaco,0,0,99,4
2020-06-19,Monaco,0,0,99,4
2020-06-20,Monaco,0,0,99,4
2020-06-21,Monaco,1,0,100,4
2020-06-22,Monaco,1,0,101,4
2020-06-23,Monaco,0,0,101,4
2020-06-24,Monaco,1,0,102,4
2020-06-25,Monaco,0,0,102,4
2020-06-26,Monaco,0,0,102,4
2020-06-27,Monaco,1,0,103,4
2020-06-28,Monaco,0,0,103,4
2020-06-29,Monaco,0,0,103,4
2020-06-30,Monaco,0,0,103,4
2020-07-01,Monaco,0,0,103,4
2020-07-02,Monaco,3,0,106,4
2020-07-03,Monaco,0,0,106,4
2020-07-04,Monaco,0,0,106,4
2020-07-05,Monaco,2,0,108,4
2020-07-06,Monaco,0,0,108,4
2020-07-07,Monaco,0,0,108,4
2020-07-08,Monaco,0,0,108,4
2020-07-09,Monaco,0,0,108,4
2020-07-10,Monaco,0,0,108,4
2020-07-11,Monaco,1,0,109,4
2020-07-12,Monaco,0,0,109,4
2020-07-13,Monaco,0,0,109,4
2020-07-14,Monaco,0,0,109,4
2020-07-15,Monaco,0,0,109,4
2020-07-16,Monaco,0,0,109,4
2020-07-17,Monaco,0,0,109,4
2020-07-18,Monaco,0,0,109,4
2020-07-19,Monaco,0,0,109,4
2020-07-20,Monaco,0,0,109,4
2020-07-21,Monaco,2,0,111,4
2020-07-22,Monaco,1,0,112,4
2020-07-23,Monaco,2,0,114,4
2020-07-24,Monaco,2,0,116,4
2020-07-25,Monaco,0,0,116,4
2020-07-26,Monaco,0,0,116,4
2020-07-27,Monaco,0,0,116,4
2020-07-28,Monaco,1,0,117,4
2020-07-29,Monaco,3,0,120,4
2020-07-30,Monaco,0,0,120,4
2020-07-31,Monaco,0,0,120,4
2020-08-01,Monaco,0,0,120,4
2020-08-02,Monaco,0,0,120,4
2020-08-03,Monaco,1,0,121,4
2020-08-04,Monaco,2,0,123,4
2020-08-05,Monaco,2,0,125,4
2020-08-06,Monaco,0,0,125,4
2020-08-07,Monaco,3,0,128,4
2020-08-08,Monaco,3,0,131,4
2020-08-09,Monaco,2,0,133,4
2020-08-10,Monaco,0,0,133,4
2020-08-11,Monaco,5,0,138,4
2020-08-12,Monaco,3,0,141,4
2020-08-13,Monaco,3,0,144,4
2020-08-14,Monaco,2,0,146,4
2020-08-15,Monaco,0,0,146,4
2020-08-16,Monaco,0,0,146,4
2020-08-17,Monaco,2,0,148,4
2020-08-18,Monaco,0,0,148,4
2020-08-19,Monaco,0,0,148,4
2020-08-20,Monaco,2,0,150,4
2020-08-21,Monaco,4,0,154,4
2020-08-22,Monaco,0,0,154,4
2020-08-23,Monaco,0,0,154,4
2020-08-24,Monaco,0,0,154,4
2020-08-25,Monaco,0,0,154,4
2020-08-26,Monaco,0,0,154,4
2020-08-27,Monaco,0,0,154,4
2020-08-28,Monaco,0,0,154,4
2020-08-29,Monaco,0,0,154,4
2020-08-30,Monaco,0,0,154,4
2020-08-31,Monaco,0,0,154,4
2020-09-01,Monaco,0,0,154,4
2020-09-02,Monaco,-12,-3,142,1
2020-09-03,Monaco,1,0,143,1
2020-09-04,Monaco,4,0,147,1
2020-09-05,Monaco,0,0,147,1
2020-09-06,Monaco,0,0,147,1
2020-09-07,Monaco,6,0,153,1
2020-09-08,Monaco,3,0,156,1
2020-09-09,Monaco,5,0,161,1
2020-09-10,Monaco,4,0,165,1
2020-09-11,Monaco,3,0,168,1
2020-09-12,Monaco,1,0,169,1
2020-09-13,Monaco,2,0,171,1
2020-09-14,Monaco,6,0,177,1
2020-09-15,Monaco,1,0,178,1
2020-09-16,Monaco,3,0,181,1
2020-09-17,Monaco,5,0,186,1
2020-09-18,Monaco,5,0,191,1
2020-09-19,Monaco,1,0,192,1
2020-09-20,Monaco,1,0,193,1
2020-09-21,Monaco,2,0,195,1
2020-09-22,Monaco,2,0,197,1
2020-09-23,Monaco,2,0,199,1
2020-09-24,Monaco,6,0,205,1
2020-09-25,Monaco,3,1,208,2
2020-09-26,Monaco,2,0,210,2
2020-09-27,Monaco,0,0,210,2
2020-09-28,Monaco,2,0,212,2
2020-09-29,Monaco,2,0,214,2
2020-09-30,Monaco,4,0,218,2
2020-10-01,Monaco,1,0,219,2
2020-10-02,Monaco,2,0,221,2
2020-10-03,Monaco,1,0,222,2
2020-10-04,Monaco,0,0,222,2
2020-10-05,Monaco,1,0,223,2
2020-10-06,Monaco,1,0,224,2
2020-10-07,Monaco,3,0,227,2
2020-10-08,Monaco,2,0,229,2
2020-10-09,Monaco,4,0,233,2
2020-10-10,Monaco,0,0,233,2
2020-10-11,Monaco,1,0,234,2
2020-10-12,Monaco,2,0,236,2
2020-10-13,Monaco,5,0,241,2
2020-10-14,Monaco,7,0,248,2
2020-10-15,Monaco,5,0,253,2
2020-10-16,Monaco,2,0,255,2
2020-10-17,Monaco,5,0,260,2
2020-10-18,Monaco,5,0,265,2
2020-10-19,Monaco,3,0,268,2
2020-10-20,Monaco,3,0,271,2
2020-10-21,Monaco,2,0,273,2
2020-10-22,Monaco,8,0,281,2
2020-10-23,Monaco,14,0,295,2
2020-10-24,Monaco,1,0,296,2
2020-10-25,Monaco,10,0,306,2
2020-10-26,Monaco,4,0,310,2
2020-10-27,Monaco,10,0,320,2
2020-10-28,Monaco,17,0,337,2
2020-10-29,Monaco,10,0,347,2
2020-10-30,Monaco,8,0,355,2
2020-10-31,Monaco,4,0,359,2
2020-11-01,Monaco,7,0,366,2
2020-11-02,Monaco,9,0,375,2
2020-11-03,Monaco,22,0,397,2
2020-11-04,Monaco,15,0,412,2
2020-11-05,Monaco,18,0,430,2
2020-11-06,Monaco,24,0,454,2
2020-11-07,Monaco,29,0,483,2
2020-11-08,Monaco,3,0,486,2
2020-11-09,Monaco,4,0,490,2
2020-11-10,Monaco,22,0,512,2
2020-11-11,Monaco,12,0,524,2
2020-11-12,Monaco,8,0,532,2
2020-11-13,Monaco,8,0,540,2
2020-11-14,Monaco,5,0,545,2
2020-11-15,Monaco,3,0,548,2
2020-11-16,Monaco,4,0,552,2
2020-11-17,Monaco,5,1,557,3
2020-11-18,Monaco,8,0,565,3
2020-11-19,Monaco,8,0,573,3
2020-11-20,Monaco,4,0,577,3
2020-11-21,Monaco,4,0,581,3
2020-11-22,Monaco,1,0,582,3
2020-11-23,Monaco,1,0,583,3
2020-11-24,Monaco,4,0,587,3
2020-11-25,Monaco,7,0,594,3
2020-11-26,Monaco,6,0,600,3
2020-11-27,Monaco,3,0,603,3
2020-11-28,Monaco,4,0,607,3
2020-11-29,Monaco,1,0,608,3
2020-11-30,Monaco,1,0,609,3
2020-12-01,Monaco,8,0,617,3
2020-12-02,Monaco,4,0,621,3
2020-12-03,Monaco,9,0,630,3
2020-12-04,Monaco,0,0,630,3
2020-12-05,Monaco,7,0,637,3
2020-12-06,Monaco,1,0,638,3
2020-12-07,Monaco,3,0,641,3
2020-12-08,Monaco,7,0,648,3
2020-12-09,Monaco,7,0,655,3
2020-12-10,Monaco,2,0,657,3
2020-12-11,Monaco,2,0,659,3
2020-12-12,Monaco,9,0,668,3
2020-12-13,Monaco,0,0,668,3
2020-12-14,Monaco,3,0,671,3
2020-12-15,Monaco,7,0,678,3
2020-12-16,Monaco,7,0,685,3
2020-12-17,Monaco,15,0,700,3
2020-12-18,Monaco,15,0,715,3
2020-12-19,Monaco,8,0,723,3
2020-12-20,Monaco,5,0,728,3
2020-12-21,Monaco,14,0,742,3
2020-12-22,Monaco,14,0,756,3
2020-12-23,Monaco,11,0,767,3
2020-12-24,Monaco,16,0,783,3
2020-12-25,Monaco,6,0,789,3
2020-12-26,Monaco,8,0,797,3
2020-12-27,Monaco,0,0,797,3
2020-12-28,Monaco,4,0,801,3
2020-12-29,Monaco,26,0,827,3
2020-12-30,Monaco,26,0,853,3
2020-12-31,Monaco,22,0,875,3
2021-01-01,Monaco,10,0,885,3
2021-01-02,Monaco,16,0,901,3
2021-01-03,Monaco,6,0,907,3
2021-01-04,Monaco,10,0,917,3
2021-01-05,Monaco,30,0,947,3
2021-01-06,Monaco,31,0,978,3
2021-01-07,Monaco,40,0,1018,3
2021-01-08,Monaco,23,1,1041,4
2021-01-09,Monaco,12,0,1053,4
2021-01-10,Monaco,4,0,1057,4
2021-01-11,Monaco,13,0,1070,4
2021-01-12,Monaco,22,3,1092,7
2021-01-13,Monaco,36,0,1128,7
2021-01-14,Monaco,17,0,1145,7
2021-01-15,Monaco,24,0,1169,7
2021-01-16,Monaco,25,0,1194,7
2021-01-17,Monaco,11,0,1205,7
2021-01-18,Monaco,7,0,1212,7
2021-01-19,Monaco,28,2,1240,9
2021-01-20,Monaco,22,0,1262,9
2021-01-21,Monaco,25,0,1287,9
2021-01-22,Monaco,24,0,1311,9
2021-01-23,Monaco,34,0,1345,9
2021-01-24,Monaco,12,0,1357,9
2021-01-25,Monaco,11,0,1368,9
2021-01-26,Monaco,31,0,1399,9
2021-01-27,Monaco,14,1,1413,10
2021-01-28,Monaco,17,1,1430,11
2021-01-29,Monaco,0,0,1430,11
2021-01-30,Monaco,45,0,1475,11
2021-01-31,Monaco,14,2,1489,13
2021-02-01,Monaco,10,1,1499,14
2021-02-02,Monaco,44,3,1543,17
2021-02-03,Monaco,29,1,1572,18
2021-02-04,Monaco,24,0,1596,18
2021-02-05,Monaco,29,1,1625,19
2021-02-06,Monaco,22,0,1647,19
2021-02-07,Monaco,8,0,1655,19
2021-02-08,Monaco,10,0,1665,19
2021-02-09,Monaco,30,0,1695,19
2021-02-10,Monaco,22,0,1717,19
2021-02-11,Monaco,18,0,1735,19
2021-02-12,Monaco,17,2,1752,21
2021-02-13,Monaco,3,0,1755,21
2021-02-14,Monaco,5,0,1760,21
2021-02-15,Monaco,14,0,1774,21
2021-02-16,Monaco,13,0,1787,21
2021-02-17,Monaco,29,1,1816,22
2021-02-18,Monaco,19,0,1835,22
2021-02-19,Monaco,9,0,1844,22
2021-02-20,Monaco,18,0,1862,22
2021-02-21,Monaco,8,0,1870,22
2021-02-22,Monaco,15,0,1885,22
2021-02-23,Monaco,19,1,1904,23
2021-02-24,Monaco,12,0,1916,23
2021-02-25,Monaco,16,0,1932,23
2021-02-26,Monaco,10,0,1942,23
2021-02-27,Monaco,11,1,1953,24
2021-02-28,Monaco,3,0,1956,24
2021-03-01,Monaco,9,0,1965,24
2021-03-02,Monaco,0,1,1965,25
2021-03-03,Monaco,16,1,1981,26
2021-03-04,Monaco,16,0,1997,26
2021-03-05,Monaco,12,0,2009,26
2021-03-06,Monaco,10,0,2019,26
2021-03-07,Monaco,4,0,2023,26
2021-03-08,Monaco,5,0,2028,26
2021-03-09,Monaco,20,0,2048,26
2021-03-10,Monaco,14,0,2062,26
2021-03-11,Monaco,13,0,2075,26
2021-03-12,Monaco,22,1,2097,27
2021-03-13,Monaco,9,0,2106,27
2021-03-14,Monaco,1,0,2107,27
2021-03-15,Monaco,13,0,2120,27
2021-03-16,Monaco,15,0,2135,27
2021-03-17,Monaco,6,0,2141,27
2021-03-18,Monaco,8,0,2149,27
2021-03-19,Monaco,15,0,2164,27
2021-03-20,Monaco,9,0,2173,27
2021-03-21,Monaco,0,0,2173,27
2021-03-22,Monaco,9,0,2182,27
2021-03-23,Monaco,17,0,2199,27
2021-03-24,Monaco,11,1,2210,28
2021-03-25,Monaco,17,0,2227,28
2021-03-26,Monaco,21,0,2248,28
2021-03-27,Monaco,6,0,2254,28
2021-03-28,Monaco,5,0,2259,28
2021-03-29,Monaco,6,0,2265,28
2021-03-30,Monaco,17,0,2282,28
2021-03-31,Monaco,6,0,2288,28
2021-04-01,Monaco,17,0,2305,28
2021-04-02,Monaco,15,0,2320,28
2021-04-03,Monaco,6,1,2326,29
2021-04-04,Monaco,3,0,2329,29
2021-04-05,Monaco,5,1,2334,30
2021-04-06,Monaco,11,0,2345,30
2021-04-07,Monaco,8,0,2353,30
2021-04-08,Monaco,11,0,2364,30
2020-03-10,Mongolia,1,0,1,0
2020-03-11,Mongolia,0,0,1,0
2020-03-12,Mongolia,0,0,1,0
2020-03-13,Mongolia,0,0,1,0
2020-03-14,Mongolia,0,0,1,0
2020-03-15,Mongolia,0,0,1,0
2020-03-16,Mongolia,0,0,1,0
2020-03-17,Mongolia,4,0,5,0
2020-03-18,Mongolia,1,0,6,0
2020-03-19,Mongolia,0,0,6,0
2020-03-20,Mongolia,0,0,6,0
2020-03-21,Mongolia,4,0,10,0
2020-03-22,Mongolia,0,0,10,0
2020-03-23,Mongolia,0,0,10,0
2020-03-24,Mongolia,0,0,10,0
2020-03-25,Mongolia,0,0,10,0
2020-03-26,Mongolia,1,0,11,0
2020-03-27,Mongolia,0,0,11,0
2020-03-28,Mongolia,1,0,12,0
2020-03-29,Mongolia,0,0,12,0
2020-03-30,Mongolia,0,0,12,0
2020-03-31,Mongolia,0,0,12,0
2020-04-01,Mongolia,2,0,14,0
2020-04-02,Mongolia,0,0,14,0
2020-04-03,Mongolia,0,0,14,0
2020-04-04,Mongolia,0,0,14,0
2020-04-05,Mongolia,0,0,14,0
2020-04-06,Mongolia,1,0,15,0
2020-04-07,Mongolia,0,0,15,0
2020-04-08,Mongolia,1,0,16,0
2020-04-09,Mongolia,0,0,16,0
2020-04-10,Mongolia,0,0,16,0
2020-04-11,Mongolia,0,0,16,0
2020-04-12,Mongolia,0,0,16,0
2020-04-13,Mongolia,1,0,17,0
2020-04-14,Mongolia,13,0,30,0
2020-04-15,Mongolia,0,0,30,0
2020-04-16,Mongolia,1,0,31,0
2020-04-17,Mongolia,0,0,31,0
2020-04-18,Mongolia,0,0,31,0
2020-04-19,Mongolia,1,0,32,0
2020-04-20,Mongolia,1,0,33,0
2020-04-21,Mongolia,1,0,34,0
2020-04-22,Mongolia,1,0,35,0
2020-04-23,Mongolia,1,0,36,0
2020-04-24,Mongolia,1,0,37,0
2020-04-25,Mongolia,0,0,37,0
2020-04-26,Mongolia,1,0,38,0
2020-04-27,Mongolia,0,0,38,0
2020-04-28,Mongolia,0,0,38,0
2020-04-29,Mongolia,0,0,38,0
2020-04-30,Mongolia,0,0,38,0
2020-05-01,Mongolia,0,0,38,0
2020-05-02,Mongolia,1,0,39,0
2020-05-03,Mongolia,0,0,39,0
2020-05-04,Mongolia,1,0,40,0
2020-05-05,Mongolia,1,0,41,0
2020-05-06,Mongolia,0,0,41,0
2020-05-07,Mongolia,0,0,41,0
2020-05-08,Mongolia,1,0,42,0
2020-05-09,Mongolia,0,0,42,0
2020-05-10,Mongolia,0,0,42,0
2020-05-11,Mongolia,0,0,42,0
2020-05-12,Mongolia,0,0,42,0
2020-05-13,Mongolia,0,0,42,0
2020-05-14,Mongolia,56,0,98,0
2020-05-15,Mongolia,0,0,98,0
2020-05-16,Mongolia,37,0,135,0
2020-05-17,Mongolia,1,0,136,0
2020-05-18,Mongolia,4,0,140,0
2020-05-19,Mongolia,0,0,140,0
2020-05-20,Mongolia,0,0,140,0
2020-05-21,Mongolia,0,0,140,0
2020-05-22,Mongolia,1,0,141,0
2020-05-23,Mongolia,0,0,141,0
2020-05-24,Mongolia,0,0,141,0
2020-05-25,Mongolia,0,0,141,0
2020-05-26,Mongolia,0,0,141,0
2020-05-27,Mongolia,7,0,148,0
2020-05-28,Mongolia,13,0,161,0
2020-05-29,Mongolia,18,0,179,0
2020-05-30,Mongolia,0,0,179,0
2020-05-31,Mongolia,0,0,179,0
2020-06-01,Mongolia,6,0,185,0
2020-06-02,Mongolia,0,0,185,0
2020-06-03,Mongolia,0,0,185,0
2020-06-04,Mongolia,1,0,186,0
2020-06-05,Mongolia,5,0,191,0
2020-06-06,Mongolia,2,0,193,0
2020-06-07,Mongolia,0,0,193,0
2020-06-08,Mongolia,1,0,194,0
2020-06-09,Mongolia,0,0,194,0
2020-06-10,Mongolia,0,0,194,0
2020-06-11,Mongolia,3,0,197,0
2020-06-12,Mongolia,0,0,197,0
2020-06-13,Mongolia,0,0,197,0
2020-06-14,Mongolia,0,0,197,0
2020-06-15,Mongolia,0,0,197,0
2020-06-16,Mongolia,0,0,197,0
2020-06-17,Mongolia,4,0,201,0
2020-06-18,Mongolia,3,0,204,0
2020-06-19,Mongolia,0,0,204,0
2020-06-20,Mongolia,2,0,206,0
2020-06-21,Mongolia,7,0,213,0
2020-06-22,Mongolia,2,0,215,0
2020-06-23,Mongolia,0,0,215,0
2020-06-24,Mongolia,1,0,216,0
2020-06-25,Mongolia,3,0,219,0
2020-06-26,Mongolia,0,0,219,0
2020-06-27,Mongolia,0,0,219,0
2020-06-28,Mongolia,1,0,220,0
2020-06-29,Mongolia,0,0,220,0
2020-06-30,Mongolia,0,0,220,0
2020-07-01,Mongolia,0,0,220,0
2020-07-02,Mongolia,0,0,220,0
2020-07-03,Mongolia,0,0,220,0
2020-07-04,Mongolia,0,0,220,0
2020-07-05,Mongolia,0,0,220,0
2020-07-06,Mongolia,5,0,225,0
2020-07-07,Mongolia,2,0,227,0
2020-07-08,Mongolia,0,0,227,0
2020-07-09,Mongolia,0,0,227,0
2020-07-10,Mongolia,0,0,227,0
2020-07-11,Mongolia,3,0,230,0
2020-07-12,Mongolia,0,0,230,0
2020-07-13,Mongolia,13,0,243,0
2020-07-14,Mongolia,18,0,261,0
2020-07-15,Mongolia,0,0,261,0
2020-07-16,Mongolia,1,0,262,0
2020-07-17,Mongolia,25,0,287,0
2020-07-18,Mongolia,0,0,287,0
2020-07-19,Mongolia,0,0,287,0
2020-07-20,Mongolia,0,0,287,0
2020-07-21,Mongolia,0,0,287,0
2020-07-22,Mongolia,0,0,287,0
2020-07-23,Mongolia,1,0,288,0
2020-07-24,Mongolia,0,0,288,0
2020-07-25,Mongolia,0,0,288,0
2020-07-26,Mongolia,0,0,288,0
2020-07-27,Mongolia,1,0,289,0
2020-07-28,Mongolia,2,0,291,0
2020-07-29,Mongolia,0,0,291,0
2020-07-30,Mongolia,0,0,291,0
2020-07-31,Mongolia,0,0,291,0
2020-08-01,Mongolia,2,0,293,0
2020-08-02,Mongolia,0,0,293,0
2020-08-03,Mongolia,0,0,293,0
2020-08-04,Mongolia,0,0,293,0
2020-08-05,Mongolia,0,0,293,0
2020-08-06,Mongolia,0,0,293,0
2020-08-07,Mongolia,0,0,293,0
2020-08-08,Mongolia,0,0,293,0
2020-08-09,Mongolia,0,0,293,0
2020-08-10,Mongolia,0,0,293,0
2020-08-11,Mongolia,0,0,293,0
2020-08-12,Mongolia,4,0,297,0
2020-08-13,Mongolia,0,0,297,0
2020-08-14,Mongolia,1,0,298,0
2020-08-15,Mongolia,0,0,298,0
2020-08-16,Mongolia,0,0,298,0
2020-08-17,Mongolia,0,0,298,0
2020-08-18,Mongolia,0,0,298,0
2020-08-19,Mongolia,0,0,298,0
2020-08-20,Mongolia,0,0,298,0
2020-08-21,Mongolia,0,0,298,0
2020-08-22,Mongolia,0,0,298,0
2020-08-23,Mongolia,0,0,298,0
2020-08-24,Mongolia,0,0,298,0
2020-08-25,Mongolia,2,0,300,0
2020-08-26,Mongolia,1,0,301,0
2020-08-27,Mongolia,0,0,301,0
2020-08-28,Mongolia,0,0,301,0
2020-08-29,Mongolia,0,0,301,0
2020-08-30,Mongolia,0,0,301,0
2020-08-31,Mongolia,3,0,304,0
2020-09-01,Mongolia,2,0,306,0
2020-09-02,Mongolia,0,0,306,0
2020-09-03,Mongolia,4,0,310,0
2020-09-04,Mongolia,0,0,310,0
2020-09-05,Mongolia,0,0,310,0
2020-09-06,Mongolia,0,0,310,0
2020-09-07,Mongolia,0,0,310,0
2020-09-08,Mongolia,0,0,310,0
2020-09-09,Mongolia,0,0,310,0
2020-09-10,Mongolia,1,0,311,0
2020-09-11,Mongolia,0,0,311,0
2020-09-12,Mongolia,0,0,311,0
2020-09-13,Mongolia,0,0,311,0
2020-09-14,Mongolia,0,0,311,0
2020-09-15,Mongolia,0,0,311,0
2020-09-16,Mongolia,0,0,311,0
2020-09-17,Mongolia,0,0,311,0
2020-09-18,Mongolia,0,0,311,0
2020-09-19,Mongolia,1,0,312,0
2020-09-20,Mongolia,0,0,312,0
2020-09-21,Mongolia,1,0,313,0
2020-09-22,Mongolia,0,0,313,0
2020-09-23,Mongolia,0,0,313,0
2020-09-24,Mongolia,0,0,313,0
2020-09-25,Mongolia,0,0,313,0
2020-09-26,Mongolia,0,0,313,0
2020-09-27,Mongolia,0,0,313,0
2020-09-28,Mongolia,0,0,313,0
2020-09-29,Mongolia,0,0,313,0
2020-09-30,Mongolia,0,0,313,0
2020-10-01,Mongolia,0,0,313,0
2020-10-02,Mongolia,0,0,313,0
2020-10-03,Mongolia,0,0,313,0
2020-10-04,Mongolia,1,0,314,0
2020-10-05,Mongolia,1,0,315,0
2020-10-06,Mongolia,0,0,315,0
2020-10-07,Mongolia,0,0,315,0
2020-10-08,Mongolia,0,0,315,0
2020-10-09,Mongolia,0,0,315,0
2020-10-10,Mongolia,0,0,315,0
2020-10-11,Mongolia,3,0,318,0
2020-10-12,Mongolia,2,0,320,0
2020-10-13,Mongolia,0,0,320,0
2020-10-14,Mongolia,0,0,320,0
2020-10-15,Mongolia,0,0,320,0
2020-10-16,Mongolia,0,0,320,0
2020-10-17,Mongolia,0,0,320,0
2020-10-18,Mongolia,4,0,324,0
2020-10-19,Mongolia,2,0,326,0
2020-10-20,Mongolia,1,0,327,0
2020-10-21,Mongolia,1,0,328,0
2020-10-22,Mongolia,0,0,328,0
2020-10-23,Mongolia,0,0,328,0
2020-10-24,Mongolia,10,0,338,0
2020-10-25,Mongolia,1,0,339,0
2020-10-26,Mongolia,1,0,340,0
2020-10-27,Mongolia,0,0,340,0
2020-10-28,Mongolia,0,0,340,0
2020-10-29,Mongolia,0,0,340,0
2020-10-30,Mongolia,6,0,346,0
2020-10-31,Mongolia,0,0,346,0
2020-11-01,Mongolia,3,0,349,0
2020-11-02,Mongolia,1,0,350,0
2020-11-03,Mongolia,2,0,352,0
2020-11-04,Mongolia,1,0,353,0
2020-11-05,Mongolia,3,0,356,0
2020-11-06,Mongolia,1,0,357,0
2020-11-07,Mongolia,0,0,357,0
2020-11-08,Mongolia,5,0,362,0
2020-11-09,Mongolia,6,0,368,0
2020-11-10,Mongolia,14,0,382,0
2020-11-11,Mongolia,24,0,406,0
2020-11-12,Mongolia,6,0,412,0
2020-11-13,Mongolia,4,0,416,0
2020-11-14,Mongolia,12,0,428,0
2020-11-15,Mongolia,3,0,431,0
2020-11-16,Mongolia,3,0,434,0
2020-11-17,Mongolia,21,0,455,0
2020-11-18,Mongolia,50,0,505,0
2020-11-19,Mongolia,50,0,555,0
2020-11-20,Mongolia,23,0,578,0
2020-11-21,Mongolia,30,0,608,0
2020-11-22,Mongolia,32,0,640,0
2020-11-23,Mongolia,32,0,672,0
2020-11-24,Mongolia,27,0,699,0
2020-11-25,Mongolia,13,0,712,0
2020-11-26,Mongolia,26,0,738,0
2020-11-27,Mongolia,22,0,760,0
2020-11-28,Mongolia,24,0,784,0
2020-11-29,Mongolia,7,0,791,0
2020-11-30,Mongolia,10,0,801,0
2020-12-01,Mongolia,11,0,812,0
2020-12-02,Mongolia,7,0,819,0
2020-12-03,Mongolia,12,0,831,0
2020-12-04,Mongolia,11,0,842,0
2020-12-05,Mongolia,7,0,849,0
2020-12-06,Mongolia,38,0,887,0
2020-12-07,Mongolia,1,0,888,0
2020-12-08,Mongolia,5,0,893,0
2020-12-09,Mongolia,5,0,898,0
2020-12-10,Mongolia,7,0,905,0
2020-12-11,Mongolia,1,0,906,0
2020-12-12,Mongolia,1,0,907,0
2020-12-13,Mongolia,5,0,912,0
2020-12-14,Mongolia,5,0,917,0
2020-12-15,Mongolia,1,0,918,0
2020-12-16,Mongolia,5,0,923,0
2020-12-17,Mongolia,18,0,941,0
2020-12-18,Mongolia,12,0,953,0
2020-12-19,Mongolia,8,0,961,0
2020-12-20,Mongolia,32,0,993,0
2020-12-21,Mongolia,13,0,1006,0
2020-12-22,Mongolia,57,0,1063,0
2020-12-23,Mongolia,6,0,1069,0
2020-12-24,Mongolia,6,0,1075,0
2020-12-25,Mongolia,7,0,1082,0
2020-12-26,Mongolia,39,0,1121,0
2020-12-27,Mongolia,16,0,1137,0
2020-12-28,Mongolia,38,0,1175,0
2020-12-29,Mongolia,20,1,1195,1
2020-12-30,Mongolia,20,0,1215,1
2020-12-31,Mongolia,5,0,1220,1
2021-01-01,Mongolia,22,0,1242,1
2021-01-02,Mongolia,21,0,1263,1
2021-01-03,Mongolia,23,0,1286,1
2021-01-04,Mongolia,22,0,1308,1
2021-01-05,Mongolia,0,0,1308,1
2021-01-06,Mongolia,0,0,1308,1
2021-01-07,Mongolia,87,1,1395,2
2021-01-08,Mongolia,13,0,1408,2
2021-01-09,Mongolia,21,0,1429,2
2021-01-10,Mongolia,13,0,1442,2
2021-01-11,Mongolia,14,0,1456,2
2021-01-12,Mongolia,13,0,1469,2
2021-01-13,Mongolia,10,0,1479,2
2021-01-14,Mongolia,12,0,1491,2
2021-01-15,Mongolia,21,0,1512,2
2021-01-16,Mongolia,5,0,1517,2
2021-01-17,Mongolia,9,0,1526,2
2021-01-18,Mongolia,10,0,1536,2
2021-01-19,Mongolia,32,0,1568,2
2021-01-20,Mongolia,16,0,1584,2
2021-01-21,Mongolia,8,0,1592,2
2021-01-22,Mongolia,19,0,1611,2
2021-01-23,Mongolia,16,0,1627,2
2021-01-24,Mongolia,16,0,1643,2
2021-01-25,Mongolia,13,0,1656,2
2021-01-26,Mongolia,11,0,1667,2
2021-01-27,Mongolia,25,0,1692,2
2021-01-28,Mongolia,18,0,1710,2
2021-01-29,Mongolia,32,0,1742,2
2021-01-30,Mongolia,37,0,1779,2
2021-01-31,Mongolia,35,0,1814,2
2021-02-01,Mongolia,18,0,1832,2
2021-02-02,Mongolia,27,0,1859,2
2021-02-03,Mongolia,31,0,1890,2
2021-02-04,Mongolia,38,0,1928,2
2021-02-05,Mongolia,61,0,1989,2
2021-02-06,Mongolia,34,0,2023,2
2021-02-07,Mongolia,50,0,2073,2
2021-02-08,Mongolia,47,0,2120,2
2021-02-09,Mongolia,54,0,2174,2
2021-02-10,Mongolia,33,0,2207,2
2021-02-11,Mongolia,40,0,2247,2
2021-02-12,Mongolia,46,0,2293,2
2021-02-13,Mongolia,58,0,2351,2
2021-02-14,Mongolia,32,0,2383,2
2021-02-15,Mongolia,33,0,2416,2
2021-02-16,Mongolia,28,0,2444,2
2021-02-17,Mongolia,49,0,2493,2
2021-02-18,Mongolia,58,0,2551,2
2021-02-19,Mongolia,35,0,2586,2
2021-02-20,Mongolia,52,0,2638,2
2021-02-21,Mongolia,55,0,2693,2
2021-02-22,Mongolia,30,0,2723,2
2021-02-23,Mongolia,32,0,2755,2
2021-02-24,Mongolia,46,0,2801,2
2021-02-25,Mongolia,30,0,2831,2
2021-02-26,Mongolia,35,0,2866,2
2021-02-27,Mongolia,41,0,2907,2
2021-02-28,Mongolia,45,0,2952,2
2021-03-01,Mongolia,48,0,3000,2
2021-03-02,Mongolia,32,0,3032,2
2021-03-03,Mongolia,44,0,3076,2
2021-03-04,Mongolia,77,0,3153,2
2021-03-05,Mongolia,8,0,3161,2
2021-03-06,Mongolia,67,0,3228,2
2021-03-07,Mongolia,108,0,3336,2
2021-03-08,Mongolia,36,1,3372,3
2021-03-09,Mongolia,109,0,3481,3
2021-03-10,Mongolia,0,0,3481,3
2021-03-11,Mongolia,183,1,3664,4
2021-03-12,Mongolia,169,0,3833,4
2021-03-13,Mongolia,128,0,3961,4
2021-03-14,Mongolia,122,0,4083,4
2021-03-15,Mongolia,127,0,4210,4
2021-03-16,Mongolia,130,0,4340,4
2021-03-17,Mongolia,158,0,4498,4
2021-03-18,Mongolia,160,0,4658,4
2021-03-19,Mongolia,148,0,4806,4
2021-03-20,Mongolia,0,0,4806,4
2021-03-21,Mongolia,380,1,5186,5
2021-03-22,Mongolia,206,0,5392,5
2021-03-23,Mongolia,218,0,5610,5
2021-03-24,Mongolia,285,0,5895,5
2021-03-25,Mongolia,437,0,6332,5
2021-03-26,Mongolia,361,0,6693,5
2021-03-27,Mongolia,0,0,6693,5
2021-03-28,Mongolia,896,1,7589,6
2021-03-29,Mongolia,481,0,8070,6
2021-03-30,Mongolia,377,0,8447,6
2021-03-31,Mongolia,394,2,8841,8
2021-04-01,Mongolia,0,0,8841,8
2021-04-02,Mongolia,757,2,9598,10
2021-04-03,Mongolia,0,0,9598,10
2021-04-04,Mongolia,1222,1,10820,11
2021-04-05,Mongolia,831,2,11651,13
2021-04-06,Mongolia,0,0,11651,13
2021-04-07,Mongolia,575,4,12226,17
2021-04-08,Mongolia,1268,2,13494,19
2020-03-17,Montenegro,2,0,2,0
2020-03-18,Montenegro,0,0,2,0
2020-03-19,Montenegro,1,0,3,0
2020-03-20,Montenegro,11,0,14,0
2020-03-21,Montenegro,0,0,14,0
2020-03-22,Montenegro,7,0,21,0
2020-03-23,Montenegro,6,1,27,1
2020-03-24,Montenegro,20,0,47,1
2020-03-25,Montenegro,5,0,52,1
2020-03-26,Montenegro,17,0,69,1
2020-03-27,Montenegro,13,0,82,1
2020-03-28,Montenegro,2,0,84,1
2020-03-29,Montenegro,1,0,85,1
2020-03-30,Montenegro,6,0,91,1
2020-03-31,Montenegro,18,1,109,2
2020-04-01,Montenegro,14,0,123,2
2020-04-02,Montenegro,21,0,144,2
2020-04-03,Montenegro,30,0,174,2
2020-04-04,Montenegro,27,0,201,2
2020-04-05,Montenegro,13,0,214,2
2020-04-06,Montenegro,19,0,233,2
2020-04-07,Montenegro,8,0,241,2
2020-04-08,Montenegro,7,0,248,2
2020-04-09,Montenegro,4,0,252,2
2020-04-10,Montenegro,3,0,255,2
2020-04-11,Montenegro,8,0,263,2
2020-04-12,Montenegro,9,1,272,3
2020-04-13,Montenegro,2,0,274,3
2020-04-14,Montenegro,9,1,283,4
2020-04-15,Montenegro,5,0,288,4
2020-04-16,Montenegro,15,0,303,4
2020-04-17,Montenegro,0,1,303,5
2020-04-18,Montenegro,4,0,307,5
2020-04-19,Montenegro,1,0,308,5
2020-04-20,Montenegro,4,0,312,5
2020-04-21,Montenegro,1,0,313,5
2020-04-22,Montenegro,2,0,315,5
2020-04-23,Montenegro,1,0,316,5
2020-04-24,Montenegro,3,1,319,6
2020-04-25,Montenegro,1,0,320,6
2020-04-26,Montenegro,1,1,321,7
2020-04-27,Montenegro,0,0,321,7
2020-04-28,Montenegro,0,0,321,7
2020-04-29,Montenegro,1,0,322,7
2020-04-30,Montenegro,0,0,322,7
2020-05-01,Montenegro,0,0,322,7
2020-05-02,Montenegro,0,1,322,8
2020-05-03,Montenegro,0,0,322,8
2020-05-04,Montenegro,1,0,323,8
2020-05-05,Montenegro,1,0,324,8
2020-05-06,Montenegro,0,0,324,8
2020-05-07,Montenegro,0,0,324,8
2020-05-08,Montenegro,0,0,324,8
2020-05-09,Montenegro,0,0,324,8
2020-05-10,Montenegro,0,1,324,9
2020-05-11,Montenegro,0,0,324,9
2020-05-12,Montenegro,0,0,324,9
2020-05-13,Montenegro,0,0,324,9
2020-05-14,Montenegro,0,0,324,9
2020-05-15,Montenegro,0,0,324,9
2020-05-16,Montenegro,0,0,324,9
2020-05-17,Montenegro,0,0,324,9
2020-05-18,Montenegro,0,0,324,9
2020-05-19,Montenegro,0,0,324,9
2020-05-20,Montenegro,0,0,324,9
2020-05-21,Montenegro,0,0,324,9
2020-05-22,Montenegro,0,0,324,9
2020-05-23,Montenegro,0,0,324,9
2020-05-24,Montenegro,0,0,324,9
2020-05-25,Montenegro,0,0,324,9
2020-05-26,Montenegro,0,0,324,9
2020-05-27,Montenegro,0,0,324,9
2020-05-28,Montenegro,0,0,324,9
2020-05-29,Montenegro,0,0,324,9
2020-05-30,Montenegro,0,0,324,9
2020-05-31,Montenegro,0,0,324,9
2020-06-01,Montenegro,0,0,324,9
2020-06-02,Montenegro,0,0,324,9
2020-06-03,Montenegro,0,0,324,9
2020-06-04,Montenegro,0,0,324,9
2020-06-05,Montenegro,0,0,324,9
2020-06-06,Montenegro,0,0,324,9
2020-06-07,Montenegro,0,0,324,9
2020-06-08,Montenegro,0,0,324,9
2020-06-09,Montenegro,0,0,324,9
2020-06-10,Montenegro,0,0,324,9
2020-06-11,Montenegro,0,0,324,9
2020-06-12,Montenegro,0,0,324,9
2020-06-13,Montenegro,0,0,324,9
2020-06-14,Montenegro,1,0,325,9
2020-06-15,Montenegro,1,0,326,9
2020-06-16,Montenegro,0,0,326,9
2020-06-17,Montenegro,7,0,333,9
2020-06-18,Montenegro,4,0,337,9
2020-06-19,Montenegro,18,0,355,9
2020-06-20,Montenegro,4,0,359,9
2020-06-21,Montenegro,3,0,362,9
2020-06-22,Montenegro,5,0,367,9
2020-06-23,Montenegro,11,0,378,9
2020-06-24,Montenegro,11,0,389,9
2020-06-25,Montenegro,25,0,414,9
2020-06-26,Montenegro,25,0,439,9
2020-06-27,Montenegro,30,0,469,9
2020-06-28,Montenegro,12,2,481,11
2020-06-29,Montenegro,20,0,501,11
2020-06-30,Montenegro,47,1,548,12
2020-07-01,Montenegro,28,0,576,12
2020-07-02,Montenegro,40,0,616,12
2020-07-03,Montenegro,47,1,663,13
2020-07-04,Montenegro,57,1,720,14
2020-07-05,Montenegro,61,0,781,14
2020-07-06,Montenegro,60,0,841,14
2020-07-07,Montenegro,66,3,907,17
2020-07-08,Montenegro,53,0,960,17
2020-07-09,Montenegro,59,2,1019,19
2020-07-10,Montenegro,0,0,1019,19
2020-07-11,Montenegro,145,4,1164,23
2020-07-12,Montenegro,57,0,1221,23
2020-07-13,Montenegro,66,1,1287,24
2020-07-14,Montenegro,0,0,1287,24
2020-07-15,Montenegro,0,0,1287,24
2020-07-16,Montenegro,0,0,1287,24
2020-07-17,Montenegro,678,2,1965,26
2020-07-18,Montenegro,107,4,2072,30
2020-07-19,Montenegro,116,2,2188,32
2020-07-20,Montenegro,0,0,2188,32
2020-07-21,Montenegro,193,3,2381,35
2020-07-22,Montenegro,91,4,2472,39
2020-07-23,Montenegro,97,1,2569,40
2020-07-24,Montenegro,96,3,2665,43
2020-07-25,Montenegro,82,0,2747,43
2020-07-26,Montenegro,52,0,2799,43
2020-07-27,Montenegro,94,2,2893,45
2020-07-28,Montenegro,56,0,2949,45
2020-07-29,Montenegro,67,2,3016,47
2020-07-30,Montenegro,0,0,3016,47
2020-07-31,Montenegro,57,1,3073,48
2020-08-01,Montenegro,125,2,3198,50
2020-08-02,Montenegro,60,1,3258,51
2020-08-03,Montenegro,43,1,3301,52
2020-08-04,Montenegro,60,1,3361,53
2020-08-05,Montenegro,50,4,3411,57
2020-08-06,Montenegro,69,3,3480,60
2020-08-07,Montenegro,69,1,3549,61
2020-08-08,Montenegro,39,1,3588,62
2020-08-09,Montenegro,30,2,3618,64
2020-08-10,Montenegro,78,4,3696,68
2020-08-11,Montenegro,52,3,3748,71
2020-08-12,Montenegro,65,2,3813,73
2020-08-13,Montenegro,44,0,3857,73
2020-08-14,Montenegro,73,0,3930,73
2020-08-15,Montenegro,30,2,3960,75
2020-08-16,Montenegro,75,2,4035,77
2020-08-17,Montenegro,50,3,4085,80
2020-08-18,Montenegro,47,0,4132,80
2020-08-19,Montenegro,42,0,4174,80
2020-08-20,Montenegro,55,1,4229,81
2020-08-21,Montenegro,48,1,4277,82
2020-08-22,Montenegro,36,2,4313,84
2020-08-23,Montenegro,30,0,4343,84
2020-08-24,Montenegro,35,0,4378,84
2020-08-25,Montenegro,66,3,4444,87
2020-08-26,Montenegro,55,1,4499,88
2020-08-27,Montenegro,59,1,4558,89
2020-08-28,Montenegro,105,3,4663,92
2020-08-29,Montenegro,64,1,4727,93
2020-08-30,Montenegro,63,5,4790,98
2020-08-31,Montenegro,45,2,4835,100
2020-09-01,Montenegro,82,2,4917,102
2020-09-02,Montenegro,102,2,5019,104
2020-09-03,Montenegro,146,0,5165,104
2020-09-04,Montenegro,110,2,5275,106
2020-09-05,Montenegro,147,1,5422,107
2020-09-06,Montenegro,131,1,5553,108
2020-09-07,Montenegro,106,1,5659,109
2020-09-08,Montenegro,216,3,5875,112
2020-09-09,Montenegro,219,2,6094,114
2020-09-10,Montenegro,128,0,6222,114
2020-09-11,Montenegro,163,1,6385,115
2020-09-12,Montenegro,145,3,6530,118
2020-09-13,Montenegro,182,2,6712,120
2020-09-14,Montenegro,188,1,6900,121
2020-09-15,Montenegro,161,2,7061,123
2020-09-16,Montenegro,230,3,7291,126
2020-09-17,Montenegro,212,3,7503,129
2020-09-18,Montenegro,208,4,7711,133
2020-09-19,Montenegro,187,1,7898,134
2020-09-20,Montenegro,714,2,8612,136
2020-09-21,Montenegro,230,2,8842,138
2020-09-22,Montenegro,296,8,9138,146
2020-09-23,Montenegro,290,5,9428,151
2020-09-24,Montenegro,289,3,9717,154
2020-09-25,Montenegro,245,1,9962,155
2020-09-26,Montenegro,235,3,10197,158
2020-09-27,Montenegro,116,0,10313,158
2020-09-28,Montenegro,128,5,10441,163
2020-09-29,Montenegro,134,1,10575,164
2020-09-30,Montenegro,197,5,10772,169
2020-10-01,Montenegro,215,1,10987,170
2020-10-02,Montenegro,703,2,11690,172
2020-10-03,Montenegro,244,2,11934,174
2020-10-04,Montenegro,193,5,12127,179
2020-10-05,Montenegro,232,3,12359,182
2020-10-06,Montenegro,225,6,12584,188
2020-10-07,Montenegro,210,2,12794,190
2020-10-08,Montenegro,210,1,13004,191
2020-10-09,Montenegro,344,3,13348,194
2020-10-10,Montenegro,293,4,13641,198
2020-10-11,Montenegro,228,4,13869,202
2020-10-12,Montenegro,181,9,14050,211
2020-10-13,Montenegro,218,2,14268,213
2020-10-14,Montenegro,193,4,14461,217
2020-10-15,Montenegro,211,4,14672,221
2020-10-16,Montenegro,609,7,15281,228
2020-10-17,Montenegro,146,3,15427,231
2020-10-18,Montenegro,188,5,15615,236
2020-10-19,Montenegro,145,4,15760,240
2020-10-20,Montenegro,132,7,15892,247
2020-10-21,Montenegro,177,3,16069,250
2020-10-22,Montenegro,190,3,16259,253
2020-10-23,Montenegro,177,2,16436,255
2020-10-24,Montenegro,193,8,16629,263
2020-10-25,Montenegro,168,3,16797,266
2020-10-26,Montenegro,112,4,16909,270
2020-10-27,Montenegro,182,5,17091,275
2020-10-28,Montenegro,301,7,17392,282
2020-10-29,Montenegro,354,8,17746,290
2020-10-30,Montenegro,320,4,18066,294
2020-10-31,Montenegro,275,7,18341,301
2020-11-01,Montenegro,373,12,18714,313
2020-11-02,Montenegro,496,7,19210,320
2020-11-03,Montenegro,767,2,19977,322
2020-11-04,Montenegro,874,4,20851,326
2020-11-05,Montenegro,682,2,21533,328
2020-11-06,Montenegro,546,0,22079,328
2020-11-07,Montenegro,300,5,22379,333
2020-11-08,Montenegro,426,4,22805,337
2020-11-09,Montenegro,803,5,23608,342
2020-11-10,Montenegro,546,7,24154,349
2020-11-11,Montenegro,711,7,24865,356
2020-11-12,Montenegro,644,8,25509,364
2020-11-13,Montenegro,600,13,26109,377
2020-11-14,Montenegro,577,8,26686,385
2020-11-15,Montenegro,491,6,27177,391
2020-11-16,Montenegro,596,5,27773,396
2020-11-17,Montenegro,619,9,28392,405
2020-11-18,Montenegro,639,9,29031,414
2020-11-19,Montenegro,546,6,29577,420
2020-11-20,Montenegro,502,9,30079,429
2020-11-21,Montenegro,574,5,30653,434
2020-11-22,Montenegro,409,5,31062,439
2020-11-23,Montenegro,556,5,31618,444
2020-11-24,Montenegro,570,6,32188,450
2020-11-25,Montenegro,620,9,32808,459
2020-11-26,Montenegro,508,10,33316,469
2020-11-27,Montenegro,520,5,33836,474
2020-11-28,Montenegro,618,7,34454,481
2020-11-29,Montenegro,427,6,34881,487
2020-11-30,Montenegro,384,12,35265,499
2020-12-01,Montenegro,584,5,35849,504
2020-12-02,Montenegro,502,6,36351,510
2020-12-03,Montenegro,581,6,36932,516
2020-12-04,Montenegro,535,6,37467,522
2020-12-05,Montenegro,412,8,37879,530
2020-12-06,Montenegro,367,3,38246,533
2020-12-07,Montenegro,316,10,38562,543
2020-12-08,Montenegro,591,6,39153,549
2020-12-09,Montenegro,454,7,39607,556
2020-12-10,Montenegro,558,10,40165,566
2020-12-11,Montenegro,381,3,40546,569
2020-12-12,Montenegro,402,9,40948,578
2020-12-13,Montenegro,478,4,41426,582
2020-12-14,Montenegro,377,3,41803,585
2020-12-15,Montenegro,345,12,42148,597
2020-12-16,Montenegro,415,13,42563,610
2020-12-17,Montenegro,432,4,42995,614
2020-12-18,Montenegro,395,6,43390,620
2020-12-19,Montenegro,319,4,43709,624
2020-12-20,Montenegro,246,2,43955,626
2020-12-21,Montenegro,329,4,44284,630
2020-12-22,Montenegro,258,7,44542,637
2020-12-23,Montenegro,520,2,45062,639
2020-12-24,Montenegro,361,9,45423,648
2020-12-25,Montenegro,522,4,45945,652
2020-12-26,Montenegro,382,6,46327,658
2020-12-27,Montenegro,367,8,46694,666
2020-12-28,Montenegro,275,9,46969,675
2020-12-29,Montenegro,435,2,47404,677
2020-12-30,Montenegro,378,4,47782,681
2020-12-31,Montenegro,465,1,48247,682
2021-01-01,Montenegro,342,2,48589,684
2021-01-02,Montenegro,267,0,48856,684
2021-01-03,Montenegro,339,5,49195,689
2021-01-04,Montenegro,435,3,49630,692
2021-01-05,Montenegro,424,7,50054,699
2021-01-06,Montenegro,643,6,50697,705
2021-01-07,Montenegro,463,7,51160,712
2021-01-08,Montenegro,436,6,51596,718
2021-01-09,Montenegro,403,3,51999,721
2021-01-10,Montenegro,432,4,52431,725
2021-01-11,Montenegro,388,4,52819,729
2021-01-12,Montenegro,519,1,53338,730
2021-01-13,Montenegro,502,7,53840,737
2021-01-14,Montenegro,476,3,54316,740
2021-01-15,Montenegro,414,1,54730,741
2021-01-16,Montenegro,406,2,55136,743
2021-01-17,Montenegro,357,2,55493,745
2021-01-18,Montenegro,310,1,55803,746
2021-01-19,Montenegro,425,3,56228,749
2021-01-20,Montenegro,351,9,56579,758
2021-01-21,Montenegro,419,4,56998,762
2021-01-22,Montenegro,484,3,57482,765
2021-01-23,Montenegro,447,1,57929,766
2021-01-24,Montenegro,387,2,58316,768
2021-01-25,Montenegro,381,2,58697,770
2021-01-26,Montenegro,565,7,59262,777
2021-01-27,Montenegro,563,6,59825,783
2021-01-28,Montenegro,463,7,60288,790
2021-01-29,Montenegro,539,10,60827,800
2021-01-30,Montenegro,375,2,61202,802
2021-01-31,Montenegro,457,3,61659,805
2021-02-01,Montenegro,313,6,61972,811
2021-02-02,Montenegro,504,7,62476,818
2021-02-03,Montenegro,642,7,63118,825
2021-02-04,Montenegro,515,1,63633,826
2021-02-05,Montenegro,535,5,64168,831
2021-02-06,Montenegro,571,5,64739,836
2021-02-07,Montenegro,488,2,65227,838
2021-02-08,Montenegro,430,4,65657,842
2021-02-09,Montenegro,577,10,66234,852
2021-02-10,Montenegro,623,9,66857,861
2021-02-11,Montenegro,584,8,67441,869
2021-02-12,Montenegro,563,11,68004,880
2021-02-13,Montenegro,472,2,68476,882
2021-02-14,Montenegro,445,8,68921,890
2021-02-15,Montenegro,373,9,69294,899
2021-02-16,Montenegro,476,11,69770,910
2021-02-17,Montenegro,404,6,70174,916
2021-02-18,Montenegro,484,10,70658,926
2021-02-19,Montenegro,454,6,71112,932
2021-02-20,Montenegro,481,7,71593,939
2021-02-21,Montenegro,402,11,71995,950
2021-02-22,Montenegro,400,7,72395,957
2021-02-23,Montenegro,574,12,72969,969
2021-02-24,Montenegro,643,7,73612,976
2021-02-25,Montenegro,571,11,74183,987
2021-02-26,Montenegro,606,7,74789,994
2021-02-27,Montenegro,543,5,75332,999
2021-02-28,Montenegro,502,4,75834,1003
2021-03-01,Montenegro,449,12,76283,1015
2021-03-02,Montenegro,585,8,76868,1023
2021-03-03,Montenegro,625,8,77493,1031
2021-03-04,Montenegro,567,8,78060,1039
2021-03-05,Montenegro,574,9,78634,1048
2021-03-06,Montenegro,603,11,79237,1059
2021-03-07,Montenegro,537,8,79774,1067
2021-03-08,Montenegro,417,18,80191,1085
2021-03-09,Montenegro,612,7,80803,1092
2021-03-10,Montenegro,654,8,81457,1100
2021-03-11,Montenegro,572,13,82029,1113
2021-03-12,Montenegro,581,4,82610,1117
2021-03-13,Montenegro,555,5,83165,1122
2021-03-14,Montenegro,528,7,83693,1129
2021-03-15,Montenegro,470,7,84163,1136
2021-03-16,Montenegro,537,15,84700,1151
2021-03-17,Montenegro,553,18,85253,1169
2021-03-18,Montenegro,521,9,85774,1178
2021-03-19,Montenegro,508,6,86282,1184
2021-03-20,Montenegro,500,10,86782,1194
2021-03-21,Montenegro,430,5,87212,1199
2021-03-22,Montenegro,426,9,87638,1208
2021-03-23,Montenegro,478,12,88116,1220
2021-03-24,Montenegro,434,4,88550,1224
2021-03-25,Montenegro,441,6,88991,1230
2021-03-26,Montenegro,372,4,89363,1234
2021-03-27,Montenegro,369,7,89732,1241
2021-03-28,Montenegro,351,4,90083,1245
2021-03-29,Montenegro,335,11,90418,1256
2021-03-30,Montenegro,414,10,90832,1266
2021-03-31,Montenegro,386,8,91218,1274
2021-04-01,Montenegro,355,12,91573,1286
2021-04-02,Montenegro,333,10,91906,1296
2021-04-03,Montenegro,316,7,92222,1303
2021-04-04,Montenegro,297,2,92519,1305
2021-04-05,Montenegro,221,12,92740,1317
2021-04-06,Montenegro,290,9,93030,1326
2021-04-07,Montenegro,279,8,93309,1334
2021-04-08,Montenegro,257,11,93566,1345
2020-03-02,Morocco,1,0,1,0
2020-03-03,Morocco,0,0,1,0
2020-03-04,Morocco,0,0,1,0
2020-03-05,Morocco,1,0,2,0
2020-03-06,Morocco,0,0,2,0
2020-03-07,Morocco,0,0,2,0
2020-03-08,Morocco,0,0,2,0
2020-03-09,Morocco,0,0,2,0
2020-03-10,Morocco,1,1,3,1
2020-03-11,Morocco,2,0,5,1
2020-03-12,Morocco,1,0,6,1
2020-03-13,Morocco,1,0,7,1
2020-03-14,Morocco,10,0,17,1
2020-03-15,Morocco,11,0,28,1
2020-03-16,Morocco,1,0,29,1
2020-03-17,Morocco,9,1,38,2
2020-03-18,Morocco,11,0,49,2
2020-03-19,Morocco,14,0,63,2
2020-03-20,Morocco,14,1,77,3
2020-03-21,Morocco,19,0,96,3
2020-03-22,Morocco,19,1,115,4
2020-03-23,Morocco,28,0,143,4
2020-03-24,Morocco,27,1,170,5
2020-03-25,Morocco,55,1,225,6
2020-03-26,Morocco,50,5,275,11
2020-03-27,Morocco,70,12,345,23
2020-03-28,Morocco,57,2,402,25
2020-03-29,Morocco,77,1,479,26
2020-03-30,Morocco,77,7,556,33
2020-03-31,Morocco,61,3,617,36
2020-04-01,Morocco,37,3,654,39
2020-04-02,Morocco,54,5,708,44
2020-04-03,Morocco,83,4,791,48
2020-04-04,Morocco,128,11,919,59
2020-04-05,Morocco,102,11,1021,70
2020-04-06,Morocco,99,10,1120,80
2020-04-07,Morocco,64,10,1184,90
2020-04-08,Morocco,91,3,1275,93
2020-04-09,Morocco,99,4,1374,97
2020-04-10,Morocco,74,10,1448,107
2020-04-11,Morocco,97,4,1545,111
2020-04-12,Morocco,116,7,1661,118
2020-04-13,Morocco,102,8,1763,126
2020-04-14,Morocco,125,0,1888,126
2020-04-15,Morocco,136,1,2024,127
2020-04-16,Morocco,259,3,2283,130
2020-04-17,Morocco,281,5,2564,135
2020-04-18,Morocco,121,2,2685,137
2020-04-19,Morocco,170,4,2855,141
2020-04-20,Morocco,191,2,3046,143
2020-04-21,Morocco,163,2,3209,145
2020-04-22,Morocco,237,4,3446,149
2020-04-23,Morocco,122,6,3568,155
2020-04-24,Morocco,190,3,3758,158
2020-04-25,Morocco,139,1,3897,159
2020-04-26,Morocco,168,2,4065,161
2020-04-27,Morocco,55,1,4120,162
2020-04-28,Morocco,132,3,4252,165
2020-04-29,Morocco,69,3,4321,168
2020-04-30,Morocco,102,2,4423,170
2020-05-01,Morocco,146,1,4569,171
2020-05-02,Morocco,160,2,4729,173
2020-05-03,Morocco,174,1,4903,174
2020-05-04,Morocco,150,5,5053,179
2020-05-05,Morocco,166,2,5219,181
2020-05-06,Morocco,189,2,5408,183
2020-05-07,Morocco,140,0,5548,183
2020-05-08,Morocco,163,3,5711,186
2020-05-09,Morocco,199,0,5910,186
2020-05-10,Morocco,153,2,6063,188
2020-05-11,Morocco,218,0,6281,188
2020-05-12,Morocco,137,0,6418,188
2020-05-13,Morocco,94,0,6512,188
2020-05-14,Morocco,95,2,6607,190
2020-05-15,Morocco,45,0,6652,190
2020-05-16,Morocco,89,2,6741,192
2020-05-17,Morocco,129,0,6870,192
2020-05-18,Morocco,82,0,6952,192
2020-05-19,Morocco,71,1,7023,193
2020-05-20,Morocco,110,1,7133,194
2020-05-21,Morocco,78,2,7211,196
2020-05-22,Morocco,121,1,7332,197
2020-05-23,Morocco,74,1,7406,198
2020-05-24,Morocco,27,1,7433,199
2020-05-25,Morocco,99,1,7532,200
2020-05-26,Morocco,45,2,7577,202
2020-05-27,Morocco,24,0,7601,202
2020-05-28,Morocco,42,0,7643,202
2020-05-29,Morocco,71,0,7714,202
2020-05-30,Morocco,66,2,7780,204
2020-05-31,Morocco,27,1,7807,205
2020-06-01,Morocco,26,0,7833,205
2020-06-02,Morocco,33,1,7866,206
2020-06-03,Morocco,56,0,7922,206
2020-06-04,Morocco,81,2,8003,208
2020-06-05,Morocco,68,0,8071,208
2020-06-06,Morocco,80,0,8151,208
2020-06-07,Morocco,73,0,8224,208
2020-06-08,Morocco,78,0,8302,208
2020-06-09,Morocco,135,2,8437,210
2020-06-10,Morocco,71,1,8508,211
2020-06-11,Morocco,29,0,8537,211
2020-06-12,Morocco,73,1,8610,212
2020-06-13,Morocco,82,0,8692,212
2020-06-14,Morocco,101,0,8793,212
2020-06-15,Morocco,92,0,8885,212
2020-06-16,Morocco,46,0,8931,212
2020-06-17,Morocco,66,1,8997,213
2020-06-18,Morocco,77,0,9074,213
2020-06-19,Morocco,539,0,9613,213
2020-06-20,Morocco,226,0,9839,213
2020-06-21,Morocco,138,1,9977,214
2020-06-22,Morocco,195,0,10172,214
2020-06-23,Morocco,172,0,10344,214
2020-06-24,Morocco,563,2,10907,216
2020-06-25,Morocco,431,1,11338,217
2020-06-26,Morocco,295,1,11633,218
2020-06-27,Morocco,244,2,11877,220
2020-06-28,Morocco,175,1,12052,221
2020-06-29,Morocco,238,4,12290,225
2020-06-30,Morocco,243,3,12533,228
2020-07-01,Morocco,103,0,12636,228
2020-07-02,Morocco,333,1,12969,229
2020-07-03,Morocco,319,1,13288,230
2020-07-04,Morocco,534,2,13822,232
2020-07-05,Morocco,393,3,14215,235
2020-07-06,Morocco,164,2,14379,237
2020-07-07,Morocco,228,3,14607,240
2020-07-08,Morocco,164,2,14771,242
2020-07-09,Morocco,308,0,15079,242
2020-07-10,Morocco,249,1,15328,243
2020-07-11,Morocco,214,2,15542,245
2020-07-12,Morocco,203,5,15745,250
2020-07-13,Morocco,191,5,15936,255
2020-07-14,Morocco,161,2,16097,257
2020-07-15,Morocco,165,2,16262,259
2020-07-16,Morocco,283,4,16545,263
2020-07-17,Morocco,181,1,16726,264
2020-07-18,Morocco,289,5,17015,269
2020-07-19,Morocco,221,4,17236,273
2020-07-20,Morocco,326,3,17562,276
2020-07-21,Morocco,180,4,17742,280
2020-07-22,Morocco,220,5,17962,285
2020-07-23,Morocco,302,7,18264,292
2020-07-24,Morocco,570,7,18834,299
2020-07-25,Morocco,811,6,19645,305
2020-07-26,Morocco,633,8,20278,313
2020-07-27,Morocco,609,3,20887,316
2020-07-28,Morocco,500,11,21387,327
2020-07-29,Morocco,826,7,22213,334
2020-07-30,Morocco,1046,12,23259,346
2020-07-31,Morocco,1063,7,24322,353
2020-08-01,Morocco,693,14,25015,367
2020-08-02,Morocco,522,15,25537,382
2020-08-03,Morocco,659,19,26196,401
2020-08-04,Morocco,1021,16,27217,417
2020-08-05,Morocco,1283,18,28500,435
2020-08-06,Morocco,1144,14,29644,449
2020-08-07,Morocco,1018,12,30662,461
2020-08-08,Morocco,1345,19,32007,480
2020-08-09,Morocco,1230,18,33237,498
2020-08-10,Morocco,826,18,34063,516
2020-08-11,Morocco,1132,17,35195,533
2020-08-12,Morocco,1499,23,36694,556
2020-08-13,Morocco,1241,28,37935,584
2020-08-14,Morocco,1306,27,39241,611
2020-08-15,Morocco,1776,21,41017,632
2020-08-16,Morocco,1472,26,42489,658
2020-08-17,Morocco,1069,23,43558,681
2020-08-18,Morocco,1245,33,44803,714
2020-08-19,Morocco,1510,29,46313,743
2020-08-20,Morocco,1325,32,47638,775
2020-08-21,Morocco,1609,42,49247,817
2020-08-22,Morocco,1565,41,50812,858
2020-08-23,Morocco,1537,30,52349,888
2020-08-24,Morocco,903,32,53252,920
2020-08-25,Morocco,1276,35,54528,955
2020-08-26,Morocco,1336,29,55864,984
2020-08-27,Morocco,1221,27,57085,1011
2020-08-28,Morocco,1404,41,58489,1052
2020-08-29,Morocco,1567,26,60056,1078
2020-08-30,Morocco,1343,33,61399,1111
2020-08-31,Morocco,1191,30,62590,1141
2020-09-01,Morocco,1191,43,63781,1184
2020-09-02,Morocco,1672,32,65453,1216
2020-09-03,Morocco,1402,37,66855,1253
2020-09-04,Morocco,1750,39,68605,1292
2020-09-05,Morocco,1555,37,70160,1329
2020-09-06,Morocco,2234,32,72394,1361
2020-09-07,Morocco,1386,33,73780,1394
2020-09-08,Morocco,1941,33,75721,1427
2020-09-09,Morocco,2157,26,77878,1453
2020-09-10,Morocco,1889,38,79767,1491
2020-09-11,Morocco,2430,33,82197,1524
2020-09-12,Morocco,2238,29,84435,1553
2020-09-13,Morocco,2251,25,86686,1578
2020-09-14,Morocco,1517,36,88203,1614
2020-09-15,Morocco,2121,34,90324,1648
2020-09-16,Morocco,1692,38,92016,1686
2020-09-17,Morocco,2488,28,94504,1714
2020-09-18,Morocco,2760,41,97264,1755
2020-09-19,Morocco,2552,40,99816,1795
2020-09-20,Morocco,1927,35,101743,1830
2020-09-21,Morocco,1376,25,103119,1855
2020-09-22,Morocco,2227,34,105346,1889
2020-09-23,Morocco,2397,29,107743,1918
2020-09-24,Morocco,2356,38,110099,1956
2020-09-25,Morocco,2423,42,112522,1998
2020-09-26,Morocco,2719,43,115241,2041
2020-09-27,Morocco,2444,28,117685,2069
2020-09-28,Morocco,1422,44,119107,2113
2020-09-29,Morocco,2076,39,121183,2152
2020-09-30,Morocco,2470,42,123653,2194
2020-10-01,Morocco,2391,35,126044,2229
2020-10-02,Morocco,2521,34,128565,2263
2020-10-03,Morocco,2663,30,131228,2293
2020-10-04,Morocco,2044,37,133272,2330
2020-10-05,Morocco,1423,39,134695,2369
2020-10-06,Morocco,2553,41,137248,2410
2020-10-07,Morocco,2776,29,140024,2439
2020-10-08,Morocco,2929,47,142953,2486
2020-10-09,Morocco,3445,44,146398,2530
2020-10-10,Morocco,3443,42,149841,2572
2020-10-11,Morocco,2563,33,152404,2605
2020-10-12,Morocco,1357,31,153761,2636
2020-10-13,Morocco,3185,49,156946,2685
2020-10-14,Morocco,3387,41,160333,2726
2020-10-15,Morocco,3317,46,163650,2772
2020-10-16,Morocco,3498,46,167148,2818
2020-10-17,Morocco,3763,60,170911,2878
2020-10-18,Morocco,2721,50,173632,2928
2020-10-19,Morocco,2117,48,175749,2976
2020-10-20,Morocco,3254,51,179003,3027
2020-10-21,Morocco,3577,52,182580,3079
2020-10-22,Morocco,4151,53,186731,3132
2020-10-23,Morocco,3685,73,190416,3205
2020-10-24,Morocco,4045,50,194461,3255
2020-10-25,Morocco,3020,46,197481,3301
2020-10-26,Morocco,2264,72,199745,3373
2020-10-27,Morocco,3988,72,203733,3445
2020-10-28,Morocco,3985,61,207718,3506
2020-10-29,Morocco,4320,66,212038,3572
2020-10-30,Morocco,3256,53,215294,3625
2020-10-31,Morocco,3790,70,219084,3695
2020-11-01,Morocco,3460,67,222544,3762
2020-11-02,Morocco,2526,64,225070,3826
2020-11-03,Morocco,4495,74,229565,3900
2020-11-04,Morocco,5745,82,235310,3982
2020-11-05,Morocco,5641,77,240951,4059
2020-11-06,Morocco,5398,68,246349,4127
2020-11-07,Morocco,5836,70,252185,4197
2020-11-08,Morocco,4596,75,256781,4272
2020-11-09,Morocco,3170,84,259951,4356
2020-11-10,Morocco,5214,69,265165,4425
2020-11-11,Morocco,5461,81,270626,4506
2020-11-12,Morocco,6195,64,276821,4570
2020-11-13,Morocco,5515,61,282336,4631
2020-11-14,Morocco,5875,66,288211,4697
2020-11-15,Morocco,4966,82,293177,4779
2020-11-16,Morocco,3012,71,296189,4850
2020-11-17,Morocco,5415,82,301604,4932
2020-11-18,Morocco,5391,81,306995,5013
2020-11-19,Morocco,4559,77,311554,5090
2020-11-20,Morocco,4706,92,316260,5182
2020-11-21,Morocco,4702,74,320962,5256
2020-11-22,Morocco,3979,60,324941,5316
2020-11-23,Morocco,2587,80,327528,5396
2020-11-24,Morocco,3999,73,331527,5469
2020-11-25,Morocco,4979,70,336506,5539
2020-11-26,Morocco,4178,80,340684,5619
2020-11-27,Morocco,4592,70,345276,5689
2020-11-28,Morocco,4412,50,349688,5739
2020-11-29,Morocco,4115,50,353803,5789
2020-11-30,Morocco,2533,57,356336,5846
2020-12-01,Morocco,3508,69,359844,5915
2020-12-02,Morocco,4346,70,364190,5985
2020-12-03,Morocco,4434,78,368624,6063
2020-12-04,Morocco,3996,73,372620,6136
2020-12-05,Morocco,4118,48,376738,6184
2020-12-06,Morocco,2919,61,379657,6245
2020-12-07,Morocco,1531,75,381188,6320
2020-12-08,Morocco,2900,50,384088,6370
2020-12-09,Morocco,4096,57,388184,6427
2020-12-10,Morocco,3345,65,391529,6492
2020-12-11,Morocco,3035,50,394564,6542
2020-12-12,Morocco,3033,47,397597,6589
2020-12-13,Morocco,2012,35,399609,6624
2020-12-14,Morocco,1217,35,400826,6659
2020-12-15,Morocco,2793,52,403619,6711
2020-12-16,Morocco,3351,38,406970,6749
2020-12-17,Morocco,2776,55,409746,6804
2020-12-18,Morocco,2647,50,412393,6854
2020-12-19,Morocco,2833,55,415226,6909
2020-12-20,Morocco,1899,48,417125,6957
2020-12-21,Morocco,877,43,418002,7000
2020-12-22,Morocco,2646,30,420648,7030
2020-12-23,Morocco,2566,56,423214,7086
2020-12-24,Morocco,2650,44,425864,7130
2020-12-25,Morocco,2329,40,428193,7170
2020-12-26,Morocco,2369,34,430562,7204
2020-12-27,Morocco,1517,36,432079,7240
2020-12-28,Morocco,950,32,433029,7272
2020-12-29,Morocco,2160,42,435189,7314
2020-12-30,Morocco,2143,41,437332,7355
2020-12-31,Morocco,1861,33,439193,7388
2021-01-01,Morocco,1777,37,440970,7425
2021-01-02,Morocco,1171,27,442141,7452
2021-01-03,Morocco,1005,33,443146,7485
2021-01-04,Morocco,656,53,443802,7538
2021-01-05,Morocco,1637,43,445439,7581
2021-01-06,Morocco,1642,37,447081,7618
2021-01-07,Morocco,1597,27,448678,7645
2021-01-08,Morocco,1543,40,450221,7685
2021-01-09,Morocco,1416,24,451637,7709
2021-01-10,Morocco,895,34,452532,7743
2021-01-11,Morocco,456,24,452988,7767
2021-01-12,Morocco,801,17,453789,7784
2021-01-13,Morocco,1266,26,455055,7810
2021-01-14,Morocco,1279,44,456334,7854
2021-01-15,Morocco,1291,34,457625,7888
2021-01-16,Morocco,1240,23,458865,7911
2021-01-17,Morocco,806,31,459671,7942
2021-01-18,Morocco,473,35,460144,7977
2021-01-19,Morocco,1246,34,461390,8011
2021-01-20,Morocco,1152,32,462542,8043
2021-01-21,Morocco,1164,33,463706,8076
2021-01-22,Morocco,1138,29,464844,8105
2021-01-23,Morocco,925,23,465769,8128
2021-01-24,Morocco,520,22,466289,8150
2021-01-25,Morocco,337,22,466626,8172
2021-01-26,Morocco,867,15,467493,8187
2021-01-27,Morocco,890,20,468383,8207
2021-01-28,Morocco,756,17,469139,8224
2021-01-29,Morocco,851,22,469990,8246
2021-01-30,Morocco,701,13,470691,8259
2021-01-31,Morocco,466,16,471157,8275
2021-02-01,Morocco,281,12,471438,8287
2021-02-02,Morocco,835,22,472273,8309
2021-02-03,Morocco,774,14,473047,8323
2021-02-04,Morocco,620,28,473667,8351
2021-02-05,Morocco,712,17,474379,8368
2021-02-06,Morocco,587,13,474966,8381
2021-02-07,Morocco,389,13,475355,8394
2021-02-08,Morocco,234,14,475589,8408
2021-02-09,Morocco,536,16,476125,8424
2021-02-10,Morocco,564,12,476689,8436
2021-02-11,Morocco,471,4,477160,8440
2021-02-12,Morocco,496,10,477656,8450
2021-02-13,Morocco,479,10,478135,8460
2021-02-14,Morocco,339,17,478474,8477
2021-02-15,Morocco,121,14,478595,8491
2021-02-16,Morocco,476,13,479071,8504
2021-02-17,Morocco,508,13,479579,8517
2021-02-18,Morocco,477,7,480056,8524
2021-02-19,Morocco,448,16,480504,8540
2021-02-20,Morocco,444,8,480948,8548
2021-02-21,Morocco,207,6,481155,8554
2021-02-22,Morocco,108,5,481263,8559
2021-02-23,Morocco,446,15,481709,8574
2021-02-24,Morocco,419,18,482128,8592
2021-02-25,Morocco,386,6,482514,8598
2021-02-26,Morocco,480,10,482994,8608
2021-02-27,Morocco,416,7,483410,8615
2021-02-28,Morocco,244,8,483654,8623
2021-03-01,Morocco,112,14,483766,8637
2021-03-02,Morocco,393,8,484159,8645
2021-03-03,Morocco,594,8,484753,8653
2021-03-04,Morocco,394,16,485147,8669
2021-03-05,Morocco,420,4,485567,8673
2021-03-06,Morocco,407,3,485974,8676
2021-03-07,Morocco,249,6,486223,8682
2021-03-08,Morocco,102,1,486325,8683
2021-03-09,Morocco,508,12,486833,8695
2021-03-10,Morocco,453,10,487286,8705
2021-03-11,Morocco,464,7,487750,8712
2021-03-12,Morocco,431,4,488181,8716
2021-03-13,Morocco,451,2,488632,8718
2021-03-14,Morocco,305,5,488937,8723
2021-03-15,Morocco,159,10,489096,8733
2021-03-16,Morocco,526,4,489622,8737
2021-03-17,Morocco,466,8,490088,8745
2021-03-18,Morocco,487,3,490575,8748
2021-03-19,Morocco,444,7,491019,8755
2021-03-20,Morocco,444,8,491463,8763
2021-03-21,Morocco,246,4,491709,8767
2021-03-22,Morocco,125,2,491834,8769
2021-03-23,Morocco,569,6,492403,8775
2021-03-24,Morocco,439,11,492842,8786
2021-03-25,Morocco,511,2,493353,8788
2021-03-26,Morocco,514,5,493867,8793
2021-03-27,Morocco,491,5,494358,8798
2021-03-28,Morocco,301,0,494659,8798
2021-03-29,Morocco,97,9,494756,8807
2021-03-30,Morocco,665,6,495421,8813
2021-03-31,Morocco,676,5,496097,8818
2021-04-01,Morocco,579,7,496676,8825
2021-04-02,Morocco,581,10,497257,8835
2021-04-03,Morocco,575,7,497832,8842
2021-04-04,Morocco,365,8,498197,8850
2021-04-05,Morocco,132,7,498329,8857
2021-04-06,Morocco,696,8,499025,8865
2021-04-07,Morocco,663,2,499688,8867
2021-04-08,Morocco,635,6,500323,8873
2020-03-22,Mozambique,1,0,1,0
2020-03-23,Mozambique,0,0,1,0
2020-03-24,Mozambique,2,0,3,0
2020-03-25,Mozambique,2,0,5,0
2020-03-26,Mozambique,2,0,7,0
2020-03-27,Mozambique,0,0,7,0
2020-03-28,Mozambique,1,0,8,0
2020-03-29,Mozambique,0,0,8,0
2020-03-30,Mozambique,0,0,8,0
2020-03-31,Mozambique,0,0,8,0
2020-04-01,Mozambique,2,0,10,0
2020-04-02,Mozambique,0,0,10,0
2020-04-03,Mozambique,0,0,10,0
2020-04-04,Mozambique,0,0,10,0
2020-04-05,Mozambique,0,0,10,0
2020-04-06,Mozambique,0,0,10,0
2020-04-07,Mozambique,0,0,10,0
2020-04-08,Mozambique,7,0,17,0
2020-04-09,Mozambique,0,0,17,0
2020-04-10,Mozambique,3,0,20,0
2020-04-11,Mozambique,0,0,20,0
2020-04-12,Mozambique,1,0,21,0
2020-04-13,Mozambique,0,0,21,0
2020-04-14,Mozambique,7,0,28,0
2020-04-15,Mozambique,1,0,29,0
2020-04-16,Mozambique,2,0,31,0
2020-04-17,Mozambique,3,0,34,0
2020-04-18,Mozambique,1,0,35,0
2020-04-19,Mozambique,4,0,39,0
2020-04-20,Mozambique,0,0,39,0
2020-04-21,Mozambique,0,0,39,0
2020-04-22,Mozambique,2,0,41,0
2020-04-23,Mozambique,5,0,46,0
2020-04-24,Mozambique,19,0,65,0
2020-04-25,Mozambique,5,0,70,0
2020-04-26,Mozambique,6,0,76,0
2020-04-27,Mozambique,0,0,76,0
2020-04-28,Mozambique,0,0,76,0
2020-04-29,Mozambique,0,0,76,0
2020-04-30,Mozambique,0,0,76,0
2020-05-01,Mozambique,3,0,79,0
2020-05-02,Mozambique,0,0,79,0
2020-05-03,Mozambique,1,0,80,0
2020-05-04,Mozambique,0,0,80,0
2020-05-05,Mozambique,1,0,81,0
2020-05-06,Mozambique,0,0,81,0
2020-05-07,Mozambique,0,0,81,0
2020-05-08,Mozambique,1,0,82,0
2020-05-09,Mozambique,5,0,87,0
2020-05-10,Mozambique,4,0,91,0
2020-05-11,Mozambique,12,0,103,0
2020-05-12,Mozambique,1,0,104,0
2020-05-13,Mozambique,0,0,104,0
2020-05-14,Mozambique,11,0,115,0
2020-05-15,Mozambique,4,0,119,0
2020-05-16,Mozambique,10,0,129,0
2020-05-17,Mozambique,8,0,137,0
2020-05-18,Mozambique,8,0,145,0
2020-05-19,Mozambique,1,0,146,0
2020-05-20,Mozambique,10,0,156,0
2020-05-21,Mozambique,6,0,162,0
2020-05-22,Mozambique,2,0,164,0
2020-05-23,Mozambique,4,0,168,0
2020-05-24,Mozambique,26,0,194,0
2020-05-25,Mozambique,15,1,209,1
2020-05-26,Mozambique,4,0,213,1
2020-05-27,Mozambique,14,0,227,1
2020-05-28,Mozambique,6,1,233,2
2020-05-29,Mozambique,1,0,234,2
2020-05-30,Mozambique,10,0,244,2
2020-05-31,Mozambique,10,0,254,2
2020-06-01,Mozambique,0,0,254,2
2020-06-02,Mozambique,53,0,307,2
2020-06-03,Mozambique,9,0,316,2
2020-06-04,Mozambique,36,0,352,2
2020-06-05,Mozambique,2,0,354,2
2020-06-06,Mozambique,55,0,409,2
2020-06-07,Mozambique,15,0,424,2
2020-06-08,Mozambique,9,0,433,2
2020-06-09,Mozambique,20,0,453,2
2020-06-10,Mozambique,19,0,472,2
2020-06-11,Mozambique,17,0,489,2
2020-06-12,Mozambique,20,0,509,2
2020-06-13,Mozambique,44,0,553,2
2020-06-14,Mozambique,30,1,583,3
2020-06-15,Mozambique,26,0,609,3
2020-06-16,Mozambique,29,1,638,4
2020-06-17,Mozambique,13,0,651,4
2020-06-18,Mozambique,11,0,662,4
2020-06-19,Mozambique,6,0,668,4
2020-06-20,Mozambique,20,0,688,4
2020-06-21,Mozambique,45,1,733,5
2020-06-22,Mozambique,4,0,737,5
2020-06-23,Mozambique,20,0,757,5
2020-06-24,Mozambique,5,0,762,5
2020-06-25,Mozambique,26,0,788,5
2020-06-26,Mozambique,28,0,816,5
2020-06-27,Mozambique,23,0,839,5
2020-06-28,Mozambique,20,0,859,5
2020-06-29,Mozambique,24,1,883,6
2020-06-30,Mozambique,6,0,889,6
2020-07-01,Mozambique,14,0,903,6
2020-07-02,Mozambique,15,0,918,6
2020-07-03,Mozambique,21,0,939,6
2020-07-04,Mozambique,30,1,969,7
2020-07-05,Mozambique,18,1,987,8
2020-07-06,Mozambique,25,0,1012,8
2020-07-07,Mozambique,28,0,1040,8
2020-07-08,Mozambique,31,0,1071,8
2020-07-09,Mozambique,21,1,1092,9
2020-07-10,Mozambique,19,0,1111,9
2020-07-11,Mozambique,24,0,1135,9
2020-07-12,Mozambique,22,0,1157,9
2020-07-13,Mozambique,62,0,1219,9
2020-07-14,Mozambique,49,0,1268,9
2020-07-15,Mozambique,62,0,1330,9
2020-07-16,Mozambique,53,0,1383,9
2020-07-17,Mozambique,19,0,1402,9
2020-07-18,Mozambique,33,1,1435,10
2020-07-19,Mozambique,56,0,1491,10
2020-07-20,Mozambique,16,1,1507,11
2020-07-21,Mozambique,29,0,1536,11
2020-07-22,Mozambique,21,0,1557,11
2020-07-23,Mozambique,25,0,1582,11
2020-07-24,Mozambique,8,0,1590,11
2020-07-25,Mozambique,26,0,1616,11
2020-07-26,Mozambique,53,0,1669,11
2020-07-27,Mozambique,32,0,1701,11
2020-07-28,Mozambique,19,0,1720,11
2020-07-29,Mozambique,28,0,1748,11
2020-07-30,Mozambique,60,0,1808,11
2020-07-31,Mozambique,56,0,1864,11
2020-08-01,Mozambique,43,1,1907,12
2020-08-02,Mozambique,39,1,1946,13
2020-08-03,Mozambique,27,1,1973,14
2020-08-04,Mozambique,56,1,2029,15
2020-08-05,Mozambique,50,0,2079,15
2020-08-06,Mozambique,41,0,2120,15
2020-08-07,Mozambique,93,0,2213,15
2020-08-08,Mozambique,28,1,2241,16
2020-08-09,Mozambique,28,0,2269,16
2020-08-10,Mozambique,142,0,2411,16
2020-08-11,Mozambique,70,1,2481,17
2020-08-12,Mozambique,78,2,2559,19
2020-08-13,Mozambique,79,0,2638,19
2020-08-14,Mozambique,70,0,2708,19
2020-08-15,Mozambique,83,0,2791,19
2020-08-16,Mozambique,64,0,2855,19
2020-08-17,Mozambique,59,0,2914,19
2020-08-18,Mozambique,77,0,2991,19
2020-08-19,Mozambique,54,0,3045,19
2020-08-20,Mozambique,70,1,3115,20
2020-08-21,Mozambique,80,0,3195,20
2020-08-22,Mozambique,109,0,3304,20
2020-08-23,Mozambique,91,0,3395,20
2020-08-24,Mozambique,45,1,3440,21
2020-08-25,Mozambique,68,0,3508,21
2020-08-26,Mozambique,82,0,3590,21
2020-08-27,Mozambique,61,0,3651,21
2020-08-28,Mozambique,46,0,3697,21
2020-08-29,Mozambique,63,1,3760,22
2020-08-30,Mozambique,61,1,3821,23
2020-08-31,Mozambique,95,0,3916,23
2020-09-01,Mozambique,123,0,4039,23
2020-09-02,Mozambique,78,2,4117,25
2020-09-03,Mozambique,90,1,4207,26
2020-09-04,Mozambique,58,0,4265,26
2020-09-05,Mozambique,76,0,4341,26
2020-09-06,Mozambique,103,1,4444,27
2020-09-07,Mozambique,113,0,4557,27
2020-09-08,Mozambique,90,1,4647,28
2020-09-09,Mozambique,117,0,4764,28
2020-09-10,Mozambique,68,3,4832,31
2020-09-11,Mozambique,86,0,4918,31
2020-09-12,Mozambique,122,4,5040,35
2020-09-13,Mozambique,229,0,5269,35
2020-09-14,Mozambique,213,0,5482,35
2020-09-15,Mozambique,231,2,5713,37
2020-09-16,Mozambique,281,2,5994,39
2020-09-17,Mozambique,167,0,6161,39
2020-09-18,Mozambique,103,1,6264,40
2020-09-19,Mozambique,273,1,6537,41
2020-09-20,Mozambique,234,2,6771,43
2020-09-21,Mozambique,141,1,6912,44
2020-09-22,Mozambique,202,1,7114,45
2020-09-23,Mozambique,148,4,7262,49
2020-09-24,Mozambique,137,2,7399,51
2020-09-25,Mozambique,190,2,7589,53
2020-09-26,Mozambique,168,1,7757,54
2020-09-27,Mozambique,226,4,7983,58
2020-09-28,Mozambique,305,1,8288,59
2020-09-29,Mozambique,268,0,8556,59
2020-09-30,Mozambique,172,2,8728,61
2020-10-01,Mozambique,160,1,8888,62
2020-10-02,Mozambique,91,2,8979,64
2020-10-03,Mozambique,70,0,9049,64
2020-10-04,Mozambique,147,2,9196,66
2020-10-05,Mozambique,100,0,9296,66
2020-10-06,Mozambique,102,1,9398,67
2020-10-07,Mozambique,96,1,9494,68
2020-10-08,Mozambique,145,0,9639,68
2020-10-09,Mozambique,103,1,9742,69
2020-10-10,Mozambique,102,1,9844,70
2020-10-11,Mozambique,157,1,10001,71
2020-10-12,Mozambique,87,1,10088,72
2020-10-13,Mozambique,170,1,10258,73
2020-10-14,Mozambique,134,0,10392,73
2020-10-15,Mozambique,145,0,10537,73
2020-10-16,Mozambique,75,0,10612,73
2020-10-17,Mozambique,95,1,10707,74
2020-10-18,Mozambique,159,1,10866,75
2020-10-19,Mozambique,214,0,11080,75
2020-10-20,Mozambique,110,3,11190,78
2020-10-21,Mozambique,141,1,11331,79
2020-10-22,Mozambique,228,2,11559,81
2020-10-23,Mozambique,189,1,11748,82
2020-10-24,Mozambique,147,3,11895,85
2020-10-25,Mozambique,91,1,11986,86
2020-10-26,Mozambique,175,2,12161,88
2020-10-27,Mozambique,112,1,12273,89
2020-10-28,Mozambique,142,2,12415,91
2020-10-29,Mozambique,110,0,12525,91
2020-10-30,Mozambique,252,0,12777,91
2020-10-31,Mozambique,92,1,12869,92
2020-11-01,Mozambique,119,1,12988,93
2020-11-02,Mozambique,142,1,13130,94
2020-11-03,Mozambique,72,1,13202,95
2020-11-04,Mozambique,81,0,13283,95
2020-11-05,Mozambique,108,2,13391,97
2020-11-06,Mozambique,94,2,13485,99
2020-11-07,Mozambique,92,0,13577,99
2020-11-08,Mozambique,191,0,13768,99
2020-11-09,Mozambique,55,0,13823,99
2020-11-10,Mozambique,69,0,13892,99
2020-11-11,Mozambique,99,5,13991,104
2020-11-12,Mozambique,103,0,14094,104
2020-11-13,Mozambique,133,6,14227,110
2020-11-14,Mozambique,113,0,14340,110
2020-11-15,Mozambique,108,3,14448,113
2020-11-16,Mozambique,66,3,14514,116
2020-11-17,Mozambique,52,2,14566,118
2020-11-18,Mozambique,63,1,14629,119
2020-11-19,Mozambique,94,1,14723,120
2020-11-20,Mozambique,154,1,14877,121
2020-11-21,Mozambique,104,2,14981,123
2020-11-22,Mozambique,56,1,15037,124
2020-11-23,Mozambique,72,2,15109,126
2020-11-24,Mozambique,122,1,15231,127
2020-11-25,Mozambique,71,1,15302,128
2020-11-26,Mozambique,165,0,15467,128
2020-11-27,Mozambique,39,0,15506,128
2020-11-28,Mozambique,80,1,15586,129
2020-11-29,Mozambique,27,1,15613,130
2020-11-30,Mozambique,88,1,15701,131
2020-12-01,Mozambique,69,0,15770,131
2020-12-02,Mozambique,96,1,15866,132
2020-12-03,Mozambique,52,0,15918,132
2020-12-04,Mozambique,120,1,16038,133
2020-12-05,Mozambique,95,0,16133,133
2020-12-06,Mozambique,111,0,16244,133
2020-12-07,Mozambique,82,3,16326,136
2020-12-08,Mozambique,47,0,16373,136
2020-12-09,Mozambique,67,2,16440,138
2020-12-10,Mozambique,81,1,16521,139
2020-12-11,Mozambique,159,0,16680,139
2020-12-12,Mozambique,132,1,16812,140
2020-12-13,Mozambique,142,2,16954,142
2020-12-14,Mozambique,48,1,17002,143
2020-12-15,Mozambique,40,1,17042,144
2020-12-16,Mozambique,101,1,17143,145
2020-12-17,Mozambique,113,0,17256,145
2020-12-18,Mozambique,82,1,17338,146
2020-12-19,Mozambique,139,1,17477,147
2020-12-20,Mozambique,91,1,17568,148
2020-12-21,Mozambique,127,1,17695,149
2020-12-22,Mozambique,72,1,17767,150
2020-12-23,Mozambique,0,0,17767,150
2020-12-24,Mozambique,264,6,18031,156
2020-12-25,Mozambique,77,0,18108,156
2020-12-26,Mozambique,54,3,18162,159
2020-12-27,Mozambique,103,2,18265,161
2020-12-28,Mozambique,45,1,18310,162
2020-12-29,Mozambique,62,0,18372,162
2020-12-30,Mozambique,113,3,18485,165
2020-12-31,Mozambique,157,1,18642,166
2021-01-01,Mozambique,152,1,18794,167
2021-01-02,Mozambique,174,1,18968,168
2021-01-03,Mozambique,341,1,19309,169
2021-01-04,Mozambique,154,2,19463,171
2021-01-05,Mozambique,79,0,19542,171
2021-01-06,Mozambique,125,1,19667,172
2021-01-07,Mozambique,294,4,19961,176
2021-01-08,Mozambique,521,5,20482,181
2021-01-09,Mozambique,879,6,21361,187
2021-01-10,Mozambique,578,5,21939,192
2021-01-11,Mozambique,395,5,22334,197
2021-01-12,Mozambique,662,4,22996,201
2021-01-13,Mozambique,730,4,23726,205
2021-01-14,Mozambique,543,6,24269,211
2021-01-15,Mozambique,735,5,25004,216
2021-01-16,Mozambique,858,18,25862,234
2021-01-17,Mozambique,689,7,26551,241
2021-01-18,Mozambique,895,8,27446,249
2021-01-19,Mozambique,824,4,28270,253
2021-01-20,Mozambique,1126,18,29396,271
2021-01-21,Mozambique,829,12,30225,283
2021-01-22,Mozambique,623,7,30848,290
2021-01-23,Mozambique,780,7,31628,297
2021-01-24,Mozambique,790,8,32418,305
2021-01-25,Mozambique,363,58,32781,363
2021-01-26,Mozambique,1274,-34,34055,329
2021-01-27,Mozambique,871,7,34926,336
2021-01-28,Mozambique,907,11,35833,347
2021-01-29,Mozambique,1275,9,37108,356
2021-01-30,Mozambique,597,7,37705,363
2021-01-31,Mozambique,949,4,38654,367
2021-02-01,Mozambique,806,19,39460,386
2021-02-02,Mozambique,800,17,40260,403
2021-02-03,Mozambique,1173,12,41433,415
2021-02-04,Mozambique,1055,12,42488,427
2021-02-05,Mozambique,696,9,43184,436
2021-02-06,Mozambique,928,15,44112,451
2021-02-07,Mozambique,488,9,44600,460
2021-02-08,Mozambique,312,5,44912,465
2021-02-09,Mozambique,873,15,45785,480
2021-02-10,Mozambique,951,6,46736,486
2021-02-11,Mozambique,1054,15,47790,501
2021-02-12,Mozambique,798,13,48588,514
2021-02-13,Mozambique,547,11,49135,525
2021-02-14,Mozambique,1130,10,50265,535
2021-02-15,Mozambique,426,12,50691,547
2021-02-16,Mozambique,1109,4,51800,551
2021-02-17,Mozambique,829,10,52629,561
2021-02-18,Mozambique,898,10,53527,571
2021-02-19,Mozambique,677,12,54204,583
2021-02-20,Mozambique,764,4,54968,587
2021-02-21,Mozambique,675,8,55643,595
2021-02-22,Mozambique,517,4,56160,599
2021-02-23,Mozambique,435,7,56595,606
2021-02-24,Mozambique,325,2,56920,608
2021-02-25,Mozambique,677,5,57597,613
2021-02-26,Mozambique,621,0,58218,613
2021-02-27,Mozambique,554,17,58772,630
2021-02-28,Mozambique,578,11,59350,641
2021-03-01,Mozambique,257,12,59607,653
2021-03-02,Mozambique,307,12,59914,665
2021-03-03,Mozambique,481,3,60395,668
2021-03-04,Mozambique,775,6,61170,674
2021-03-05,Mozambique,359,6,61529,680
2021-03-06,Mozambique,602,6,62131,686
2021-03-07,Mozambique,389,7,62520,693
2021-03-08,Mozambique,183,5,62703,698
2021-03-09,Mozambique,179,2,62882,700
2021-03-10,Mozambique,292,7,63174,707
2021-03-11,Mozambique,471,4,63645,711
2021-03-12,Mozambique,359,8,64004,719
2021-03-13,Mozambique,292,3,64296,722
2021-03-14,Mozambique,220,3,64516,725
2021-03-15,Mozambique,0,0,64516,725
2021-03-16,Mozambique,413,7,64929,732
2021-03-17,Mozambique,268,1,65197,733
2021-03-18,Mozambique,255,4,65452,737
2021-03-19,Mozambique,347,3,65799,740
2021-03-20,Mozambique,265,3,66064,743
2021-03-21,Mozambique,148,3,66212,746
2021-03-22,Mozambique,94,1,66306,747
2021-03-23,Mozambique,190,3,66496,750
2021-03-24,Mozambique,153,2,66649,752
2021-03-25,Mozambique,113,1,66762,753
2021-03-26,Mozambique,117,5,66879,758
2021-03-27,Mozambique,132,4,67011,762
2021-03-28,Mozambique,186,2,67197,764
2021-03-29,Mozambique,0,0,67197,764
2021-03-30,Mozambique,95,5,67292,769
2021-03-31,Mozambique,287,6,67579,775
2021-04-01,Mozambique,150,0,67729,775
2021-04-02,Mozambique,194,3,67923,778
2021-04-03,Mozambique,82,4,68005,782
2021-04-04,Mozambique,114,0,68119,782
2021-04-05,Mozambique,108,0,68227,782
2021-04-06,Mozambique,65,3,68292,785
2021-04-07,Mozambique,139,0,68431,785
2021-04-08,Mozambique,35,3,68466,788
2020-03-27,Myanmar,8,0,8,0
2020-03-28,Myanmar,0,0,8,0
2020-03-29,Myanmar,2,0,10,0
2020-03-30,Myanmar,4,0,14,0
2020-03-31,Myanmar,1,1,15,1
2020-04-01,Myanmar,0,0,15,1
2020-04-02,Myanmar,5,0,20,1
2020-04-03,Myanmar,0,0,20,1
2020-04-04,Myanmar,1,0,21,1
2020-04-05,Myanmar,0,0,21,1
2020-04-06,Myanmar,1,0,22,1
2020-04-07,Myanmar,0,0,22,1
2020-04-08,Myanmar,0,2,22,3
2020-04-09,Myanmar,1,0,23,3
2020-04-10,Myanmar,4,0,27,3
2020-04-11,Myanmar,11,0,38,3
2020-04-12,Myanmar,3,1,41,4
2020-04-13,Myanmar,21,0,62,4
2020-04-14,Myanmar,1,0,63,4
2020-04-15,Myanmar,11,0,74,4
2020-04-16,Myanmar,11,0,85,4
2020-04-17,Myanmar,3,0,88,4
2020-04-18,Myanmar,10,1,98,5
2020-04-19,Myanmar,13,0,111,5
2020-04-20,Myanmar,8,0,119,5
2020-04-21,Myanmar,2,0,121,5
2020-04-22,Myanmar,2,0,123,5
2020-04-23,Myanmar,16,0,139,5
2020-04-24,Myanmar,5,0,144,5
2020-04-25,Myanmar,2,0,146,5
2020-04-26,Myanmar,0,0,146,5
2020-04-27,Myanmar,0,0,146,5
2020-04-28,Myanmar,4,0,150,5
2020-04-29,Myanmar,0,1,150,6
2020-04-30,Myanmar,1,0,151,6
2020-05-01,Myanmar,0,0,151,6
2020-05-02,Myanmar,0,0,151,6
2020-05-03,Myanmar,4,0,155,6
2020-05-04,Myanmar,6,0,161,6
2020-05-05,Myanmar,0,0,161,6
2020-05-06,Myanmar,0,0,161,6
2020-05-07,Myanmar,15,0,176,6
2020-05-08,Myanmar,1,0,177,6
2020-05-09,Myanmar,1,0,178,6
2020-05-10,Myanmar,2,0,180,6
2020-05-11,Myanmar,0,0,180,6
2020-05-12,Myanmar,0,0,180,6
2020-05-13,Myanmar,1,0,181,6
2020-05-14,Myanmar,0,0,181,6
2020-05-15,Myanmar,1,0,182,6
2020-05-16,Myanmar,0,0,182,6
2020-05-17,Myanmar,2,0,184,6
2020-05-18,Myanmar,7,0,191,6
2020-05-19,Myanmar,2,0,193,6
2020-05-20,Myanmar,6,0,199,6
2020-05-21,Myanmar,0,0,199,6
2020-05-22,Myanmar,0,0,199,6
2020-05-23,Myanmar,2,0,201,6
2020-05-24,Myanmar,0,0,201,6
2020-05-25,Myanmar,2,0,203,6
2020-05-26,Myanmar,3,0,206,6
2020-05-27,Myanmar,0,0,206,6
2020-05-28,Myanmar,0,0,206,6
2020-05-29,Myanmar,1,0,207,6
2020-05-30,Myanmar,17,0,224,6
2020-05-31,Myanmar,0,0,224,6
2020-06-01,Myanmar,4,0,228,6
2020-06-02,Myanmar,4,0,232,6
2020-06-03,Myanmar,1,0,233,6
2020-06-04,Myanmar,3,0,236,6
2020-06-05,Myanmar,0,0,236,6
2020-06-06,Myanmar,4,0,240,6
2020-06-07,Myanmar,2,0,242,6
2020-06-08,Myanmar,2,0,244,6
2020-06-09,Myanmar,2,0,246,6
2020-06-10,Myanmar,2,0,248,6
2020-06-11,Myanmar,12,0,260,6
2020-06-12,Myanmar,1,0,261,6
2020-06-13,Myanmar,0,0,261,6
2020-06-14,Myanmar,0,0,261,6
2020-06-15,Myanmar,1,0,262,6
2020-06-16,Myanmar,0,0,262,6
2020-06-17,Myanmar,0,0,262,6
2020-06-18,Myanmar,24,0,286,6
2020-06-19,Myanmar,0,0,286,6
2020-06-20,Myanmar,1,0,287,6
2020-06-21,Myanmar,3,0,290,6
2020-06-22,Myanmar,1,0,291,6
2020-06-23,Myanmar,1,0,292,6
2020-06-24,Myanmar,1,0,293,6
2020-06-25,Myanmar,0,0,293,6
2020-06-26,Myanmar,0,0,293,6
2020-06-27,Myanmar,3,0,296,6
2020-06-28,Myanmar,3,0,299,6
2020-06-29,Myanmar,0,0,299,6
2020-06-30,Myanmar,0,0,299,6
2020-07-01,Myanmar,4,0,303,6
2020-07-02,Myanmar,1,0,304,6
2020-07-03,Myanmar,2,0,306,6
2020-07-04,Myanmar,7,0,313,6
2020-07-05,Myanmar,0,0,313,6
2020-07-06,Myanmar,3,0,316,6
2020-07-07,Myanmar,0,0,316,6
2020-07-08,Myanmar,1,0,317,6
2020-07-09,Myanmar,4,0,321,6
2020-07-10,Myanmar,5,0,326,6
2020-07-11,Myanmar,4,0,330,6
2020-07-12,Myanmar,1,0,331,6
2020-07-13,Myanmar,5,0,336,6
2020-07-14,Myanmar,1,0,337,6
2020-07-15,Myanmar,0,0,337,6
2020-07-16,Myanmar,2,0,339,6
2020-07-17,Myanmar,0,0,339,6
2020-07-18,Myanmar,1,0,340,6
2020-07-19,Myanmar,1,0,341,6
2020-07-20,Myanmar,0,0,341,6
2020-07-21,Myanmar,0,0,341,6
2020-07-22,Myanmar,2,0,343,6
2020-07-23,Myanmar,0,0,343,6
2020-07-24,Myanmar,3,0,346,6
2020-07-25,Myanmar,2,0,348,6
2020-07-26,Myanmar,2,0,350,6
2020-07-27,Myanmar,0,0,350,6
2020-07-28,Myanmar,1,0,351,6
2020-07-29,Myanmar,0,0,351,6
2020-07-30,Myanmar,2,0,353,6
2020-07-31,Myanmar,0,0,353,6
2020-08-01,Myanmar,0,0,353,6
2020-08-02,Myanmar,0,0,353,6
2020-08-03,Myanmar,2,0,355,6
2020-08-04,Myanmar,1,0,356,6
2020-08-05,Myanmar,1,0,357,6
2020-08-06,Myanmar,0,0,357,6
2020-08-07,Myanmar,2,0,359,6
2020-08-08,Myanmar,0,0,359,6
2020-08-09,Myanmar,1,0,360,6
2020-08-10,Myanmar,0,0,360,6
2020-08-11,Myanmar,0,0,360,6
2020-08-12,Myanmar,1,0,361,6
2020-08-13,Myanmar,8,0,369,6
2020-08-14,Myanmar,5,0,374,6
2020-08-15,Myanmar,0,0,374,6
2020-08-16,Myanmar,1,0,375,6
2020-08-17,Myanmar,1,0,376,6
2020-08-18,Myanmar,0,0,376,6
2020-08-19,Myanmar,18,0,394,6
2020-08-20,Myanmar,5,0,399,6
2020-08-21,Myanmar,36,0,435,6
2020-08-22,Myanmar,6,0,441,6
2020-08-23,Myanmar,9,0,450,6
2020-08-24,Myanmar,24,0,474,6
2020-08-25,Myanmar,30,0,504,6
2020-08-26,Myanmar,76,0,580,6
2020-08-27,Myanmar,22,0,602,6
2020-08-28,Myanmar,41,0,643,6
2020-08-29,Myanmar,106,0,749,6
2020-08-30,Myanmar,26,0,775,6
2020-08-31,Myanmar,107,0,882,6
2020-09-01,Myanmar,37,0,919,6
2020-09-02,Myanmar,76,0,995,6
2020-09-03,Myanmar,116,0,1111,6
2020-09-04,Myanmar,60,1,1171,7
2020-09-05,Myanmar,148,1,1319,8
2020-09-06,Myanmar,100,0,1419,8
2020-09-07,Myanmar,99,0,1518,8
2020-09-08,Myanmar,289,4,1807,12
2020-09-09,Myanmar,202,2,2009,14
2020-09-10,Myanmar,141,0,2150,14
2020-09-11,Myanmar,272,0,2422,14
2020-09-12,Myanmar,374,2,2796,16
2020-09-13,Myanmar,219,8,3015,24
2020-09-14,Myanmar,180,8,3195,32
2020-09-15,Myanmar,441,7,3636,39
2020-09-16,Myanmar,258,7,3894,46
2020-09-17,Myanmar,405,15,4299,61
2020-09-18,Myanmar,322,14,4621,75
2020-09-19,Myanmar,642,6,5263,81
2020-09-20,Myanmar,542,13,5805,94
2020-09-21,Myanmar,666,6,6471,100
2020-09-22,Myanmar,488,16,6959,116
2020-09-23,Myanmar,868,17,7827,133
2020-09-24,Myanmar,688,22,8515,155
2020-09-25,Myanmar,597,19,9112,174
2020-09-26,Myanmar,879,24,9991,198
2020-09-27,Myanmar,743,28,10734,226
2020-09-28,Myanmar,897,30,11631,256
2020-09-29,Myanmar,794,28,12425,284
2020-09-30,Myanmar,948,26,13373,310
2020-10-01,Myanmar,1010,11,14383,321
2020-10-02,Myanmar,1142,32,15525,353
2020-10-03,Myanmar,978,18,16503,371
2020-10-04,Myanmar,1291,41,17794,412
2020-10-05,Myanmar,987,32,18781,444
2020-10-06,Myanmar,1252,27,20033,471
2020-10-07,Myanmar,1400,39,21433,510
2020-10-08,Myanmar,1012,25,22445,535
2020-10-09,Myanmar,1461,31,23906,566
2020-10-10,Myanmar,2158,32,26064,598
2020-10-11,Myanmar,1910,48,27974,646
2020-10-12,Myanmar,1340,18,29314,664
2020-10-13,Myanmar,1123,29,30437,693
2020-10-14,Myanmar,888,39,31325,732
2020-10-15,Myanmar,1026,33,32351,765
2020-10-16,Myanmar,1137,34,33488,799
2020-10-17,Myanmar,1387,39,34875,838
2020-10-18,Myanmar,1150,42,36025,880
2020-10-19,Myanmar,1180,34,37205,914
2020-10-20,Myanmar,1297,31,38502,945
2020-10-21,Myanmar,1194,27,39696,972
2020-10-22,Myanmar,1312,33,41008,1005
2020-10-23,Myanmar,1357,33,42365,1038
2020-10-24,Myanmar,1423,28,43788,1066
2020-10-25,Myanmar,986,29,44774,1095
2020-10-26,Myanmar,1426,27,46200,1122
2020-10-27,Myanmar,1466,25,47666,1147
2020-10-28,Myanmar,1406,25,49072,1172
2020-10-29,Myanmar,1331,27,50403,1199
2020-10-30,Myanmar,1093,20,51496,1219
2020-10-31,Myanmar,1210,18,52706,1237
2020-11-01,Myanmar,699,21,53405,1258
2020-11-02,Myanmar,1202,24,54607,1282
2020-11-03,Myanmar,1197,25,55804,1307
2020-11-04,Myanmar,1136,23,56940,1330
2020-11-05,Myanmar,995,22,57935,1352
2020-11-06,Myanmar,1342,24,59277,1376
2020-11-07,Myanmar,1071,20,60348,1396
2020-11-08,Myanmar,1029,24,61377,1420
2020-11-09,Myanmar,598,17,61975,1437
2020-11-10,Myanmar,1266,24,63241,1461
2020-11-11,Myanmar,1212,19,64453,1480
2020-11-12,Myanmar,1145,28,65598,1508
2020-11-13,Myanmar,1136,26,66734,1534
2020-11-14,Myanmar,1277,18,68011,1552
2020-11-15,Myanmar,983,25,68994,1577
2020-11-16,Myanmar,1167,22,70161,1599
2020-11-17,Myanmar,1569,26,71730,1625
2020-11-18,Myanmar,1592,25,73322,1650
2020-11-19,Myanmar,1560,26,74882,1676
2020-11-20,Myanmar,1532,19,76414,1695
2020-11-21,Myanmar,1434,27,77848,1722
2020-11-22,Myanmar,1398,17,79246,1739
2020-11-23,Myanmar,1259,26,80505,1765
2020-11-24,Myanmar,1731,19,82236,1784
2020-11-25,Myanmar,1330,26,83566,1810
2020-11-26,Myanmar,1639,36,85205,1846
2020-11-27,Myanmar,1428,19,86633,1865
2020-11-28,Myanmar,1344,22,87977,1887
2020-11-29,Myanmar,1509,31,89486,1918
2020-11-30,Myanmar,1227,23,90713,1941
2020-12-01,Myanmar,1476,31,92189,1972
2020-12-02,Myanmar,1411,26,93600,1998
2020-12-03,Myanmar,1418,30,95018,2028
2020-12-04,Myanmar,1502,31,96520,2059
2020-12-05,Myanmar,1527,22,98047,2081
2020-12-06,Myanmar,1108,29,99155,2110
2020-12-07,Myanmar,1276,22,100431,2132
2020-12-08,Myanmar,1308,19,101739,2151
2020-12-09,Myanmar,1427,23,103166,2174
2020-12-10,Myanmar,1321,27,104487,2201
2020-12-11,Myanmar,1376,19,105863,2220
2020-12-12,Myanmar,1352,25,107215,2245
2020-12-13,Myanmar,1127,23,108342,2268
2020-12-14,Myanmar,1170,24,109512,2292
2020-12-15,Myanmar,1155,27,110667,2319
2020-12-16,Myanmar,1233,27,111900,2346
2020-12-17,Myanmar,1182,31,113082,2377
2020-12-18,Myanmar,1116,21,114198,2398
2020-12-19,Myanmar,989,26,115187,2424
2020-12-20,Myanmar,947,19,116134,2443
2020-12-21,Myanmar,848,22,116982,2465
2020-12-22,Myanmar,964,19,117946,2484
2020-12-23,Myanmar,923,23,118869,2507
2020-12-24,Myanmar,919,25,119788,2532
2020-12-25,Myanmar,758,20,120546,2552
2020-12-26,Myanmar,734,27,121280,2579
2020-12-27,Myanmar,606,22,121886,2601
2020-12-28,Myanmar,648,17,122534,2618
2020-12-29,Myanmar,619,19,123153,2637
2020-12-30,Myanmar,587,27,123740,2664
2020-12-31,Myanmar,890,18,124630,2682
2021-01-01,Myanmar,412,15,125042,2697
2021-01-02,Myanmar,574,14,125616,2711
2021-01-03,Myanmar,729,17,126345,2728
2021-01-04,Myanmar,590,16,126935,2744
2021-01-05,Myanmar,649,22,127584,2766
2021-01-06,Myanmar,594,19,128178,2785
2021-01-07,Myanmar,594,14,128772,2799
2021-01-08,Myanmar,711,13,129483,2812
2021-01-09,Myanmar,566,14,130049,2826
2021-01-10,Myanmar,555,20,130604,2846
2021-01-11,Myanmar,582,12,131186,2858
2021-01-12,Myanmar,551,20,131737,2878
2021-01-13,Myanmar,523,24,132260,2902
2021-01-14,Myanmar,605,10,132865,2912
2021-01-15,Myanmar,513,14,133378,2926
2021-01-16,Myanmar,491,16,133869,2942
2021-01-17,Myanmar,449,13,134318,2955
2021-01-18,Myanmar,477,18,134795,2973
2021-01-19,Myanmar,448,13,135243,2986
2021-01-20,Myanmar,478,11,135721,2997
2021-01-21,Myanmar,445,16,136166,3013
2021-01-22,Myanmar,425,18,136591,3031
2021-01-23,Myanmar,507,14,137098,3045
2021-01-24,Myanmar,476,17,137574,3062
2021-01-25,Myanmar,383,7,137957,3069
2021-01-26,Myanmar,411,13,138368,3082
2021-01-27,Myanmar,434,7,138802,3089
2021-01-28,Myanmar,350,14,139152,3103
2021-01-29,Myanmar,363,12,139515,3115
2021-01-30,Myanmar,349,10,139864,3125
2021-01-31,Myanmar,281,6,140145,3131
2021-02-01,Myanmar,209,7,140354,3138
2021-02-02,Myanmar,0,0,140354,3138
2021-02-03,Myanmar,573,22,140927,3160
2021-02-04,Myanmar,177,3,141104,3163
2021-02-05,Myanmar,200,5,141304,3168
2021-02-06,Myanmar,0,0,141304,3168
2021-02-07,Myanmar,0,0,141304,3168
2021-02-08,Myanmar,123,9,141427,3177
2021-02-09,Myanmar,21,3,141448,3180
2021-02-10,Myanmar,39,1,141487,3181
2021-02-11,Myanmar,35,3,141522,3184
2021-02-12,Myanmar,21,4,141543,3188
2021-02-13,Myanmar,42,0,141585,3188
2021-02-14,Myanmar,16,1,141601,3189
2021-02-15,Myanmar,36,1,141637,3190
2021-02-16,Myanmar,22,2,141659,3192
2021-02-17,Myanmar,31,0,141690,3192
2021-02-18,Myanmar,19,-1,141709,3191
2021-02-19,Myanmar,19,3,141728,3194
2021-02-20,Myanmar,7,2,141735,3196
2021-02-21,Myanmar,15,0,141750,3196
2021-02-22,Myanmar,11,1,141761,3197
2021-02-23,Myanmar,22,0,141783,3197
2021-02-24,Myanmar,33,0,141816,3197
2021-02-25,Myanmar,25,1,141841,3198
2021-02-26,Myanmar,34,0,141875,3198
2021-02-27,Myanmar,15,1,141890,3199
2021-02-28,Myanmar,6,0,141896,3199
2021-03-01,Myanmar,20,0,141916,3199
2021-03-02,Myanmar,49,0,141965,3199
2021-03-03,Myanmar,19,0,141984,3199
2021-03-04,Myanmar,16,1,142000,3200
2021-03-05,Myanmar,0,0,142000,3200
2021-03-06,Myanmar,23,0,142023,3200
2021-03-07,Myanmar,11,0,142034,3200
2021-03-08,Myanmar,11,0,142045,3200
2021-03-09,Myanmar,14,0,142059,3200
2021-03-10,Myanmar,14,0,142073,3200
2021-03-11,Myanmar,41,1,142114,3201
2021-03-12,Myanmar,8,0,142122,3201
2021-03-13,Myanmar,14,0,142136,3201
2021-03-14,Myanmar,11,1,142147,3202
2021-03-15,Myanmar,0,0,142147,3202
2021-03-16,Myanmar,15,1,142162,3203
2021-03-17,Myanmar,28,0,142190,3203
2021-03-18,Myanmar,22,1,142212,3204
2021-03-19,Myanmar,0,0,142212,3204
2021-03-20,Myanmar,0,0,142212,3204
2021-03-21,Myanmar,0,0,142212,3204
2021-03-22,Myanmar,34,0,142246,3204
2021-03-23,Myanmar,18,0,142264,3204
2021-03-24,Myanmar,28,0,142292,3204
2021-03-25,Myanmar,23,0,142315,3204
2021-03-26,Myanmar,25,1,142340,3205
2021-03-27,Myanmar,37,1,142377,3206
2021-03-28,Myanmar,8,0,142385,3206
2021-03-29,Myanmar,8,0,142393,3206
2021-03-30,Myanmar,19,0,142412,3206
2021-03-31,Myanmar,22,0,142434,3206
2021-04-01,Myanmar,32,0,142466,3206
2021-04-02,Myanmar,0,0,142466,3206
2021-04-03,Myanmar,13,0,142479,3206
2021-04-04,Myanmar,18,0,142497,3206
2021-04-05,Myanmar,14,0,142511,3206
2021-04-06,Myanmar,19,0,142530,3206
2021-04-07,Myanmar,11,0,142541,3206
2021-04-08,Myanmar,8,0,142549,3206
2020-03-14,Namibia,2,0,2,0
2020-03-15,Namibia,0,0,2,0
2020-03-16,Namibia,0,0,2,0
2020-03-17,Namibia,0,0,2,0
2020-03-18,Namibia,0,0,2,0
2020-03-19,Namibia,1,0,3,0
2020-03-20,Namibia,0,0,3,0
2020-03-21,Namibia,0,0,3,0
2020-03-22,Namibia,0,0,3,0
2020-03-23,Namibia,1,0,4,0
2020-03-24,Namibia,3,0,7,0
2020-03-25,Namibia,0,0,7,0
2020-03-26,Namibia,1,0,8,0
2020-03-27,Namibia,0,0,8,0
2020-03-28,Namibia,0,0,8,0
2020-03-29,Namibia,3,0,11,0
2020-03-30,Namibia,0,0,11,0
2020-03-31,Namibia,0,0,11,0
2020-04-01,Namibia,3,0,14,0
2020-04-02,Namibia,0,0,14,0
2020-04-03,Namibia,0,0,14,0
2020-04-04,Namibia,0,0,14,0
2020-04-05,Namibia,2,0,16,0
2020-04-06,Namibia,0,0,16,0
2020-04-07,Namibia,0,0,16,0
2020-04-08,Namibia,0,0,16,0
2020-04-09,Namibia,0,0,16,0
2020-04-10,Namibia,0,0,16,0
2020-04-11,Namibia,0,0,16,0
2020-04-12,Namibia,0,0,16,0
2020-04-13,Namibia,0,0,16,0
2020-04-14,Namibia,0,0,16,0
2020-04-15,Namibia,0,0,16,0
2020-04-16,Namibia,0,0,16,0
2020-04-17,Namibia,0,0,16,0
2020-04-18,Namibia,0,0,16,0
2020-04-19,Namibia,0,0,16,0
2020-04-20,Namibia,0,0,16,0
2020-04-21,Namibia,0,0,16,0
2020-04-22,Namibia,0,0,16,0
2020-04-23,Namibia,0,0,16,0
2020-04-24,Namibia,0,0,16,0
2020-04-25,Namibia,0,0,16,0
2020-04-26,Namibia,0,0,16,0
2020-04-27,Namibia,0,0,16,0
2020-04-28,Namibia,0,0,16,0
2020-04-29,Namibia,0,0,16,0
2020-04-30,Namibia,0,0,16,0
2020-05-01,Namibia,0,0,16,0
2020-05-02,Namibia,0,0,16,0
2020-05-03,Namibia,0,0,16,0
2020-05-04,Namibia,0,0,16,0
2020-05-05,Namibia,0,0,16,0
2020-05-06,Namibia,0,0,16,0
2020-05-07,Namibia,0,0,16,0
2020-05-08,Namibia,0,0,16,0
2020-05-09,Namibia,0,0,16,0
2020-05-10,Namibia,0,0,16,0
2020-05-11,Namibia,0,0,16,0
2020-05-12,Namibia,0,0,16,0
2020-05-13,Namibia,0,0,16,0
2020-05-14,Namibia,0,0,16,0
2020-05-15,Namibia,0,0,16,0
2020-05-16,Namibia,0,0,16,0
2020-05-17,Namibia,0,0,16,0
2020-05-18,Namibia,0,0,16,0
2020-05-19,Namibia,0,0,16,0
2020-05-20,Namibia,0,0,16,0
2020-05-21,Namibia,2,0,18,0
2020-05-22,Namibia,1,0,19,0
2020-05-23,Namibia,1,0,20,0
2020-05-24,Namibia,1,0,21,0
2020-05-25,Namibia,0,0,21,0
2020-05-26,Namibia,0,0,21,0
2020-05-27,Namibia,1,0,22,0
2020-05-28,Namibia,0,0,22,0
2020-05-29,Namibia,1,0,23,0
2020-05-30,Namibia,0,0,23,0
2020-05-31,Namibia,1,0,24,0
2020-06-01,Namibia,1,0,25,0
2020-06-02,Namibia,0,0,25,0
2020-06-03,Namibia,0,0,25,0
2020-06-04,Namibia,0,0,25,0
2020-06-05,Namibia,0,0,25,0
2020-06-06,Namibia,4,0,29,0
2020-06-07,Namibia,0,0,29,0
2020-06-08,Namibia,2,0,31,0
2020-06-09,Namibia,0,0,31,0
2020-06-10,Namibia,0,0,31,0
2020-06-11,Namibia,0,0,31,0
2020-06-12,Namibia,0,0,31,0
2020-06-13,Namibia,1,0,32,0
2020-06-14,Namibia,0,0,32,0
2020-06-15,Namibia,0,0,32,0
2020-06-16,Namibia,2,0,34,0
2020-06-17,Namibia,2,0,36,0
2020-06-18,Namibia,3,0,39,0
2020-06-19,Namibia,6,0,45,0
2020-06-20,Namibia,1,0,46,0
2020-06-21,Namibia,9,0,55,0
2020-06-22,Namibia,8,0,63,0
2020-06-23,Namibia,9,0,72,0
2020-06-24,Namibia,4,0,76,0
2020-06-25,Namibia,26,0,102,0
2020-06-26,Namibia,19,0,121,0
2020-06-27,Namibia,15,0,136,0
2020-06-28,Namibia,47,0,183,0
2020-06-29,Namibia,13,0,196,0
2020-06-30,Namibia,9,0,205,0
2020-07-01,Namibia,80,0,285,0
2020-07-02,Namibia,8,0,293,0
2020-07-03,Namibia,57,0,350,0
2020-07-04,Namibia,25,0,375,0
2020-07-05,Namibia,37,0,412,0
2020-07-06,Namibia,73,0,485,0
2020-07-07,Namibia,54,0,539,0
2020-07-08,Namibia,54,0,593,0
2020-07-09,Namibia,22,0,615,0
2020-07-10,Namibia,53,1,668,1
2020-07-11,Namibia,0,0,668,1
2020-07-12,Namibia,117,0,785,1
2020-07-13,Namibia,76,0,861,1
2020-07-14,Namibia,3,1,864,2
2020-07-15,Namibia,96,0,960,2
2020-07-16,Namibia,72,0,1032,2
2020-07-17,Namibia,46,0,1078,2
2020-07-18,Namibia,125,0,1203,2
2020-07-19,Namibia,44,1,1247,3
2020-07-20,Namibia,97,1,1344,4
2020-07-21,Namibia,22,3,1366,7
2020-07-22,Namibia,36,0,1402,7
2020-07-23,Namibia,120,0,1522,7
2020-07-24,Namibia,96,0,1618,7
2020-07-25,Namibia,69,0,1687,7
2020-07-26,Namibia,88,1,1775,8
2020-07-27,Namibia,68,0,1843,8
2020-07-28,Namibia,74,0,1917,8
2020-07-29,Namibia,69,1,1986,9
2020-07-30,Namibia,66,1,2052,10
2020-07-31,Namibia,77,0,2129,10
2020-08-01,Namibia,95,1,2224,11
2020-08-02,Namibia,70,0,2294,11
2020-08-03,Namibia,112,1,2406,12
2020-08-04,Namibia,64,0,2470,12
2020-08-05,Namibia,70,0,2540,12
2020-08-06,Namibia,112,3,2652,15
2020-08-07,Namibia,150,1,2802,16
2020-08-08,Namibia,0,0,2802,16
2020-08-09,Namibia,147,3,2949,19
2020-08-10,Namibia,152,0,3101,19
2020-08-11,Namibia,128,0,3229,19
2020-08-12,Namibia,177,3,3406,22
2020-08-13,Namibia,138,5,3544,27
2020-08-14,Namibia,182,4,3726,31
2020-08-15,Namibia,181,4,3907,35
2020-08-16,Namibia,247,0,4154,35
2020-08-17,Namibia,190,1,4344,36
2020-08-18,Namibia,120,1,4464,37
2020-08-19,Namibia,201,2,4665,39
2020-08-20,Namibia,247,2,4912,41
2020-08-21,Namibia,315,1,5227,42
2020-08-22,Namibia,311,4,5538,46
2020-08-23,Namibia,316,6,5854,52
2020-08-24,Namibia,176,4,6030,56
2020-08-25,Namibia,130,1,6160,57
2020-08-26,Namibia,271,2,6431,59
2020-08-27,Namibia,281,1,6712,60
2020-08-28,Namibia,194,5,6906,65
2020-08-29,Namibia,210,4,7116,69
2020-08-30,Namibia,249,3,7365,72
2020-08-31,Namibia,185,3,7550,75
2020-09-01,Namibia,142,6,7692,81
2020-09-02,Namibia,152,1,7844,82
2020-09-03,Namibia,238,4,8082,86
2020-09-04,Namibia,241,1,8323,87
2020-09-05,Namibia,191,0,8514,87
2020-09-06,Namibia,171,2,8685,89
2020-09-07,Namibia,125,2,8810,91
2020-09-08,Namibia,118,0,8928,91
2020-09-09,Namibia,180,2,9108,93
2020-09-10,Namibia,148,3,9256,96
2020-09-11,Namibia,181,2,9437,98
2020-09-12,Namibia,167,0,9604,98
2020-09-13,Namibia,115,3,9719,101
2020-09-14,Namibia,99,2,9818,103
2020-09-15,Namibia,83,3,9901,106
2020-09-16,Namibia,63,2,9964,108
2020-09-17,Namibia,114,0,10078,108
2020-09-18,Namibia,129,0,10207,108
2020-09-19,Namibia,85,3,10292,111
2020-09-20,Namibia,85,1,10377,112
2020-09-21,Namibia,149,1,10526,113
2020-09-22,Namibia,81,3,10607,116
2020-09-23,Namibia,56,1,10663,117
2020-09-24,Namibia,77,2,10740,119
2020-09-25,Namibia,95,0,10835,119
2020-09-26,Namibia,83,1,10918,120
2020-09-27,Namibia,115,0,11033,120
2020-09-28,Namibia,88,1,11121,121
2020-09-29,Namibia,19,0,11140,121
2020-09-30,Namibia,125,0,11265,121
2020-10-01,Namibia,108,2,11373,123
2020-10-02,Namibia,107,0,11480,123
2020-10-03,Namibia,92,0,11572,123
2020-10-04,Namibia,54,0,11626,123
2020-10-05,Namibia,28,2,11654,125
2020-10-06,Namibia,19,0,11673,125
2020-10-07,Namibia,41,1,11714,126
2020-10-08,Namibia,67,1,11781,127
2020-10-09,Namibia,48,0,11829,127
2020-10-10,Namibia,62,1,11891,128
2020-10-11,Namibia,45,0,11936,128
2020-10-12,Namibia,53,1,11989,129
2020-10-13,Namibia,11,0,12000,129
2020-10-14,Namibia,69,1,12069,130
2020-10-15,Namibia,34,0,12103,130
2020-10-16,Namibia,112,1,12215,131
2020-10-17,Namibia,48,0,12263,131
2020-10-18,Namibia,30,0,12293,131
2020-10-19,Namibia,33,0,12326,131
2020-10-20,Namibia,41,1,12367,132
2020-10-21,Namibia,39,1,12406,133
2020-10-22,Namibia,54,0,12460,133
2020-10-23,Namibia,41,0,12501,133
2020-10-24,Namibia,78,0,12579,133
2020-10-25,Namibia,81,0,12660,133
2020-10-26,Namibia,15,0,12675,133
2020-10-27,Namibia,54,0,12729,133
2020-10-28,Namibia,77,0,12806,133
2020-10-29,Namibia,52,0,12858,133
2020-10-30,Namibia,49,0,12907,133
2020-10-31,Namibia,28,0,12935,133
2020-11-01,Namibia,53,0,12988,133
2020-11-02,Namibia,24,0,13012,133
2020-11-03,Namibia,18,0,13030,133
2020-11-04,Namibia,16,0,13046,133
2020-11-05,Namibia,44,0,13090,133
2020-11-06,Namibia,53,0,13143,133
2020-11-07,Namibia,27,1,13170,134
2020-11-08,Namibia,41,0,13211,134
2020-11-09,Namibia,29,0,13240,134
2020-11-10,Namibia,13,0,13253,134
2020-11-11,Namibia,39,0,13292,134
2020-11-12,Namibia,53,1,13345,135
2020-11-13,Namibia,27,3,13372,138
2020-11-14,Namibia,77,0,13449,138
2020-11-15,Namibia,59,0,13508,138
2020-11-16,Namibia,47,0,13555,138
2020-11-17,Namibia,11,2,13566,140
2020-11-18,Namibia,44,0,13610,140
2020-11-19,Namibia,52,1,13662,141
2020-11-20,Namibia,50,2,13712,143
2020-11-21,Namibia,99,2,13811,145
2020-11-22,Namibia,54,0,13865,145
2020-11-23,Namibia,32,0,13897,145
2020-11-24,Namibia,41,0,13938,145
2020-11-25,Namibia,68,0,14006,145
2020-11-26,Namibia,149,2,14155,147
2020-11-27,Namibia,52,2,14207,149
2020-11-28,Namibia,78,1,14285,150
2020-11-29,Namibia,60,1,14345,151
2020-11-30,Namibia,35,0,14380,151
2020-12-01,Namibia,36,0,14416,151
2020-12-02,Namibia,61,0,14477,151
2020-12-03,Namibia,122,0,14599,151
2020-12-04,Namibia,205,1,14804,152
2020-12-05,Namibia,146,0,14950,152
2020-12-06,Namibia,128,0,15078,152
2020-12-07,Namibia,141,0,15219,152
2020-12-08,Namibia,79,1,15298,153
2020-12-09,Namibia,174,2,15472,155
2020-12-10,Namibia,301,3,15773,158
2020-12-11,Namibia,324,2,16097,160
2020-12-12,Namibia,172,0,16269,160
2020-12-13,Namibia,267,0,16536,160
2020-12-14,Namibia,190,3,16726,163
2020-12-15,Namibia,187,1,16913,164
2020-12-16,Namibia,363,0,17276,164
2020-12-17,Namibia,331,0,17607,164
2020-12-18,Namibia,434,5,18041,169
2020-12-19,Namibia,396,2,18437,171
2020-12-20,Namibia,277,6,18714,177
2020-12-21,Namibia,585,3,19299,180
2020-12-22,Namibia,330,1,19629,181
2020-12-23,Namibia,355,2,19984,183
2020-12-24,Namibia,595,4,20579,187
2020-12-25,Namibia,683,0,21262,187
2020-12-26,Namibia,136,0,21398,187
2020-12-27,Namibia,525,4,21923,191
2020-12-28,Namibia,364,2,22287,193
2020-12-29,Namibia,564,2,22851,195
2020-12-30,Namibia,482,1,23333,196
2020-12-31,Namibia,608,9,23941,205
2021-01-01,Namibia,604,3,24545,208
2021-01-02,Namibia,109,5,24654,213
2021-01-03,Namibia,462,2,25116,215
2021-01-04,Namibia,270,3,25386,218
2021-01-05,Namibia,501,4,25887,222
2021-01-06,Namibia,432,13,26319,235
2021-01-07,Namibia,363,5,26682,240
2021-01-08,Namibia,573,5,27255,245
2021-01-09,Namibia,468,6,27723,251
2021-01-10,Namibia,536,3,28259,254
2021-01-11,Namibia,343,7,28602,261
2021-01-12,Namibia,269,3,28871,264
2021-01-13,Namibia,312,7,29183,271
2021-01-14,Namibia,387,4,29570,275
2021-01-15,Namibia,319,5,29889,280
2021-01-16,Namibia,309,0,30198,280
2021-01-17,Namibia,165,5,30363,285
2021-01-18,Namibia,390,8,30753,293
2021-01-19,Namibia,242,3,30995,296
2021-01-20,Namibia,258,5,31253,301
2021-01-21,Namibia,262,9,31515,310
2021-01-22,Namibia,333,1,31848,311
2021-01-23,Namibia,365,6,32213,317
2021-01-24,Namibia,212,2,32425,319
2021-01-25,Namibia,225,0,32650,319
2021-01-26,Namibia,307,9,32957,328
2021-01-27,Namibia,308,4,33265,332
2021-01-28,Namibia,194,0,33459,332
2021-01-29,Namibia,237,10,33696,342
2021-01-30,Namibia,136,8,33832,350
2021-01-31,Namibia,112,2,33944,352
2021-02-01,Namibia,224,1,34168,353
2021-02-02,Namibia,102,2,34270,355
2021-02-03,Namibia,102,4,34372,359
2021-02-04,Namibia,147,5,34519,364
2021-02-05,Namibia,96,6,34615,370
2021-02-06,Namibia,229,1,34844,371
2021-02-07,Namibia,129,4,34973,375
2021-02-08,Namibia,97,0,35070,375
2021-02-09,Namibia,131,2,35201,377
2021-02-10,Namibia,41,1,35242,378
2021-02-11,Namibia,111,4,35353,382
2021-02-12,Namibia,201,2,35554,384
2021-02-13,Namibia,243,2,35797,386
2021-02-14,Namibia,155,2,35952,388
2021-02-15,Namibia,273,1,36225,389
2021-02-16,Namibia,141,3,36366,392
2021-02-17,Namibia,74,2,36440,394
2021-02-18,Namibia,240,0,36680,394
2021-02-19,Namibia,313,5,36993,399
2021-02-20,Namibia,302,3,37295,402
2021-02-21,Namibia,188,0,37483,402
2021-02-22,Namibia,259,4,37742,406
2021-02-23,Namibia,154,5,37896,411
2021-02-24,Namibia,80,2,37976,413
2021-02-25,Namibia,230,3,38206,416
2021-02-26,Namibia,218,2,38424,418
2021-02-27,Namibia,218,2,38642,420
2021-02-28,Namibia,203,4,38845,424
2021-03-01,Namibia,188,4,39033,428
2021-03-02,Namibia,149,2,39182,430
2021-03-03,Namibia,115,4,39297,434
2021-03-04,Namibia,169,2,39466,436
2021-03-05,Namibia,210,1,39676,437
2021-03-06,Namibia,201,0,39877,437
2021-03-07,Namibia,153,1,40030,438
2021-03-08,Namibia,157,1,40187,439
2021-03-09,Namibia,150,5,40337,444
2021-03-10,Namibia,114,4,40451,448
2021-03-11,Namibia,180,2,40631,450
2021-03-12,Namibia,179,6,40810,456
2021-03-13,Namibia,215,2,41025,458
2021-03-14,Namibia,175,0,41200,458
2021-03-15,Namibia,224,7,41424,465
2021-03-16,Namibia,42,9,41466,474
2021-03-17,Namibia,80,3,41546,477
2021-03-18,Namibia,138,6,41684,483
2021-03-19,Namibia,281,3,41965,486
2021-03-20,Namibia,238,6,42203,492
2021-03-21,Namibia,274,0,42477,492
2021-03-22,Namibia,176,2,42653,494
2021-03-23,Namibia,118,4,42771,498
2021-03-24,Namibia,93,4,42864,502
2021-03-25,Namibia,146,0,43010,502
2021-03-26,Namibia,169,2,43179,504
2021-03-27,Namibia,320,4,43499,508
2021-03-28,Namibia,133,1,43632,509
2021-03-29,Namibia,291,4,43923,513
2021-03-30,Namibia,128,7,44051,520
2021-03-31,Namibia,88,3,44139,523
2021-04-01,Namibia,235,5,44374,528
2021-04-02,Namibia,207,3,44581,531
2021-04-03,Namibia,102,2,44683,533
2021-04-04,Namibia,107,4,44790,537
2021-04-05,Namibia,96,1,44886,538
2021-04-06,Namibia,122,4,45008,542
2021-04-07,Namibia,31,6,45039,548
2021-04-08,Namibia,15,9,45054,557
2020-01-25,Nepal,1,0,1,0
2020-01-26,Nepal,0,0,1,0
2020-01-27,Nepal,0,0,1,0
2020-01-28,Nepal,0,0,1,0
2020-01-29,Nepal,0,0,1,0
2020-01-30,Nepal,0,0,1,0
2020-01-31,Nepal,0,0,1,0
2020-02-01,Nepal,0,0,1,0
2020-02-02,Nepal,0,0,1,0
2020-02-03,Nepal,0,0,1,0
2020-02-04,Nepal,0,0,1,0
2020-02-05,Nepal,0,0,1,0
2020-02-06,Nepal,0,0,1,0
2020-02-07,Nepal,0,0,1,0
2020-02-08,Nepal,0,0,1,0
2020-02-09,Nepal,0,0,1,0
2020-02-10,Nepal,0,0,1,0
2020-02-11,Nepal,0,0,1,0
2020-02-12,Nepal,0,0,1,0
2020-02-13,Nepal,0,0,1,0
2020-02-14,Nepal,0,0,1,0
2020-02-15,Nepal,0,0,1,0
2020-02-16,Nepal,0,0,1,0
2020-02-17,Nepal,0,0,1,0
2020-02-18,Nepal,0,0,1,0
2020-02-19,Nepal,0,0,1,0
2020-02-20,Nepal,0,0,1,0
2020-02-21,Nepal,0,0,1,0
2020-02-22,Nepal,0,0,1,0
2020-02-23,Nepal,0,0,1,0
2020-02-24,Nepal,0,0,1,0
2020-02-25,Nepal,0,0,1,0
2020-02-26,Nepal,0,0,1,0
2020-02-27,Nepal,0,0,1,0
2020-02-28,Nepal,0,0,1,0
2020-02-29,Nepal,0,0,1,0
2020-03-01,Nepal,0,0,1,0
2020-03-02,Nepal,0,0,1,0
2020-03-03,Nepal,0,0,1,0
2020-03-04,Nepal,0,0,1,0
2020-03-05,Nepal,0,0,1,0
2020-03-06,Nepal,0,0,1,0
2020-03-07,Nepal,0,0,1,0
2020-03-08,Nepal,0,0,1,0
2020-03-09,Nepal,0,0,1,0
2020-03-10,Nepal,0,0,1,0
2020-03-11,Nepal,0,0,1,0
2020-03-12,Nepal,0,0,1,0
2020-03-13,Nepal,0,0,1,0
2020-03-14,Nepal,0,0,1,0
2020-03-15,Nepal,0,0,1,0
2020-03-16,Nepal,0,0,1,0
2020-03-17,Nepal,0,0,1,0
2020-03-18,Nepal,0,0,1,0
2020-03-19,Nepal,0,0,1,0
2020-03-20,Nepal,0,0,1,0
2020-03-21,Nepal,0,0,1,0
2020-03-22,Nepal,0,0,1,0
2020-03-23,Nepal,1,0,2,0
2020-03-24,Nepal,0,0,2,0
2020-03-25,Nepal,1,0,3,0
2020-03-26,Nepal,0,0,3,0
2020-03-27,Nepal,1,0,4,0
2020-03-28,Nepal,1,0,5,0
2020-03-29,Nepal,0,0,5,0
2020-03-30,Nepal,0,0,5,0
2020-03-31,Nepal,0,0,5,0
2020-04-01,Nepal,0,0,5,0
2020-04-02,Nepal,1,0,6,0
2020-04-03,Nepal,0,0,6,0
2020-04-04,Nepal,3,0,9,0
2020-04-05,Nepal,0,0,9,0
2020-04-06,Nepal,0,0,9,0
2020-04-07,Nepal,0,0,9,0
2020-04-08,Nepal,0,0,9,0
2020-04-09,Nepal,0,0,9,0
2020-04-10,Nepal,0,0,9,0
2020-04-11,Nepal,0,0,9,0
2020-04-12,Nepal,3,0,12,0
2020-04-13,Nepal,2,0,14,0
2020-04-14,Nepal,2,0,16,0
2020-04-15,Nepal,0,0,16,0
2020-04-16,Nepal,0,0,16,0
2020-04-17,Nepal,14,0,30,0
2020-04-18,Nepal,1,0,31,0
2020-04-19,Nepal,0,0,31,0
2020-04-20,Nepal,0,0,31,0
2020-04-21,Nepal,12,0,43,0
2020-04-22,Nepal,2,0,45,0
2020-04-23,Nepal,3,0,48,0
2020-04-24,Nepal,1,0,49,0
2020-04-25,Nepal,0,0,49,0
2020-04-26,Nepal,3,0,52,0
2020-04-27,Nepal,0,0,52,0
2020-04-28,Nepal,2,0,54,0
2020-04-29,Nepal,3,0,57,0
2020-04-30,Nepal,0,0,57,0
2020-05-01,Nepal,2,0,59,0
2020-05-02,Nepal,0,0,59,0
2020-05-03,Nepal,16,0,75,0
2020-05-04,Nepal,0,0,75,0
2020-05-05,Nepal,7,0,82,0
2020-05-06,Nepal,17,0,99,0
2020-05-07,Nepal,2,0,101,0
2020-05-08,Nepal,1,0,102,0
2020-05-09,Nepal,8,0,110,0
2020-05-10,Nepal,0,0,110,0
2020-05-11,Nepal,24,0,134,0
2020-05-12,Nepal,83,0,217,0
2020-05-13,Nepal,33,0,250,0
2020-05-14,Nepal,-1,0,249,0
2020-05-15,Nepal,18,0,267,0
2020-05-16,Nepal,24,1,291,1
2020-05-17,Nepal,4,1,295,2
2020-05-18,Nepal,80,0,375,2
2020-05-19,Nepal,27,0,402,2
2020-05-20,Nepal,25,0,427,2
2020-05-21,Nepal,30,1,457,3
2020-05-22,Nepal,59,0,516,3
2020-05-23,Nepal,68,0,584,3
2020-05-24,Nepal,19,0,603,3
2020-05-25,Nepal,79,1,682,4
2020-05-26,Nepal,90,0,772,4
2020-05-27,Nepal,114,0,886,4
2020-05-28,Nepal,156,1,1042,5
2020-05-29,Nepal,170,1,1212,6
2020-05-30,Nepal,189,0,1401,6
2020-05-31,Nepal,171,2,1572,8
2020-06-01,Nepal,239,0,1811,8
2020-06-02,Nepal,288,0,2099,8
2020-06-03,Nepal,201,1,2300,9
2020-06-04,Nepal,334,1,2634,10
2020-06-05,Nepal,278,1,2912,11
2020-06-06,Nepal,323,2,3235,13
2020-06-07,Nepal,213,0,3448,13
2020-06-08,Nepal,314,1,3762,14
2020-06-09,Nepal,324,1,4086,15
2020-06-10,Nepal,278,0,4364,15
2020-06-11,Nepal,250,0,4614,15
2020-06-12,Nepal,448,1,5062,16
2020-06-13,Nepal,273,2,5335,18
2020-06-14,Nepal,425,1,5760,19
2020-06-15,Nepal,451,0,6211,19
2020-06-16,Nepal,380,0,6591,19
2020-06-17,Nepal,586,1,7177,20
2020-06-18,Nepal,671,2,7848,22
2020-06-19,Nepal,426,0,8274,22
2020-06-20,Nepal,331,0,8605,22
2020-06-21,Nepal,421,1,9026,23
2020-06-22,Nepal,535,0,9561,23
2020-06-23,Nepal,538,1,10099,24
2020-06-24,Nepal,629,0,10728,24
2020-06-25,Nepal,434,2,11162,26
2020-06-26,Nepal,593,1,11755,27
2020-06-27,Nepal,554,1,12309,28
2020-06-28,Nepal,463,0,12772,28
2020-06-29,Nepal,476,1,13248,29
2020-06-30,Nepal,316,0,13564,29
2020-07-01,Nepal,482,1,14046,30
2020-07-02,Nepal,473,1,14519,31
2020-07-03,Nepal,740,1,15259,32
2020-07-04,Nepal,232,2,15491,34
2020-07-05,Nepal,293,0,15784,34
2020-07-06,Nepal,180,1,15964,35
2020-07-07,Nepal,204,0,16168,35
2020-07-08,Nepal,255,0,16423,35
2020-07-09,Nepal,108,0,16531,35
2020-07-10,Nepal,118,0,16649,35
2020-07-11,Nepal,70,3,16719,38
2020-07-12,Nepal,82,0,16801,38
2020-07-13,Nepal,144,0,16945,38
2020-07-14,Nepal,116,0,17061,38
2020-07-15,Nepal,116,1,17177,39
2020-07-16,Nepal,167,0,17344,39
2020-07-17,Nepal,101,1,17445,40
2020-07-18,Nepal,57,0,17502,40
2020-07-19,Nepal,156,0,17658,40
2020-07-20,Nepal,186,0,17844,40
2020-07-21,Nepal,150,0,17994,40
2020-07-22,Nepal,100,2,18094,42
2020-07-23,Nepal,147,1,18241,43
2020-07-24,Nepal,133,1,18374,44
2020-07-25,Nepal,109,1,18483,45
2020-07-26,Nepal,130,0,18613,45
2020-07-27,Nepal,139,3,18752,48
2020-07-28,Nepal,311,1,19063,49
2020-07-29,Nepal,210,0,19273,49
2020-07-30,Nepal,274,3,19547,52
2020-07-31,Nepal,224,4,19771,56
2020-08-01,Nepal,315,0,20086,56
2020-08-02,Nepal,246,1,20332,57
2020-08-03,Nepal,418,0,20750,57
2020-08-04,Nepal,259,1,21009,58
2020-08-05,Nepal,381,2,21390,60
2020-08-06,Nepal,360,5,21750,65
2020-08-07,Nepal,464,5,22214,70
2020-08-08,Nepal,378,3,22592,73
2020-08-09,Nepal,380,2,22972,75
2020-08-10,Nepal,338,4,23310,79
2020-08-11,Nepal,638,4,23948,83
2020-08-12,Nepal,484,8,24432,91
2020-08-13,Nepal,525,4,24957,95
2020-08-14,Nepal,594,4,25551,99
2020-08-15,Nepal,468,3,26019,102
2020-08-16,Nepal,641,2,26660,104
2020-08-17,Nepal,581,3,27241,107
2020-08-18,Nepal,1016,7,28257,114
2020-08-19,Nepal,681,6,28938,120
2020-08-20,Nepal,707,6,29645,126
2020-08-21,Nepal,838,11,30483,137
2020-08-22,Nepal,634,9,31117,146
2020-08-23,Nepal,818,3,31935,149
2020-08-24,Nepal,743,8,32678,157
2020-08-25,Nepal,855,7,33533,164
2020-08-26,Nepal,885,11,34418,175
2020-08-27,Nepal,1111,8,35529,183
2020-08-28,Nepal,927,12,36456,195
2020-08-29,Nepal,884,12,37340,207
2020-08-30,Nepal,1221,14,38561,221
2020-08-31,Nepal,899,7,39460,228
2020-09-01,Nepal,1069,11,40529,239
2020-09-02,Nepal,1120,12,41649,251
2020-09-03,Nepal,1228,6,42877,257
2020-09-04,Nepal,1359,14,44236,271
2020-09-05,Nepal,1041,9,45277,280
2020-09-06,Nepal,980,9,46257,289
2020-09-07,Nepal,979,11,47236,300
2020-09-08,Nepal,902,6,48138,306
2020-09-09,Nepal,1081,6,49219,312
2020-09-10,Nepal,1246,5,50465,317
2020-09-11,Nepal,1454,5,51919,322
2020-09-12,Nepal,1201,14,53120,336
2020-09-13,Nepal,1039,9,54159,345
2020-09-14,Nepal,1170,15,55329,360
2020-09-15,Nepal,1459,11,56788,371
2020-09-16,Nepal,1539,8,58327,379
2020-09-17,Nepal,1246,4,59573,383
2020-09-18,Nepal,2020,7,61593,390
2020-09-19,Nepal,1204,11,62797,401
2020-09-20,Nepal,1325,10,64122,411
2020-09-21,Nepal,1154,16,65276,427
2020-09-22,Nepal,1356,2,66632,429
2020-09-23,Nepal,1172,7,67804,436
2020-09-24,Nepal,1497,17,69301,453
2020-09-25,Nepal,1313,6,70614,459
2020-09-26,Nepal,1207,8,71821,467
2020-09-27,Nepal,1573,10,73394,477
2020-09-28,Nepal,1351,4,74745,481
2020-09-29,Nepal,1513,10,76258,491
2020-09-30,Nepal,1559,7,77817,498
2020-10-01,Nepal,1911,11,79728,509
2020-10-02,Nepal,2722,11,82450,520
2020-10-03,Nepal,2120,8,84570,528
2020-10-04,Nepal,2253,7,86823,535
2020-10-05,Nepal,2440,19,89263,554
2020-10-06,Nepal,1551,9,90814,563
2020-10-07,Nepal,3439,15,94253,578
2020-10-08,Nepal,4364,12,98617,590
2020-10-09,Nepal,2059,10,100676,600
2020-10-10,Nepal,5008,14,105684,614
2020-10-11,Nepal,2071,22,107755,636
2020-10-12,Nepal,4047,9,111802,645
2020-10-13,Nepal,3556,18,115358,663
2020-10-14,Nepal,2638,12,117996,675
2020-10-15,Nepal,3749,19,121745,694
2020-10-16,Nepal,4392,21,126137,715
2020-10-17,Nepal,3167,12,129304,727
2020-10-18,Nepal,2942,12,132246,739
2020-10-19,Nepal,3790,18,136036,757
2020-10-20,Nepal,3093,8,139129,765
2020-10-21,Nepal,5743,26,144872,791
2020-10-22,Nepal,3637,21,148509,812
2020-10-23,Nepal,4499,17,153008,829
2020-10-24,Nepal,2225,13,155233,842
2020-10-25,Nepal,2856,5,158089,847
2020-10-26,Nepal,1741,15,159830,862
2020-10-27,Nepal,570,14,160400,876
2020-10-28,Nepal,1954,11,162354,887
2020-10-29,Nepal,2364,17,164718,904
2020-10-30,Nepal,3517,16,168235,920
2020-10-31,Nepal,2508,17,170743,937
2020-11-01,Nepal,2824,23,173567,960
2020-11-02,Nepal,2933,24,176500,984
2020-11-03,Nepal,3114,20,179614,1004
2020-11-04,Nepal,3309,30,182923,1034
2020-11-05,Nepal,3051,18,185974,1052
2020-11-06,Nepal,2909,18,188883,1070
2020-11-07,Nepal,2753,17,191636,1087
2020-11-08,Nepal,2817,21,194453,1108
2020-11-09,Nepal,2571,18,197024,1126
2020-11-10,Nepal,2736,22,199760,1148
2020-11-11,Nepal,2569,26,202329,1174
2020-11-12,Nepal,1913,15,204242,1189
2020-11-13,Nepal,2111,13,206353,1202
2020-11-14,Nepal,1946,13,208299,1215
2020-11-15,Nepal,1477,6,209776,1221
2020-11-16,Nepal,1197,9,210973,1230
2020-11-17,Nepal,502,17,211475,1247
2020-11-18,Nepal,1442,12,212917,1259
2020-11-19,Nepal,2103,17,215020,1276
2020-11-20,Nepal,1945,22,216965,1298
2020-11-21,Nepal,1674,7,218639,1305
2020-11-22,Nepal,1669,16,220308,1321
2020-11-23,Nepal,1980,16,222288,1337
2020-11-24,Nepal,1790,24,224078,1361
2020-11-25,Nepal,1948,28,226026,1389
2020-11-26,Nepal,1614,23,227640,1412
2020-11-27,Nepal,1703,23,229343,1435
2020-11-28,Nepal,1380,19,230723,1454
2020-11-29,Nepal,1255,25,231978,1479
2020-11-30,Nepal,1474,29,233452,1508
2020-12-01,Nepal,0,21,233452,1529
2020-12-02,Nepal,2794,9,236246,1538
2020-12-03,Nepal,1343,13,237589,1551
2020-12-04,Nepal,1272,16,238861,1567
2020-12-05,Nepal,1024,10,239885,1577
2020-12-06,Nepal,1096,17,240981,1594
2020-12-07,Nepal,1014,20,241995,1614
2020-12-08,Nepal,1382,23,243377,1637
2020-12-09,Nepal,1056,14,244433,1651
2020-12-10,Nepal,1217,12,245650,1663
2020-12-11,Nepal,1044,11,246694,1674
2020-12-12,Nepal,899,15,247593,1689
2020-12-13,Nepal,830,9,248423,1698
2020-12-14,Nepal,821,18,249244,1716
2020-12-15,Nepal,936,14,250180,1730
2020-12-16,Nepal,736,13,250916,1743
2020-12-17,Nepal,776,6,251692,1749
2020-12-18,Nepal,782,16,252474,1765
2020-12-19,Nepal,710,12,253184,1777
2020-12-20,Nepal,588,11,253772,1788
2020-12-21,Nepal,742,7,254514,1795
2020-12-22,Nepal,722,3,255236,1798
2020-12-23,Nepal,743,5,255979,1803
2020-12-24,Nepal,613,5,256592,1808
2020-12-25,Nepal,608,8,257200,1816
2020-12-26,Nepal,500,3,257700,1819
2020-12-27,Nepal,481,6,258181,1825
2020-12-28,Nepal,659,7,258840,1832
2020-12-29,Nepal,708,8,259548,1840
2020-12-30,Nepal,511,7,260059,1847
2020-12-31,Nepal,534,9,260593,1856
2021-01-01,Nepal,426,8,261019,1864
2021-01-02,Nepal,419,6,261438,1870
2021-01-03,Nepal,421,8,261859,1878
2021-01-04,Nepal,403,7,262262,1885
2021-01-05,Nepal,522,8,262784,1893
2021-01-06,Nepal,409,6,263193,1899
2021-01-07,Nepal,412,4,263605,1903
2021-01-08,Nepal,554,6,264159,1909
2021-01-09,Nepal,362,3,264521,1912
2021-01-10,Nepal,259,5,264780,1917
2021-01-11,Nepal,488,10,265268,1927
2021-01-12,Nepal,430,5,265698,1932
2021-01-13,Nepal,445,5,266143,1937
2021-01-14,Nepal,403,6,266546,1943
2021-01-15,Nepal,270,5,266816,1948
2021-01-16,Nepal,240,6,267056,1954
2021-01-17,Nepal,266,5,267322,1959
2021-01-18,Nepal,322,6,267644,1965
2021-01-19,Nepal,348,4,267992,1969
2021-01-20,Nepal,318,6,268310,1975
2021-01-21,Nepal,336,4,268646,1979
2021-01-22,Nepal,302,7,268948,1986
2021-01-23,Nepal,232,8,269180,1994
2021-01-24,Nepal,270,7,269450,2001
2021-01-25,Nepal,339,10,269789,2011
2021-01-26,Nepal,303,6,270092,2017
2021-01-27,Nepal,283,3,270375,2020
2021-01-28,Nepal,213,0,270588,2020
2021-01-29,Nepal,157,5,270745,2025
2021-01-30,Nepal,109,2,270854,2027
2021-01-31,Nepal,105,2,270959,2029
2021-02-01,Nepal,159,0,271118,2029
2021-02-02,Nepal,171,1,271289,2030
2021-02-03,Nepal,142,1,271431,2031
2021-02-04,Nepal,171,2,271602,2033
2021-02-05,Nepal,105,2,271707,2035
2021-02-06,Nepal,99,0,271806,2035
2021-02-07,Nepal,119,3,271925,2038
2021-02-08,Nepal,130,7,272055,2045
2021-02-09,Nepal,160,2,272215,2047
2021-02-10,Nepal,134,0,272349,2047
2021-02-11,Nepal,81,5,272430,2052
2021-02-12,Nepal,127,2,272557,2054
2021-02-13,Nepal,57,0,272614,2054
2021-02-14,Nepal,104,0,272718,2054
2021-02-15,Nepal,122,1,272840,2055
2021-02-16,Nepal,105,0,272945,2055
2021-02-17,Nepal,125,0,273070,2055
2021-02-18,Nepal,96,3,273166,2058
2021-02-19,Nepal,97,3,273263,2061
2021-02-20,Nepal,88,0,273351,2061
2021-02-21,Nepal,80,0,273431,2061
2021-02-22,Nepal,125,0,273556,2061
2021-02-23,Nepal,110,4,273666,2065
2021-02-24,Nepal,94,619,273760,2684
2021-02-25,Nepal,112,1,273872,2685
2021-02-26,Nepal,112,86,273984,2771
2021-02-27,Nepal,81,2,274065,2773
2021-02-28,Nepal,78,1,274143,2774
2021-03-01,Nepal,73,3,274216,2777
2021-03-02,Nepal,78,0,274294,2777
2021-03-03,Nepal,87,1,274381,2778
2021-03-04,Nepal,107,0,274488,2778
2021-03-05,Nepal,120,232,274608,3010
2021-03-06,Nepal,47,0,274655,3010
2021-03-07,Nepal,66,0,274721,3010
2021-03-08,Nepal,89,1,274810,3011
2021-03-09,Nepal,59,1,274869,3012
2021-03-10,Nepal,104,0,274973,3012
2021-03-11,Nepal,97,0,275070,3012
2021-03-12,Nepal,48,0,275118,3012
2021-03-13,Nepal,60,2,275178,3014
2021-03-14,Nepal,53,0,275231,3014
2021-03-15,Nepal,79,0,275310,3014
2021-03-16,Nepal,114,0,275424,3014
2021-03-17,Nepal,94,0,275518,3014
2021-03-18,Nepal,107,1,275625,3015
2021-03-19,Nepal,125,1,275750,3016
2021-03-20,Nepal,79,0,275829,3016
2021-03-21,Nepal,77,0,275906,3016
2021-03-22,Nepal,150,3,276056,3019
2021-03-23,Nepal,188,0,276244,3019
2021-03-24,Nepal,145,1,276389,3020
2021-03-25,Nepal,120,0,276509,3020
2021-03-26,Nepal,156,4,276665,3024
2021-03-27,Nepal,85,3,276750,3027
2021-03-28,Nepal,89,0,276839,3027
2021-03-29,Nepal,141,0,276980,3027
2021-03-30,Nepal,167,3,277147,3030
2021-03-31,Nepal,162,0,277309,3030
2021-04-01,Nepal,152,1,277461,3031
2021-04-02,Nepal,179,0,277640,3031
2021-04-03,Nepal,128,1,277768,3032
2021-04-04,Nepal,176,0,277944,3032
2021-04-05,Nepal,266,4,278210,3036
2021-04-06,Nepal,260,0,278470,3036
2021-04-07,Nepal,298,2,278768,3038
2021-04-08,Nepal,332,0,279100,3038
2020-02-27,Netherlands,1,0,1,0
2020-02-28,Netherlands,0,0,1,0
2020-02-29,Netherlands,5,0,6,0
2020-03-01,Netherlands,4,0,10,0
2020-03-02,Netherlands,8,0,18,0
2020-03-03,Netherlands,6,0,24,0
2020-03-04,Netherlands,14,0,38,0
2020-03-05,Netherlands,44,0,82,0
2020-03-06,Netherlands,46,1,128,1
2020-03-07,Netherlands,60,0,188,1
2020-03-08,Netherlands,77,2,265,3
2020-03-09,Netherlands,56,0,321,3
2020-03-10,Netherlands,61,1,382,4
2020-03-11,Netherlands,121,1,503,5
2020-03-12,Netherlands,0,0,503,5
2020-03-13,Netherlands,303,5,806,10
2020-03-14,Netherlands,156,2,962,12
2020-03-15,Netherlands,176,8,1138,20
2020-03-16,Netherlands,278,4,1416,24
2020-03-17,Netherlands,295,19,1711,43
2020-03-18,Netherlands,347,15,2058,58
2020-03-19,Netherlands,409,19,2467,77
2020-03-20,Netherlands,536,30,3003,107
2020-03-21,Netherlands,637,30,3640,137
2020-03-22,Netherlands,577,43,4217,180
2020-03-23,Netherlands,547,34,4764,214
2020-03-24,Netherlands,816,63,5580,277
2020-03-25,Netherlands,858,80,6438,357
2020-03-26,Netherlands,1030,78,7468,435
2020-03-27,Netherlands,1179,112,8647,547
2020-03-28,Netherlands,1172,93,9819,640
2020-03-29,Netherlands,1111,132,10930,772
2020-03-30,Netherlands,887,93,11817,865
2020-03-31,Netherlands,850,175,12667,1040
2020-04-01,Netherlands,1029,135,13696,1175
2020-04-02,Netherlands,1092,166,14788,1341
2020-04-03,Netherlands,1033,149,15821,1490
2020-04-04,Netherlands,906,166,16727,1656
2020-04-05,Netherlands,1226,115,17953,1771
2020-04-06,Netherlands,973,103,18926,1874
2020-04-07,Netherlands,783,234,19709,2108
2020-04-08,Netherlands,973,147,20682,2255
2020-04-09,Netherlands,1221,148,21903,2403
2020-04-10,Netherlands,1346,117,23249,2520
2020-04-11,Netherlands,1322,133,24571,2653
2020-04-12,Netherlands,1175,94,25746,2747
2020-04-13,Netherlands,964,86,26710,2833
2020-04-14,Netherlands,870,122,27580,2955
2020-04-15,Netherlands,736,190,28316,3145
2020-04-16,Netherlands,1067,182,29383,3327
2020-04-17,Netherlands,1236,144,30619,3471
2020-04-18,Netherlands,1147,142,31766,3613
2020-04-19,Netherlands,1072,84,32838,3697
2020-04-20,Netherlands,750,67,33588,3764
2020-04-21,Netherlands,729,165,34317,3929
2020-04-22,Netherlands,715,139,35032,4068
2020-04-23,Netherlands,889,124,35921,4192
2020-04-24,Netherlands,808,112,36729,4304
2020-04-25,Netherlands,655,120,37384,4424
2020-04-26,Netherlands,656,67,38040,4491
2020-04-27,Netherlands,400,43,38440,4534
2020-04-28,Netherlands,172,48,38612,4582
2020-04-29,Netherlands,386,145,38998,4727
2020-04-30,Netherlands,514,84,39512,4811
2020-05-01,Netherlands,477,98,39989,4909
2020-05-02,Netherlands,445,94,40434,5003
2020-05-03,Netherlands,335,69,40769,5072
2020-05-04,Netherlands,199,26,40968,5098
2020-05-05,Netherlands,318,87,41286,5185
2020-05-06,Netherlands,232,36,41518,5221
2020-05-07,Netherlands,455,85,41973,5306
2020-05-08,Netherlands,319,71,42292,5377
2020-05-09,Netherlands,289,64,42581,5441
2020-05-10,Netherlands,245,18,42826,5459
2020-05-11,Netherlands,161,16,42987,5475
2020-05-12,Netherlands,196,54,43183,5529
2020-05-13,Netherlands,227,52,43410,5581
2020-05-14,Netherlands,270,28,43680,5609
2020-05-15,Netherlands,200,53,43880,5662
2020-05-16,Netherlands,190,27,44070,5689
2020-05-17,Netherlands,125,10,44195,5699
2020-05-18,Netherlands,146,14,44341,5713
2020-05-19,Netherlands,108,21,44449,5734
2020-05-20,Netherlands,198,33,44647,5767
2020-05-21,Netherlands,253,27,44900,5794
2020-05-22,Netherlands,188,13,45088,5807
2020-05-23,Netherlands,177,23,45265,5830
2020-05-24,Netherlands,172,11,45437,5841
2020-05-25,Netherlands,210,8,45647,5849
2020-05-26,Netherlands,133,26,45780,5875
2020-05-27,Netherlands,190,15,45970,5890
2020-05-28,Netherlands,182,32,46152,5922
2020-05-29,Netherlands,176,28,46328,5950
2020-05-30,Netherlands,132,20,46460,5970
2020-05-31,Netherlands,185,5,46645,5975
2020-06-01,Netherlands,104,6,46749,5981
2020-06-02,Netherlands,103,5,46852,5986
2020-06-03,Netherlands,87,10,46939,5996
2020-06-04,Netherlands,209,13,47148,6009
2020-06-05,Netherlands,210,15,47358,6024
2020-06-06,Netherlands,183,6,47541,6030
2020-06-07,Netherlands,239,2,47780,6032
2020-06-08,Netherlands,165,3,47945,6035
2020-06-09,Netherlands,164,15,48109,6050
2020-06-10,Netherlands,185,11,48294,6061
2020-06-11,Netherlands,164,2,48458,6063
2020-06-12,Netherlands,210,9,48668,6072
2020-06-13,Netherlands,179,4,48847,6076
2020-06-14,Netherlands,143,2,48990,6078
2020-06-15,Netherlands,165,6,49155,6084
2020-06-16,Netherlands,140,5,49295,6089
2020-06-17,Netherlands,117,4,49412,6093
2020-06-18,Netherlands,115,4,49527,6097
2020-06-19,Netherlands,107,3,49634,6100
2020-06-20,Netherlands,76,8,49710,6108
2020-06-21,Netherlands,91,1,49801,6109
2020-06-22,Netherlands,65,0,49866,6109
2020-06-23,Netherlands,64,5,49930,6114
2020-06-24,Netherlands,82,2,50012,6116
2020-06-25,Netherlands,110,3,50122,6119
2020-06-26,Netherlands,91,3,50213,6122
2020-06-27,Netherlands,69,2,50282,6124
2020-06-28,Netherlands,73,0,50355,6124
2020-06-29,Netherlands,78,2,50433,6126
2020-06-30,Netherlands,50,6,50483,6132
2020-07-01,Netherlands,62,2,50545,6134
2020-07-02,Netherlands,78,3,50623,6137
2020-07-03,Netherlands,75,2,50698,6139
2020-07-04,Netherlands,63,6,50761,6145
2020-07-05,Netherlands,73,1,50834,6146
2020-07-06,Netherlands,36,1,50870,6147
2020-07-07,Netherlands,37,4,50907,6151
2020-07-08,Netherlands,52,3,50959,6154
2020-07-09,Netherlands,54,2,51013,6156
2020-07-10,Netherlands,42,-1,51055,6155
2020-07-11,Netherlands,81,1,51136,6156
2020-07-12,Netherlands,101,0,51237,6156
2020-07-13,Netherlands,71,0,51308,6156
2020-07-14,Netherlands,54,-2,51362,6154
2020-07-15,Netherlands,109,1,51471,6155
2020-07-16,Netherlands,101,1,51572,6156
2020-07-17,Netherlands,110,1,51682,6157
2020-07-18,Netherlands,127,-2,51809,6155
2020-07-19,Netherlands,146,0,51955,6155
2020-07-20,Netherlands,187,0,52142,6155
2020-07-21,Netherlands,165,0,52307,6155
2020-07-22,Netherlands,168,3,52475,6158
2020-07-23,Netherlands,165,0,52640,6158
2020-07-24,Netherlands,197,0,52837,6158
2020-07-25,Netherlands,147,1,52984,6159
2020-07-26,Netherlands,294,19,53278,6178
2020-07-27,Netherlands,146,-18,53424,6160
2020-07-28,Netherlands,223,4,53647,6164
2020-07-29,Netherlands,248,2,53895,6166
2020-07-30,Netherlands,354,0,54249,6166
2020-07-31,Netherlands,341,0,54590,6166
2020-08-01,Netherlands,431,1,55021,6167
2020-08-02,Netherlands,387,2,55408,6169
2020-08-03,Netherlands,378,0,55786,6169
2020-08-04,Netherlands,493,1,56279,6170
2020-08-05,Netherlands,471,3,56750,6173
2020-08-06,Netherlands,715,0,57465,6173
2020-08-07,Netherlands,652,1,58117,6174
2020-08-08,Netherlands,600,4,58717,6178
2020-08-09,Netherlands,643,0,59360,6178
2020-08-10,Netherlands,698,0,60058,6178
2020-08-11,Netherlands,333,-16,60391,6162
2020-08-12,Netherlands,1327,20,61718,6182
2020-08-13,Netherlands,688,5,62406,6187
2020-08-14,Netherlands,721,2,63127,6189
2020-08-15,Netherlands,762,2,63889,6191
2020-08-16,Netherlands,579,3,64468,6194
2020-08-17,Netherlands,512,0,64980,6194
2020-08-18,Netherlands,580,3,65560,6197
2020-08-19,Netherlands,658,7,66218,6204
2020-08-20,Netherlands,625,11,66843,6215
2020-08-21,Netherlands,613,4,67456,6219
2020-08-22,Netherlands,595,6,68051,6225
2020-08-23,Netherlands,519,0,68570,6225
2020-08-24,Netherlands,654,2,69224,6227
2020-08-25,Netherlands,459,6,69683,6233
2020-08-26,Netherlands,699,8,70382,6241
2020-08-27,Netherlands,602,3,70984,6244
2020-08-28,Netherlands,573,3,71557,6247
2020-08-29,Netherlands,571,5,72128,6252
2020-08-30,Netherlands,551,0,72679,6252
2020-08-31,Netherlands,553,0,73232,6252
2020-09-01,Netherlands,570,8,73802,6260
2020-09-02,Netherlands,858,7,74660,6267
2020-09-03,Netherlands,696,1,75356,6268
2020-09-04,Netherlands,817,2,76173,6270
2020-09-05,Netherlands,734,5,76907,6275
2020-09-06,Netherlands,950,2,77857,6277
2020-09-07,Netherlands,845,1,78702,6278
2020-09-08,Netherlands,1090,1,79792,6279
2020-09-09,Netherlands,1293,2,81085,6281
2020-09-10,Netherlands,931,4,82016,6285
2020-09-11,Netherlands,1354,5,83370,6290
2020-09-12,Netherlands,1339,1,84709,6291
2020-09-13,Netherlands,1167,1,85876,6292
2020-09-14,Netherlands,1318,4,87194,6296
2020-09-15,Netherlands,1479,4,88673,6300
2020-09-16,Netherlands,1752,3,90425,6303
2020-09-17,Netherlands,1837,7,92262,6310
2020-09-18,Netherlands,2083,8,94345,6318
2020-09-19,Netherlands,1916,2,96261,6320
2020-09-20,Netherlands,1956,4,98217,6324
2020-09-21,Netherlands,2274,3,100491,6327
2020-09-22,Netherlands,2353,11,102844,6338
2020-09-23,Netherlands,2460,6,105304,6344
2020-09-24,Netherlands,2595,17,107899,6361
2020-09-25,Netherlands,2859,16,110758,6377
2020-09-26,Netherlands,2760,38,113518,6415
2020-09-27,Netherlands,3041,8,116559,6423
2020-09-28,Netherlands,2950,6,119509,6429
2020-09-29,Netherlands,3111,14,122620,6443
2020-09-30,Netherlands,3368,14,125988,6457
2020-10-01,Netherlands,3295,13,129283,6470
2020-10-02,Netherlands,3883,12,133166,6482
2020-10-03,Netherlands,4028,21,137194,6503
2020-10-04,Netherlands,4032,5,141226,6508
2020-10-05,Netherlands,4611,1,145837,6509
2020-10-06,Netherlands,4576,29,150413,6538
2020-10-07,Netherlands,5052,36,155465,6574
2020-10-08,Netherlands,5867,13,161332,6587
2020-10-09,Netherlands,6016,14,167348,6601
2020-10-10,Netherlands,6546,23,173894,6624
2020-10-11,Netherlands,6394,18,180288,6642
2020-10-12,Netherlands,6850,12,187138,6654
2020-10-13,Netherlands,7453,35,194591,6689
2020-10-14,Netherlands,7351,31,201942,6720
2020-10-15,Netherlands,7857,29,209799,6749
2020-10-16,Netherlands,8022,16,217821,6765
2020-10-17,Netherlands,8149,32,225970,6797
2020-10-18,Netherlands,8233,14,234203,6811
2020-10-19,Netherlands,8014,17,242217,6828
2020-10-20,Netherlands,8194,46,250411,6874
2020-10-21,Netherlands,8796,60,259207,6934
2020-10-22,Netherlands,9310,47,268517,6981
2020-10-23,Netherlands,10029,45,278546,7026
2020-10-24,Netherlands,8683,55,287229,7081
2020-10-25,Netherlands,10237,27,297466,7108
2020-10-26,Netherlands,10365,26,307831,7134
2020-10-27,Netherlands,10321,70,318152,7204
2020-10-28,Netherlands,8156,61,326308,7265
2020-10-29,Netherlands,10321,56,336629,7321
2020-10-30,Netherlands,11172,87,347801,7408
2020-10-31,Netherlands,9839,51,357640,7459
2020-11-01,Netherlands,8711,39,366351,7498
2020-11-02,Netherlands,8312,29,374663,7527
2020-11-03,Netherlands,7777,113,382440,7640
2020-11-04,Netherlands,7680,108,390120,7748
2020-11-05,Netherlands,6992,88,397112,7836
2020-11-06,Netherlands,7280,118,404392,7954
2020-11-07,Netherlands,6715,74,411107,8028
2020-11-08,Netherlands,5699,44,416806,8072
2020-11-09,Netherlands,4697,40,421503,8112
2020-11-10,Netherlands,4724,99,426227,8211
2020-11-11,Netherlands,5469,75,431696,8286
2020-11-12,Netherlands,5680,89,437376,8375
2020-11-13,Netherlands,6157,55,443533,8430
2020-11-14,Netherlands,5968,86,449501,8516
2020-11-15,Netherlands,5460,43,454961,8559
2020-11-16,Netherlands,4876,44,459837,8603
2020-11-17,Netherlands,4368,86,464205,8689
2020-11-18,Netherlands,4695,83,468900,8772
2020-11-19,Netherlands,5741,74,474641,8846
2020-11-20,Netherlands,6008,52,480649,8898
2020-11-21,Netherlands,6171,48,486820,8946
2020-11-22,Netherlands,5473,21,492293,8967
2020-11-23,Netherlands,5208,54,497501,9021
2020-11-24,Netherlands,4002,90,501503,9111
2020-11-25,Netherlands,5054,74,506557,9185
2020-11-26,Netherlands,4605,75,511162,9260
2020-11-27,Netherlands,5883,83,517045,9343
2020-11-28,Netherlands,4594,60,521639,9403
2020-11-29,Netherlands,5697,23,527336,9426
2020-11-30,Netherlands,4594,27,531930,9453
2020-12-01,Netherlands,4199,65,536129,9518
2020-12-02,Netherlands,5109,66,541238,9584
2020-12-03,Netherlands,5744,61,546982,9645
2020-12-04,Netherlands,6058,59,553040,9704
2020-12-05,Netherlands,6676,39,559716,9743
2020-12-06,Netherlands,6912,25,566628,9768
2020-12-07,Netherlands,7122,18,573750,9786
2020-12-08,Netherlands,6247,71,579997,9857
2020-12-09,Netherlands,6646,66,586643,9923
2020-12-10,Netherlands,8830,62,595473,9985
2020-12-11,Netherlands,8979,66,604452,10051
2020-12-12,Netherlands,9178,53,613630,10104
2020-12-13,Netherlands,9937,30,623567,10134
2020-12-14,Netherlands,8518,34,632085,10168
2020-12-15,Netherlands,6716,86,638801,10254
2020-12-16,Netherlands,11271,79,650072,10333
2020-12-17,Netherlands,12871,75,662943,10408
2020-12-18,Netherlands,12024,84,674967,10492
2020-12-19,Netherlands,12283,54,687250,10546
2020-12-20,Netherlands,13072,32,700322,10578
2020-12-21,Netherlands,11218,28,711540,10606
2020-12-22,Netherlands,9889,114,721429,10720
2020-12-23,Netherlands,10473,105,731902,10825
2020-12-24,Netherlands,11591,89,743493,10914
2020-12-25,Netherlands,11545,101,755038,11015
2020-12-26,Netherlands,9869,47,764907,11062
2020-12-27,Netherlands,9102,28,774009,11090
2020-12-28,Netherlands,7458,45,781467,11135
2020-12-29,Netherlands,7592,170,789059,11305
2020-12-30,Netherlands,9533,112,798592,11417
2020-12-31,Netherlands,9790,108,808382,11525
2021-01-01,Netherlands,8234,99,816616,11624
2021-01-02,Netherlands,8633,36,825249,11660
2021-01-03,Netherlands,7453,47,832702,11707
2021-01-04,Netherlands,6614,63,839316,11770
2021-01-05,Netherlands,6506,152,845822,11922
2021-01-06,Netherlands,7238,174,853060,12096
2021-01-07,Netherlands,9745,86,862805,12182
2021-01-08,Netherlands,8258,87,871063,12269
2021-01-09,Netherlands,7380,137,878443,12406
2021-01-10,Netherlands,6655,55,885098,12461
2021-01-11,Netherlands,5468,51,890566,12512
2021-01-12,Netherlands,4977,152,895543,12664
2021-01-13,Netherlands,6197,122,901740,12786
2021-01-14,Netherlands,6566,89,908306,12875
2021-01-15,Netherlands,6082,94,914388,12969
2021-01-16,Netherlands,5324,97,919712,13066
2021-01-17,Netherlands,5643,41,925355,13107
2021-01-18,Netherlands,4792,50,930147,13157
2021-01-19,Netherlands,4356,107,934503,13264
2021-01-20,Netherlands,5603,86,940106,13350
2021-01-21,Netherlands,5842,89,945948,13439
2021-01-22,Netherlands,5799,89,951747,13528
2021-01-23,Netherlands,5466,88,957213,13616
2021-01-24,Netherlands,4940,30,962153,13646
2021-01-25,Netherlands,4041,40,966194,13686
2021-01-26,Netherlands,3962,86,970156,13772
2021-01-27,Netherlands,4816,69,974972,13841
2021-01-28,Netherlands,4730,84,979702,13925
2021-01-29,Netherlands,4418,56,984120,13981
2021-01-30,Netherlands,4230,88,988350,14069
2021-01-31,Netherlands,3725,39,992075,14108
2021-02-01,Netherlands,3225,27,995300,14135
2021-02-02,Netherlands,3624,83,998924,14218
2021-02-03,Netherlands,4086,63,1003010,14281
2021-02-04,Netherlands,4258,65,1007268,14346
2021-02-05,Netherlands,4368,61,1011636,14407
2021-02-06,Netherlands,4121,61,1015757,14468
2021-02-07,Netherlands,3963,48,1019720,14516
2021-02-08,Netherlands,2246,27,1021966,14543
2021-02-09,Netherlands,1813,86,1023779,14629
2021-02-10,Netherlands,3244,81,1027023,14710
2021-02-11,Netherlands,4431,72,1031454,14782
2021-02-12,Netherlands,4387,65,1035841,14847
2021-02-13,Netherlands,4229,66,1040070,14913
2021-02-14,Netherlands,3471,23,1043541,14936
2021-02-15,Netherlands,2840,27,1046381,14963
2021-02-16,Netherlands,2739,87,1049120,15050
2021-02-17,Netherlands,3424,88,1052544,15138
2021-02-18,Netherlands,4572,73,1057116,15211
2021-02-19,Netherlands,4787,50,1061903,15261
2021-02-20,Netherlands,4619,62,1066522,15323
2021-02-21,Netherlands,4701,17,1071223,15340
2021-02-22,Netherlands,4202,32,1075425,15372
2021-02-23,Netherlands,3847,94,1079272,15466
2021-02-24,Netherlands,4414,63,1083686,15529
2021-02-25,Netherlands,5044,32,1088730,15561
2021-02-26,Netherlands,5169,65,1093899,15626
2021-02-27,Netherlands,4976,42,1098875,15668
2021-02-28,Netherlands,4689,20,1103564,15688
2021-03-01,Netherlands,3783,22,1107347,15710
2021-03-02,Netherlands,4017,65,1111364,15775
2021-03-03,Netherlands,5040,49,1116404,15824
2021-03-04,Netherlands,4162,33,1120566,15857
2021-03-05,Netherlands,4733,33,1125299,15890
2021-03-06,Netherlands,5395,41,1130694,15931
2021-03-07,Netherlands,4564,31,1135258,15962
2021-03-08,Netherlands,3844,28,1139102,15990
2021-03-09,Netherlands,4379,56,1143481,16046
2021-03-10,Netherlands,5355,31,1148836,16077
2021-03-11,Netherlands,5421,50,1154257,16127
2021-03-12,Netherlands,6123,26,1160380,16153
2021-03-13,Netherlands,6543,23,1166923,16176
2021-03-14,Netherlands,6052,24,1172975,16200
2021-03-15,Netherlands,5526,18,1178501,16218
2021-03-16,Netherlands,5066,33,1183567,16251
2021-03-17,Netherlands,6140,47,1189707,16298
2021-03-18,Netherlands,6338,34,1196045,16332
2021-03-19,Netherlands,7577,47,1203622,16379
2021-03-20,Netherlands,7825,16,1211447,16395
2021-03-21,Netherlands,7163,16,1218610,16411
2021-03-22,Netherlands,6337,15,1224947,16426
2021-03-23,Netherlands,5799,49,1230746,16475
2021-03-24,Netherlands,7918,35,1238664,16510
2021-03-25,Netherlands,8018,26,1246682,16536
2021-03-26,Netherlands,8040,25,1254722,16561
2021-03-27,Netherlands,9160,31,1263882,16592
2021-03-28,Netherlands,7698,15,1271580,16607
2021-03-29,Netherlands,6939,13,1278519,16620
2021-03-30,Netherlands,6066,37,1284585,16657
2021-03-31,Netherlands,8221,32,1292806,16689
2021-04-01,Netherlands,8321,24,1301127,16713
2021-04-02,Netherlands,7647,20,1308774,16733
2021-04-03,Netherlands,8139,33,1316913,16766
2021-04-04,Netherlands,7108,24,1324021,16790
2021-04-05,Netherlands,5539,11,1329560,16801
2021-04-06,Netherlands,5752,25,1335312,16826
2021-04-07,Netherlands,6430,24,1341742,16850
2021-04-08,Netherlands,8292,23,1350034,16873
2020-02-28,New Zealand,1,0,1,0
2020-02-29,New Zealand,0,0,1,0
2020-03-01,New Zealand,0,0,1,0
2020-03-02,New Zealand,0,0,1,0
2020-03-03,New Zealand,0,0,1,0
2020-03-04,New Zealand,2,0,3,0
2020-03-05,New Zealand,0,0,3,0
2020-03-06,New Zealand,1,0,4,0
2020-03-07,New Zealand,1,0,5,0
2020-03-08,New Zealand,0,0,5,0
2020-03-09,New Zealand,0,0,5,0
2020-03-10,New Zealand,0,0,5,0
2020-03-11,New Zealand,0,0,5,0
2020-03-12,New Zealand,0,0,5,0
2020-03-13,New Zealand,0,0,5,0
2020-03-14,New Zealand,1,0,6,0
2020-03-15,New Zealand,2,0,8,0
2020-03-16,New Zealand,0,0,8,0
2020-03-17,New Zealand,4,0,12,0
2020-03-18,New Zealand,8,0,20,0
2020-03-19,New Zealand,8,0,28,0
2020-03-20,New Zealand,11,0,39,0
2020-03-21,New Zealand,13,0,52,0
2020-03-22,New Zealand,50,0,102,0
2020-03-23,New Zealand,0,0,102,0
2020-03-24,New Zealand,53,0,155,0
2020-03-25,New Zealand,50,0,205,0
2020-03-26,New Zealand,78,0,283,0
2020-03-27,New Zealand,85,0,368,0
2020-03-28,New Zealand,83,0,451,0
2020-03-29,New Zealand,63,1,514,1
2020-03-30,New Zealand,75,0,589,1
2020-03-31,New Zealand,58,0,647,1
2020-04-01,New Zealand,61,0,708,1
2020-04-02,New Zealand,89,0,797,1
2020-04-03,New Zealand,71,0,868,1
2020-04-04,New Zealand,82,0,950,1
2020-04-05,New Zealand,89,0,1039,1
2020-04-06,New Zealand,67,0,1106,1
2020-04-07,New Zealand,54,0,1160,1
2020-04-08,New Zealand,50,0,1210,1
2020-04-09,New Zealand,29,0,1239,1
2020-04-10,New Zealand,44,1,1283,2
2020-04-11,New Zealand,29,2,1312,4
2020-04-12,New Zealand,18,0,1330,4
2020-04-13,New Zealand,19,1,1349,5
2020-04-14,New Zealand,17,4,1366,9
2020-04-15,New Zealand,20,0,1386,9
2020-04-16,New Zealand,15,0,1401,9
2020-04-17,New Zealand,8,2,1409,11
2020-04-18,New Zealand,13,0,1422,11
2020-04-19,New Zealand,9,1,1431,12
2020-04-20,New Zealand,9,0,1440,12
2020-04-21,New Zealand,5,1,1445,13
2020-04-22,New Zealand,6,1,1451,14
2020-04-23,New Zealand,5,3,1456,17
2020-04-24,New Zealand,5,1,1461,18
2020-04-25,New Zealand,9,0,1470,18
2020-04-26,New Zealand,-1,1,1469,19
2020-04-27,New Zealand,3,0,1472,19
2020-04-28,New Zealand,2,0,1474,19
2020-04-29,New Zealand,2,0,1476,19
2020-04-30,New Zealand,3,0,1479,19
2020-05-01,New Zealand,6,1,1485,20
2020-05-02,New Zealand,2,0,1487,20
2020-05-03,New Zealand,0,0,1487,20
2020-05-04,New Zealand,-1,0,1486,20
2020-05-05,New Zealand,2,1,1488,21
2020-05-06,New Zealand,1,0,1489,21
2020-05-07,New Zealand,1,0,1490,21
2020-05-08,New Zealand,2,0,1492,21
2020-05-09,New Zealand,2,0,1494,21
2020-05-10,New Zealand,3,0,1497,21
2020-05-11,New Zealand,0,0,1497,21
2020-05-12,New Zealand,0,0,1497,21
2020-05-13,New Zealand,0,0,1497,21
2020-05-14,New Zealand,1,0,1498,21
2020-05-15,New Zealand,0,0,1498,21
2020-05-16,New Zealand,1,0,1499,21
2020-05-17,New Zealand,0,0,1499,21
2020-05-18,New Zealand,0,0,1499,21
2020-05-19,New Zealand,4,0,1503,21
2020-05-20,New Zealand,0,0,1503,21
2020-05-21,New Zealand,1,0,1504,21
2020-05-22,New Zealand,0,0,1504,21
2020-05-23,New Zealand,0,0,1504,21
2020-05-24,New Zealand,0,0,1504,21
2020-05-25,New Zealand,0,0,1504,21
2020-05-26,New Zealand,0,0,1504,21
2020-05-27,New Zealand,0,1,1504,22
2020-05-28,New Zealand,0,0,1504,22
2020-05-29,New Zealand,0,0,1504,22
2020-05-30,New Zealand,0,0,1504,22
2020-05-31,New Zealand,0,0,1504,22
2020-06-01,New Zealand,0,0,1504,22
2020-06-02,New Zealand,0,0,1504,22
2020-06-03,New Zealand,0,0,1504,22
2020-06-04,New Zealand,0,0,1504,22
2020-06-05,New Zealand,0,0,1504,22
2020-06-06,New Zealand,0,0,1504,22
2020-06-07,New Zealand,0,0,1504,22
2020-06-08,New Zealand,0,0,1504,22
2020-06-09,New Zealand,0,0,1504,22
2020-06-10,New Zealand,0,0,1504,22
2020-06-11,New Zealand,0,0,1504,22
2020-06-12,New Zealand,0,0,1504,22
2020-06-13,New Zealand,0,0,1504,22
2020-06-14,New Zealand,0,0,1504,22
2020-06-15,New Zealand,2,0,1506,22
2020-06-16,New Zealand,0,0,1506,22
2020-06-17,New Zealand,1,0,1507,22
2020-06-18,New Zealand,0,0,1507,22
2020-06-19,New Zealand,2,0,1509,22
2020-06-20,New Zealand,2,0,1511,22
2020-06-21,New Zealand,2,0,1513,22
2020-06-22,New Zealand,2,0,1515,22
2020-06-23,New Zealand,1,0,1516,22
2020-06-24,New Zealand,3,0,1519,22
2020-06-25,New Zealand,1,0,1520,22
2020-06-26,New Zealand,2,0,1522,22
2020-06-27,New Zealand,4,0,1526,22
2020-06-28,New Zealand,2,0,1528,22
2020-06-29,New Zealand,0,0,1528,22
2020-06-30,New Zealand,0,0,1528,22
2020-07-01,New Zealand,2,0,1530,22
2020-07-02,New Zealand,0,0,1530,22
2020-07-03,New Zealand,0,0,1530,22
2020-07-04,New Zealand,3,0,1533,22
2020-07-05,New Zealand,1,0,1534,22
2020-07-06,New Zealand,2,0,1536,22
2020-07-07,New Zealand,1,0,1537,22
2020-07-08,New Zealand,3,0,1540,22
2020-07-09,New Zealand,2,0,1542,22
2020-07-10,New Zealand,1,0,1543,22
2020-07-11,New Zealand,1,0,1544,22
2020-07-12,New Zealand,0,0,1544,22
2020-07-13,New Zealand,1,0,1545,22
2020-07-14,New Zealand,2,0,1547,22
2020-07-15,New Zealand,1,0,1548,22
2020-07-16,New Zealand,1,0,1549,22
2020-07-17,New Zealand,1,0,1550,22
2020-07-18,New Zealand,3,0,1553,22
2020-07-19,New Zealand,1,0,1554,22
2020-07-20,New Zealand,1,0,1555,22
2020-07-21,New Zealand,0,0,1555,22
2020-07-22,New Zealand,0,0,1555,22
2020-07-23,New Zealand,1,0,1556,22
2020-07-24,New Zealand,0,0,1556,22
2020-07-25,New Zealand,0,0,1556,22
2020-07-26,New Zealand,0,0,1556,22
2020-07-27,New Zealand,1,0,1557,22
2020-07-28,New Zealand,2,0,1559,22
2020-07-29,New Zealand,1,0,1560,22
2020-07-30,New Zealand,0,0,1560,22
2020-07-31,New Zealand,2,0,1562,22
2020-08-01,New Zealand,3,0,1565,22
2020-08-02,New Zealand,2,0,1567,22
2020-08-03,New Zealand,0,0,1567,22
2020-08-04,New Zealand,2,0,1569,22
2020-08-05,New Zealand,0,0,1569,22
2020-08-06,New Zealand,0,0,1569,22
2020-08-07,New Zealand,0,0,1569,22
2020-08-08,New Zealand,0,0,1569,22
2020-08-09,New Zealand,0,0,1569,22
2020-08-10,New Zealand,1,0,1570,22
2020-08-11,New Zealand,0,0,1570,22
2020-08-12,New Zealand,19,0,1589,22
2020-08-13,New Zealand,13,0,1602,22
2020-08-14,New Zealand,7,0,1609,22
2020-08-15,New Zealand,13,0,1622,22
2020-08-16,New Zealand,9,0,1631,22
2020-08-17,New Zealand,12,0,1643,22
2020-08-18,New Zealand,6,0,1649,22
2020-08-19,New Zealand,5,0,1654,22
2020-08-20,New Zealand,11,0,1665,22
2020-08-21,New Zealand,6,0,1671,22
2020-08-22,New Zealand,3,0,1674,22
2020-08-23,New Zealand,9,0,1683,22
2020-08-24,New Zealand,7,0,1690,22
2020-08-25,New Zealand,5,0,1695,22
2020-08-26,New Zealand,7,0,1702,22
2020-08-27,New Zealand,12,0,1714,22
2020-08-28,New Zealand,13,0,1727,22
2020-08-29,New Zealand,2,0,1729,22
2020-08-30,New Zealand,9,0,1738,22
2020-08-31,New Zealand,14,0,1752,22
2020-09-01,New Zealand,5,0,1757,22
2020-09-02,New Zealand,2,0,1759,22
2020-09-03,New Zealand,5,0,1764,22
2020-09-04,New Zealand,3,2,1767,24
2020-09-05,New Zealand,5,0,1772,24
2020-09-06,New Zealand,4,0,1776,24
2020-09-07,New Zealand,6,0,1782,24
2020-09-08,New Zealand,6,0,1788,24
2020-09-09,New Zealand,4,0,1792,24
2020-09-10,New Zealand,1,0,1793,24
2020-09-11,New Zealand,2,0,1795,24
2020-09-12,New Zealand,2,0,1797,24
2020-09-13,New Zealand,1,0,1798,24
2020-09-14,New Zealand,3,0,1801,24
2020-09-15,New Zealand,1,1,1802,25
2020-09-16,New Zealand,7,0,1809,25
2020-09-17,New Zealand,0,0,1809,25
2020-09-18,New Zealand,2,0,1811,25
2020-09-19,New Zealand,4,0,1815,25
2020-09-20,New Zealand,0,0,1815,25
2020-09-21,New Zealand,0,0,1815,25
2020-09-22,New Zealand,9,0,1824,25
2020-09-23,New Zealand,3,0,1827,25
2020-09-24,New Zealand,2,0,1829,25
2020-09-25,New Zealand,2,0,1831,25
2020-09-26,New Zealand,2,0,1833,25
2020-09-27,New Zealand,0,0,1833,25
2020-09-28,New Zealand,2,0,1835,25
2020-09-29,New Zealand,1,0,1836,25
2020-09-30,New Zealand,12,0,1848,25
2020-10-01,New Zealand,0,0,1848,25
2020-10-02,New Zealand,1,0,1849,25
2020-10-03,New Zealand,5,0,1854,25
2020-10-04,New Zealand,1,0,1855,25
2020-10-05,New Zealand,3,0,1858,25
2020-10-06,New Zealand,3,0,1861,25
2020-10-07,New Zealand,3,0,1864,25
2020-10-08,New Zealand,2,0,1866,25
2020-10-09,New Zealand,4,0,1870,25
2020-10-10,New Zealand,1,0,1871,25
2020-10-11,New Zealand,0,0,1871,25
2020-10-12,New Zealand,1,0,1872,25
2020-10-13,New Zealand,2,0,1874,25
2020-10-14,New Zealand,2,0,1876,25
2020-10-15,New Zealand,4,0,1880,25
2020-10-16,New Zealand,3,0,1883,25
2020-10-17,New Zealand,3,0,1886,25
2020-10-18,New Zealand,0,0,1886,25
2020-10-19,New Zealand,1,0,1887,25
2020-10-20,New Zealand,25,0,1912,25
2020-10-21,New Zealand,2,0,1914,25
2020-10-22,New Zealand,9,0,1923,25
2020-10-23,New Zealand,11,0,1934,25
2020-10-24,New Zealand,1,0,1935,25
2020-10-25,New Zealand,5,0,1940,25
2020-10-26,New Zealand,1,0,1941,25
2020-10-27,New Zealand,2,0,1943,25
2020-10-28,New Zealand,6,0,1949,25
2020-10-29,New Zealand,1,0,1950,25
2020-10-30,New Zealand,7,0,1957,25
2020-10-31,New Zealand,2,0,1959,25
2020-11-01,New Zealand,4,0,1963,25
2020-11-02,New Zealand,5,0,1968,25
2020-11-03,New Zealand,3,0,1971,25
2020-11-04,New Zealand,2,0,1973,25
2020-11-05,New Zealand,1,0,1974,25
2020-11-06,New Zealand,2,0,1976,25
2020-11-07,New Zealand,6,0,1982,25
2020-11-08,New Zealand,4,0,1986,25
2020-11-09,New Zealand,1,0,1987,25
2020-11-10,New Zealand,1,0,1988,25
2020-11-11,New Zealand,3,0,1991,25
2020-11-12,New Zealand,4,0,1995,25
2020-11-13,New Zealand,3,0,1998,25
2020-11-14,New Zealand,3,0,2001,25
2020-11-15,New Zealand,0,0,2001,25
2020-11-16,New Zealand,4,0,2005,25
2020-11-17,New Zealand,3,0,2008,25
2020-11-18,New Zealand,2,0,2010,25
2020-11-19,New Zealand,3,0,2013,25
2020-11-20,New Zealand,6,0,2019,25
2020-11-21,New Zealand,9,0,2028,25
2020-11-22,New Zealand,2,0,2030,25
2020-11-23,New Zealand,1,0,2031,25
2020-11-24,New Zealand,8,0,2039,25
2020-11-25,New Zealand,1,0,2040,25
2020-11-26,New Zealand,7,0,2047,25
2020-11-27,New Zealand,3,0,2050,25
2020-11-28,New Zealand,0,0,2050,25
2020-11-29,New Zealand,6,0,2056,25
2020-11-30,New Zealand,3,0,2059,25
2020-12-01,New Zealand,1,0,2060,25
2020-12-02,New Zealand,9,0,2069,25
2020-12-03,New Zealand,0,0,2069,25
2020-12-04,New Zealand,9,0,2078,25
2020-12-05,New Zealand,0,0,2078,25
2020-12-06,New Zealand,1,0,2079,25
2020-12-07,New Zealand,6,0,2085,25
2020-12-08,New Zealand,3,0,2088,25
2020-12-09,New Zealand,0,0,2088,25
2020-12-10,New Zealand,4,0,2092,25
2020-12-11,New Zealand,0,0,2092,25
2020-12-12,New Zealand,4,0,2096,25
2020-12-13,New Zealand,0,0,2096,25
2020-12-14,New Zealand,0,0,2096,25
2020-12-15,New Zealand,4,0,2100,25
2020-12-16,New Zealand,0,0,2100,25
2020-12-17,New Zealand,10,0,2110,25
2020-12-18,New Zealand,0,0,2110,25
2020-12-19,New Zealand,6,0,2116,25
2020-12-20,New Zealand,5,0,2121,25
2020-12-21,New Zealand,0,0,2121,25
2020-12-22,New Zealand,7,0,2128,25
2020-12-23,New Zealand,0,0,2128,25
2020-12-24,New Zealand,0,0,2128,25
2020-12-25,New Zealand,0,0,2128,25
2020-12-26,New Zealand,16,0,2144,25
2020-12-27,New Zealand,0,0,2144,25
2020-12-28,New Zealand,7,0,2151,25
2020-12-29,New Zealand,0,0,2151,25
2020-12-30,New Zealand,11,0,2162,25
2020-12-31,New Zealand,0,0,2162,25
2021-01-01,New Zealand,0,0,2162,25
2021-01-02,New Zealand,19,0,2181,25
2021-01-03,New Zealand,0,0,2181,25
2021-01-04,New Zealand,5,0,2186,25
2021-01-05,New Zealand,0,0,2186,25
2021-01-06,New Zealand,2,0,2188,25
2021-01-07,New Zealand,0,0,2188,25
2021-01-08,New Zealand,0,0,2188,25
2021-01-09,New Zealand,31,0,2219,25
2021-01-10,New Zealand,3,0,2222,25
2021-01-11,New Zealand,0,0,2222,25
2021-01-12,New Zealand,6,0,2228,25
2021-01-13,New Zealand,0,0,2228,25
2021-01-14,New Zealand,18,0,2246,25
2021-01-15,New Zealand,0,0,2246,25
2021-01-16,New Zealand,10,0,2256,25
2021-01-17,New Zealand,6,0,2262,25
2021-01-18,New Zealand,0,0,2262,25
2021-01-19,New Zealand,5,0,2267,25
2021-01-20,New Zealand,0,0,2267,25
2021-01-21,New Zealand,9,0,2276,25
2021-01-22,New Zealand,0,0,2276,25
2021-01-23,New Zealand,7,0,2283,25
2021-01-24,New Zealand,5,0,2288,25
2021-01-25,New Zealand,2,0,2290,25
2021-01-26,New Zealand,5,0,2295,25
2021-01-27,New Zealand,4,0,2299,25
2021-01-28,New Zealand,6,0,2305,25
2021-01-29,New Zealand,-2,0,2303,25
2021-01-30,New Zealand,1,0,2304,25
2021-01-31,New Zealand,0,0,2304,25
2021-02-01,New Zealand,3,0,2307,25
2021-02-02,New Zealand,1,0,2308,25
2021-02-03,New Zealand,5,0,2313,25
2021-02-04,New Zealand,2,0,2315,25
2021-02-05,New Zealand,0,0,2315,25
2021-02-06,New Zealand,5,0,2320,25
2021-02-07,New Zealand,0,0,2320,25
2021-02-08,New Zealand,2,0,2322,25
2021-02-09,New Zealand,2,0,2324,25
2021-02-10,New Zealand,0,0,2324,25
2021-02-11,New Zealand,2,0,2326,25
2021-02-12,New Zealand,2,0,2328,25
2021-02-13,New Zealand,2,0,2330,25
2021-02-14,New Zealand,6,0,2336,25
2021-02-15,New Zealand,1,1,2337,26
2021-02-16,New Zealand,3,0,2340,26
2021-02-17,New Zealand,4,0,2344,26
2021-02-18,New Zealand,4,0,2348,26
2021-02-19,New Zealand,2,0,2350,26
2021-02-20,New Zealand,0,0,2350,26
2021-02-21,New Zealand,7,0,2357,26
2021-02-22,New Zealand,6,0,2363,26
2021-02-23,New Zealand,2,0,2365,26
2021-02-24,New Zealand,3,0,2368,26
2021-02-25,New Zealand,3,0,2371,26
2021-02-26,New Zealand,1,0,2372,26
2021-02-27,New Zealand,4,0,2376,26
2021-02-28,New Zealand,2,0,2378,26
2021-03-01,New Zealand,4,0,2382,26
2021-03-02,New Zealand,2,0,2384,26
2021-03-03,New Zealand,5,0,2389,26
2021-03-04,New Zealand,0,0,2389,26
2021-03-05,New Zealand,9,0,2398,26
2021-03-06,New Zealand,1,0,2399,26
2021-03-07,New Zealand,6,0,2405,26
2021-03-08,New Zealand,4,0,2409,26
2021-03-09,New Zealand,1,0,2410,26
2021-03-10,New Zealand,6,0,2416,26
2021-03-11,New Zealand,1,0,2417,26
2021-03-12,New Zealand,5,0,2422,26
2021-03-13,New Zealand,1,0,2423,26
2021-03-14,New Zealand,7,0,2430,26
2021-03-15,New Zealand,2,0,2432,26
2021-03-16,New Zealand,2,0,2434,26
2021-03-17,New Zealand,0,0,2434,26
2021-03-18,New Zealand,10,0,2444,26
2021-03-19,New Zealand,0,0,2444,26
2021-03-20,New Zealand,9,0,2453,26
2021-03-21,New Zealand,9,0,2462,26
2021-03-22,New Zealand,0,0,2462,26
2021-03-23,New Zealand,8,0,2470,26
2021-03-24,New Zealand,6,0,2476,26
2021-03-25,New Zealand,3,0,2479,26
2021-03-26,New Zealand,2,0,2481,26
2021-03-27,New Zealand,1,0,2482,26
2021-03-28,New Zealand,11,0,2493,26
2021-03-29,New Zealand,2,0,2495,26
2021-03-30,New Zealand,2,0,2497,26
2021-03-31,New Zealand,4,0,2501,26
2021-04-01,New Zealand,0,0,2501,26
2021-04-02,New Zealand,0,0,2501,26
2021-04-03,New Zealand,0,0,2501,26
2021-04-04,New Zealand,6,0,2507,26
2021-04-05,New Zealand,17,0,2524,26
2021-04-06,New Zealand,7,0,2531,26
2021-04-07,New Zealand,24,0,2555,26
2021-04-08,New Zealand,6,0,2561,26
2020-03-19,Nicaragua,1,0,1,0
2020-03-20,Nicaragua,0,0,1,0
2020-03-21,Nicaragua,1,0,2,0
2020-03-22,Nicaragua,0,0,2,0
2020-03-23,Nicaragua,0,0,2,0
2020-03-24,Nicaragua,0,0,2,0
2020-03-25,Nicaragua,0,0,2,0
2020-03-26,Nicaragua,0,0,2,0
2020-03-27,Nicaragua,0,1,2,1
2020-03-28,Nicaragua,2,0,4,1
2020-03-29,Nicaragua,0,0,4,1
2020-03-30,Nicaragua,0,0,4,1
2020-03-31,Nicaragua,1,0,5,1
2020-04-01,Nicaragua,0,0,5,1
2020-04-02,Nicaragua,0,0,5,1
2020-04-03,Nicaragua,0,0,5,1
2020-04-04,Nicaragua,0,0,5,1
2020-04-05,Nicaragua,1,0,6,1
2020-04-06,Nicaragua,0,0,6,1
2020-04-07,Nicaragua,0,0,6,1
2020-04-08,Nicaragua,0,0,6,1
2020-04-09,Nicaragua,1,0,7,1
2020-04-10,Nicaragua,0,0,7,1
2020-04-11,Nicaragua,1,0,8,1
2020-04-12,Nicaragua,1,0,9,1
2020-04-13,Nicaragua,0,0,9,1
2020-04-14,Nicaragua,0,0,9,1
2020-04-15,Nicaragua,0,0,9,1
2020-04-16,Nicaragua,0,0,9,1
2020-04-17,Nicaragua,0,0,9,1
2020-04-18,Nicaragua,0,1,9,2
2020-04-19,Nicaragua,1,0,10,2
2020-04-20,Nicaragua,0,0,10,2
2020-04-21,Nicaragua,0,0,10,2
2020-04-22,Nicaragua,0,0,10,2
2020-04-23,Nicaragua,1,1,11,3
2020-04-24,Nicaragua,0,0,11,3
2020-04-25,Nicaragua,1,0,12,3
2020-04-26,Nicaragua,1,0,13,3
2020-04-27,Nicaragua,0,0,13,3
2020-04-28,Nicaragua,0,0,13,3
2020-04-29,Nicaragua,0,0,13,3
2020-04-30,Nicaragua,1,0,14,3
2020-05-01,Nicaragua,0,0,14,3
2020-05-02,Nicaragua,0,0,14,3
2020-05-03,Nicaragua,1,2,15,5
2020-05-04,Nicaragua,0,0,15,5
2020-05-05,Nicaragua,1,0,16,5
2020-05-06,Nicaragua,0,0,16,5
2020-05-07,Nicaragua,0,0,16,5
2020-05-08,Nicaragua,0,0,16,5
2020-05-09,Nicaragua,0,0,16,5
2020-05-10,Nicaragua,0,0,16,5
2020-05-11,Nicaragua,0,0,16,5
2020-05-12,Nicaragua,9,3,25,8
2020-05-13,Nicaragua,0,0,25,8
2020-05-14,Nicaragua,0,0,25,8
2020-05-15,Nicaragua,0,0,25,8
2020-05-16,Nicaragua,0,0,25,8
2020-05-17,Nicaragua,0,0,25,8
2020-05-18,Nicaragua,0,0,25,8
2020-05-19,Nicaragua,229,9,254,17
2020-05-20,Nicaragua,0,0,254,17
2020-05-21,Nicaragua,25,0,279,17
2020-05-22,Nicaragua,0,0,279,17
2020-05-23,Nicaragua,0,0,279,17
2020-05-24,Nicaragua,0,0,279,17
2020-05-25,Nicaragua,0,0,279,17
2020-05-26,Nicaragua,480,18,759,35
2020-05-27,Nicaragua,0,0,759,35
2020-05-28,Nicaragua,0,0,759,35
2020-05-29,Nicaragua,0,0,759,35
2020-05-30,Nicaragua,0,0,759,35
2020-05-31,Nicaragua,0,0,759,35
2020-06-01,Nicaragua,0,0,759,35
2020-06-02,Nicaragua,359,11,1118,46
2020-06-03,Nicaragua,0,0,1118,46
2020-06-04,Nicaragua,0,0,1118,46
2020-06-05,Nicaragua,0,0,1118,46
2020-06-06,Nicaragua,0,0,1118,46
2020-06-07,Nicaragua,0,0,1118,46
2020-06-08,Nicaragua,0,0,1118,46
2020-06-09,Nicaragua,346,9,1464,55
2020-06-10,Nicaragua,0,0,1464,55
2020-06-11,Nicaragua,0,0,1464,55
2020-06-12,Nicaragua,0,0,1464,55
2020-06-13,Nicaragua,0,0,1464,55
2020-06-14,Nicaragua,0,0,1464,55
2020-06-15,Nicaragua,0,0,1464,55
2020-06-16,Nicaragua,359,9,1823,64
2020-06-17,Nicaragua,0,0,1823,64
2020-06-18,Nicaragua,0,0,1823,64
2020-06-19,Nicaragua,0,0,1823,64
2020-06-20,Nicaragua,0,0,1823,64
2020-06-21,Nicaragua,0,0,1823,64
2020-06-22,Nicaragua,0,0,1823,64
2020-06-23,Nicaragua,347,10,2170,74
2020-06-24,Nicaragua,0,0,2170,74
2020-06-25,Nicaragua,0,0,2170,74
2020-06-26,Nicaragua,0,0,2170,74
2020-06-27,Nicaragua,0,0,2170,74
2020-06-28,Nicaragua,0,0,2170,74
2020-06-29,Nicaragua,0,0,2170,74
2020-06-30,Nicaragua,349,9,2519,83
2020-07-01,Nicaragua,0,0,2519,83
2020-07-02,Nicaragua,0,0,2519,83
2020-07-03,Nicaragua,0,0,2519,83
2020-07-04,Nicaragua,0,0,2519,83
2020-07-05,Nicaragua,0,0,2519,83
2020-07-06,Nicaragua,0,0,2519,83
2020-07-07,Nicaragua,327,8,2846,91
2020-07-08,Nicaragua,0,0,2846,91
2020-07-09,Nicaragua,0,0,2846,91
2020-07-10,Nicaragua,0,0,2846,91
2020-07-11,Nicaragua,0,0,2846,91
2020-07-12,Nicaragua,0,0,2846,91
2020-07-13,Nicaragua,0,0,2846,91
2020-07-14,Nicaragua,301,8,3147,99
2020-07-15,Nicaragua,0,0,3147,99
2020-07-16,Nicaragua,0,0,3147,99
2020-07-17,Nicaragua,0,0,3147,99
2020-07-18,Nicaragua,0,0,3147,99
2020-07-19,Nicaragua,0,0,3147,99
2020-07-20,Nicaragua,0,0,3147,99
2020-07-21,Nicaragua,292,9,3439,108
2020-07-22,Nicaragua,0,0,3439,108
2020-07-23,Nicaragua,0,0,3439,108
2020-07-24,Nicaragua,0,0,3439,108
2020-07-25,Nicaragua,0,0,3439,108
2020-07-26,Nicaragua,0,0,3439,108
2020-07-27,Nicaragua,0,0,3439,108
2020-07-28,Nicaragua,233,8,3672,116
2020-07-29,Nicaragua,0,0,3672,116
2020-07-30,Nicaragua,0,0,3672,116
2020-07-31,Nicaragua,0,0,3672,116
2020-08-01,Nicaragua,0,0,3672,116
2020-08-02,Nicaragua,0,0,3672,116
2020-08-03,Nicaragua,0,0,3672,116
2020-08-04,Nicaragua,230,7,3902,123
2020-08-05,Nicaragua,0,0,3902,123
2020-08-06,Nicaragua,0,0,3902,123
2020-08-07,Nicaragua,0,0,3902,123
2020-08-08,Nicaragua,0,0,3902,123
2020-08-09,Nicaragua,0,0,3902,123
2020-08-10,Nicaragua,0,0,3902,123
2020-08-11,Nicaragua,213,5,4115,128
2020-08-12,Nicaragua,0,0,4115,128
2020-08-13,Nicaragua,0,0,4115,128
2020-08-14,Nicaragua,0,0,4115,128
2020-08-15,Nicaragua,0,0,4115,128
2020-08-16,Nicaragua,0,0,4115,128
2020-08-17,Nicaragua,0,0,4115,128
2020-08-18,Nicaragua,196,5,4311,133
2020-08-19,Nicaragua,0,0,4311,133
2020-08-20,Nicaragua,0,0,4311,133
2020-08-21,Nicaragua,0,0,4311,133
2020-08-22,Nicaragua,0,0,4311,133
2020-08-23,Nicaragua,0,0,4311,133
2020-08-24,Nicaragua,0,0,4311,133
2020-08-25,Nicaragua,183,4,4494,137
2020-08-26,Nicaragua,0,0,4494,137
2020-08-27,Nicaragua,0,0,4494,137
2020-08-28,Nicaragua,0,0,4494,137
2020-08-29,Nicaragua,0,0,4494,137
2020-08-30,Nicaragua,0,0,4494,137
2020-08-31,Nicaragua,0,0,4494,137
2020-09-01,Nicaragua,174,4,4668,141
2020-09-02,Nicaragua,0,0,4668,141
2020-09-03,Nicaragua,0,0,4668,141
2020-09-04,Nicaragua,0,0,4668,141
2020-09-05,Nicaragua,0,0,4668,141
2020-09-06,Nicaragua,0,0,4668,141
2020-09-07,Nicaragua,0,0,4668,141
2020-09-08,Nicaragua,150,3,4818,144
2020-09-09,Nicaragua,0,0,4818,144
2020-09-10,Nicaragua,0,0,4818,144
2020-09-11,Nicaragua,0,0,4818,144
2020-09-12,Nicaragua,0,0,4818,144
2020-09-13,Nicaragua,0,0,4818,144
2020-09-14,Nicaragua,0,0,4818,144
2020-09-15,Nicaragua,143,3,4961,147
2020-09-16,Nicaragua,0,0,4961,147
2020-09-17,Nicaragua,0,0,4961,147
2020-09-18,Nicaragua,0,0,4961,147
2020-09-19,Nicaragua,0,0,4961,147
2020-09-20,Nicaragua,0,0,4961,147
2020-09-21,Nicaragua,0,0,4961,147
2020-09-22,Nicaragua,112,2,5073,149
2020-09-23,Nicaragua,0,0,5073,149
2020-09-24,Nicaragua,0,0,5073,149
2020-09-25,Nicaragua,0,0,5073,149
2020-09-26,Nicaragua,0,0,5073,149
2020-09-27,Nicaragua,0,0,5073,149
2020-09-28,Nicaragua,0,0,5073,149
2020-09-29,Nicaragua,97,2,5170,151
2020-09-30,Nicaragua,0,0,5170,151
2020-10-01,Nicaragua,0,0,5170,151
2020-10-02,Nicaragua,0,0,5170,151
2020-10-03,Nicaragua,0,0,5170,151
2020-10-04,Nicaragua,0,0,5170,151
2020-10-05,Nicaragua,0,0,5170,151
2020-10-06,Nicaragua,94,0,5264,151
2020-10-07,Nicaragua,0,2,5264,153
2020-10-08,Nicaragua,0,0,5264,153
2020-10-09,Nicaragua,0,0,5264,153
2020-10-10,Nicaragua,0,0,5264,153
2020-10-11,Nicaragua,0,0,5264,153
2020-10-12,Nicaragua,0,0,5264,153
2020-10-13,Nicaragua,89,1,5353,154
2020-10-14,Nicaragua,0,0,5353,154
2020-10-15,Nicaragua,0,0,5353,154
2020-10-16,Nicaragua,0,0,5353,154
2020-10-17,Nicaragua,0,0,5353,154
2020-10-18,Nicaragua,0,0,5353,154
2020-10-19,Nicaragua,0,0,5353,154
2020-10-20,Nicaragua,81,1,5434,155
2020-10-21,Nicaragua,0,0,5434,155
2020-10-22,Nicaragua,0,0,5434,155
2020-10-23,Nicaragua,0,0,5434,155
2020-10-24,Nicaragua,0,0,5434,155
2020-10-25,Nicaragua,0,0,5434,155
2020-10-26,Nicaragua,0,0,5434,155
2020-10-27,Nicaragua,80,1,5514,156
2020-10-28,Nicaragua,0,0,5514,156
2020-10-29,Nicaragua,0,0,5514,156
2020-10-30,Nicaragua,0,0,5514,156
2020-10-31,Nicaragua,0,0,5514,156
2020-11-01,Nicaragua,0,0,5514,156
2020-11-02,Nicaragua,0,0,5514,156
2020-11-03,Nicaragua,0,0,5514,156
2020-11-04,Nicaragua,0,0,5514,156
2020-11-05,Nicaragua,77,1,5591,157
2020-11-06,Nicaragua,0,0,5591,157
2020-11-07,Nicaragua,0,0,5591,157
2020-11-08,Nicaragua,0,0,5591,157
2020-11-09,Nicaragua,0,0,5591,157
2020-11-10,Nicaragua,70,1,5661,158
2020-11-11,Nicaragua,0,0,5661,158
2020-11-12,Nicaragua,0,0,5661,158
2020-11-13,Nicaragua,0,0,5661,158
2020-11-14,Nicaragua,0,0,5661,158
2020-11-15,Nicaragua,0,0,5661,158
2020-11-16,Nicaragua,0,0,5661,158
2020-11-17,Nicaragua,64,1,5725,159
2020-11-18,Nicaragua,0,0,5725,159
2020-11-19,Nicaragua,0,0,5725,159
2020-11-20,Nicaragua,0,0,5725,159
2020-11-21,Nicaragua,0,0,5725,159
2020-11-22,Nicaragua,0,0,5725,159
2020-11-23,Nicaragua,0,0,5725,159
2020-11-24,Nicaragua,59,1,5784,160
2020-11-25,Nicaragua,0,0,5784,160
2020-11-26,Nicaragua,0,0,5784,160
2020-11-27,Nicaragua,0,0,5784,160
2020-11-28,Nicaragua,0,0,5784,160
2020-11-29,Nicaragua,0,0,5784,160
2020-11-30,Nicaragua,0,0,5784,160
2020-12-01,Nicaragua,54,1,5838,161
2020-12-02,Nicaragua,0,0,5838,161
2020-12-03,Nicaragua,0,0,5838,161
2020-12-04,Nicaragua,0,0,5838,161
2020-12-05,Nicaragua,0,0,5838,161
2020-12-06,Nicaragua,0,0,5838,161
2020-12-07,Nicaragua,0,0,5838,161
2020-12-08,Nicaragua,49,1,5887,162
2020-12-09,Nicaragua,0,0,5887,162
2020-12-10,Nicaragua,0,0,5887,162
2020-12-11,Nicaragua,0,0,5887,162
2020-12-12,Nicaragua,0,0,5887,162
2020-12-13,Nicaragua,0,0,5887,162
2020-12-14,Nicaragua,0,0,5887,162
2020-12-15,Nicaragua,0,0,5887,162
2020-12-16,Nicaragua,51,1,5938,163
2020-12-17,Nicaragua,0,0,5938,163
2020-12-18,Nicaragua,0,0,5938,163
2020-12-19,Nicaragua,0,0,5938,163
2020-12-20,Nicaragua,0,0,5938,163
2020-12-21,Nicaragua,0,0,5938,163
2020-12-22,Nicaragua,0,0,5938,163
2020-12-23,Nicaragua,53,1,5991,164
2020-12-24,Nicaragua,0,0,5991,164
2020-12-25,Nicaragua,0,0,5991,164
2020-12-26,Nicaragua,0,0,5991,164
2020-12-27,Nicaragua,0,0,5991,164
2020-12-28,Nicaragua,0,0,5991,164
2020-12-29,Nicaragua,55,1,6046,165
2020-12-30,Nicaragua,0,0,6046,165
2020-12-31,Nicaragua,0,0,6046,165
2021-01-01,Nicaragua,0,0,6046,165
2021-01-02,Nicaragua,0,0,6046,165
2021-01-03,Nicaragua,0,0,6046,165
2021-01-04,Nicaragua,0,0,6046,165
2021-01-05,Nicaragua,51,1,6097,166
2021-01-06,Nicaragua,0,0,6097,166
2021-01-07,Nicaragua,0,0,6097,166
2021-01-08,Nicaragua,0,0,6097,166
2021-01-09,Nicaragua,0,0,6097,166
2021-01-10,Nicaragua,0,0,6097,166
2021-01-11,Nicaragua,0,0,6097,166
2021-01-12,Nicaragua,55,1,6152,167
2021-01-13,Nicaragua,0,0,6152,167
2021-01-14,Nicaragua,0,0,6152,167
2021-01-15,Nicaragua,0,0,6152,167
2021-01-16,Nicaragua,0,0,6152,167
2021-01-17,Nicaragua,0,0,6152,167
2021-01-18,Nicaragua,0,0,6152,167
2021-01-19,Nicaragua,52,1,6204,168
2021-01-20,Nicaragua,0,0,6204,168
2021-01-21,Nicaragua,0,0,6204,168
2021-01-22,Nicaragua,0,0,6204,168
2021-01-23,Nicaragua,0,0,6204,168
2021-01-24,Nicaragua,0,0,6204,168
2021-01-25,Nicaragua,0,0,6204,168
2021-01-26,Nicaragua,49,1,6253,169
2021-01-27,Nicaragua,0,0,6253,169
2021-01-28,Nicaragua,0,0,6253,169
2021-01-29,Nicaragua,0,0,6253,169
2021-01-30,Nicaragua,0,0,6253,169
2021-01-31,Nicaragua,0,0,6253,169
2021-02-01,Nicaragua,0,0,6253,169
2021-02-02,Nicaragua,46,1,6299,170
2021-02-03,Nicaragua,0,0,6299,170
2021-02-04,Nicaragua,0,0,6299,170
2021-02-05,Nicaragua,0,0,6299,170
2021-02-06,Nicaragua,0,0,6299,170
2021-02-07,Nicaragua,0,0,6299,170
2021-02-08,Nicaragua,0,0,6299,170
2021-02-09,Nicaragua,48,1,6347,171
2021-02-10,Nicaragua,0,0,6347,171
2021-02-11,Nicaragua,0,0,6347,171
2021-02-12,Nicaragua,0,0,6347,171
2021-02-13,Nicaragua,0,0,6347,171
2021-02-14,Nicaragua,0,0,6347,171
2021-02-15,Nicaragua,0,0,6347,171
2021-02-16,Nicaragua,51,1,6398,172
2021-02-17,Nicaragua,0,0,6398,172
2021-02-18,Nicaragua,0,0,6398,172
2021-02-19,Nicaragua,0,0,6398,172
2021-02-20,Nicaragua,0,0,6398,172
2021-02-21,Nicaragua,0,0,6398,172
2021-02-22,Nicaragua,0,0,6398,172
2021-02-23,Nicaragua,47,1,6445,173
2021-02-24,Nicaragua,0,0,6445,173
2021-02-25,Nicaragua,0,0,6445,173
2021-02-26,Nicaragua,0,0,6445,173
2021-02-27,Nicaragua,0,0,6445,173
2021-02-28,Nicaragua,0,0,6445,173
2021-03-01,Nicaragua,0,0,6445,173
2021-03-02,Nicaragua,44,1,6489,174
2021-03-03,Nicaragua,0,0,6489,174
2021-03-04,Nicaragua,0,0,6489,174
2021-03-05,Nicaragua,0,0,6489,174
2021-03-06,Nicaragua,0,0,6489,174
2021-03-07,Nicaragua,0,0,6489,174
2021-03-08,Nicaragua,0,0,6489,174
2021-03-09,Nicaragua,48,1,6537,175
2021-03-10,Nicaragua,0,0,6537,175
2021-03-11,Nicaragua,0,0,6537,175
2021-03-12,Nicaragua,0,0,6537,175
2021-03-13,Nicaragua,0,0,6537,175
2021-03-14,Nicaragua,0,0,6537,175
2021-03-15,Nicaragua,0,0,6537,175
2021-03-16,Nicaragua,45,1,6582,176
2021-03-17,Nicaragua,0,0,6582,176
2021-03-18,Nicaragua,0,0,6582,176
2021-03-19,Nicaragua,0,0,6582,176
2021-03-20,Nicaragua,0,0,6582,176
2021-03-21,Nicaragua,0,0,6582,176
2021-03-22,Nicaragua,0,0,6582,176
2021-03-23,Nicaragua,47,1,6629,177
2021-03-24,Nicaragua,0,0,6629,177
2021-03-25,Nicaragua,0,0,6629,177
2021-03-26,Nicaragua,0,0,6629,177
2021-03-27,Nicaragua,0,0,6629,177
2021-03-28,Nicaragua,0,0,6629,177
2021-03-29,Nicaragua,0,0,6629,177
2021-03-30,Nicaragua,48,1,6677,178
2021-03-31,Nicaragua,0,0,6677,178
2021-04-01,Nicaragua,0,0,6677,178
2021-04-02,Nicaragua,0,0,6677,178
2021-04-03,Nicaragua,0,0,6677,178
2021-04-04,Nicaragua,0,0,6677,178
2021-04-05,Nicaragua,0,0,6677,178
2021-04-06,Nicaragua,50,1,6727,179
2021-04-07,Nicaragua,0,0,6727,179
2021-04-08,Nicaragua,0,0,6727,179
2020-03-20,Niger,1,0,1,0
2020-03-21,Niger,0,0,1,0
2020-03-22,Niger,1,0,2,0
2020-03-23,Niger,1,0,3,0
2020-03-24,Niger,0,0,3,0
2020-03-25,Niger,4,1,7,1
2020-03-26,Niger,3,0,10,1
2020-03-27,Niger,0,0,10,1
2020-03-28,Niger,0,0,10,1
2020-03-29,Niger,8,0,18,1
2020-03-30,Niger,9,2,27,3
2020-03-31,Niger,0,0,27,3
2020-04-01,Niger,47,2,74,5
2020-04-02,Niger,24,0,98,5
2020-04-03,Niger,22,0,120,5
2020-04-04,Niger,24,3,144,8
2020-04-05,Niger,40,2,184,10
2020-04-06,Niger,69,0,253,10
2020-04-07,Niger,25,1,278,11
2020-04-08,Niger,64,0,342,11
2020-04-09,Niger,68,0,410,11
2020-04-10,Niger,28,0,438,11
2020-04-11,Niger,53,0,491,11
2020-04-12,Niger,38,1,529,12
2020-04-13,Niger,0,0,529,12
2020-04-14,Niger,41,2,570,14
2020-04-15,Niger,14,0,584,14
2020-04-16,Niger,0,0,584,14
2020-04-17,Niger,43,4,627,18
2020-04-18,Niger,12,1,639,19
2020-04-19,Niger,9,1,648,20
2020-04-20,Niger,0,0,648,20
2020-04-21,Niger,9,0,657,20
2020-04-22,Niger,5,2,662,22
2020-04-23,Niger,9,2,671,24
2020-04-24,Niger,10,0,681,24
2020-04-25,Niger,3,3,684,27
2020-04-26,Niger,12,2,696,29
2020-04-27,Niger,5,0,701,29
2020-04-28,Niger,8,2,709,31
2020-04-29,Niger,4,1,713,32
2020-04-30,Niger,6,0,719,32
2020-05-01,Niger,9,1,728,33
2020-05-02,Niger,8,2,736,35
2020-05-03,Niger,14,1,750,36
2020-05-04,Niger,5,1,755,37
2020-05-05,Niger,8,1,763,38
2020-05-06,Niger,7,0,770,38
2020-05-07,Niger,11,4,781,42
2020-05-08,Niger,14,2,795,44
2020-05-09,Niger,20,1,815,45
2020-05-10,Niger,6,1,821,46
2020-05-11,Niger,11,0,832,46
2020-05-12,Niger,22,1,854,47
2020-05-13,Niger,6,2,860,49
2020-05-14,Niger,16,1,876,50
2020-05-15,Niger,9,1,885,51
2020-05-16,Niger,4,0,889,51
2020-05-17,Niger,15,3,904,54
2020-05-18,Niger,5,1,909,55
2020-05-19,Niger,5,0,914,55
2020-05-20,Niger,6,3,920,58
2020-05-21,Niger,4,2,924,60
2020-05-22,Niger,13,0,937,60
2020-05-23,Niger,6,1,943,61
2020-05-24,Niger,2,0,945,61
2020-05-25,Niger,6,1,951,62
2020-05-26,Niger,1,1,952,63
2020-05-27,Niger,0,0,952,63
2020-05-28,Niger,3,1,955,64
2020-05-29,Niger,0,0,955,64
2020-05-30,Niger,1,0,956,64
2020-05-31,Niger,2,0,958,64
2020-06-01,Niger,0,1,958,65
2020-06-02,Niger,2,0,960,65
2020-06-03,Niger,1,0,961,65
2020-06-04,Niger,2,0,963,65
2020-06-05,Niger,3,0,966,65
2020-06-06,Niger,4,0,970,65
2020-06-07,Niger,3,0,973,65
2020-06-08,Niger,0,0,973,65
2020-06-09,Niger,1,0,974,65
2020-06-10,Niger,0,0,974,65
2020-06-11,Niger,0,0,974,65
2020-06-12,Niger,4,0,978,65
2020-06-13,Niger,2,1,980,66
2020-06-14,Niger,0,0,980,66
2020-06-15,Niger,0,0,980,66
2020-06-16,Niger,36,0,1016,66
2020-06-17,Niger,4,1,1020,67
2020-06-18,Niger,0,0,1020,67
2020-06-19,Niger,0,0,1020,67
2020-06-20,Niger,15,0,1035,67
2020-06-21,Niger,1,0,1036,67
2020-06-22,Niger,10,0,1046,67
2020-06-23,Niger,5,0,1051,67
2020-06-24,Niger,0,0,1051,67
2020-06-25,Niger,5,0,1056,67
2020-06-26,Niger,3,0,1059,67
2020-06-27,Niger,3,0,1062,67
2020-06-28,Niger,12,0,1074,67
2020-06-29,Niger,1,0,1075,67
2020-06-30,Niger,0,0,1075,67
2020-07-01,Niger,0,0,1075,67
2020-07-02,Niger,6,1,1081,68
2020-07-03,Niger,1,0,1082,68
2020-07-04,Niger,0,0,1082,68
2020-07-05,Niger,6,0,1088,68
2020-07-06,Niger,5,0,1093,68
2020-07-07,Niger,1,0,1094,68
2020-07-08,Niger,3,0,1097,68
2020-07-09,Niger,0,0,1097,68
2020-07-10,Niger,2,0,1099,68
2020-07-11,Niger,0,0,1099,68
2020-07-12,Niger,0,0,1099,68
2020-07-13,Niger,0,0,1099,68
2020-07-14,Niger,0,0,1099,68
2020-07-15,Niger,1,1,1100,69
2020-07-16,Niger,2,0,1102,69
2020-07-17,Niger,0,0,1102,69
2020-07-18,Niger,2,0,1104,69
2020-07-19,Niger,0,0,1104,69
2020-07-20,Niger,1,0,1105,69
2020-07-21,Niger,8,0,1113,69
2020-07-22,Niger,9,0,1122,69
2020-07-23,Niger,2,0,1124,69
2020-07-24,Niger,0,0,1124,69
2020-07-25,Niger,0,0,1124,69
2020-07-26,Niger,12,0,1136,69
2020-07-27,Niger,-4,0,1132,69
2020-07-28,Niger,0,0,1132,69
2020-07-29,Niger,0,0,1132,69
2020-07-30,Niger,2,0,1134,69
2020-07-31,Niger,0,0,1134,69
2020-08-01,Niger,2,0,1136,69
2020-08-02,Niger,11,0,1147,69
2020-08-03,Niger,5,0,1152,69
2020-08-04,Niger,0,0,1152,69
2020-08-05,Niger,0,0,1152,69
2020-08-06,Niger,1,0,1153,69
2020-08-07,Niger,0,0,1153,69
2020-08-08,Niger,4,0,1157,69
2020-08-09,Niger,1,0,1158,69
2020-08-10,Niger,0,0,1158,69
2020-08-11,Niger,0,0,1158,69
2020-08-12,Niger,3,0,1161,69
2020-08-13,Niger,0,0,1161,69
2020-08-14,Niger,0,0,1161,69
2020-08-15,Niger,4,0,1165,69
2020-08-16,Niger,2,0,1167,69
2020-08-17,Niger,0,0,1167,69
2020-08-18,Niger,0,0,1167,69
2020-08-19,Niger,0,0,1167,69
2020-08-20,Niger,2,0,1169,69
2020-08-21,Niger,3,0,1172,69
2020-08-22,Niger,0,0,1172,69
2020-08-23,Niger,0,0,1172,69
2020-08-24,Niger,0,0,1172,69
2020-08-25,Niger,1,0,1173,69
2020-08-26,Niger,0,0,1173,69
2020-08-27,Niger,0,0,1173,69
2020-08-28,Niger,2,0,1175,69
2020-08-29,Niger,0,0,1175,69
2020-08-30,Niger,0,0,1175,69
2020-08-31,Niger,1,0,1176,69
2020-09-01,Niger,0,0,1176,69
2020-09-02,Niger,0,0,1176,69
2020-09-03,Niger,1,0,1177,69
2020-09-04,Niger,0,0,1177,69
2020-09-05,Niger,0,0,1177,69
2020-09-06,Niger,0,0,1177,69
2020-09-07,Niger,0,0,1177,69
2020-09-08,Niger,1,0,1178,69
2020-09-09,Niger,0,0,1178,69
2020-09-10,Niger,0,0,1178,69
2020-09-11,Niger,0,0,1178,69
2020-09-12,Niger,0,0,1178,69
2020-09-13,Niger,2,0,1180,69
2020-09-14,Niger,0,0,1180,69
2020-09-15,Niger,2,0,1182,69
2020-09-16,Niger,0,0,1182,69
2020-09-17,Niger,1,0,1183,69
2020-09-18,Niger,0,0,1183,69
2020-09-19,Niger,0,0,1183,69
2020-09-20,Niger,5,0,1188,69
2020-09-21,Niger,1,0,1189,69
2020-09-22,Niger,4,0,1193,69
2020-09-23,Niger,0,0,1193,69
2020-09-24,Niger,1,0,1194,69
2020-09-25,Niger,0,0,1194,69
2020-09-26,Niger,0,0,1194,69
2020-09-27,Niger,2,0,1196,69
2020-09-28,Niger,0,0,1196,69
2020-09-29,Niger,0,0,1196,69
2020-09-30,Niger,1,0,1197,69
2020-10-01,Niger,0,0,1197,69
2020-10-02,Niger,1,0,1198,69
2020-10-03,Niger,2,0,1200,69
2020-10-04,Niger,0,0,1200,69
2020-10-05,Niger,0,0,1200,69
2020-10-06,Niger,0,0,1200,69
2020-10-07,Niger,0,0,1200,69
2020-10-08,Niger,1,0,1201,69
2020-10-09,Niger,0,0,1201,69
2020-10-10,Niger,0,0,1201,69
2020-10-11,Niger,0,0,1201,69
2020-10-12,Niger,1,0,1202,69
2020-10-13,Niger,1,0,1203,69
2020-10-14,Niger,2,0,1205,69
2020-10-15,Niger,2,0,1207,69
2020-10-16,Niger,2,0,1209,69
2020-10-17,Niger,0,0,1209,69
2020-10-18,Niger,1,0,1210,69
2020-10-19,Niger,1,0,1211,69
2020-10-20,Niger,1,0,1212,69
2020-10-21,Niger,2,0,1214,69
2020-10-22,Niger,1,0,1215,69
2020-10-23,Niger,0,0,1215,69
2020-10-24,Niger,0,0,1215,69
2020-10-25,Niger,0,0,1215,69
2020-10-26,Niger,0,0,1215,69
2020-10-27,Niger,3,0,1218,69
2020-10-28,Niger,0,0,1218,69
2020-10-29,Niger,1,0,1219,69
2020-10-30,Niger,1,0,1220,69
2020-10-31,Niger,0,0,1220,69
2020-11-01,Niger,1,0,1221,69
2020-11-02,Niger,1,0,1222,69
2020-11-03,Niger,0,0,1222,69
2020-11-04,Niger,3,0,1225,69
2020-11-05,Niger,1,0,1226,69
2020-11-06,Niger,4,0,1230,69
2020-11-07,Niger,12,0,1242,69
2020-11-08,Niger,1,0,1243,69
2020-11-09,Niger,3,0,1246,69
2020-11-10,Niger,10,0,1256,69
2020-11-11,Niger,7,0,1263,69
2020-11-12,Niger,19,0,1282,69
2020-11-13,Niger,7,0,1289,69
2020-11-14,Niger,12,1,1301,70
2020-11-15,Niger,6,0,1307,70
2020-11-16,Niger,9,0,1316,70
2020-11-17,Niger,11,0,1327,70
2020-11-18,Niger,4,0,1331,70
2020-11-19,Niger,4,0,1335,70
2020-11-20,Niger,5,0,1340,70
2020-11-21,Niger,11,0,1351,70
2020-11-22,Niger,17,0,1368,70
2020-11-23,Niger,13,0,1381,70
2020-11-24,Niger,25,0,1406,70
2020-11-25,Niger,13,0,1419,70
2020-11-26,Niger,24,0,1443,70
2020-11-27,Niger,29,0,1472,70
2020-11-28,Niger,12,0,1484,70
2020-11-29,Niger,32,0,1516,70
2020-11-30,Niger,32,2,1548,72
2020-12-01,Niger,38,3,1586,75
2020-12-02,Niger,54,1,1640,76
2020-12-03,Niger,0,0,1640,76
2020-12-04,Niger,86,1,1726,77
2020-12-05,Niger,63,0,1789,77
2020-12-06,Niger,67,0,1856,77
2020-12-07,Niger,38,1,1894,78
2020-12-08,Niger,93,1,1987,79
2020-12-09,Niger,91,0,2078,79
2020-12-10,Niger,48,1,2126,80
2020-12-11,Niger,34,0,2160,80
2020-12-12,Niger,39,0,2199,80
2020-12-13,Niger,59,0,2258,80
2020-12-14,Niger,64,2,2322,82
2020-12-15,Niger,39,0,2361,82
2020-12-16,Niger,0,0,2361,82
2020-12-17,Niger,145,2,2506,84
2020-12-18,Niger,54,1,2560,85
2020-12-19,Niger,52,1,2612,86
2020-12-20,Niger,47,1,2659,87
2020-12-21,Niger,65,0,2724,87
2020-12-22,Niger,79,2,2803,89
2020-12-23,Niger,73,0,2876,89
2020-12-24,Niger,57,1,2933,90
2020-12-25,Niger,72,1,3005,91
2020-12-26,Niger,52,3,3057,94
2020-12-27,Niger,53,2,3110,96
2020-12-28,Niger,49,3,3159,99
2020-12-29,Niger,49,3,3208,102
2020-12-30,Niger,0,0,3208,102
2020-12-31,Niger,115,2,3323,104
2021-01-01,Niger,80,2,3403,106
2021-01-02,Niger,34,4,3437,110
2021-01-03,Niger,28,0,3465,110
2021-01-04,Niger,0,0,3465,110
2021-01-05,Niger,35,0,3500,110
2021-01-06,Niger,134,3,3634,113
2021-01-07,Niger,72,6,3706,119
2021-01-08,Niger,41,6,3747,125
2021-01-09,Niger,72,1,3819,126
2021-01-10,Niger,58,0,3877,126
2021-01-11,Niger,47,2,3924,128
2021-01-12,Niger,45,7,3969,135
2021-01-13,Niger,29,1,3998,136
2021-01-14,Niger,60,1,4058,137
2021-01-15,Niger,47,1,4105,138
2021-01-16,Niger,27,0,4132,138
2021-01-17,Niger,24,2,4156,140
2021-01-18,Niger,48,5,4204,145
2021-01-19,Niger,21,1,4225,146
2021-01-20,Niger,24,1,4249,147
2021-01-21,Niger,18,0,4267,147
2021-01-22,Niger,41,3,4308,150
2021-01-23,Niger,13,1,4321,151
2021-01-24,Niger,32,0,4353,151
2021-01-25,Niger,0,0,4353,151
2021-01-26,Niger,54,2,4407,153
2021-01-27,Niger,26,0,4433,153
2021-01-28,Niger,41,4,4474,157
2021-01-29,Niger,15,2,4489,159
2021-01-30,Niger,27,0,4516,159
2021-01-31,Niger,1,0,4517,159
2021-02-01,Niger,20,2,4537,161
2021-02-02,Niger,11,1,4548,162
2021-02-03,Niger,17,1,4565,163
2021-02-04,Niger,10,1,4575,164
2021-02-05,Niger,14,1,4589,165
2021-02-06,Niger,9,0,4598,165
2021-02-07,Niger,14,0,4612,165
2021-02-08,Niger,9,1,4621,166
2021-02-09,Niger,22,1,4643,167
2021-02-10,Niger,13,0,4656,167
2021-02-11,Niger,9,0,4665,167
2021-02-12,Niger,13,2,4678,169
2021-02-13,Niger,12,0,4690,169
2021-02-14,Niger,5,0,4695,169
2021-02-15,Niger,7,0,4702,169
2021-02-16,Niger,4,0,4706,169
2021-02-17,Niger,9,1,4715,170
2021-02-18,Niger,3,0,4718,170
2021-02-19,Niger,7,0,4725,170
2021-02-20,Niger,8,0,4733,170
2021-02-21,Niger,0,0,4733,170
2021-02-22,Niger,7,2,4740,172
2021-02-23,Niger,0,0,4740,172
2021-02-24,Niger,0,0,4740,172
2021-02-25,Niger,0,0,4740,172
2021-02-26,Niger,0,0,4740,172
2021-02-27,Niger,0,0,4740,172
2021-02-28,Niger,0,0,4740,172
2021-03-01,Niger,0,0,4740,172
2021-03-02,Niger,0,0,4740,172
2021-03-03,Niger,0,0,4740,172
2021-03-04,Niger,0,0,4740,172
2021-03-05,Niger,0,0,4740,172
2021-03-06,Niger,0,0,4740,172
2021-03-07,Niger,82,5,4822,177
2021-03-08,Niger,6,0,4828,177
2021-03-09,Niger,7,0,4835,177
2021-03-10,Niger,13,2,4848,179
2021-03-11,Niger,5,1,4853,180
2021-03-12,Niger,0,0,4853,180
2021-03-13,Niger,4,1,4857,181
2021-03-14,Niger,3,1,4860,182
2021-03-15,Niger,5,0,4865,182
2021-03-16,Niger,5,1,4870,183
2021-03-17,Niger,34,2,4904,185
2021-03-18,Niger,2,0,4906,185
2021-03-19,Niger,5,0,4911,185
2021-03-20,Niger,7,0,4918,185
2021-03-21,Niger,0,0,4918,185
2021-03-22,Niger,10,0,4928,185
2021-03-23,Niger,11,0,4939,185
2021-03-24,Niger,0,0,4939,185
2021-03-25,Niger,25,0,4964,185
2021-03-26,Niger,8,0,4972,185
2021-03-27,Niger,0,0,4972,185
2021-03-28,Niger,15,0,4987,185
2021-03-29,Niger,0,0,4987,185
2021-03-30,Niger,14,1,5001,186
2021-03-31,Niger,0,0,5001,186
2021-04-01,Niger,20,1,5021,187
2021-04-02,Niger,0,0,5021,187
2021-04-03,Niger,7,1,5028,188
2021-04-04,Niger,13,0,5041,188
2021-04-05,Niger,0,0,5041,188
2021-04-06,Niger,7,0,5048,188
2021-04-07,Niger,4,0,5052,188
2021-04-08,Niger,6,0,5058,188
2020-02-28,Nigeria,1,0,1,0
2020-02-29,Nigeria,0,0,1,0
2020-03-01,Nigeria,0,0,1,0
2020-03-02,Nigeria,0,0,1,0
2020-03-03,Nigeria,0,0,1,0
2020-03-04,Nigeria,0,0,1,0
2020-03-05,Nigeria,0,0,1,0
2020-03-06,Nigeria,0,0,1,0
2020-03-07,Nigeria,0,0,1,0
2020-03-08,Nigeria,0,0,1,0
2020-03-09,Nigeria,1,0,2,0
2020-03-10,Nigeria,0,0,2,0
2020-03-11,Nigeria,0,0,2,0
2020-03-12,Nigeria,0,0,2,0
2020-03-13,Nigeria,0,0,2,0
2020-03-14,Nigeria,0,0,2,0
2020-03-15,Nigeria,0,0,2,0
2020-03-16,Nigeria,0,0,2,0
2020-03-17,Nigeria,1,0,3,0
2020-03-18,Nigeria,5,0,8,0
2020-03-19,Nigeria,0,0,8,0
2020-03-20,Nigeria,4,0,12,0
2020-03-21,Nigeria,10,0,22,0
2020-03-22,Nigeria,8,0,30,0
2020-03-23,Nigeria,10,1,40,1
2020-03-24,Nigeria,4,0,44,1
2020-03-25,Nigeria,7,0,51,1
2020-03-26,Nigeria,14,0,65,1
2020-03-27,Nigeria,5,0,70,1
2020-03-28,Nigeria,19,0,89,1
2020-03-29,Nigeria,22,0,111,1
2020-03-30,Nigeria,20,1,131,2
2020-03-31,Nigeria,4,0,135,2
2020-04-01,Nigeria,39,0,174,2
2020-04-02,Nigeria,10,0,184,2
2020-04-03,Nigeria,26,2,210,4
2020-04-04,Nigeria,4,0,214,4
2020-04-05,Nigeria,18,1,232,5
2020-04-06,Nigeria,6,0,238,5
2020-04-07,Nigeria,16,1,254,6
2020-04-08,Nigeria,22,0,276,6
2020-04-09,Nigeria,12,1,288,7
2020-04-10,Nigeria,17,0,305,7
2020-04-11,Nigeria,13,3,318,10
2020-04-12,Nigeria,5,0,323,10
2020-04-13,Nigeria,20,0,343,10
2020-04-14,Nigeria,30,1,373,11
2020-04-15,Nigeria,34,1,407,12
2020-04-16,Nigeria,35,1,442,13
2020-04-17,Nigeria,51,4,493,17
2020-04-18,Nigeria,49,2,542,19
2020-04-19,Nigeria,85,2,627,21
2020-04-20,Nigeria,38,1,665,22
2020-04-21,Nigeria,0,0,665,22
2020-04-22,Nigeria,208,6,873,28
2020-04-23,Nigeria,108,3,981,31
2020-04-24,Nigeria,114,1,1095,32
2020-04-25,Nigeria,87,3,1182,35
2020-04-26,Nigeria,91,5,1273,40
2020-04-27,Nigeria,64,0,1337,40
2020-04-28,Nigeria,195,4,1532,44
2020-04-29,Nigeria,196,7,1728,51
2020-04-30,Nigeria,204,7,1932,58
2020-05-01,Nigeria,238,10,2170,68
2020-05-02,Nigeria,218,17,2388,85
2020-05-03,Nigeria,170,2,2558,87
2020-05-04,Nigeria,244,6,2802,93
2020-05-05,Nigeria,148,5,2950,98
2020-05-06,Nigeria,195,5,3145,103
2020-05-07,Nigeria,381,4,3526,107
2020-05-08,Nigeria,386,10,3912,117
2020-05-09,Nigeria,239,11,4151,128
2020-05-10,Nigeria,248,15,4399,143
2020-05-11,Nigeria,242,7,4641,150
2020-05-12,Nigeria,146,8,4787,158
2020-05-13,Nigeria,184,6,4971,164
2020-05-14,Nigeria,191,3,5162,167
2020-05-15,Nigeria,288,4,5450,171
2020-05-16,Nigeria,171,5,5621,176
2020-05-17,Nigeria,338,6,5959,182
2020-05-18,Nigeria,216,9,6175,191
2020-05-19,Nigeria,226,1,6401,192
2020-05-20,Nigeria,276,8,6677,200
2020-05-21,Nigeria,339,11,7016,211
2020-05-22,Nigeria,245,10,7261,221
2020-05-23,Nigeria,265,0,7526,221
2020-05-24,Nigeria,313,5,7839,226
2020-05-25,Nigeria,229,7,8068,233
2020-05-26,Nigeria,276,16,8344,249
2020-05-27,Nigeria,389,5,8733,254
2020-05-28,Nigeria,182,5,8915,259
2020-05-29,Nigeria,387,2,9302,261
2020-05-30,Nigeria,553,12,9855,273
2020-05-31,Nigeria,307,14,10162,287
2020-06-01,Nigeria,416,12,10578,299
2020-06-02,Nigeria,241,15,10819,314
2020-06-03,Nigeria,347,1,11166,315
2020-06-04,Nigeria,350,8,11516,323
2020-06-05,Nigeria,328,10,11844,333
2020-06-06,Nigeria,389,9,12233,342
2020-06-07,Nigeria,253,12,12486,354
2020-06-08,Nigeria,315,7,12801,361
2020-06-09,Nigeria,663,4,13464,365
2020-06-10,Nigeria,409,17,13873,382
2020-06-11,Nigeria,681,5,14554,387
2020-06-12,Nigeria,627,12,15181,399
2020-06-13,Nigeria,501,8,15682,407
2020-06-14,Nigeria,403,13,16085,420
2020-06-15,Nigeria,573,4,16658,424
2020-06-16,Nigeria,490,31,17148,455
2020-06-17,Nigeria,587,14,17735,469
2020-06-18,Nigeria,745,6,18480,475
2020-06-19,Nigeria,667,12,19147,487
2020-06-20,Nigeria,661,19,19808,506
2020-06-21,Nigeria,436,12,20244,518
2020-06-22,Nigeria,675,7,20919,525
2020-06-23,Nigeria,452,8,21371,533
2020-06-24,Nigeria,649,9,22020,542
2020-06-25,Nigeria,594,7,22614,549
2020-06-26,Nigeria,684,5,23298,554
2020-06-27,Nigeria,779,4,24077,558
2020-06-28,Nigeria,490,7,24567,565
2020-06-29,Nigeria,566,8,25133,573
2020-06-30,Nigeria,561,17,25694,590
2020-07-01,Nigeria,790,13,26484,603
2020-07-02,Nigeria,626,13,27110,616
2020-07-03,Nigeria,454,12,27564,628
2020-07-04,Nigeria,603,6,28167,634
2020-07-05,Nigeria,544,11,28711,645
2020-07-06,Nigeria,575,9,29286,654
2020-07-07,Nigeria,503,15,29789,669
2020-07-08,Nigeria,460,15,30249,684
2020-07-09,Nigeria,499,5,30748,689
2020-07-10,Nigeria,575,20,31323,709
2020-07-11,Nigeria,664,15,31987,724
2020-07-12,Nigeria,571,16,32558,740
2020-07-13,Nigeria,595,4,33153,744
2020-07-14,Nigeria,463,10,33616,754
2020-07-15,Nigeria,643,6,34259,760
2020-07-16,Nigeria,595,9,34854,769
2020-07-17,Nigeria,600,3,35454,772
2020-07-18,Nigeria,653,6,36107,778
2020-07-19,Nigeria,556,11,36663,789
2020-07-20,Nigeria,562,12,37225,801
2020-07-21,Nigeria,576,4,37801,805
2020-07-22,Nigeria,543,8,38344,813
2020-07-23,Nigeria,604,20,38948,833
2020-07-24,Nigeria,591,12,39539,845
2020-07-25,Nigeria,438,11,39977,856
2020-07-26,Nigeria,555,2,40532,858
2020-07-27,Nigeria,648,2,41180,860
2020-07-28,Nigeria,624,8,41804,868
2020-07-29,Nigeria,404,5,42208,873
2020-07-30,Nigeria,481,5,42689,878
2020-07-31,Nigeria,462,1,43151,879
2020-08-01,Nigeria,386,4,43537,883
2020-08-02,Nigeria,304,5,43841,888
2020-08-03,Nigeria,288,8,44129,896
2020-08-04,Nigeria,304,14,44433,910
2020-08-05,Nigeria,457,17,44890,927
2020-08-06,Nigeria,354,3,45244,930
2020-08-07,Nigeria,443,6,45687,936
2020-08-08,Nigeria,453,6,46140,942
2020-08-09,Nigeria,437,3,46577,945
2020-08-10,Nigeria,290,5,46867,950
2020-08-11,Nigeria,423,6,47290,956
2020-08-12,Nigeria,453,0,47743,956
2020-08-13,Nigeria,373,10,48116,966
2020-08-14,Nigeria,329,7,48445,973
2020-08-15,Nigeria,325,1,48770,974
2020-08-16,Nigeria,298,1,49068,975
2020-08-17,Nigeria,417,2,49485,977
2020-08-18,Nigeria,410,4,49895,981
2020-08-19,Nigeria,593,4,50488,985
2020-08-20,Nigeria,476,7,50964,992
2020-08-21,Nigeria,340,4,51304,996
2020-08-22,Nigeria,601,1,51905,997
2020-08-23,Nigeria,322,5,52227,1002
2020-08-24,Nigeria,321,2,52548,1004
2020-08-25,Nigeria,252,3,52800,1007
2020-08-26,Nigeria,221,3,53021,1010
2020-08-27,Nigeria,296,1,53317,1011
2020-08-28,Nigeria,160,0,53477,1011
2020-08-29,Nigeria,250,0,53727,1011
2020-08-30,Nigeria,138,2,53865,1013
2020-08-31,Nigeria,143,0,54008,1013
2020-09-01,Nigeria,239,10,54247,1023
2020-09-02,Nigeria,216,4,54463,1027
2020-09-03,Nigeria,125,21,54588,1048
2020-09-04,Nigeria,155,3,54743,1051
2020-09-05,Nigeria,162,3,54905,1054
2020-09-06,Nigeria,100,3,55005,1057
2020-09-07,Nigeria,155,4,55160,1061
2020-09-08,Nigeria,296,6,55456,1067
2020-09-09,Nigeria,176,3,55632,1070
2020-09-10,Nigeria,197,5,55829,1075
2020-09-11,Nigeria,188,1,56017,1076
2020-09-12,Nigeria,160,2,56177,1078
2020-09-13,Nigeria,79,4,56256,1082
2020-09-14,Nigeria,132,1,56388,1083
2020-09-15,Nigeria,90,5,56478,1088
2020-09-16,Nigeria,126,3,56604,1091
2020-09-17,Nigeria,131,2,56735,1093
2020-09-18,Nigeria,221,1,56956,1094
2020-09-19,Nigeria,189,1,57145,1095
2020-09-20,Nigeria,97,3,57242,1098
2020-09-21,Nigeria,195,2,57437,1100
2020-09-22,Nigeria,176,0,57613,1100
2020-09-23,Nigeria,111,2,57724,1102
2020-09-24,Nigeria,125,0,57849,1102
2020-09-25,Nigeria,213,1,58062,1103
2020-09-26,Nigeria,136,3,58198,1106
2020-09-27,Nigeria,126,2,58324,1108
2020-09-28,Nigeria,136,3,58460,1111
2020-09-29,Nigeria,187,0,58647,1111
2020-09-30,Nigeria,201,1,58848,1112
2020-10-01,Nigeria,153,0,59001,1112
2020-10-02,Nigeria,126,0,59127,1112
2020-10-03,Nigeria,160,1,59287,1113
2020-10-04,Nigeria,58,0,59345,1113
2020-10-05,Nigeria,120,0,59465,1113
2020-10-06,Nigeria,118,0,59583,1113
2020-10-07,Nigeria,155,0,59738,1113
2020-10-08,Nigeria,103,0,59841,1113
2020-10-09,Nigeria,151,0,59992,1113
2020-10-10,Nigeria,111,2,60103,1115
2020-10-11,Nigeria,163,0,60266,1115
2020-10-12,Nigeria,164,0,60430,1115
2020-10-13,Nigeria,225,1,60655,1116
2020-10-14,Nigeria,179,0,60834,1116
2020-10-15,Nigeria,148,0,60982,1116
2020-10-16,Nigeria,212,3,61194,1119
2020-10-17,Nigeria,113,4,61307,1123
2020-10-18,Nigeria,133,2,61440,1125
2020-10-19,Nigeria,118,0,61558,1125
2020-10-20,Nigeria,72,0,61630,1125
2020-10-21,Nigeria,37,0,61667,1125
2020-10-22,Nigeria,138,2,61805,1127
2020-10-23,Nigeria,77,2,61882,1129
2020-10-24,Nigeria,48,0,61930,1129
2020-10-25,Nigeria,62,1,61992,1130
2020-10-26,Nigeria,119,2,62111,1132
2020-10-27,Nigeria,113,3,62224,1135
2020-10-28,Nigeria,147,4,62371,1139
2020-10-29,Nigeria,150,2,62521,1141
2020-10-30,Nigeria,170,3,62691,1144
2020-10-31,Nigeria,162,0,62853,1144
2020-11-01,Nigeria,111,2,62964,1146
2020-11-02,Nigeria,72,1,63036,1147
2020-11-03,Nigeria,137,4,63173,1151
2020-11-04,Nigeria,155,4,63328,1155
2020-11-05,Nigeria,180,0,63508,1155
2020-11-06,Nigeria,223,0,63731,1155
2020-11-07,Nigeria,59,0,63790,1155
2020-11-08,Nigeria,300,-1,64090,1154
2020-11-09,Nigeria,94,4,64184,1158
2020-11-10,Nigeria,152,2,64336,1160
2020-11-11,Nigeria,180,2,64516,1162
2020-11-12,Nigeria,212,0,64728,1162
2020-11-13,Nigeria,156,1,64884,1163
2020-11-14,Nigeria,112,0,64996,1163
2020-11-15,Nigeria,152,0,65148,1163
2020-11-16,Nigeria,157,0,65305,1163
2020-11-17,Nigeria,152,0,65457,1163
2020-11-18,Nigeria,236,0,65693,1163
2020-11-19,Nigeria,146,2,65839,1165
2020-11-20,Nigeria,143,0,65982,1165
2020-11-21,Nigeria,246,1,66228,1166
2020-11-22,Nigeria,155,1,66383,1167
2020-11-23,Nigeria,56,1,66439,1168
2020-11-24,Nigeria,168,1,66607,1169
2020-11-25,Nigeria,198,0,66805,1169
2020-11-26,Nigeria,169,0,66974,1169
2020-11-27,Nigeria,246,2,67220,1171
2020-11-28,Nigeria,110,0,67330,1171
2020-11-29,Nigeria,82,2,67412,1173
2020-11-30,Nigeria,145,0,67557,1173
2020-12-01,Nigeria,281,3,67838,1176
2020-12-02,Nigeria,122,1,67960,1177
2020-12-03,Nigeria,343,2,68303,1179
2020-12-04,Nigeria,324,0,68627,1179
2020-12-05,Nigeria,310,1,68937,1180
2020-12-06,Nigeria,318,0,69255,1180
2020-12-07,Nigeria,390,1,69645,1181
2020-12-08,Nigeria,550,1,70195,1182
2020-12-09,Nigeria,474,2,70669,1184
2020-12-10,Nigeria,675,6,71344,1190
2020-12-11,Nigeria,796,0,72140,1190
2020-12-12,Nigeria,617,4,72757,1194
2020-12-13,Nigeria,418,3,73175,1197
2020-12-14,Nigeria,199,0,73374,1197
2020-12-15,Nigeria,758,3,74132,1200
2020-12-16,Nigeria,930,0,75062,1200
2020-12-17,Nigeria,1145,1,76207,1201
2020-12-18,Nigeria,806,11,77013,1212
2020-12-19,Nigeria,920,6,77933,1218
2020-12-20,Nigeria,501,3,78434,1221
2020-12-21,Nigeria,356,6,78790,1227
2020-12-22,Nigeria,999,4,79789,1231
2020-12-23,Nigeria,1133,5,80922,1236
2020-12-24,Nigeria,1041,6,81963,1242
2020-12-25,Nigeria,784,4,82747,1246
2020-12-26,Nigeria,829,1,83576,1247
2020-12-27,Nigeria,838,7,84414,1254
2020-12-28,Nigeria,397,10,84811,1264
2020-12-29,Nigeria,749,3,85560,1267
2020-12-30,Nigeria,1016,11,86576,1278
2020-12-31,Nigeria,1031,11,87607,1289
2021-01-01,Nigeria,980,5,88587,1294
2021-01-02,Nigeria,576,8,89163,1302
2021-01-03,Nigeria,917,9,90080,1311
2021-01-04,Nigeria,1271,7,91351,1318
2021-01-05,Nigeria,1354,1,92705,1319
2021-01-06,Nigeria,1664,5,94369,1324
2021-01-07,Nigeria,1565,6,95934,1330
2021-01-08,Nigeria,1544,12,97478,1342
2021-01-09,Nigeria,1585,8,99063,1350
2021-01-10,Nigeria,1024,8,100087,1358
2021-01-11,Nigeria,1244,3,101331,1361
2021-01-12,Nigeria,1270,12,102601,1373
2021-01-13,Nigeria,1398,9,103999,1382
2021-01-14,Nigeria,1479,23,105478,1405
2021-01-15,Nigeria,1867,8,107345,1413
2021-01-16,Nigeria,1598,7,108943,1420
2021-01-17,Nigeria,1444,15,110387,1435
2021-01-18,Nigeria,1617,14,112004,1449
2021-01-19,Nigeria,1301,15,113305,1464
2021-01-20,Nigeria,1386,14,114691,1478
2021-01-21,Nigeria,1964,7,116655,1485
2021-01-22,Nigeria,1483,5,118138,1490
2021-01-23,Nigeria,2464,12,120602,1502
2021-01-24,Nigeria,964,2,121566,1504
2021-01-25,Nigeria,1430,3,122996,1507
2021-01-26,Nigeria,1303,15,124299,1522
2021-01-27,Nigeria,1861,21,126160,1543
2021-01-28,Nigeria,864,4,127024,1547
2021-01-29,Nigeria,1650,30,128674,1577
2021-01-30,Nigeria,1883,1,130557,1578
2021-01-31,Nigeria,685,8,131242,1586
2021-02-01,Nigeria,676,21,131918,1607
2021-02-02,Nigeria,1634,6,133552,1613
2021-02-03,Nigeria,1138,5,134690,1618
2021-02-04,Nigeria,1340,14,136030,1632
2021-02-05,Nigeria,1624,9,137654,1641
2021-02-06,Nigeria,1588,6,139242,1647
2021-02-07,Nigeria,506,20,139748,1667
2021-02-08,Nigeria,643,6,140391,1673
2021-02-09,Nigeria,1056,21,141447,1694
2021-02-10,Nigeria,1131,8,142578,1702
2021-02-11,Nigeria,938,8,143516,1710
2021-02-12,Nigeria,1005,24,144521,1734
2021-02-13,Nigeria,1143,13,145664,1747
2021-02-14,Nigeria,520,5,146184,1752
2021-02-15,Nigeria,744,9,146928,1761
2021-02-16,Nigeria,1368,16,148296,1777
2021-02-17,Nigeria,1073,10,149369,1787
2021-02-18,Nigeria,877,16,150246,1803
2021-02-19,Nigeria,662,10,150908,1813
2021-02-20,Nigeria,645,18,151553,1831
2021-02-21,Nigeria,521,8,152074,1839
2021-02-22,Nigeria,542,23,152616,1862
2021-02-23,Nigeria,571,12,153187,1874
2021-02-24,Nigeria,655,11,153842,1885
2021-02-25,Nigeria,634,6,154476,1891
2021-02-26,Nigeria,600,11,155076,1902
2021-02-27,Nigeria,341,3,155417,1905
2021-02-28,Nigeria,240,2,155657,1907
2021-03-01,Nigeria,360,8,156017,1915
2021-03-02,Nigeria,479,8,156496,1923
2021-03-03,Nigeria,464,16,156960,1939
2021-03-04,Nigeria,711,12,157671,1951
2021-03-05,Nigeria,371,3,158042,1954
2021-03-06,Nigeria,195,10,158237,1964
2021-03-07,Nigeria,269,5,158506,1969
2021-03-08,Nigeria,400,13,158906,1982
2021-03-09,Nigeria,346,6,159252,1988
2021-03-10,Nigeria,394,5,159646,1993
2021-03-11,Nigeria,287,8,159933,2001
2021-03-12,Nigeria,399,8,160332,2009
2021-03-13,Nigeria,205,4,160537,2013
2021-03-14,Nigeria,120,0,160657,2013
2021-03-15,Nigeria,238,3,160895,2016
2021-03-16,Nigeria,179,2,161074,2018
2021-03-17,Nigeria,187,9,161261,2027
2021-03-18,Nigeria,148,0,161409,2027
2021-03-19,Nigeria,130,0,161539,2027
2021-03-20,Nigeria,112,3,161651,2030
2021-03-21,Nigeria,86,0,161737,2030
2021-03-22,Nigeria,131,0,161868,2030
2021-03-23,Nigeria,208,1,162076,2031
2021-03-24,Nigeria,102,0,162178,2031
2021-03-25,Nigeria,97,5,162275,2036
2021-03-26,Nigeria,113,3,162388,2039
2021-03-27,Nigeria,101,2,162489,2041
2021-03-28,Nigeria,104,7,162593,2048
2021-03-29,Nigeria,48,1,162641,2049
2021-03-30,Nigeria,121,7,162762,2056
2021-03-31,Nigeria,129,1,162891,2057
2021-04-01,Nigeria,106,1,162997,2058
2021-04-02,Nigeria,66,0,163063,2058
2021-04-03,Nigeria,50,0,163113,2058
2021-04-04,Nigeria,82,0,163195,2058
2021-04-05,Nigeria,135,0,163330,2058
2021-04-06,Nigeria,58,0,163388,2058
2021-04-07,Nigeria,110,0,163498,2058
2021-04-08,Nigeria,83,0,163581,2058
2020-01-22,North America,0,0,1,0
2020-01-23,North America,0,0,1,0
2020-01-24,North America,1,0,2,0
2020-01-25,North America,0,0,2,0
2020-01-26,North America,4,0,6,0
2020-01-27,North America,0,0,6,0
2020-01-28,North America,1,0,7,0
2020-01-29,North America,1,0,8,0
2020-01-30,North America,0,0,8,0
2020-01-31,North America,4,0,12,0
2020-02-01,North America,0,0,12,0
2020-02-02,North America,0,0,12,0
2020-02-03,North America,3,0,15,0
2020-02-04,North America,0,0,15,0
2020-02-05,North America,1,0,16,0
2020-02-06,North America,1,0,17,0
2020-02-07,North America,2,0,19,0
2020-02-08,North America,0,0,19,0
2020-02-09,North America,0,0,19,0
2020-02-10,North America,0,0,19,0
2020-02-11,North America,1,0,20,0
2020-02-12,North America,0,0,20,0
2020-02-13,North America,1,0,21,0
2020-02-14,North America,0,0,21,0
2020-02-15,North America,0,0,21,0
2020-02-16,North America,0,0,21,0
2020-02-17,North America,1,0,22,0
2020-02-18,North America,0,0,22,0
2020-02-19,North America,0,0,22,0
2020-02-20,North America,0,0,22,0
2020-02-21,North America,3,0,25,0
2020-02-22,North America,0,0,25,0
2020-02-23,North America,0,0,25,0
2020-02-24,North America,1,0,26,0
2020-02-25,North America,1,0,27,0
2020-02-26,North America,0,0,27,0
2020-02-27,North America,3,0,30,0
2020-02-28,North America,2,0,32,0
2020-02-29,North America,17,1,49,1
2020-03-01,North America,13,0,62,1
2020-03-02,North America,26,5,88,6
2020-03-03,North America,22,1,110,7
2020-03-04,North America,36,4,146,11
2020-03-05,North America,81,1,227,12
2020-03-06,North America,68,2,295,14
2020-03-07,North America,171,3,466,17
2020-03-08,North America,134,4,600,21
2020-03-09,North America,92,2,692,23
2020-03-10,North America,191,6,883,29
2020-03-11,North America,409,6,1292,35
2020-03-12,North America,468,10,1760,45
2020-03-13,North America,748,8,2508,53
2020-03-14,North America,802,7,3310,60
2020-03-15,North America,312,12,3622,72
2020-03-16,North America,1686,31,5308,103
2020-03-17,North America,1949,40,7257,143
2020-03-18,North America,2893,66,10150,209
2020-03-19,North America,4759,76,14909,285
2020-03-20,North America,6658,111,21567,396
2020-03-21,North America,6563,108,28130,504
2020-03-22,North America,9382,128,37512,632
2020-03-23,North America,12026,203,49538,835
2020-03-24,North America,11471,251,61009,1086
2020-03-25,North America,12853,350,73862,1436
2020-03-26,North America,19053,439,92915,1875
2020-03-27,North America,19743,548,112658,2423
2020-03-28,North America,21031,677,133689,3100
2020-03-29,North America,20084,658,153773,3758
2020-03-30,North America,23532,765,177305,4523
2020-03-31,North America,28016,1131,205321,5654
2020-04-01,North America,33718,1329,239039,6983
2020-04-02,North America,34457,1584,273496,8567
2020-04-03,North America,33970,1508,307466,10075
2020-04-04,North America,33483,1676,340949,11751
2020-04-05,North America,33367,1733,374316,13484
2020-04-06,North America,32855,1906,407171,15390
2020-04-07,North America,32770,2674,439941,18064
2020-04-08,North America,33282,2275,473223,20339
2020-04-09,North America,38389,2365,511612,22704
2020-04-10,North America,36881,2343,548493,25047
2020-04-11,North America,31236,2306,579729,27353
2020-04-12,North America,29252,2053,608981,29406
2020-04-13,North America,29133,2194,638114,31600
2020-04-14,North America,30804,2659,668918,34259
2020-04-15,North America,27637,2820,696555,37079
2020-04-16,North America,33520,2406,730075,39485
2020-04-17,North America,36365,2319,766440,41804
2020-04-18,North America,30640,2258,797080,44062
2020-04-19,North America,28659,2180,825739,46242
2020-04-20,North America,33006,2422,858745,48664
2020-04-21,North America,28756,2877,887501,51541
2020-04-22,North America,32719,2783,920220,54324
2020-04-23,North America,37058,2756,957278,57080
2020-04-24,North America,35795,2542,993073,59622
2020-04-25,North America,33370,2002,1026443,61624
2020-04-26,North America,29581,1619,1056024,63243
2020-04-27,North America,26666,1786,1082690,65029
2020-04-28,North America,27579,2568,1110269,67597
2020-04-29,North America,29964,2845,1140233,70442
2020-04-30,North America,32873,2531,1173106,72973
2020-05-01,North America,38991,2244,1212097,75217
2020-05-02,North America,31335,1993,1243432,77210
2020-05-03,North America,28795,1439,1272227,78649
2020-05-04,North America,27600,1761,1299827,80410
2020-05-05,North America,27679,2682,1327506,83092
2020-05-06,North America,28499,2695,1356005,85787
2020-05-07,North America,31686,2362,1387691,88149
2020-05-08,North America,30932,2131,1418623,90280
2020-05-09,North America,29246,1837,1447869,92117
2020-05-10,North America,22618,1222,1470487,93339
2020-05-11,North America,22498,1304,1492985,94643
2020-05-12,North America,26695,2129,1519680,96772
2020-05-13,North America,24290,2155,1543970,98927
2020-05-14,North America,31099,2197,1575069,101124
2020-05-15,North America,29337,2094,1604406,103218
2020-05-16,North America,28428,1614,1632834,104832
2020-05-17,North America,22141,1054,1654975,105886
2020-05-18,North America,26850,1490,1681825,107376
2020-05-19,North America,26255,1893,1708080,109269
2020-05-20,North America,26712,2061,1734792,111330
2020-05-21,North America,30897,1726,1765689,113056
2020-05-22,North America,28987,1824,1794676,114880
2020-05-23,North America,26896,1383,1821572,116263
2020-05-24,North America,25555,966,1847127,117229
2020-05-25,North America,23428,935,1870555,118164
2020-05-26,North America,25598,1311,1896153,119475
2020-05-27,North America,24297,2045,1920450,121520
2020-05-28,North America,27978,1697,1948428,123217
2020-05-29,North America,30037,1607,1978465,124824
2020-05-30,North America,28920,1415,2007385,126239
2020-05-31,North America,24513,840,2031898,127079
2020-06-01,North America,22500,1086,2054398,128165
2020-06-02,North America,27641,1560,2082039,129725
2020-06-03,North America,25809,2196,2107848,131921
2020-06-04,North America,28414,1929,2136262,133850
2020-06-05,North America,31872,1637,2168134,135487
2020-06-06,North America,26998,1089,2195132,136576
2020-06-07,North America,23805,724,2218937,137300
2020-06-08,North America,23033,934,2241970,138234
2020-06-09,North America,25302,1598,2267272,139832
2020-06-10,North America,28684,1687,2295956,141519
2020-06-11,North America,30651,1493,2326607,143012
2020-06-12,North America,32937,1403,2359544,144415
2020-06-13,North America,31717,1232,2391261,145647
2020-06-14,North America,26150,674,2417411,146321
2020-06-15,North America,25044,897,2442455,147218
2020-06-16,North America,31145,1628,2473600,148846
2020-06-17,North America,34984,1587,2508584,150433
2020-06-18,North America,37260,1409,2545844,151842
2020-06-19,North America,39948,1368,2585792,153210
2020-06-20,North America,40839,1043,2626631,154253
2020-06-21,North America,33673,1420,2660304,155673
2020-06-22,North America,40048,1272,2700352,156945
2020-06-23,North America,46943,1647,2747295,158592
2020-06-24,North America,44289,1789,2791584,160381
2020-06-25,North America,50419,1352,2842003,161733
2020-06-26,North America,54375,1481,2896378,163214
2020-06-27,North America,49673,1195,2946051,164409
2020-06-28,North America,49034,649,2995085,165058
2020-06-29,North America,48870,935,3043955,165993
2020-06-30,North America,56011,1307,3099966,167300
2020-07-01,North America,61736,1576,3161702,168876
2020-07-02,North America,67817,1529,3229519,170405
2020-07-03,North America,62984,1433,3292503,171838
2020-07-04,North America,57482,945,3349985,172783
2020-07-05,North America,60621,680,3410606,173463
2020-07-06,North America,52316,966,3462922,174429
2020-07-07,North America,70871,2169,3533793,176598
2020-07-08,North America,71376,1737,3605169,178335
2020-07-09,North America,74916,1846,3680085,180181
2020-07-10,North America,79802,1637,3759887,181818
2020-07-11,North America,70827,1384,3830714,183202
2020-07-12,North America,67796,849,3898510,184051
2020-07-13,North America,68429,1021,3966939,185072
2020-07-14,North America,79953,1903,4046892,186975
2020-07-15,North America,80114,1686,4127006,188661
2020-07-16,North America,87562,1745,4214568,190406
2020-07-17,North America,84847,1789,4299415,192195
2020-07-18,North America,78955,1574,4378370,193769
2020-07-19,North America,71267,866,4449637,194635
2020-07-20,North America,72135,976,4521772,195611
2020-07-21,North America,76388,2155,4598160,197766
2020-07-22,North America,81591,2123,4679751,199889
2020-07-23,North America,83111,1927,4762862,201816
2020-07-24,North America,87040,2013,4849902,203829
2020-07-25,North America,78219,1779,4928121,205608
2020-07-26,North America,66648,942,4994769,206550
2020-07-27,North America,66678,1620,5061447,208170
2020-07-28,North America,78501,2346,5139948,210516
2020-07-29,North America,83222,2084,5223170,212600
2020-07-30,North America,80826,2028,5303996,214628
2020-07-31,North America,83168,2051,5387164,216679
2020-08-01,North America,71634,2003,5458798,218682
2020-08-02,North America,54672,801,5513470,219483
2020-08-03,North America,54144,927,5567614,220410
2020-08-04,North America,70295,2327,5637909,222737
2020-08-05,North America,66244,2353,5704153,225090
2020-08-06,North America,71078,2207,5775231,227297
2020-08-07,North America,71999,2155,5847230,229452
2020-08-08,North America,65944,1888,5913174,231340
2020-08-09,North America,54108,966,5967282,232306
2020-08-10,North America,57558,1394,6024840,233700
2020-08-11,North America,59594,2030,6084434,235730
2020-08-12,North America,66740,2360,6151174,238090
2020-08-13,North America,64505,1795,6215679,239885
2020-08-14,North America,76606,2067,6292285,241952
2020-08-15,North America,58644,1737,6350929,243689
2020-08-16,North America,47910,914,6398839,244603
2020-08-17,North America,43454,845,6442293,245448
2020-08-18,North America,54858,2126,6497151,247574
2020-08-19,North America,58515,2123,6555666,249697
2020-08-20,North America,54780,1814,6610446,251511
2020-08-21,North America,59929,1702,6670375,253213
2020-08-22,North America,54464,1737,6724839,254950
2020-08-23,North America,42686,797,6767525,255747
2020-08-24,North America,44432,903,6811957,256650
2020-08-25,North America,49977,1978,6861934,258628
2020-08-26,North America,55525,1955,6917459,260583
2020-08-27,North America,56608,1753,6974067,262336
2020-08-28,North America,58356,1634,7032423,263970
2020-08-29,North America,53387,1676,7085810,265646
2020-08-30,North America,41282,861,7127092,266507
2020-08-31,North America,44674,900,7171766,267407
2020-09-01,North America,52470,1976,7224236,269383
2020-09-02,North America,50859,1749,7275095,271132
2020-09-03,North America,55592,1675,7330687,272807
2020-09-04,North America,60822,1560,7391509,274367
2020-09-05,North America,55372,1383,7446881,275750
2020-09-06,North America,38455,713,7485336,276463
2020-09-07,North America,30998,628,7516334,277091
2020-09-08,North America,38379,1269,7554713,278360
2020-09-09,North America,43425,1795,7598138,280155
2020-09-10,North America,46081,1595,7644219,281750
2020-09-11,North America,58352,1784,7702571,283534
2020-09-12,North America,52663,1218,7755234,284752
2020-09-13,North America,41685,701,7796919,285453
2020-09-14,North America,43637,767,7840556,286220
2020-09-15,North America,48295,1902,7888851,288122
2020-09-16,North America,48775,1334,7937626,289456
2020-09-17,North America,53835,1177,7991461,290633
2020-09-18,North America,59953,1666,8051414,292299
2020-09-19,North America,52819,1297,8104233,293596
2020-09-20,North America,45653,569,8149886,294165
2020-09-21,North America,61083,736,8210969,294901
2020-09-22,North America,49655,1754,8260624,296655
2020-09-23,North America,49427,1747,8310051,298402
2020-09-24,North America,57838,1485,8367889,299887
2020-09-25,North America,60062,1433,8427951,301320
2020-09-26,North America,55453,1272,8483404,302592
2020-09-27,North America,44576,547,8527980,303139
2020-09-28,North America,42762,620,8570742,303759
2020-09-29,North America,53317,1519,8624059,305278
2020-09-30,North America,51014,1531,8675073,306809
2020-10-01,North America,56582,1399,8731655,308208
2020-10-02,North America,65893,1431,8797548,309639
2020-10-03,North America,59030,1170,8856578,310809
2020-10-04,North America,44263,691,8900841,311500
2020-10-05,North America,74610,3378,8975451,314878
2020-10-06,North America,56300,1248,9031751,316126
2020-10-07,North America,61772,1411,9093523,317537
2020-10-08,North America,70850,1447,9164373,318984
2020-10-09,North America,69072,1448,9233445,320432
2020-10-10,North America,66037,894,9299482,321326
2020-10-11,North America,53409,670,9352891,321996
2020-10-12,North America,49950,646,9402841,322642
2020-10-13,North America,63683,1369,9466524,324011
2020-10-14,North America,71242,1544,9537766,325555
2020-10-15,North America,77231,1362,9614997,326917
2020-10-16,North America,82498,1454,9697495,328371
2020-10-17,North America,66579,1219,9764074,329590
2020-10-18,North America,59901,669,9823975,330259
2020-10-19,North America,78636,745,9902611,331004
2020-10-20,North America,73743,1546,9976354,332550
2020-10-21,North America,77029,1783,10053383,334333
2020-10-22,North America,89734,991,10143117,335324
2020-10-23,North America,94468,1930,10237585,337254
2020-10-24,North America,95707,1475,10333292,338729
2020-10-25,North America,71582,731,10404874,339460
2020-10-26,North America,79074,882,10483948,340342
2020-10-27,North America,89044,1702,10572992,342044
2020-10-28,North America,92041,1640,10665033,343684
2020-10-29,North America,104068,1575,10769101,345259
2020-10-30,North America,113094,1690,10882195,346949
2020-10-31,North America,101925,1470,10984120,348419
2020-11-01,North America,114608,707,11098728,349126
2020-11-02,North America,95347,866,11194075,349992
2020-11-03,North America,140141,2199,11334216,352191
2020-11-04,North America,116220,1866,11450436,354057
2020-11-05,North America,141370,1792,11591806,355849
2020-11-06,North America,143290,1912,11735096,357761
2020-11-07,North America,141963,1661,11877059,359422
2020-11-08,North America,127199,876,12004258,360298
2020-11-09,North America,133836,1106,12138094,361404
2020-11-10,North America,154754,2161,12292848,363565
2020-11-11,North America,162225,2145,12455073,365710
2020-11-12,North America,179891,1952,12634964,367662
2020-11-13,North America,195662,1911,12830626,369573
2020-11-14,North America,182159,2120,13012785,371693
2020-11-15,North America,146741,1155,13159526,372848
2020-11-16,North America,175374,1287,13334900,374135
2020-11-17,North America,174059,1998,13508959,376133
2020-11-18,North America,185613,2640,13694572,378773
2020-11-19,North America,205394,2771,13899966,381544
2020-11-20,North America,213801,2798,14113767,384342
2020-11-21,North America,195201,2274,14308968,386616
2020-11-22,North America,163265,1416,14472233,388032
2020-11-23,North America,194134,1515,14666367,389547
2020-11-24,North America,195185,3101,14861552,392648
2020-11-25,North America,203786,3242,15065338,395890
2020-11-26,North America,132342,2180,15197680,398070
2020-11-27,North America,231183,2330,15428863,400400
2020-11-28,North America,176002,2061,15604865,402461
2020-11-29,North America,154358,1353,15759223,403814
2020-11-30,North America,179973,1816,15939196,405630
2020-12-01,North America,206028,3493,16145224,409123
2020-12-02,North America,226282,3785,16371506,412908
2020-12-03,North America,247704,3743,16619210,416651
2020-12-04,North America,256866,3537,16876076,420188
2020-12-05,North America,238215,3066,17114291,423254
2020-12-06,North America,199176,1745,17313467,424999
2020-12-07,North America,214651,2196,17528118,427195
2020-12-08,North America,247105,3599,17775223,430794
2020-12-09,North America,247205,4165,18022428,434959
2020-12-10,North America,257009,3881,18279437,438840
2020-12-11,North America,265013,4316,18544450,443156
2020-12-12,North America,241149,3310,18785599,446466
2020-12-13,North America,206862,2017,18992461,448483
2020-12-14,North America,213392,2256,19205853,450739
2020-12-15,North America,232999,4140,19438852,454879
2020-12-16,North America,270220,4609,19709072,459488
2020-12-17,North America,265042,4460,19974114,463948
2020-12-18,North America,277529,3908,20251643,467856
2020-12-19,North America,215974,3456,20467617,471312
2020-12-20,North America,206288,2212,20673905,473524
2020-12-21,North America,217910,2574,20891815,476098
2020-12-22,North America,223598,4538,21115413,480636
2020-12-23,North America,254770,4472,21370183,485108
2020-12-24,North America,220418,4019,21590601,489127
2020-12-25,North America,114802,2194,21705403,491321
2020-12-26,North America,238092,2215,21943495,493536
2020-12-27,North America,176135,2012,22119630,495548
2020-12-28,North America,194265,2721,22313895,498269
2020-12-29,North America,229660,4933,22543555,503202
2020-12-30,North America,263025,5008,22806580,508210
2020-12-31,North America,263785,4573,23070365,512783
2021-01-01,North America,172063,2981,23242428,515764
2021-01-02,North America,314727,3015,23557155,518779
2021-01-03,North America,233475,1986,23790630,520765
2021-01-04,North America,209567,3001,24000197,523766
2021-01-05,North America,260721,4999,24260918,528765
2021-01-06,North America,286704,5368,24547622,534133
2021-01-07,North America,308664,5288,24856286,539421
2021-01-08,North America,325382,5434,25181668,544855
2021-01-09,North America,296414,4713,25478082,549568
2021-01-10,North America,236495,2696,25714577,552264
2021-01-11,North America,238413,3002,25952990,555266
2021-01-12,North America,257740,6105,26210730,561371
2021-01-13,North America,262748,5576,26473478,566947
2021-01-14,North America,267668,5266,26741146,572213
2021-01-15,North America,278121,5283,27019267,577496
2021-01-16,North America,236759,4882,27256026,582378
2021-01-17,North America,200928,2569,27456954,584947
2021-01-18,North America,164811,2332,27621765,587279
2021-01-19,North America,208647,4611,27830412,591890
2021-01-20,North America,216918,6272,28047330,598162
2021-01-21,North America,229742,6260,28277072,604422
2021-01-22,North America,224620,5581,28501692,610003
2021-01-23,North America,202452,5049,28704144,615052
2021-01-24,North America,151667,2631,28855811,617683
2021-01-25,North America,172058,2884,29027869,620567
2021-01-26,North America,175559,6049,29203428,626616
2021-01-27,North America,182555,5808,29385983,632424
2021-01-28,North America,199185,5870,29585168,638294
2021-01-29,North America,194859,5329,29780027,643623
2021-01-30,North America,168199,4514,29948226,648137
2021-01-31,North America,128033,2489,30076259,650626
2021-02-01,North America,149834,2840,30226093,653466
2021-02-02,North America,128697,4122,30354790,657588
2021-02-03,North America,144279,5850,30499069,663438
2021-02-04,North America,134409,4006,30633478,667444
2021-02-05,North America,171186,6939,30804664,674383
2021-02-06,North America,126219,4316,30930883,678699
2021-02-07,North America,103074,1953,31033957,680652
2021-02-08,North America,102938,2341,31136895,682993
2021-02-09,North America,113748,5014,31250643,688007
2021-02-10,North America,114986,4860,31365629,692867
2021-02-11,North America,125546,4875,31491175,697742
2021-02-12,North America,118009,4422,31609184,702164
2021-02-13,North America,105621,3578,31714805,705742
2021-02-14,North America,74636,1669,31789441,707411
2021-02-15,North America,63567,1546,31853008,708957
2021-02-16,North America,80485,3237,31933493,712194
2021-02-17,North America,86389,3617,32019882,715811
2021-02-18,North America,87367,3716,32107249,719527
2021-02-19,North America,95471,3688,32202720,723215
2021-02-20,North America,86499,2765,32289219,725980
2021-02-21,North America,66832,1652,32356051,727632
2021-02-22,North America,66163,1889,32422214,729521
2021-02-23,North America,88479,3659,32510693,733180
2021-02-24,North America,91115,4326,32601808,737506
2021-02-25,North America,93263,3382,32695071,740888
2021-02-26,North America,91924,3007,32786995,743895
2021-02-27,North America,78592,2429,32865587,746324
2021-02-28,North America,59489,1613,32925076,747937
2021-03-01,North America,68850,2078,32993926,750015
2021-03-02,North America,72292,3091,33066218,753106
2021-03-03,North America,82110,3511,33148328,756617
2021-03-04,North America,82607,2873,33230935,759490
2021-03-05,North America,79880,2594,33310815,762084
2021-03-06,North America,71397,2363,33382212,764447
2021-03-07,North America,50029,1026,33432241,765473
2021-03-08,North America,54265,1160,33486506,766633
2021-03-09,North America,72983,2790,33559489,769423
2021-03-10,North America,72142,2370,33631631,771793
2021-03-11,North America,76673,2327,33708304,774120
2021-03-12,North America,76956,2381,33785260,776501
2021-03-13,North America,65552,2460,33850812,778961
2021-03-14,North America,46410,861,33897222,779822
2021-03-15,North America,65032,1084,33962254,780906
2021-03-16,North America,63622,1452,34025876,782358
2021-03-17,North America,73486,2083,34099362,784441
2021-03-18,North America,74956,2412,34174318,786853
2021-03-19,North America,77299,1834,34251617,788687
2021-03-20,North America,68696,1482,34320313,790169
2021-03-21,North America,42229,728,34362542,790897
2021-03-22,North America,61058,864,34423600,791761
2021-03-23,North America,68491,1762,34492091,793523
2021-03-24,North America,100751,2122,34592842,795645
2021-03-25,North America,82378,2233,34675220,797878
2021-03-26,North America,93343,1892,34768563,799770
2021-03-27,North America,75168,1393,34843731,801163
2021-03-28,North America,52632,757,34896363,801920
2021-03-29,North America,79334,989,34975697,802909
2021-03-30,North America,74909,1777,35050606,804686
2021-03-31,North America,84738,1771,35135344,806457
2021-04-01,North America,94278,1613,35229622,808070
2021-04-02,North America,79548,1185,35309170,809255
2021-04-03,North America,74808,941,35383978,810196
2021-04-04,North America,42469,479,35426447,810675
2021-04-05,North America,90000,847,35516447,811522
2021-04-06,North America,85299,1552,35601746,813074
2021-04-07,North America,91564,3287,35693310,816361
2021-04-08,North America,98353,1656,35791663,818017
2020-02-26,North Macedonia,1,0,1,0
2020-02-27,North Macedonia,0,0,1,0
2020-02-28,North Macedonia,0,0,1,0
2020-02-29,North Macedonia,0,0,1,0
2020-03-01,North Macedonia,0,0,1,0
2020-03-02,North Macedonia,0,0,1,0
2020-03-03,North Macedonia,0,0,1,0
2020-03-04,North Macedonia,0,0,1,0
2020-03-05,North Macedonia,0,0,1,0
2020-03-06,North Macedonia,2,0,3,0
2020-03-07,North Macedonia,0,0,3,0
2020-03-08,North Macedonia,0,0,3,0
2020-03-09,North Macedonia,0,0,3,0
2020-03-10,North Macedonia,4,0,7,0
2020-03-11,North Macedonia,0,0,7,0
2020-03-12,North Macedonia,0,0,7,0
2020-03-13,North Macedonia,7,0,14,0
2020-03-14,North Macedonia,0,0,14,0
2020-03-15,North Macedonia,0,0,14,0
2020-03-16,North Macedonia,4,0,18,0
2020-03-17,North Macedonia,8,0,26,0
2020-03-18,North Macedonia,9,0,35,0
2020-03-19,North Macedonia,13,0,48,0
2020-03-20,North Macedonia,19,0,67,0
2020-03-21,North Macedonia,18,0,85,0
2020-03-22,North Macedonia,30,1,115,1
2020-03-23,North Macedonia,21,1,136,2
2020-03-24,North Macedonia,12,0,148,2
2020-03-25,North Macedonia,29,1,177,3
2020-03-26,North Macedonia,24,0,201,3
2020-03-27,North Macedonia,18,0,219,3
2020-03-28,North Macedonia,22,1,241,4
2020-03-29,North Macedonia,18,2,259,6
2020-03-30,North Macedonia,26,1,285,7
2020-03-31,North Macedonia,44,2,329,9
2020-04-01,North Macedonia,25,2,354,11
2020-04-02,North Macedonia,30,0,384,11
2020-04-03,North Macedonia,46,1,430,12
2020-04-04,North Macedonia,53,5,483,17
2020-04-05,North Macedonia,72,1,555,18
2020-04-06,North Macedonia,15,5,570,23
2020-04-07,North Macedonia,29,3,599,26
2020-04-08,North Macedonia,18,3,617,29
2020-04-09,North Macedonia,46,1,663,30
2020-04-10,North Macedonia,48,2,711,32
2020-04-11,North Macedonia,49,2,760,34
2020-04-12,North Macedonia,68,0,828,34
2020-04-13,North Macedonia,26,4,854,38
2020-04-14,North Macedonia,54,6,908,44
2020-04-15,North Macedonia,66,1,974,45
2020-04-16,North Macedonia,107,1,1081,46
2020-04-17,North Macedonia,36,3,1117,49
2020-04-18,North Macedonia,53,0,1170,49
2020-04-19,North Macedonia,37,2,1207,51
2020-04-20,North Macedonia,18,3,1225,54
2020-04-21,North Macedonia,6,1,1231,55
2020-04-22,North Macedonia,28,1,1259,56
2020-04-23,North Macedonia,41,0,1300,56
2020-04-24,North Macedonia,26,1,1326,57
2020-04-25,North Macedonia,41,2,1367,59
2020-04-26,North Macedonia,19,2,1386,61
2020-04-27,North Macedonia,13,4,1399,65
2020-04-28,North Macedonia,22,6,1421,71
2020-04-29,North Macedonia,21,2,1442,73
2020-04-30,North Macedonia,23,4,1465,77
2020-05-01,North Macedonia,29,4,1494,81
2020-05-02,North Macedonia,12,1,1506,82
2020-05-03,North Macedonia,5,2,1511,84
2020-05-04,North Macedonia,7,1,1518,85
2020-05-05,North Macedonia,8,1,1526,86
2020-05-06,North Macedonia,13,2,1539,88
2020-05-07,North Macedonia,33,1,1572,89
2020-05-08,North Macedonia,14,1,1586,90
2020-05-09,North Macedonia,36,1,1622,91
2020-05-10,North Macedonia,20,0,1642,91
2020-05-11,North Macedonia,22,0,1664,91
2020-05-12,North Macedonia,10,1,1674,92
2020-05-13,North Macedonia,20,3,1694,95
2020-05-14,North Macedonia,29,0,1723,95
2020-05-15,North Macedonia,17,2,1740,97
2020-05-16,North Macedonia,22,1,1762,98
2020-05-17,North Macedonia,30,3,1792,101
2020-05-18,North Macedonia,25,3,1817,104
2020-05-19,North Macedonia,22,2,1839,106
2020-05-20,North Macedonia,19,4,1858,110
2020-05-21,North Macedonia,40,1,1898,111
2020-05-22,North Macedonia,23,1,1921,112
2020-05-23,North Macedonia,20,1,1941,113
2020-05-24,North Macedonia,37,0,1978,113
2020-05-25,North Macedonia,21,0,1999,113
2020-05-26,North Macedonia,15,3,2014,116
2020-05-27,North Macedonia,25,3,2039,119
2020-05-28,North Macedonia,38,2,2077,121
2020-05-29,North Macedonia,52,5,2129,126
2020-05-30,North Macedonia,35,5,2164,131
2020-05-31,North Macedonia,62,2,2226,133
2020-06-01,North Macedonia,89,7,2315,140
2020-06-02,North Macedonia,76,1,2391,141
2020-06-03,North Macedonia,101,4,2492,145
2020-06-04,North Macedonia,119,2,2611,147
2020-06-05,North Macedonia,179,2,2790,149
2020-06-06,North Macedonia,125,2,2915,151
2020-06-07,North Macedonia,110,2,3025,153
2020-06-08,North Macedonia,127,3,3152,156
2020-06-09,North Macedonia,87,1,3239,157
2020-06-10,North Macedonia,125,7,3364,164
2020-06-11,North Macedonia,174,5,3538,169
2020-06-12,North Macedonia,163,2,3701,171
2020-06-13,North Macedonia,194,8,3895,179
2020-06-14,North Macedonia,162,9,4057,188
2020-06-15,North Macedonia,100,5,4157,193
2020-06-16,North Macedonia,142,8,4299,201
2020-06-17,North Macedonia,183,9,4482,210
2020-06-18,North Macedonia,182,6,4664,216
2020-06-19,North Macedonia,156,6,4820,222
2020-06-20,North Macedonia,185,11,5005,233
2020-06-21,North Macedonia,101,5,5106,238
2020-06-22,North Macedonia,90,9,5196,247
2020-06-23,North Macedonia,115,4,5311,251
2020-06-24,North Macedonia,134,8,5445,259
2020-06-25,North Macedonia,150,6,5595,265
2020-06-26,North Macedonia,163,3,5758,268
2020-06-27,North Macedonia,148,9,5906,277
2020-06-28,North Macedonia,174,9,6080,286
2020-06-29,North Macedonia,129,12,6209,298
2020-06-30,North Macedonia,125,4,6334,302
2020-07-01,North Macedonia,120,4,6454,306
2020-07-02,North Macedonia,171,15,6625,321
2020-07-03,North Macedonia,162,7,6787,328
2020-07-04,North Macedonia,145,6,6932,334
2020-07-05,North Macedonia,114,7,7046,341
2020-07-06,North Macedonia,78,5,7124,346
2020-07-07,North Macedonia,120,5,7244,351
2020-07-08,North Macedonia,162,8,7406,359
2020-07-09,North Macedonia,166,3,7572,362
2020-07-10,North Macedonia,205,6,7777,368
2020-07-11,North Macedonia,198,8,7975,376
2020-07-12,North Macedonia,136,6,8111,382
2020-07-13,North Macedonia,86,3,8197,385
2020-07-14,North Macedonia,135,4,8332,389
2020-07-15,North Macedonia,198,4,8530,393
2020-07-16,North Macedonia,93,8,8623,401
2020-07-17,North Macedonia,163,5,8786,406
2020-07-18,North Macedonia,240,8,9026,414
2020-07-19,North Macedonia,127,8,9153,422
2020-07-20,North Macedonia,96,10,9249,432
2020-07-21,North Macedonia,163,0,9412,432
2020-07-22,North Macedonia,135,10,9547,442
2020-07-23,North Macedonia,122,3,9669,445
2020-07-24,North Macedonia,128,6,9797,451
2020-07-25,North Macedonia,137,9,9934,460
2020-07-26,North Macedonia,152,0,10086,460
2020-07-27,North Macedonia,127,6,10213,466
2020-07-28,North Macedonia,102,5,10315,471
2020-07-29,North Macedonia,188,5,10503,476
2020-07-30,North Macedonia,114,4,10617,480
2020-07-31,North Macedonia,137,6,10754,486
2020-08-01,North Macedonia,137,7,10891,493
2020-08-02,North Macedonia,163,4,11054,497
2020-08-03,North Macedonia,74,3,11128,500
2020-08-04,North Macedonia,74,5,11202,505
2020-08-05,North Macedonia,87,6,11289,511
2020-08-06,North Macedonia,110,6,11399,517
2020-08-07,North Macedonia,155,2,11554,519
2020-08-08,North Macedonia,200,4,11754,523
2020-08-09,North Macedonia,85,4,11839,527
2020-08-10,North Macedonia,103,1,11942,528
2020-08-11,North Macedonia,141,1,12083,529
2020-08-12,North Macedonia,134,1,12217,530
2020-08-13,North Macedonia,140,2,12357,532
2020-08-14,North Macedonia,158,3,12515,535
2020-08-15,North Macedonia,138,4,12653,539
2020-08-16,North Macedonia,86,5,12739,544
2020-08-17,North Macedonia,101,3,12840,547
2020-08-18,North Macedonia,130,2,12970,549
2020-08-19,North Macedonia,106,2,13076,551
2020-08-20,North Macedonia,118,3,13194,554
2020-08-21,North Macedonia,114,3,13308,557
2020-08-22,North Macedonia,150,6,13458,563
2020-08-23,North Macedonia,137,1,13595,564
2020-08-24,North Macedonia,78,4,13673,568
2020-08-25,North Macedonia,126,5,13799,573
2020-08-26,North Macedonia,115,5,13914,578
2020-08-27,North Macedonia,90,7,14004,585
2020-08-28,North Macedonia,159,5,14163,590
2020-08-29,North Macedonia,130,6,14293,596
2020-08-30,North Macedonia,37,4,14330,600
2020-08-31,North Macedonia,11,3,14341,603
2020-09-01,North Macedonia,114,1,14455,604
2020-09-02,North Macedonia,145,2,14600,606
2020-09-03,North Macedonia,162,0,14762,606
2020-09-04,North Macedonia,109,3,14871,609
2020-09-05,North Macedonia,127,5,14998,614
2020-09-06,North Macedonia,92,3,15090,617
2020-09-07,North Macedonia,37,6,15127,623
2020-09-08,North Macedonia,99,8,15226,631
2020-09-09,North Macedonia,67,3,15293,634
2020-09-10,North Macedonia,121,3,15414,637
2020-09-11,North Macedonia,141,5,15555,642
2020-09-12,North Macedonia,139,4,15694,646
2020-09-13,North Macedonia,97,2,15791,648
2020-09-14,North Macedonia,36,4,15827,652
2020-09-15,North Macedonia,98,9,15925,661
2020-09-16,North Macedonia,163,7,16088,668
2020-09-17,North Macedonia,186,7,16274,675
2020-09-18,North Macedonia,143,8,16417,683
2020-09-19,North Macedonia,140,6,16557,689
2020-09-20,North Macedonia,178,4,16735,693
2020-09-21,North Macedonia,45,7,16780,700
2020-09-22,North Macedonia,87,5,16867,705
2020-09-23,North Macedonia,182,5,17049,710
2020-09-24,North Macedonia,151,2,17200,712
2020-09-25,North Macedonia,143,9,17343,721
2020-09-26,North Macedonia,140,1,17483,722
2020-09-27,North Macedonia,146,3,17629,725
2020-09-28,North Macedonia,45,4,17674,729
2020-09-29,North Macedonia,112,8,17786,737
2020-09-30,North Macedonia,191,2,17977,739
2020-10-01,North Macedonia,161,4,18138,743
2020-10-02,North Macedonia,225,6,18363,749
2020-10-03,North Macedonia,239,4,18602,753
2020-10-04,North Macedonia,188,3,18790,756
2020-10-05,North Macedonia,83,4,18873,760
2020-10-06,North Macedonia,223,8,19096,768
2020-10-07,North Macedonia,317,4,19413,772
2020-10-08,North Macedonia,364,3,19777,775
2020-10-09,North Macedonia,386,6,20163,781
2020-10-10,North Macedonia,392,4,20555,785
2020-10-11,North Macedonia,382,7,20937,792
2020-10-12,North Macedonia,176,5,21113,797
2020-10-13,North Macedonia,80,3,21193,800
2020-10-14,North Macedonia,443,9,21636,809
2020-10-15,North Macedonia,534,6,22170,815
2020-10-16,North Macedonia,437,6,22607,821
2020-10-17,North Macedonia,594,3,23201,824
2020-10-18,North Macedonia,427,10,23628,834
2020-10-19,North Macedonia,160,12,23788,846
2020-10-20,North Macedonia,408,4,24196,850
2020-10-21,North Macedonia,640,12,24836,862
2020-10-22,North Macedonia,637,12,25473,874
2020-10-23,North Macedonia,518,9,25991,883
2020-10-24,North Macedonia,403,14,26394,897
2020-10-25,North Macedonia,560,22,26954,919
2020-10-26,North Macedonia,245,15,27199,934
2020-10-27,North Macedonia,628,15,27827,949
2020-10-28,North Macedonia,870,14,28697,963
2020-10-29,North Macedonia,861,14,29558,977
2020-10-30,North Macedonia,930,5,30488,982
2020-10-31,North Macedonia,1084,12,31572,994
2020-11-01,North Macedonia,864,10,32436,1004
2020-11-02,North Macedonia,561,21,32997,1025
2020-11-03,North Macedonia,911,24,33908,1049
2020-11-04,North Macedonia,1189,22,35097,1071
2020-11-05,North Macedonia,1275,13,36372,1084
2020-11-06,North Macedonia,1127,12,37499,1096
2020-11-07,North Macedonia,1283,14,38782,1110
2020-11-08,North Macedonia,978,26,39760,1136
2020-11-09,North Macedonia,515,20,40275,1156
2020-11-10,North Macedonia,947,30,41222,1186
2020-11-11,North Macedonia,1318,26,42540,1212
2020-11-12,North Macedonia,1295,26,43835,1238
2020-11-13,North Macedonia,1063,25,44898,1263
2020-11-14,North Macedonia,1164,18,46062,1281
2020-11-15,North Macedonia,988,24,47050,1305
2020-11-16,North Macedonia,586,40,47636,1345
2020-11-17,North Macedonia,977,31,48613,1376
2020-11-18,North Macedonia,1402,21,50015,1397
2020-11-19,North Macedonia,1198,26,51213,1423
2020-11-20,North Macedonia,1236,39,52449,1462
2020-11-21,North Macedonia,1182,25,53631,1487
2020-11-22,North Macedonia,1112,24,54743,1511
2020-11-23,North Macedonia,384,35,55127,1546
2020-11-24,North Macedonia,1037,15,56164,1561
2020-11-25,North Macedonia,1287,39,57451,1600
2020-11-26,North Macedonia,1157,30,58608,1630
2020-11-27,North Macedonia,1093,28,59701,1658
2020-11-28,North Macedonia,1022,41,60723,1699
2020-11-29,North Macedonia,820,32,61543,1731
2020-11-30,North Macedonia,335,32,61878,1763
2020-12-01,North Macedonia,1067,29,62945,1792
2020-12-02,North Macedonia,945,33,63890,1825
2020-12-03,North Macedonia,1341,22,65231,1847
2020-12-04,North Macedonia,1099,30,66330,1877
2020-12-05,North Macedonia,981,24,67311,1901
2020-12-06,North Macedonia,657,23,67968,1924
2020-12-07,North Macedonia,364,25,68332,1949
2020-12-08,North Macedonia,1120,28,69452,1977
2020-12-09,North Macedonia,502,46,69954,2023
2020-12-10,North Macedonia,929,28,70883,2051
2020-12-11,North Macedonia,1161,26,72044,2077
2020-12-12,North Macedonia,981,19,73025,2096
2020-12-13,North Macedonia,613,25,73638,2121
2020-12-14,North Macedonia,213,26,73851,2147
2020-12-15,North Macedonia,881,22,74732,2169
2020-12-16,North Macedonia,865,25,75597,2194
2020-12-17,North Macedonia,654,31,76251,2225
2020-12-18,North Macedonia,883,29,77134,2254
2020-12-19,North Macedonia,815,20,77949,2274
2020-12-20,North Macedonia,356,18,78305,2292
2020-12-21,North Macedonia,129,22,78434,2314
2020-12-22,North Macedonia,756,26,79190,2340
2020-12-23,North Macedonia,625,14,79815,2354
2020-12-24,North Macedonia,592,21,80407,2375
2020-12-25,North Macedonia,489,26,80896,2401
2020-12-26,North Macedonia,529,26,81425,2427
2020-12-27,North Macedonia,296,18,81721,2445
2020-12-28,North Macedonia,83,11,81804,2456
2020-12-29,North Macedonia,497,17,82301,2473
2020-12-30,North Macedonia,493,15,82794,2488
2020-12-31,North Macedonia,535,15,83329,2503
2021-01-01,North Macedonia,414,7,83743,2510
2021-01-02,North Macedonia,46,12,83789,2522
2021-01-03,North Macedonia,235,8,84024,2530
2021-01-04,North Macedonia,105,20,84129,2550
2021-01-05,North Macedonia,580,9,84709,2559
2021-01-06,North Macedonia,619,12,85328,2571
2021-01-07,North Macedonia,166,10,85494,2581
2021-01-08,North Macedonia,100,11,85594,2592
2021-01-09,North Macedonia,556,22,86150,2614
2021-01-10,North Macedonia,344,8,86494,2622
2021-01-11,North Macedonia,103,13,86597,2635
2021-01-12,North Macedonia,520,12,87117,2647
2021-01-13,North Macedonia,473,10,87590,2657
2021-01-14,North Macedonia,396,15,87986,2672
2021-01-15,North Macedonia,403,10,88389,2682
2021-01-16,North Macedonia,360,14,88749,2696
2021-01-17,North Macedonia,189,6,88938,2702
2021-01-18,North Macedonia,54,13,88992,2715
2021-01-19,North Macedonia,400,11,89392,2726
2021-01-20,North Macedonia,71,13,89463,2739
2021-01-21,North Macedonia,354,15,89817,2754
2021-01-22,North Macedonia,307,14,90124,2768
2021-01-23,North Macedonia,347,11,90471,2779
2021-01-24,North Macedonia,183,6,90654,2785
2021-01-25,North Macedonia,63,6,90717,2791
2021-01-26,North Macedonia,444,21,91161,2812
2021-01-27,North Macedonia,394,9,91555,2821
2021-01-28,North Macedonia,336,10,91891,2831
2021-01-29,North Macedonia,302,10,92193,2841
2021-01-30,North Macedonia,325,7,92518,2848
2021-01-31,North Macedonia,175,7,92693,2855
2021-02-01,North Macedonia,60,11,92753,2866
2021-02-02,North Macedonia,407,7,93160,2873
2021-02-03,North Macedonia,350,20,93510,2893
2021-02-04,North Macedonia,372,7,93882,2900
2021-02-05,North Macedonia,314,8,94196,2908
2021-02-06,North Macedonia,403,8,94599,2916
2021-02-07,North Macedonia,199,8,94798,2924
2021-02-08,North Macedonia,73,22,94871,2946
2021-02-09,North Macedonia,476,9,95347,2955
2021-02-10,North Macedonia,389,4,95736,2959
2021-02-11,North Macedonia,416,7,96152,2966
2021-02-12,North Macedonia,366,5,96518,2971
2021-02-13,North Macedonia,354,5,96872,2976
2021-02-14,North Macedonia,180,13,97052,2989
2021-02-15,North Macedonia,49,9,97101,2998
2021-02-16,North Macedonia,355,5,97456,3003
2021-02-17,North Macedonia,347,7,97803,3010
2021-02-18,North Macedonia,371,8,98174,3018
2021-02-19,North Macedonia,410,19,98584,3037
2021-02-20,North Macedonia,447,10,99031,3047
2021-02-21,North Macedonia,254,16,99285,3063
2021-02-22,North Macedonia,123,13,99408,3076
2021-02-23,North Macedonia,509,9,99917,3085
2021-02-24,North Macedonia,715,13,100632,3098
2021-02-25,North Macedonia,582,13,101214,3111
2021-02-26,North Macedonia,548,8,101762,3119
2021-02-27,North Macedonia,720,7,102482,3126
2021-02-28,North Macedonia,305,11,102787,3137
2021-03-01,North Macedonia,233,7,103020,3144
2021-03-02,North Macedonia,726,7,103746,3151
2021-03-03,North Macedonia,802,5,104548,3156
2021-03-04,North Macedonia,721,9,105269,3165
2021-03-05,North Macedonia,841,11,106110,3176
2021-03-06,North Macedonia,722,9,106832,3185
2021-03-07,North Macedonia,331,10,107163,3195
2021-03-08,North Macedonia,316,11,107479,3206
2021-03-09,North Macedonia,871,22,108350,3228
2021-03-10,North Macedonia,912,16,109262,3244
2021-03-11,North Macedonia,947,21,110209,3265
2021-03-12,North Macedonia,868,15,111077,3280
2021-03-13,North Macedonia,1030,20,112107,3300
2021-03-14,North Macedonia,539,19,112646,3319
2021-03-15,North Macedonia,284,21,112930,3340
2021-03-16,North Macedonia,999,24,113929,3364
2021-03-17,North Macedonia,1293,24,115222,3388
2021-03-18,North Macedonia,1216,15,116438,3403
2021-03-19,North Macedonia,999,21,117437,3424
2021-03-20,North Macedonia,1299,24,118736,3448
2021-03-21,North Macedonia,642,25,119378,3473
2021-03-22,North Macedonia,450,30,119828,3503
2021-03-23,North Macedonia,1054,25,120882,3528
2021-03-24,North Macedonia,1345,17,122227,3545
2021-03-25,North Macedonia,1264,29,123491,3574
2021-03-26,North Macedonia,1419,33,124910,3607
2021-03-27,North Macedonia,1320,35,126230,3642
2021-03-28,North Macedonia,708,33,126938,3675
2021-03-29,North Macedonia,302,41,127240,3716
2021-03-30,North Macedonia,1271,33,128511,3749
2021-03-31,North Macedonia,1511,32,130022,3781
2021-04-01,North Macedonia,1402,29,131424,3810
2021-04-02,North Macedonia,1316,50,132740,3860
2021-04-03,North Macedonia,1394,45,134134,3905
2021-04-04,North Macedonia,733,35,134867,3940
2021-04-05,North Macedonia,300,37,135167,3977
2021-04-06,North Macedonia,1259,45,136426,4022
2021-04-07,North Macedonia,1302,51,137728,4073
2021-04-08,North Macedonia,1163,35,138891,4108
2020-02-26,Norway,1,0,1,0
2020-02-27,Norway,0,0,1,0
2020-02-28,Norway,5,0,6,0
2020-02-29,Norway,9,0,15,0
2020-03-01,Norway,4,0,19,0
2020-03-02,Norway,6,0,25,0
2020-03-03,Norway,7,0,32,0
2020-03-04,Norway,24,0,56,0
2020-03-05,Norway,31,0,87,0
2020-03-06,Norway,21,0,108,0
2020-03-07,Norway,39,0,147,0
2020-03-08,Norway,29,0,176,0
2020-03-09,Norway,29,0,205,0
2020-03-10,Norway,195,0,400,0
2020-03-11,Norway,198,0,598,0
2020-03-12,Norway,104,0,702,0
2020-03-13,Norway,294,0,996,0
2020-03-14,Norway,94,3,1090,3
2020-03-15,Norway,131,0,1221,3
2020-03-16,Norway,112,0,1333,3
2020-03-17,Norway,130,0,1463,3
2020-03-18,Norway,87,3,1550,6
2020-03-19,Norway,196,1,1746,7
2020-03-20,Norway,168,0,1914,7
2020-03-21,Norway,204,0,2118,7
2020-03-22,Norway,267,0,2385,7
2020-03-23,Norway,236,3,2621,10
2020-03-24,Norway,242,2,2863,12
2020-03-25,Norway,221,2,3084,14
2020-03-26,Norway,285,0,3369,14
2020-03-27,Norway,386,5,3755,19
2020-03-28,Norway,260,4,4015,23
2020-03-29,Norway,269,2,4284,25
2020-03-30,Norway,161,7,4445,32
2020-03-31,Norway,196,7,4641,39
2020-04-01,Norway,222,5,4863,44
2020-04-02,Norway,284,6,5147,50
2020-04-03,Norway,223,9,5370,59
2020-04-04,Norway,180,3,5550,62
2020-04-05,Norway,137,9,5687,71
2020-04-06,Norway,178,5,5865,76
2020-04-07,Norway,221,13,6086,89
2020-04-08,Norway,0,12,6086,101
2020-04-09,Norway,125,7,6211,108
2020-04-10,Norway,103,5,6314,113
2020-04-11,Norway,95,6,6409,119
2020-04-12,Norway,116,9,6525,128
2020-04-13,Norway,78,6,6603,134
2020-04-14,Norway,20,5,6623,139
2020-04-15,Norway,117,11,6740,150
2020-04-16,Norway,156,2,6896,152
2020-04-17,Norway,41,9,6937,161
2020-04-18,Norway,99,3,7036,164
2020-04-19,Norway,42,1,7078,165
2020-04-20,Norway,78,16,7156,181
2020-04-21,Norway,35,1,7191,182
2020-04-22,Norway,147,5,7338,187
2020-04-23,Norway,63,7,7401,194
2020-04-24,Norway,62,5,7463,199
2020-04-25,Norway,36,2,7499,201
2020-04-26,Norway,28,0,7527,201
2020-04-27,Norway,72,4,7599,205
2020-04-28,Norway,61,1,7660,206
2020-04-29,Norway,50,1,7710,207
2020-04-30,Norway,28,3,7738,210
2020-05-01,Norway,45,0,7783,210
2020-05-02,Norway,26,1,7809,211
2020-05-03,Norway,38,0,7847,211
2020-05-04,Norway,57,3,7904,214
2020-05-05,Norway,51,1,7955,215
2020-05-06,Norway,41,1,7996,216
2020-05-07,Norway,38,1,8034,217
2020-05-08,Norway,36,1,8070,218
2020-05-09,Norway,29,1,8099,219
2020-05-10,Norway,6,0,8105,219
2020-05-11,Norway,27,5,8132,224
2020-05-12,Norway,25,4,8157,228
2020-05-13,Norway,18,1,8175,229
2020-05-14,Norway,21,3,8196,232
2020-05-15,Norway,23,0,8219,232
2020-05-16,Norway,18,0,8237,232
2020-05-17,Norway,12,0,8249,232
2020-05-18,Norway,8,1,8257,233
2020-05-19,Norway,10,0,8267,233
2020-05-20,Norway,14,1,8281,234
2020-05-21,Norway,28,1,8309,235
2020-05-22,Norway,23,0,8332,235
2020-05-23,Norway,14,0,8346,235
2020-05-24,Norway,6,0,8352,235
2020-05-25,Norway,12,0,8364,235
2020-05-26,Norway,19,0,8383,235
2020-05-27,Norway,18,0,8401,235
2020-05-28,Norway,10,1,8411,236
2020-05-29,Norway,11,0,8422,236
2020-05-30,Norway,15,0,8437,236
2020-05-31,Norway,3,0,8440,236
2020-06-01,Norway,6,0,8446,236
2020-06-02,Norway,9,1,8455,237
2020-06-03,Norway,22,0,8477,237
2020-06-04,Norway,27,1,8504,238
2020-06-05,Norway,18,0,8522,238
2020-06-06,Norway,9,0,8531,238
2020-06-07,Norway,16,0,8547,238
2020-06-08,Norway,14,1,8561,239
2020-06-09,Norway,15,0,8576,239
2020-06-10,Norway,18,0,8594,239
2020-06-11,Norway,14,3,8608,242
2020-06-12,Norway,12,0,8620,242
2020-06-13,Norway,8,0,8628,242
2020-06-14,Norway,3,0,8631,242
2020-06-15,Norway,16,0,8647,242
2020-06-16,Norway,13,0,8660,242
2020-06-17,Norway,32,1,8692,243
2020-06-18,Norway,16,1,8708,244
2020-06-19,Norway,18,0,8726,244
2020-06-20,Norway,16,0,8742,244
2020-06-21,Norway,3,0,8745,244
2020-06-22,Norway,6,4,8751,248
2020-06-23,Norway,21,0,8772,248
2020-06-24,Norway,16,1,8788,249
2020-06-25,Norway,0,0,8788,249
2020-06-26,Norway,44,0,8832,249
2020-06-27,Norway,14,0,8846,249
2020-06-28,Norway,9,0,8855,249
2020-06-29,Norway,7,0,8862,249
2020-06-30,Norway,17,1,8879,250
2020-07-01,Norway,17,1,8896,251
2020-07-02,Norway,6,0,8902,251
2020-07-03,Norway,19,0,8921,251
2020-07-04,Norway,5,0,8926,251
2020-07-05,Norway,4,0,8930,251
2020-07-06,Norway,6,0,8936,251
2020-07-07,Norway,11,0,8947,251
2020-07-08,Norway,3,0,8950,251
2020-07-09,Norway,15,1,8965,252
2020-07-10,Norway,9,0,8974,252
2020-07-11,Norway,3,0,8977,252
2020-07-12,Norway,4,0,8981,252
2020-07-13,Norway,3,1,8984,253
2020-07-14,Norway,17,0,9001,253
2020-07-15,Norway,10,0,9011,253
2020-07-16,Norway,4,1,9015,254
2020-07-17,Norway,10,1,9025,255
2020-07-18,Norway,3,0,9028,255
2020-07-19,Norway,0,0,9028,255
2020-07-20,Norway,6,0,9034,255
2020-07-21,Norway,19,0,9053,255
2020-07-22,Norway,6,0,9059,255
2020-07-23,Norway,26,0,9085,255
2020-07-24,Norway,7,0,9092,255
2020-07-25,Norway,19,0,9111,255
2020-07-26,Norway,6,0,9117,255
2020-07-27,Norway,15,0,9132,255
2020-07-28,Norway,18,0,9150,255
2020-07-29,Norway,22,0,9172,255
2020-07-30,Norway,36,0,9208,255
2020-07-31,Norway,32,0,9240,255
2020-08-01,Norway,13,0,9253,255
2020-08-02,Norway,15,0,9268,255
2020-08-03,Norway,66,1,9334,256
2020-08-04,Norway,28,0,9362,256
2020-08-05,Norway,47,0,9409,256
2020-08-06,Norway,59,0,9468,256
2020-08-07,Norway,83,0,9551,256
2020-08-08,Norway,48,0,9599,256
2020-08-09,Norway,39,0,9638,256
2020-08-10,Norway,46,0,9684,256
2020-08-11,Norway,67,0,9751,256
2020-08-12,Norway,32,0,9783,256
2020-08-13,Norway,68,1,9851,257
2020-08-14,Norway,57,4,9908,261
2020-08-15,Norway,57,0,9965,261
2020-08-16,Norway,40,0,10005,261
2020-08-17,Norway,55,0,10060,261
2020-08-18,Norway,51,1,10111,262
2020-08-19,Norway,51,0,10162,262
2020-08-20,Norway,35,2,10197,264
2020-08-21,Norway,78,0,10275,264
2020-08-22,Norway,24,0,10299,264
2020-08-23,Norway,24,0,10323,264
2020-08-24,Norway,72,0,10395,264
2020-08-25,Norway,59,0,10454,264
2020-08-26,Norway,50,0,10504,264
2020-08-27,Norway,38,0,10542,264
2020-08-28,Norway,40,0,10582,264
2020-08-29,Norway,29,0,10611,264
2020-08-30,Norway,32,0,10643,264
2020-08-31,Norway,139,0,10782,264
2020-09-01,Norway,89,0,10871,264
2020-09-02,Norway,163,0,11034,264
2020-09-03,Norway,86,0,11120,264
2020-09-04,Norway,111,0,11231,264
2020-09-05,Norway,65,0,11296,264
2020-09-06,Norway,92,0,11388,264
2020-09-07,Norway,133,0,11521,264
2020-09-08,Norway,102,0,11623,264
2020-09-09,Norway,123,0,11746,264
2020-09-10,Norway,121,1,11867,265
2020-09-11,Norway,136,0,12003,265
2020-09-12,Norway,76,0,12079,265
2020-09-13,Norway,75,0,12154,265
2020-09-14,Norway,122,0,12276,265
2020-09-15,Norway,117,0,12393,265
2020-09-16,Norway,105,0,12498,265
2020-09-17,Norway,146,1,12644,266
2020-09-18,Norway,125,1,12769,267
2020-09-19,Norway,89,0,12858,267
2020-09-20,Norway,39,0,12897,267
2020-09-21,Norway,108,0,13005,267
2020-09-22,Norway,148,0,13153,267
2020-09-23,Norway,124,0,13277,267
2020-09-24,Norway,129,3,13406,270
2020-09-25,Norway,139,0,13545,270
2020-09-26,Norway,82,0,13627,270
2020-09-27,Norway,71,0,13698,270
2020-09-28,Norway,90,4,13788,274
2020-09-29,Norway,127,0,13915,274
2020-09-30,Norway,112,0,14027,274
2020-10-01,Norway,122,0,14149,274
2020-10-02,Norway,135,1,14284,275
2020-10-03,Norway,78,0,14362,275
2020-10-04,Norway,95,0,14457,275
2020-10-05,Norway,148,0,14605,275
2020-10-06,Norway,179,0,14784,275
2020-10-07,Norway,229,0,15013,275
2020-10-08,Norway,208,0,15221,275
2020-10-09,Norway,167,0,15388,275
2020-10-10,Norway,78,0,15466,275
2020-10-11,Norway,58,0,15524,275
2020-10-12,Norway,115,1,15639,276
2020-10-13,Norway,154,1,15793,277
2020-10-14,Norway,160,0,15953,277
2020-10-15,Norway,184,1,16137,278
2020-10-16,Norway,135,0,16272,278
2020-10-17,Norway,97,0,16369,278
2020-10-18,Norway,88,0,16457,278
2020-10-19,Norway,146,0,16603,278
2020-10-20,Norway,169,0,16772,278
2020-10-21,Norway,192,1,16964,279
2020-10-22,Norway,270,0,17234,279
2020-10-23,Norway,298,0,17532,279
2020-10-24,Norway,217,0,17749,279
2020-10-25,Norway,160,0,17909,279
2020-10-26,Norway,433,0,18342,279
2020-10-27,Norway,324,1,18666,280
2020-10-28,Norway,403,0,19069,280
2020-10-29,Norway,495,1,19564,281
2020-10-30,Norway,498,1,20062,282
2020-10-31,Norway,269,0,20331,282
2020-11-01,Norway,304,0,20635,282
2020-11-02,Norway,704,0,21339,282
2020-11-03,Norway,617,0,21956,282
2020-11-04,Norway,622,0,22578,282
2020-11-05,Norway,651,2,23229,284
2020-11-06,Norway,606,1,23835,285
2020-11-07,Norway,408,0,24243,285
2020-11-08,Norway,489,0,24732,285
2020-11-09,Norway,593,0,25325,285
2020-11-10,Norway,562,0,25887,285
2020-11-11,Norway,624,0,26511,285
2020-11-12,Norway,717,6,27228,291
2020-11-13,Norway,688,3,27916,294
2020-11-14,Norway,518,0,28434,294
2020-11-15,Norway,0,0,28434,294
2020-11-16,Norway,0,0,28434,294
2020-11-17,Norway,1680,4,30114,298
2020-11-18,Norway,656,2,30770,300
2020-11-19,Norway,671,5,31441,305
2020-11-20,Norway,573,1,32014,306
2020-11-21,Norway,338,0,32352,306
2020-11-22,Norway,413,0,32765,306
2020-11-23,Norway,418,5,33183,311
2020-11-24,Norway,534,3,33717,314
2020-11-25,Norway,551,2,34268,316
2020-11-26,Norway,480,0,34748,316
2020-11-27,Norway,445,12,35193,328
2020-11-28,Norway,353,0,35546,328
2020-11-29,Norway,282,0,35828,328
2020-11-30,Norway,322,4,36150,332
2020-12-01,Norway,441,2,36591,334
2020-12-02,Norway,378,17,36969,351
2020-12-03,Norway,402,2,37371,353
2020-12-04,Norway,430,1,37801,354
2020-12-05,Norway,272,0,38073,354
2020-12-06,Norway,250,0,38323,354
2020-12-07,Norway,380,5,38703,359
2020-12-08,Norway,460,2,39163,361
2020-12-09,Norway,362,0,39525,361
2020-12-10,Norway,498,21,40023,382
2020-12-11,Norway,416,5,40439,387
2020-12-12,Norway,364,0,40803,387
2020-12-13,Norway,200,0,41003,387
2020-12-14,Norway,331,6,41334,393
2020-12-15,Norway,518,2,41852,395
2020-12-16,Norway,460,7,42312,402
2020-12-17,Norway,464,2,42776,404
2020-12-18,Norway,431,0,43207,404
2020-12-19,Norway,375,0,43582,404
2020-12-20,Norway,323,0,43905,404
2020-12-21,Norway,431,1,44336,405
2020-12-22,Norway,596,0,44932,405
2020-12-23,Norway,523,16,45455,421
2020-12-24,Norway,476,0,45931,421
2020-12-25,Norway,317,0,46248,421
2020-12-26,Norway,430,0,46678,421
2020-12-27,Norway,381,0,47059,421
2020-12-28,Norway,526,8,47585,429
2020-12-29,Norway,693,4,48278,433
2020-12-30,Norway,732,3,49010,436
2020-12-31,Norway,557,0,49567,436
2021-01-01,Norway,236,0,49803,436
2021-01-02,Norway,463,0,50266,436
2021-01-03,Norway,450,0,50716,436
2021-01-04,Norway,529,13,51245,449
2021-01-05,Norway,935,3,52180,452
2021-01-06,Norway,787,13,52967,465
2021-01-07,Norway,825,2,53792,467
2021-01-08,Norway,684,5,54476,472
2021-01-09,Norway,443,0,54919,472
2021-01-10,Norway,555,0,55474,472
2021-01-11,Norway,429,6,55903,478
2021-01-12,Norway,712,4,56615,482
2021-01-13,Norway,667,27,57282,509
2021-01-14,Norway,454,2,57736,511
2021-01-15,Norway,466,6,58202,517
2021-01-16,Norway,243,0,58445,517
2021-01-17,Norway,206,0,58651,517
2021-01-18,Norway,383,4,59034,521
2021-01-19,Norway,422,4,59456,525
2021-01-20,Norway,431,18,59887,543
2021-01-21,Norway,372,1,60259,544
2021-01-22,Norway,306,0,60565,544
2021-01-23,Norway,238,0,60803,544
2021-01-24,Norway,279,0,61082,544
2021-01-25,Norway,233,4,61315,548
2021-01-26,Norway,279,2,61594,550
2021-01-27,Norway,367,6,61961,556
2021-01-28,Norway,315,1,62276,557
2021-01-29,Norway,299,7,62575,564
2021-01-30,Norway,218,0,62793,564
2021-01-31,Norway,173,0,62966,564
2021-02-01,Norway,296,3,63262,567
2021-02-02,Norway,291,1,63553,568
2021-02-03,Norway,286,6,63839,574
2021-02-04,Norway,373,8,64212,582
2021-02-05,Norway,271,0,64483,582
2021-02-06,Norway,170,0,64653,582
2021-02-07,Norway,119,0,64772,582
2021-02-08,Norway,346,0,65118,582
2021-02-09,Norway,220,1,65338,583
2021-02-10,Norway,209,9,65547,592
2021-02-11,Norway,264,0,65811,592
2021-02-12,Norway,425,0,66236,592
2021-02-13,Norway,156,0,66392,592
2021-02-14,Norway,109,0,66501,592
2021-02-15,Norway,353,1,66854,593
2021-02-16,Norway,286,0,67140,593
2021-02-17,Norway,358,14,67498,607
2021-02-18,Norway,326,0,67824,607
2021-02-19,Norway,283,0,68107,607
2021-02-20,Norway,208,0,68315,607
2021-02-21,Norway,217,0,68532,607
2021-02-22,Norway,226,1,68758,608
2021-02-23,Norway,390,0,69148,608
2021-02-24,Norway,341,12,69489,620
2021-02-25,Norway,551,0,70040,620
2021-02-26,Norway,524,2,70564,622
2021-02-27,Norway,262,0,70826,622
2021-02-28,Norway,180,0,71006,622
2021-03-01,Norway,729,1,71735,623
2021-03-02,Norway,499,0,72234,623
2021-03-03,Norway,689,9,72923,632
2021-03-04,Norway,570,0,73493,632
2021-03-05,Norway,690,0,74183,632
2021-03-06,Norway,363,0,74546,632
2021-03-07,Norway,396,0,74942,632
2021-03-08,Norway,828,0,75770,632
2021-03-09,Norway,714,0,76484,632
2021-03-10,Norway,685,0,77169,632
2021-03-11,Norway,872,7,78041,639
2021-03-12,Norway,905,0,78946,639
2021-03-13,Norway,854,0,79800,639
2021-03-14,Norway,640,0,80440,639
2021-03-15,Norway,865,1,81305,640
2021-03-16,Norway,1150,1,82455,641
2021-03-17,Norway,1064,7,83519,648
2021-03-18,Norway,1034,0,84553,648
2021-03-19,Norway,989,0,85542,648
2021-03-20,Norway,820,0,86362,648
2021-03-21,Norway,577,0,86939,648
2021-03-22,Norway,1096,1,88035,649
2021-03-23,Norway,1085,0,89120,649
2021-03-24,Norway,984,7,90104,656
2021-03-25,Norway,831,0,90935,656
2021-03-26,Norway,1072,0,92007,656
2021-03-27,Norway,462,0,92469,656
2021-03-28,Norway,681,0,93150,656
2021-03-29,Norway,989,4,94139,660
2021-03-30,Norway,1069,1,95208,661
2021-03-31,Norway,871,12,96079,673
2021-04-01,Norway,691,0,96770,673
2021-04-02,Norway,640,0,97410,673
2021-04-03,Norway,692,0,98102,673
2021-04-04,Norway,574,0,98676,673
2021-04-05,Norway,573,3,99249,676
2021-04-06,Norway,900,1,100149,677
2021-04-07,Norway,933,6,101082,683
2021-04-08,Norway,878,1,101960,684
2020-01-25,Oceania,0,0,0,0
2020-01-26,Oceania,4,0,4,0
2020-01-27,Oceania,1,0,5,0
2020-01-28,Oceania,0,0,5,0
2020-01-29,Oceania,1,0,6,0
2020-01-30,Oceania,3,0,9,0
2020-01-31,Oceania,0,0,9,0
2020-02-01,Oceania,3,0,12,0
2020-02-02,Oceania,0,0,12,0
2020-02-03,Oceania,0,0,12,0
2020-02-04,Oceania,1,0,13,0
2020-02-05,Oceania,0,0,13,0
2020-02-06,Oceania,1,0,14,0
2020-02-07,Oceania,1,0,15,0
2020-02-08,Oceania,0,0,15,0
2020-02-09,Oceania,0,0,15,0
2020-02-10,Oceania,0,0,15,0
2020-02-11,Oceania,0,0,15,0
2020-02-12,Oceania,0,0,15,0
2020-02-13,Oceania,0,0,15,0
2020-02-14,Oceania,0,0,15,0
2020-02-15,Oceania,0,0,15,0
2020-02-16,Oceania,0,0,15,0
2020-02-17,Oceania,0,0,15,0
2020-02-18,Oceania,0,0,15,0
2020-02-19,Oceania,0,0,15,0
2020-02-20,Oceania,0,0,15,0
2020-02-21,Oceania,0,0,15,0
2020-02-22,Oceania,0,0,15,0
2020-02-23,Oceania,0,0,15,0
2020-02-24,Oceania,0,0,15,0
2020-02-25,Oceania,0,0,15,0
2020-02-26,Oceania,0,0,15,0
2020-02-27,Oceania,0,0,15,0
2020-02-28,Oceania,1,0,16,0
2020-02-29,Oceania,10,0,26,0
2020-03-01,Oceania,2,1,28,1
2020-03-02,Oceania,3,0,31,1
2020-03-03,Oceania,9,0,40,1
2020-03-04,Oceania,15,1,55,2
2020-03-05,Oceania,3,0,58,2
2020-03-06,Oceania,6,0,64,2
2020-03-07,Oceania,4,0,68,2
2020-03-08,Oceania,13,1,81,3
2020-03-09,Oceania,15,0,96,3
2020-03-10,Oceania,16,0,112,3
2020-03-11,Oceania,21,0,133,3
2020-03-12,Oceania,0,0,133,3
2020-03-13,Oceania,72,0,205,3
2020-03-14,Oceania,51,0,256,3
2020-03-15,Oceania,49,0,305,3
2020-03-16,Oceania,80,0,385,3
2020-03-17,Oceania,79,2,464,5
2020-03-18,Oceania,124,1,588,6
2020-03-19,Oceania,122,0,710,6
2020-03-20,Oceania,122,1,832,7
2020-03-21,Oceania,293,0,1125,7
2020-03-22,Oceania,529,0,1654,7
2020-03-23,Oceania,134,0,1788,7
2020-03-24,Oceania,416,1,2204,8
2020-03-25,Oceania,371,0,2575,8
2020-03-26,Oceania,524,5,3099,13
2020-03-27,Oceania,418,0,3517,13
2020-03-28,Oceania,580,1,4097,14
2020-03-29,Oceania,407,3,4504,17
2020-03-30,Oceania,452,1,4956,18
2020-03-31,Oceania,256,1,5212,19
2020-04-01,Oceania,364,2,5576,21
2020-04-02,Oceania,345,4,5921,25
2020-04-03,Oceania,285,4,6206,29
2020-04-04,Oceania,307,2,6513,31
2020-04-05,Oceania,226,5,6739,36
2020-04-06,Oceania,180,5,6919,41
2020-04-07,Oceania,153,5,7072,46
2020-04-08,Oceania,165,5,7237,51
2020-04-09,Oceania,127,1,7364,52
2020-04-10,Oceania,152,4,7516,56
2020-04-11,Oceania,117,5,7633,61
2020-04-12,Oceania,30,3,7663,64
2020-04-13,Oceania,55,2,7718,66
2020-04-14,Oceania,81,5,7799,71
2020-04-15,Oceania,45,1,7844,72
2020-04-16,Oceania,43,0,7887,72
2020-04-17,Oceania,68,5,7955,77
2020-04-18,Oceania,59,1,8014,78
2020-04-19,Oceania,51,1,8065,79
2020-04-20,Oceania,23,0,8088,79
2020-04-21,Oceania,27,1,8115,80
2020-04-22,Oceania,14,1,8129,81
2020-04-23,Oceania,15,11,8144,92
2020-04-24,Oceania,20,5,8164,97
2020-04-25,Oceania,26,1,8190,98
2020-04-26,Oceania,19,4,8209,102
2020-04-27,Oceania,10,0,8219,102
2020-04-28,Oceania,25,6,8244,108
2020-04-29,Oceania,10,2,8254,110
2020-04-30,Oceania,17,2,8271,112
2020-05-01,Oceania,18,1,8289,113
2020-05-02,Oceania,23,1,8312,114
2020-05-03,Oceania,23,1,8335,115
2020-05-04,Oceania,24,1,8359,116
2020-05-05,Oceania,30,2,8389,118
2020-05-06,Oceania,20,0,8409,118
2020-05-07,Oceania,20,0,8429,118
2020-05-08,Oceania,7,0,8436,118
2020-05-09,Oceania,23,0,8459,118
2020-05-10,Oceania,12,0,8471,118
2020-05-11,Oceania,22,0,8493,118
2020-05-12,Oceania,10,1,8503,119
2020-05-13,Oceania,9,0,8512,119
2020-05-14,Oceania,31,0,8543,119
2020-05-15,Oceania,16,0,8559,119
2020-05-16,Oceania,10,0,8569,119
2020-05-17,Oceania,10,1,8579,120
2020-05-18,Oceania,14,0,8593,120
2020-05-19,Oceania,8,1,8601,121
2020-05-20,Oceania,9,0,8610,121
2020-05-21,Oceania,15,1,8625,122
2020-05-22,Oceania,4,0,8629,122
2020-05-23,Oceania,15,1,8644,123
2020-05-24,Oceania,0,0,8644,123
2020-05-25,Oceania,12,0,8656,123
2020-05-26,Oceania,13,1,8669,124
2020-05-27,Oceania,11,1,8680,125
2020-05-28,Oceania,15,0,8695,125
2020-05-29,Oceania,19,0,8714,125
2020-05-30,Oceania,8,0,8722,125
2020-05-31,Oceania,10,0,8732,125
2020-06-01,Oceania,19,-1,8751,124
2020-06-02,Oceania,8,0,8759,124
2020-06-03,Oceania,11,0,8770,124
2020-06-04,Oceania,7,0,8777,124
2020-06-05,Oceania,5,0,8782,124
2020-06-06,Oceania,7,0,8789,124
2020-06-07,Oceania,6,0,8795,124
2020-06-08,Oceania,2,0,8797,124
2020-06-09,Oceania,7,0,8804,124
2020-06-10,Oceania,11,0,8815,124
2020-06-11,Oceania,4,0,8819,124
2020-06-12,Oceania,5,0,8824,124
2020-06-13,Oceania,26,0,8850,124
2020-06-14,Oceania,15,0,8865,124
2020-06-15,Oceania,14,0,8879,124
2020-06-16,Oceania,23,0,8902,124
2020-06-17,Oceania,22,0,8924,124
2020-06-18,Oceania,18,0,8942,124
2020-06-19,Oceania,4,0,8946,124
2020-06-20,Oceania,52,0,8998,124
2020-06-21,Oceania,15,0,9013,124
2020-06-22,Oceania,21,0,9034,124
2020-06-23,Oceania,30,1,9064,125
2020-06-24,Oceania,41,1,9105,126
2020-06-25,Oceania,38,0,9143,126
2020-06-26,Oceania,9,0,9152,126
2020-06-27,Oceania,89,0,9241,126
2020-06-28,Oceania,80,0,9321,126
2020-06-29,Oceania,70,0,9391,126
2020-06-30,Oceania,86,0,9477,126
2020-07-01,Oceania,83,0,9560,126
2020-07-02,Oceania,65,0,9625,126
2020-07-03,Oceania,194,0,9819,126
2020-07-04,Oceania,186,0,10005,126
2020-07-05,Oceania,142,2,10147,128
2020-07-06,Oceania,176,0,10323,128
2020-07-07,Oceania,132,0,10455,128
2020-07-08,Oceania,173,0,10628,128
2020-07-09,Oceania,325,0,10953,128
2020-07-10,Oceania,180,1,11133,129
2020-07-11,Oceania,245,1,11378,130
2020-07-12,Oceania,183,0,11561,130
2020-07-13,Oceania,272,0,11833,130
2020-07-14,Oceania,238,3,12071,133
2020-07-15,Oceania,324,2,12395,135
2020-07-16,Oceania,424,3,12819,138
2020-07-17,Oceania,213,2,13032,140
2020-07-18,Oceania,365,4,13397,144
2020-07-19,Oceania,269,1,13666,145
2020-07-20,Oceania,363,3,14029,148
2020-07-21,Oceania,474,2,14503,150
2020-07-22,Oceania,411,5,14914,155
2020-07-23,Oceania,295,6,15209,161
2020-07-24,Oceania,356,6,15565,167
2020-07-25,Oceania,460,10,16025,177
2020-07-26,Oceania,555,6,16580,183
2020-07-27,Oceania,369,6,16949,189
2020-07-28,Oceania,282,9,17231,198
2020-07-29,Oceania,717,14,17948,212
2020-07-30,Oceania,605,8,18553,220
2020-07-31,Oceania,388,6,18941,226
2020-08-01,Oceania,637,7,19578,233
2020-08-02,Oceania,444,13,20022,246
2020-08-03,Oceania,413,11,20435,257
2020-08-04,Oceania,720,15,21155,272
2020-08-05,Oceania,484,8,21639,280
2020-08-06,Oceania,392,12,22031,292
2020-08-07,Oceania,451,12,22482,304
2020-08-08,Oceania,386,17,22868,321
2020-08-09,Oceania,339,18,23207,339
2020-08-10,Oceania,317,18,23524,357
2020-08-11,Oceania,414,21,23938,378
2020-08-12,Oceania,323,9,24261,387
2020-08-13,Oceania,382,14,24643,401
2020-08-14,Oceania,300,4,24943,405
2020-08-15,Oceania,265,17,25208,422
2020-08-16,Oceania,332,25,25540,447
2020-08-17,Oceania,237,17,25777,464
2020-08-18,Oceania,236,12,26013,476
2020-08-19,Oceania,252,13,26265,489
2020-08-20,Oceania,196,10,26461,499
2020-08-21,Oceania,201,13,26662,512
2020-08-22,Oceania,212,17,26874,529
2020-08-23,Oceania,153,15,27027,544
2020-08-24,Oceania,145,8,27172,552
2020-08-25,Oceania,174,24,27346,576
2020-08-26,Oceania,125,23,27471,599
2020-08-27,Oceania,143,12,27614,611
2020-08-28,Oceania,141,18,27755,629
2020-08-29,Oceania,125,11,27880,640
2020-08-30,Oceania,91,41,27971,681
2020-08-31,Oceania,87,5,28058,686
2020-09-01,Oceania,111,6,28169,692
2020-09-02,Oceania,139,15,28308,707
2020-09-03,Oceania,92,59,28400,766
2020-09-04,Oceania,82,13,28482,779
2020-09-05,Oceania,87,5,28569,784
2020-09-06,Oceania,56,9,28625,793
2020-09-07,Oceania,58,8,28683,801
2020-09-08,Oceania,104,11,28787,812
2020-09-09,Oceania,65,7,28852,819
2020-09-10,Oceania,44,9,28896,828
2020-09-11,Oceania,46,6,28942,834
2020-09-12,Oceania,46,7,28988,841
2020-09-13,Oceania,44,7,29032,848
2020-09-14,Oceania,51,0,29083,848
2020-09-15,Oceania,40,9,29123,857
2020-09-16,Oceania,47,8,29170,865
2020-09-17,Oceania,48,5,29218,870
2020-09-18,Oceania,26,7,29244,877
2020-09-19,Oceania,17,5,29261,882
2020-09-20,Oceania,15,3,29276,885
2020-09-21,Oceania,30,3,29306,888
2020-09-22,Oceania,49,5,29355,893
2020-09-23,Oceania,11,2,29366,895
2020-09-24,Oceania,26,8,29392,903
2020-09-25,Oceania,19,1,29411,904
2020-09-26,Oceania,26,2,29437,906
2020-09-27,Oceania,4,3,29441,909
2020-09-28,Oceania,13,7,29454,916
2020-09-29,Oceania,26,4,29480,920
2020-09-30,Oceania,30,2,29510,922
2020-10-01,Oceania,18,2,29528,924
2020-10-02,Oceania,13,3,29541,927
2020-10-03,Oceania,20,1,29561,928
2020-10-04,Oceania,14,0,29575,928
2020-10-05,Oceania,28,1,29603,929
2020-10-06,Oceania,12,2,29615,931
2020-10-07,Oceania,28,0,29643,931
2020-10-08,Oceania,30,0,29673,931
2020-10-09,Oceania,22,0,29695,931
2020-10-10,Oceania,20,1,29715,932
2020-10-11,Oceania,27,0,29742,932
2020-10-12,Oceania,39,1,29781,933
2020-10-13,Oceania,29,5,29810,938
2020-10-14,Oceania,35,0,29845,938
2020-10-15,Oceania,19,0,29864,938
2020-10-16,Oceania,10,0,29874,938
2020-10-17,Oceania,18,0,29892,938
2020-10-18,Oceania,9,1,29901,939
2020-10-19,Oceania,7,0,29908,939
2020-10-20,Oceania,63,0,29971,939
2020-10-21,Oceania,18,0,29989,939
2020-10-22,Oceania,30,0,30019,939
2020-10-23,Oceania,30,0,30049,939
2020-10-24,Oceania,19,0,30068,939
2020-10-25,Oceania,17,0,30085,939
2020-10-26,Oceania,20,0,30105,939
2020-10-27,Oceania,20,2,30125,941
2020-10-28,Oceania,20,0,30145,941
2020-10-29,Oceania,17,0,30162,941
2020-10-30,Oceania,13,0,30175,941
2020-10-31,Oceania,12,0,30187,941
2020-11-01,Oceania,10,0,30197,941
2020-11-02,Oceania,20,0,30217,941
2020-11-03,Oceania,22,0,30239,941
2020-11-04,Oceania,10,0,30249,941
2020-11-05,Oceania,14,0,30263,941
2020-11-06,Oceania,10,0,30273,941
2020-11-07,Oceania,12,0,30285,941
2020-11-08,Oceania,13,0,30298,941
2020-11-09,Oceania,8,0,30306,941
2020-11-10,Oceania,4,0,30310,941
2020-11-11,Oceania,8,0,30318,941
2020-11-12,Oceania,5,0,30323,941
2020-11-13,Oceania,10,0,30333,941
2020-11-14,Oceania,32,0,30365,941
2020-11-15,Oceania,40,0,30405,941
2020-11-16,Oceania,13,0,30418,941
2020-11-17,Oceania,25,0,30443,941
2020-11-18,Oceania,13,0,30456,941
2020-11-19,Oceania,10,0,30466,941
2020-11-20,Oceania,20,0,30486,941
2020-11-21,Oceania,24,0,30510,941
2020-11-22,Oceania,15,0,30525,941
2020-11-23,Oceania,36,0,30561,941
2020-11-24,Oceania,22,0,30583,941
2020-11-25,Oceania,28,0,30611,941
2020-11-26,Oceania,15,0,30626,941
2020-11-27,Oceania,17,0,30643,941
2020-11-28,Oceania,6,0,30649,941
2020-11-29,Oceania,16,1,30665,942
2020-11-30,Oceania,28,0,30693,942
2020-12-01,Oceania,25,0,30718,942
2020-12-02,Oceania,25,0,30743,942
2020-12-03,Oceania,12,0,30755,942
2020-12-04,Oceania,18,0,30773,942
2020-12-05,Oceania,9,0,30782,942
2020-12-06,Oceania,8,0,30790,942
2020-12-07,Oceania,21,0,30811,942
2020-12-08,Oceania,22,0,30833,942
2020-12-09,Oceania,7,0,30840,942
2020-12-10,Oceania,15,0,30855,942
2020-12-11,Oceania,50,1,30905,943
2020-12-12,Oceania,9,0,30914,943
2020-12-13,Oceania,14,0,30928,943
2020-12-14,Oceania,11,0,30939,943
2020-12-15,Oceania,20,0,30959,943
2020-12-16,Oceania,12,0,30971,943
2020-12-17,Oceania,62,0,31033,943
2020-12-18,Oceania,33,0,31066,943
2020-12-19,Oceania,48,0,31114,943
2020-12-20,Oceania,35,0,31149,943
2020-12-21,Oceania,22,1,31171,944
2020-12-22,Oceania,25,0,31196,944
2020-12-23,Oceania,25,0,31221,944
2020-12-24,Oceania,31,0,31252,944
2020-12-25,Oceania,23,0,31275,944
2020-12-26,Oceania,27,0,31302,944
2020-12-27,Oceania,29,1,31331,945
2020-12-28,Oceania,19,0,31350,945
2020-12-29,Oceania,35,0,31385,945
2020-12-30,Oceania,35,0,31420,945
2020-12-31,Oceania,20,0,31440,945
2021-01-01,Oceania,35,0,31475,945
2021-01-02,Oceania,43,0,31518,945
2021-01-03,Oceania,39,0,31557,945
2021-01-04,Oceania,18,0,31575,945
2021-01-05,Oceania,23,0,31598,945
2021-01-06,Oceania,12,0,31610,945
2021-01-07,Oceania,25,0,31635,945
2021-01-08,Oceania,23,0,31658,945
2021-01-09,Oceania,44,0,31702,945
2021-01-10,Oceania,22,0,31724,945
2021-01-11,Oceania,28,0,31752,945
2021-01-12,Oceania,26,0,31778,945
2021-01-13,Oceania,20,0,31798,945
2021-01-14,Oceania,28,0,31826,945
2021-01-15,Oceania,20,0,31846,945
2021-01-16,Oceania,31,0,31877,945
2021-01-17,Oceania,19,0,31896,945
2021-01-18,Oceania,10,0,31906,945
2021-01-19,Oceania,14,0,31920,945
2021-01-20,Oceania,10,0,31930,945
2021-01-21,Oceania,16,0,31946,945
2021-01-22,Oceania,5,0,31951,945
2021-01-23,Oceania,13,0,31964,945
2021-01-24,Oceania,16,0,31980,945
2021-01-25,Oceania,5,0,31985,945
2021-01-26,Oceania,26,0,32011,945
2021-01-27,Oceania,13,0,32024,945
2021-01-28,Oceania,11,0,32035,945
2021-01-29,Oceania,5,0,32040,945
2021-01-30,Oceania,6,0,32046,945
2021-01-31,Oceania,7,0,32053,945
2021-02-01,Oceania,24,0,32077,945
2021-02-02,Oceania,7,0,32084,945
2021-02-03,Oceania,15,0,32099,945
2021-02-04,Oceania,6,0,32105,945
2021-02-05,Oceania,30,0,32135,945
2021-02-06,Oceania,8,0,32143,945
2021-02-07,Oceania,10,0,32153,945
2021-02-08,Oceania,10,0,32163,945
2021-02-09,Oceania,13,0,32176,945
2021-02-10,Oceania,9,0,32185,945
2021-02-11,Oceania,24,0,32209,945
2021-02-12,Oceania,7,0,32216,945
2021-02-13,Oceania,8,0,32224,945
2021-02-14,Oceania,8,0,32232,945
2021-02-15,Oceania,7,1,32239,946
2021-02-16,Oceania,50,1,32289,947
2021-02-17,Oceania,5,0,32294,947
2021-02-18,Oceania,10,0,32304,947
2021-02-19,Oceania,4,0,32308,947
2021-02-20,Oceania,21,0,32329,947
2021-02-21,Oceania,11,0,32340,947
2021-02-22,Oceania,99,0,32439,947
2021-02-23,Oceania,59,0,32498,947
2021-02-24,Oceania,40,1,32538,948
2021-02-25,Oceania,102,1,32640,949
2021-02-26,Oceania,11,0,32651,949
2021-02-27,Oceania,56,0,32707,949
2021-02-28,Oceania,10,0,32717,949
2021-03-01,Oceania,102,2,32819,951
2021-03-02,Oceania,12,0,32831,951
2021-03-03,Oceania,20,0,32851,951
2021-03-04,Oceania,14,0,32865,951
2021-03-05,Oceania,144,2,33009,953
2021-03-06,Oceania,6,0,33015,953
2021-03-07,Oceania,109,0,33124,953
2021-03-08,Oceania,111,0,33235,953
2021-03-09,Oceania,85,0,33320,953
2021-03-10,Oceania,22,0,33342,953
2021-03-11,Oceania,91,5,33433,958
2021-03-12,Oceania,15,0,33448,958
2021-03-13,Oceania,6,0,33454,958
2021-03-14,Oceania,374,0,33828,958
2021-03-15,Oceania,105,5,33933,963
2021-03-16,Oceania,101,0,34034,963
2021-03-17,Oceania,12,0,34046,963
2021-03-18,Oceania,156,5,34202,968
2021-03-19,Oceania,188,5,34390,973
2021-03-20,Oceania,440,0,34830,973
2021-03-21,Oceania,19,0,34849,973
2021-03-22,Oceania,279,0,35128,973
2021-03-23,Oceania,417,1,35545,974
2021-03-24,Oceania,366,2,35911,976
2021-03-25,Oceania,12,0,35923,976
2021-03-26,Oceania,566,0,36489,976
2021-03-27,Oceania,8,0,36497,976
2021-03-28,Oceania,552,6,37049,982
2021-03-29,Oceania,187,4,37236,986
2021-03-30,Oceania,281,7,37517,993
2021-03-31,Oceania,394,4,37911,997
2021-04-01,Oceania,132,0,38043,997
2021-04-02,Oceania,371,0,38414,997
2021-04-03,Oceania,151,0,38565,997
2021-04-04,Oceania,434,1,38999,998
2021-04-05,Oceania,393,6,39392,1004
2021-04-06,Oceania,21,0,39413,1004
2021-04-07,Oceania,258,1,39671,1005
2021-04-08,Oceania,216,0,39887,1005
2020-02-24,Oman,2,0,2,0
2020-02-25,Oman,0,0,2,0
2020-02-26,Oman,2,0,4,0
2020-02-27,Oman,0,0,4,0
2020-02-28,Oman,0,0,4,0
2020-02-29,Oman,2,0,6,0
2020-03-01,Oman,0,0,6,0
2020-03-02,Oman,0,0,6,0
2020-03-03,Oman,6,0,12,0
2020-03-04,Oman,3,0,15,0
2020-03-05,Oman,1,0,16,0
2020-03-06,Oman,0,0,16,0
2020-03-07,Oman,0,0,16,0
2020-03-08,Oman,0,0,16,0
2020-03-09,Oman,0,0,16,0
2020-03-10,Oman,2,0,18,0
2020-03-11,Oman,0,0,18,0
2020-03-12,Oman,0,0,18,0
2020-03-13,Oman,1,0,19,0
2020-03-14,Oman,0,0,19,0
2020-03-15,Oman,3,0,22,0
2020-03-16,Oman,0,0,22,0
2020-03-17,Oman,2,0,24,0
2020-03-18,Oman,15,0,39,0
2020-03-19,Oman,9,0,48,0
2020-03-20,Oman,0,0,48,0
2020-03-21,Oman,4,0,52,0
2020-03-22,Oman,3,0,55,0
2020-03-23,Oman,11,0,66,0
2020-03-24,Oman,18,0,84,0
2020-03-25,Oman,15,0,99,0
2020-03-26,Oman,10,0,109,0
2020-03-27,Oman,22,0,131,0
2020-03-28,Oman,21,0,152,0
2020-03-29,Oman,15,0,167,0
2020-03-30,Oman,12,0,179,0
2020-03-31,Oman,13,1,192,1
2020-04-01,Oman,18,0,210,1
2020-04-02,Oman,21,0,231,1
2020-04-03,Oman,21,0,252,1
2020-04-04,Oman,25,1,277,2
2020-04-05,Oman,21,0,298,2
2020-04-06,Oman,33,0,331,2
2020-04-07,Oman,40,0,371,2
2020-04-08,Oman,48,0,419,2
2020-04-09,Oman,38,1,457,3
2020-04-10,Oman,27,0,484,3
2020-04-11,Oman,62,0,546,3
2020-04-12,Oman,53,1,599,4
2020-04-13,Oman,128,0,727,4
2020-04-14,Oman,86,0,813,4
2020-04-15,Oman,97,0,910,4
2020-04-16,Oman,109,0,1019,4
2020-04-17,Oman,50,2,1069,6
2020-04-18,Oman,111,0,1180,6
2020-04-19,Oman,86,1,1266,7
2020-04-20,Oman,144,0,1410,7
2020-04-21,Oman,98,1,1508,8
2020-04-22,Oman,106,0,1614,8
2020-04-23,Oman,102,1,1716,9
2020-04-24,Oman,74,1,1790,10
2020-04-25,Oman,115,0,1905,10
2020-04-26,Oman,93,0,1998,10
2020-04-27,Oman,51,0,2049,10
2020-04-28,Oman,82,0,2131,10
2020-04-29,Oman,143,0,2274,10
2020-04-30,Oman,74,1,2348,11
2020-05-01,Oman,99,0,2447,11
2020-05-02,Oman,36,1,2483,12
2020-05-03,Oman,85,0,2568,12
2020-05-04,Oman,69,0,2637,12
2020-05-05,Oman,98,1,2735,13
2020-05-06,Oman,168,0,2903,13
2020-05-07,Oman,55,2,2958,15
2020-05-08,Oman,154,1,3112,16
2020-05-09,Oman,112,1,3224,17
2020-05-10,Oman,175,0,3399,17
2020-05-11,Oman,174,0,3573,17
2020-05-12,Oman,148,0,3721,17
2020-05-13,Oman,298,0,4019,17
2020-05-14,Oman,322,1,4341,18
2020-05-15,Oman,284,2,4625,20
2020-05-16,Oman,404,1,5029,21
2020-05-17,Oman,157,1,5186,22
2020-05-18,Oman,193,3,5379,25
2020-05-19,Oman,292,2,5671,27
2020-05-20,Oman,372,3,6043,30
2020-05-21,Oman,327,1,6370,31
2020-05-22,Oman,424,3,6794,34
2020-05-23,Oman,463,2,7257,36
2020-05-24,Oman,513,1,7770,37
2020-05-25,Oman,0,0,7770,37
2020-05-26,Oman,348,0,8118,37
2020-05-27,Oman,255,2,8373,39
2020-05-28,Oman,636,1,9009,40
2020-05-29,Oman,811,0,9820,40
2020-05-30,Oman,603,2,10423,42
2020-05-31,Oman,1014,7,11437,49
2020-06-01,Oman,786,1,12223,50
2020-06-02,Oman,576,9,12799,59
2020-06-03,Oman,738,8,13537,67
2020-06-04,Oman,779,0,14316,67
2020-06-05,Oman,770,5,15086,72
2020-06-06,Oman,930,0,16016,72
2020-06-07,Oman,866,3,16882,75
2020-06-08,Oman,604,6,17486,81
2020-06-09,Oman,712,2,18198,83
2020-06-10,Oman,689,1,18887,84
2020-06-11,Oman,1067,5,19954,89
2020-06-12,Oman,1117,7,21071,96
2020-06-13,Oman,1006,3,22077,99
2020-06-14,Oman,1404,5,23481,104
2020-06-15,Oman,1043,4,24524,108
2020-06-16,Oman,745,6,25269,114
2020-06-17,Oman,810,2,26079,116
2020-06-18,Oman,739,3,26818,119
2020-06-19,Oman,852,6,27670,125
2020-06-20,Oman,896,3,28566,128
2020-06-21,Oman,905,3,29471,131
2020-06-22,Oman,1605,6,31076,137
2020-06-23,Oman,1318,3,32394,140
2020-06-24,Oman,1142,2,33536,142
2020-06-25,Oman,1366,2,34902,144
2020-06-26,Oman,1132,9,36034,153
2020-06-27,Oman,919,6,36953,159
2020-06-28,Oman,1197,4,38150,163
2020-06-29,Oman,910,6,39060,169
2020-06-30,Oman,1010,7,40070,176
2020-07-01,Oman,1124,9,41194,185
2020-07-02,Oman,1361,3,42555,188
2020-07-03,Oman,1374,5,43929,193
2020-07-04,Oman,1177,10,45106,203
2020-07-05,Oman,1072,10,46178,213
2020-07-06,Oman,1557,5,47735,218
2020-07-07,Oman,1262,6,48997,224
2020-07-08,Oman,1210,9,50207,233
2020-07-09,Oman,1518,3,51725,236
2020-07-10,Oman,1889,8,53614,244
2020-07-11,Oman,1083,4,54697,248
2020-07-12,Oman,1318,9,56015,257
2020-07-13,Oman,2164,2,58179,259
2020-07-14,Oman,1389,14,59568,273
2020-07-15,Oman,1679,8,61247,281
2020-07-16,Oman,1327,9,62574,290
2020-07-17,Oman,1619,8,64193,298
2020-07-18,Oman,1311,10,65504,308
2020-07-19,Oman,1157,10,66661,318
2020-07-20,Oman,1739,8,68400,326
2020-07-21,Oman,1487,11,69887,337
2020-07-22,Oman,1660,12,71547,349
2020-07-23,Oman,1099,6,72646,355
2020-07-24,Oman,1145,4,73791,359
2020-07-25,Oman,1067,12,74858,371
2020-07-26,Oman,1147,13,76005,384
2020-07-27,Oman,1053,9,77058,393
2020-07-28,Oman,846,9,77904,402
2020-07-29,Oman,665,10,78569,412
2020-07-30,Oman,590,9,79159,421
2020-07-31,Oman,0,0,79159,421
2020-08-01,Oman,0,0,79159,421
2020-08-02,Oman,0,0,79159,421
2020-08-03,Oman,0,0,79159,421
2020-08-04,Oman,0,0,79159,421
2020-08-05,Oman,1127,67,80286,488
2020-08-06,Oman,427,4,80713,492
2020-08-07,Oman,354,10,81067,502
2020-08-08,Oman,290,7,81357,509
2020-08-09,Oman,223,4,81580,513
2020-08-10,Oman,207,8,81787,521
2020-08-11,Oman,263,12,82050,533
2020-08-12,Oman,249,6,82299,539
2020-08-13,Oman,232,12,82531,551
2020-08-14,Oman,212,6,82743,557
2020-08-15,Oman,181,5,82924,562
2020-08-16,Oman,162,10,83086,572
2020-08-17,Oman,140,16,83226,588
2020-08-18,Oman,192,9,83418,597
2020-08-19,Oman,188,6,83606,603
2020-08-20,Oman,163,6,83769,609
2020-08-21,Oman,0,0,83769,609
2020-08-22,Oman,0,0,83769,609
2020-08-23,Oman,0,0,83769,609
2020-08-24,Oman,740,28,84509,637
2020-08-25,Oman,143,5,84652,642
2020-08-26,Oman,166,4,84818,646
2020-08-27,Oman,187,4,85005,650
2020-08-28,Oman,0,0,85005,650
2020-08-29,Oman,0,0,85005,650
2020-08-30,Oman,539,27,85544,677
2020-08-31,Oman,178,8,85722,685
2020-09-01,Oman,206,4,85928,689
2020-09-02,Oman,0,0,85928,689
2020-09-03,Oman,452,16,86380,705
2020-09-04,Oman,0,0,86380,705
2020-09-05,Oman,0,0,86380,705
2020-09-06,Oman,692,23,87072,728
2020-09-07,Oman,256,6,87328,734
2020-09-08,Oman,262,8,87590,742
2020-09-09,Oman,349,9,87939,751
2020-09-10,Oman,398,11,88337,762
2020-09-11,Oman,0,0,88337,762
2020-09-12,Oman,0,0,88337,762
2020-09-13,Oman,1409,18,89746,780
2020-09-14,Oman,476,10,90222,790
2020-09-15,Oman,438,7,90660,797
2020-09-16,Oman,536,8,91196,805
2020-09-17,Oman,557,13,91753,818
2020-09-18,Oman,0,0,91753,818
2020-09-19,Oman,0,0,91753,818
2020-09-20,Oman,1722,28,93475,846
2020-09-21,Oman,576,7,94051,853
2020-09-22,Oman,660,12,94711,865
2020-09-23,Oman,628,10,95339,875
2020-09-24,Oman,568,10,95907,885
2020-09-25,Oman,0,0,95907,885
2020-09-26,Oman,0,0,95907,885
2020-09-27,Oman,1543,24,97450,909
2020-09-28,Oman,607,15,98057,924
2020-09-29,Oman,528,11,98585,935
2020-09-30,Oman,0,0,98585,935
2020-10-01,Oman,0,0,98585,935
2020-10-02,Oman,0,0,98585,935
2020-10-03,Oman,0,0,98585,935
2020-10-04,Oman,2685,42,101270,977
2020-10-05,Oman,544,8,101814,985
2020-10-06,Oman,834,5,102648,990
2020-10-07,Oman,817,10,103465,1000
2020-10-08,Oman,664,9,104129,1009
2020-10-09,Oman,0,0,104129,1009
2020-10-10,Oman,0,0,104129,1009
2020-10-11,Oman,1761,29,105890,1038
2020-10-12,Oman,685,8,106575,1046
2020-10-13,Oman,638,7,107213,1053
2020-10-14,Oman,563,8,107776,1061
2020-10-15,Oman,520,10,108296,1071
2020-10-16,Oman,0,0,108296,1071
2020-10-17,Oman,0,0,108296,1071
2020-10-18,Oman,1657,30,109953,1101
2020-10-19,Oman,641,13,110594,1114
2020-10-20,Oman,439,8,111033,1122
2020-10-21,Oman,451,15,111484,1137
2020-10-22,Oman,353,10,111837,1147
2020-10-23,Oman,0,0,111837,1147
2020-10-24,Oman,0,0,111837,1147
2020-10-25,Oman,1095,27,112932,1174
2020-10-26,Oman,422,16,113354,1190
2020-10-27,Oman,466,13,113820,1203
2020-10-28,Oman,614,5,114434,1208
2020-10-29,Oman,0,0,114434,1208
2020-10-30,Oman,0,0,114434,1208
2020-10-31,Oman,0,0,114434,1208
2020-11-01,Oman,1300,38,115734,1246
2020-11-02,Oman,418,10,116152,1256
2020-11-03,Oman,376,8,116528,1264
2020-11-04,Oman,319,11,116847,1275
2020-11-05,Oman,320,11,117167,1286
2020-11-06,Oman,0,0,117167,1286
2020-11-07,Oman,0,0,117167,1286
2020-11-08,Oman,973,15,118140,1301
2020-11-09,Oman,363,9,118503,1310
2020-11-10,Oman,381,6,118884,1316
2020-11-11,Oman,302,5,119186,1321
2020-11-12,Oman,256,5,119442,1326
2020-11-13,Oman,0,0,119442,1326
2020-11-14,Oman,0,0,119442,1326
2020-11-15,Oman,947,12,120389,1338
2020-11-16,Oman,329,12,120718,1350
2020-11-17,Oman,0,0,120718,1350
2020-11-18,Oman,411,10,121129,1360
2020-11-19,Oman,231,5,121360,1365
2020-11-20,Oman,0,0,121360,1365
2020-11-21,Oman,0,0,121360,1365
2020-11-22,Oman,721,15,122081,1380
2020-11-23,Oman,275,6,122356,1386
2020-11-24,Oman,223,5,122579,1391
2020-11-25,Oman,0,0,122579,1391
2020-11-26,Oman,0,0,122579,1391
2020-11-27,Oman,0,0,122579,1391
2020-11-28,Oman,0,0,122579,1391
2020-11-29,Oman,905,27,123484,1418
2020-11-30,Oman,215,5,123699,1423
2020-12-01,Oman,209,7,123908,1430
2020-12-02,Oman,237,0,124145,1430
2020-12-03,Oman,184,5,124329,1435
2020-12-04,Oman,0,0,124329,1435
2020-12-05,Oman,0,0,124329,1435
2020-12-06,Oman,557,9,124886,1444
2020-12-07,Oman,229,8,125115,1452
2020-12-08,Oman,210,2,125325,1454
2020-12-09,Oman,165,7,125490,1461
2020-12-10,Oman,179,2,125669,1463
2020-12-11,Oman,0,0,125669,1463
2020-12-12,Oman,0,0,125669,1463
2020-12-13,Oman,571,8,126240,1471
2020-12-14,Oman,264,1,126504,1472
2020-12-15,Oman,215,3,126719,1475
2020-12-16,Oman,116,5,126835,1480
2020-12-17,Oman,184,3,127019,1483
2020-12-18,Oman,0,0,127019,1483
2020-12-19,Oman,0,0,127019,1483
2020-12-20,Oman,648,5,127667,1488
2020-12-21,Oman,264,1,127931,1489
2020-12-22,Oman,212,1,128143,1490
2020-12-23,Oman,93,1,128236,1491
2020-12-24,Oman,54,0,128290,1491
2020-12-25,Oman,0,0,128290,1491
2020-12-26,Oman,0,0,128290,1491
2020-12-27,Oman,182,4,128472,1495
2020-12-28,Oman,91,0,128563,1495
2020-12-29,Oman,70,2,128633,1497
2020-12-30,Oman,86,0,128719,1497
2020-12-31,Oman,148,2,128867,1499
2021-01-01,Oman,0,0,128867,1499
2021-01-02,Oman,0,0,128867,1499
2021-01-03,Oman,537,2,129404,1501
2021-01-04,Oman,180,1,129584,1502
2021-01-05,Oman,190,0,129774,1502
2021-01-06,Oman,114,2,129888,1504
2021-01-07,Oman,182,1,130070,1505
2021-01-08,Oman,0,0,130070,1505
2021-01-09,Oman,0,0,130070,1505
2021-01-10,Oman,538,3,130608,1508
2021-01-11,Oman,172,0,130780,1508
2021-01-12,Oman,164,0,130944,1508
2021-01-13,Oman,142,0,131086,1508
2021-01-14,Oman,178,1,131264,1509
2021-01-15,Oman,0,0,131264,1509
2021-01-16,Oman,0,0,131264,1509
2021-01-17,Oman,526,3,131790,1512
2021-01-18,Oman,221,2,132011,1514
2021-01-19,Oman,135,2,132146,1516
2021-01-20,Oman,171,0,132317,1516
2021-01-21,Oman,169,1,132486,1517
2021-01-22,Oman,0,0,132486,1517
2021-01-23,Oman,0,0,132486,1517
2021-01-24,Oman,558,4,133044,1521
2021-01-25,Oman,209,1,133253,1522
2021-01-26,Oman,154,2,133407,1524
2021-01-27,Oman,167,1,133574,1525
2021-01-28,Oman,154,2,133728,1527
2021-01-29,Oman,0,0,133728,1527
2021-01-30,Oman,0,0,133728,1527
2021-01-31,Oman,598,2,134326,1529
2021-02-01,Oman,198,3,134524,1532
2021-02-02,Oman,161,0,134685,1532
2021-02-03,Oman,171,0,134856,1532
2021-02-04,Oman,185,0,135041,1532
2021-02-05,Oman,0,0,135041,1532
2021-02-06,Oman,0,0,135041,1532
2021-02-07,Oman,633,2,135674,1534
2021-02-08,Oman,316,1,135990,1535
2021-02-09,Oman,197,1,136187,1536
2021-02-10,Oman,190,1,136377,1537
2021-02-11,Oman,245,2,136622,1539
2021-02-12,Oman,0,0,136622,1539
2021-02-13,Oman,0,0,136622,1539
2021-02-14,Oman,684,3,137306,1542
2021-02-15,Oman,286,1,137592,1543
2021-02-16,Oman,337,1,137929,1544
2021-02-17,Oman,277,5,138206,1549
2021-02-18,Oman,288,0,138494,1549
2021-02-19,Oman,0,0,138494,1549
2021-02-20,Oman,0,0,138494,1549
2021-02-21,Oman,868,3,139362,1552
2021-02-22,Oman,330,3,139692,1555
2021-02-23,Oman,297,2,139989,1557
2021-02-24,Oman,311,1,140300,1558
2021-02-25,Oman,288,4,140588,1562
2021-02-26,Oman,0,0,140588,1562
2021-02-27,Oman,0,0,140588,1562
2021-02-28,Oman,908,8,141496,1570
2021-03-01,Oman,312,7,141808,1577
2021-03-02,Oman,361,3,142169,1580
2021-03-03,Oman,358,3,142527,1583
2021-03-04,Oman,369,0,142896,1583
2021-03-05,Oman,0,0,142896,1583
2021-03-06,Oman,0,0,142896,1583
2021-03-07,Oman,1059,8,143955,1591
2021-03-08,Oman,449,3,144404,1594
2021-03-09,Oman,427,3,144831,1597
2021-03-10,Oman,426,3,145257,1600
2021-03-11,Oman,0,0,145257,1600
2021-03-12,Oman,0,0,145257,1600
2021-03-13,Oman,0,0,145257,1600
2021-03-14,Oman,1610,8,146867,1608
2021-03-15,Oman,556,1,147423,1609
2021-03-16,Oman,587,5,148010,1614
2021-03-17,Oman,548,3,148558,1617
2021-03-18,Oman,577,3,149135,1620
2021-03-19,Oman,0,0,149135,1620
2021-03-20,Oman,0,0,149135,1620
2021-03-21,Oman,1665,2,150800,1622
2021-03-22,Oman,728,7,151528,1629
2021-03-23,Oman,836,4,152364,1633
2021-03-24,Oman,741,11,153105,1644
2021-03-25,Oman,733,6,153838,1650
2021-03-26,Oman,0,0,153838,1650
2021-03-27,Oman,0,0,153838,1650
2021-03-28,Oman,2249,11,156087,1661
2021-03-29,Oman,796,1,156883,1662
2021-03-30,Oman,1173,7,158056,1669
2021-03-31,Oman,1162,9,159218,1678
2021-04-01,Oman,800,3,160018,1681
2021-04-02,Oman,0,0,160018,1681
2021-04-03,Oman,0,0,160018,1681
2021-04-04,Oman,3139,9,163157,1690
2021-04-05,Oman,1117,32,164274,1722
2021-04-06,Oman,1206,6,165480,1728
2021-04-07,Oman,1205,7,166685,1735
2021-04-08,Oman,1320,12,168005,1747
2020-02-25,Pakistan,2,0,2,0
2020-02-26,Pakistan,0,0,2,0
2020-02-27,Pakistan,0,0,2,0
2020-02-28,Pakistan,2,0,4,0
2020-02-29,Pakistan,0,0,4,0
2020-03-01,Pakistan,0,0,4,0
2020-03-02,Pakistan,1,0,5,0
2020-03-03,Pakistan,0,0,5,0
2020-03-04,Pakistan,0,0,5,0
2020-03-05,Pakistan,1,0,6,0
2020-03-06,Pakistan,0,0,6,0
2020-03-07,Pakistan,0,0,6,0
2020-03-08,Pakistan,0,0,6,0
2020-03-09,Pakistan,10,0,16,0
2020-03-10,Pakistan,3,0,19,0
2020-03-11,Pakistan,1,0,20,0
2020-03-12,Pakistan,8,0,28,0
2020-03-13,Pakistan,3,0,31,0
2020-03-14,Pakistan,22,0,53,0
2020-03-15,Pakistan,83,0,136,0
2020-03-16,Pakistan,100,0,236,0
2020-03-17,Pakistan,63,0,299,0
2020-03-18,Pakistan,155,2,454,2
2020-03-19,Pakistan,47,1,501,3
2020-03-20,Pakistan,229,0,730,3
2020-03-21,Pakistan,46,2,776,5
2020-03-22,Pakistan,99,1,875,6
2020-03-23,Pakistan,97,1,972,7
2020-03-24,Pakistan,91,1,1063,8
2020-03-25,Pakistan,138,1,1201,9
2020-03-26,Pakistan,172,2,1373,11
2020-03-27,Pakistan,122,1,1495,12
2020-03-28,Pakistan,102,2,1597,14
2020-03-29,Pakistan,120,7,1717,21
2020-03-30,Pakistan,221,5,1938,26
2020-03-31,Pakistan,180,1,2118,27
2020-04-01,Pakistan,303,7,2421,34
2020-04-02,Pakistan,265,6,2686,40
2020-04-03,Pakistan,132,1,2818,41
2020-04-04,Pakistan,339,6,3157,47
2020-04-05,Pakistan,609,6,3766,53
2020-04-06,Pakistan,269,4,4035,57
2020-04-07,Pakistan,228,4,4263,61
2020-04-08,Pakistan,226,4,4489,65
2020-04-09,Pakistan,206,1,4695,66
2020-04-10,Pakistan,316,20,5011,86
2020-04-11,Pakistan,219,5,5230,91
2020-04-12,Pakistan,266,2,5496,93
2020-04-13,Pakistan,341,3,5837,96
2020-04-14,Pakistan,546,15,6383,111
2020-04-15,Pakistan,536,17,6919,128
2020-04-16,Pakistan,106,7,7025,135
2020-04-17,Pakistan,613,8,7638,143
2020-04-18,Pakistan,710,25,8348,168
2020-04-19,Pakistan,70,8,8418,176
2020-04-20,Pakistan,1147,25,9565,201
2020-04-21,Pakistan,511,11,10076,212
2020-04-22,Pakistan,1079,25,11155,237
2020-04-23,Pakistan,785,16,11940,253
2020-04-24,Pakistan,783,16,12723,269
2020-04-25,Pakistan,605,12,13328,281
2020-04-26,Pakistan,587,11,13915,292
2020-04-27,Pakistan,697,20,14612,312
2020-04-28,Pakistan,913,31,15525,343
2020-04-29,Pakistan,1292,42,16817,385
2020-04-30,Pakistan,1297,32,18114,417
2020-05-01,Pakistan,989,23,19103,440
2020-05-02,Pakistan,981,17,20084,457
2020-05-03,Pakistan,857,19,20941,476
2020-05-04,Pakistan,1108,38,22049,514
2020-05-05,Pakistan,2024,50,24073,564
2020-05-06,Pakistan,571,21,24644,585
2020-05-07,Pakistan,1791,14,26435,599
2020-05-08,Pakistan,2301,37,28736,636
2020-05-09,Pakistan,1598,23,30334,659
2020-05-10,Pakistan,1747,47,32081,706
2020-05-11,Pakistan,2255,31,34336,737
2020-05-12,Pakistan,962,24,35298,761
2020-05-13,Pakistan,490,9,35788,770
2020-05-14,Pakistan,3011,64,38799,834
2020-05-15,Pakistan,0,0,38799,834
2020-05-16,Pakistan,1352,39,40151,873
2020-05-17,Pakistan,1974,30,42125,903
2020-05-18,Pakistan,1841,36,43966,939
2020-05-19,Pakistan,1932,46,45898,985
2020-05-20,Pakistan,2193,32,48091,1017
2020-05-21,Pakistan,2603,50,50694,1067
2020-05-22,Pakistan,1743,34,52437,1101
2020-05-23,Pakistan,2164,32,54601,1133
2020-05-24,Pakistan,1748,34,56349,1167
2020-05-25,Pakistan,1356,30,57705,1197
2020-05-26,Pakistan,1446,28,59151,1225
2020-05-27,Pakistan,2076,35,61227,1260
2020-05-28,Pakistan,2801,57,64028,1317
2020-05-29,Pakistan,2429,78,66457,1395
2020-05-30,Pakistan,3039,88,69496,1483
2020-05-31,Pakistan,2964,60,72460,1543
2020-06-01,Pakistan,3938,78,76398,1621
2020-06-02,Pakistan,4065,67,80463,1688
2020-06-03,Pakistan,4801,82,85264,1770
2020-06-04,Pakistan,3985,68,89249,1838
2020-06-05,Pakistan,4734,97,93983,1935
2020-06-06,Pakistan,4960,67,98943,2002
2020-06-07,Pakistan,4728,65,103671,2067
2020-06-08,Pakistan,4646,105,108317,2172
2020-06-09,Pakistan,5385,83,113702,2255
2020-06-10,Pakistan,5834,101,119536,2356
2020-06-11,Pakistan,6397,107,125933,2463
2020-06-12,Pakistan,0,0,125933,2463
2020-06-13,Pakistan,6472,88,132405,2551
2020-06-14,Pakistan,12073,178,144478,2729
2020-06-15,Pakistan,4443,110,148921,2839
2020-06-16,Pakistan,5839,136,154760,2975
2020-06-17,Pakistan,5358,118,160118,3093
2020-06-18,Pakistan,4944,136,165062,3229
2020-06-19,Pakistan,6604,153,171666,3382
2020-06-20,Pakistan,4951,119,176617,3501
2020-06-21,Pakistan,4471,89,181088,3590
2020-06-22,Pakistan,3946,105,185034,3695
2020-06-23,Pakistan,3892,60,188926,3755
2020-06-24,Pakistan,4044,148,192970,3903
2020-06-25,Pakistan,2775,59,195745,3962
2020-06-26,Pakistan,3138,73,198883,4035
2020-06-27,Pakistan,4072,83,202955,4118
2020-06-28,Pakistan,3557,49,206512,4167
2020-06-29,Pakistan,2825,137,209337,4304
2020-06-30,Pakistan,4133,91,213470,4395
2020-07-01,Pakistan,4339,78,217809,4473
2020-07-02,Pakistan,4087,78,221896,4551
2020-07-03,Pakistan,0,0,221896,4551
2020-07-04,Pakistan,3387,68,225283,4619
2020-07-05,Pakistan,6535,143,231818,4762
2020-07-06,Pakistan,2691,77,234509,4839
2020-07-07,Pakistan,2980,83,237489,4922
2020-07-08,Pakistan,3359,61,240848,4983
2020-07-09,Pakistan,2751,75,243599,5058
2020-07-10,Pakistan,2752,65,246351,5123
2020-07-11,Pakistan,2521,74,248872,5197
2020-07-12,Pakistan,2753,69,251625,5266
2020-07-13,Pakistan,1979,54,253604,5320
2020-07-14,Pakistan,2165,66,255769,5386
2020-07-15,Pakistan,2145,40,257914,5426
2020-07-16,Pakistan,0,0,257914,5426
2020-07-17,Pakistan,4003,96,261917,5522
2020-07-18,Pakistan,1579,46,263496,5568
2020-07-19,Pakistan,1587,31,265083,5599
2020-07-20,Pakistan,1013,40,266096,5639
2020-07-21,Pakistan,1332,38,267428,5677
2020-07-22,Pakistan,1763,32,269191,5709
2020-07-23,Pakistan,1209,54,270400,5763
2020-07-24,Pakistan,1487,24,271887,5787
2020-07-25,Pakistan,1226,35,273113,5822
2020-07-26,Pakistan,0,0,273113,5822
2020-07-27,Pakistan,1176,20,274289,5842
2020-07-28,Pakistan,936,23,275225,5865
2020-07-29,Pakistan,1063,27,276288,5892
2020-07-30,Pakistan,1114,32,277402,5924
2020-07-31,Pakistan,903,27,278305,5951
2020-08-01,Pakistan,0,0,278305,5951
2020-08-02,Pakistan,1394,25,279699,5976
2020-08-03,Pakistan,762,23,280461,5999
2020-08-04,Pakistan,0,0,280461,5999
2020-08-05,Pakistan,675,15,281136,6014
2020-08-06,Pakistan,727,21,281863,6035
2020-08-07,Pakistan,782,17,282645,6052
2020-08-08,Pakistan,842,16,283487,6068
2020-08-09,Pakistan,634,14,284121,6082
2020-08-10,Pakistan,539,15,284660,6097
2020-08-11,Pakistan,531,15,285191,6112
2020-08-12,Pakistan,730,17,285921,6129
2020-08-13,Pakistan,753,10,286674,6139
2020-08-14,Pakistan,626,14,287300,6153
2020-08-15,Pakistan,747,9,288047,6162
2020-08-16,Pakistan,1168,13,289215,6175
2020-08-17,Pakistan,0,0,289215,6175
2020-08-18,Pakistan,617,15,289832,6190
2020-08-19,Pakistan,613,11,290445,6201
2020-08-20,Pakistan,513,8,290958,6209
2020-08-21,Pakistan,630,10,291588,6219
2020-08-22,Pakistan,586,12,292174,6231
2020-08-23,Pakistan,1087,13,293261,6244
2020-08-24,Pakistan,0,0,293261,6244
2020-08-25,Pakistan,450,11,293711,6255
2020-08-26,Pakistan,482,12,294193,6267
2020-08-27,Pakistan,445,7,294638,6274
2020-08-28,Pakistan,415,9,295053,6283
2020-08-29,Pakistan,319,1,295372,6284
2020-08-30,Pakistan,264,4,295636,6288
2020-08-31,Pakistan,213,6,295849,6294
2020-09-01,Pakistan,300,4,296149,6298
2020-09-02,Pakistan,865,30,297014,6328
2020-09-03,Pakistan,498,7,297512,6335
2020-09-04,Pakistan,513,5,298025,6340
2020-09-05,Pakistan,0,0,298025,6340
2020-09-06,Pakistan,878,5,298903,6345
2020-09-07,Pakistan,330,5,299233,6350
2020-09-08,Pakistan,426,9,299659,6359
2020-09-09,Pakistan,371,6,300030,6365
2020-09-10,Pakistan,341,5,300371,6370
2020-09-11,Pakistan,584,3,300955,6373
2020-09-12,Pakistan,526,6,301481,6379
2020-09-13,Pakistan,539,4,302020,6383
2020-09-14,Pakistan,404,6,302424,6389
2020-09-15,Pakistan,665,4,303089,6393
2020-09-16,Pakistan,545,6,303634,6399
2020-09-17,Pakistan,752,9,304386,6408
2020-09-18,Pakistan,645,7,305031,6415
2020-09-19,Pakistan,640,1,305671,6416
2020-09-20,Pakistan,633,4,306304,6420
2020-09-21,Pakistan,582,4,306886,6424
2020-09-22,Pakistan,532,8,307418,6432
2020-09-23,Pakistan,799,5,308217,6437
2020-09-24,Pakistan,798,7,309015,6444
2020-09-25,Pakistan,566,7,309581,6451
2020-09-26,Pakistan,694,6,310275,6457
2020-09-27,Pakistan,566,9,310841,6466
2020-09-28,Pakistan,675,8,311516,6474
2020-09-29,Pakistan,747,5,312263,6479
2020-09-30,Pakistan,543,5,312806,6484
2020-10-01,Pakistan,625,15,313431,6499
2020-10-02,Pakistan,553,8,313984,6507
2020-10-03,Pakistan,632,6,314616,6513
2020-10-04,Pakistan,0,0,314616,6513
2020-10-05,Pakistan,1111,10,315727,6523
2020-10-06,Pakistan,624,12,316351,6535
2020-10-07,Pakistan,583,9,316934,6544
2020-10-08,Pakistan,661,8,317595,6552
2020-10-09,Pakistan,671,6,318266,6558
2020-10-10,Pakistan,666,12,318932,6570
2020-10-11,Pakistan,385,10,319317,6580
2020-10-12,Pakistan,531,8,319848,6588
2020-10-13,Pakistan,615,13,320463,6601
2020-10-14,Pakistan,755,13,321218,6614
2020-10-15,Pakistan,659,7,321877,6621
2020-10-16,Pakistan,575,17,322452,6638
2020-10-17,Pakistan,567,16,323019,6654
2020-10-18,Pakistan,433,5,323452,6659
2020-10-19,Pakistan,582,14,324034,6673
2020-10-20,Pakistan,710,19,324744,6692
2020-10-21,Pakistan,736,10,325480,6702
2020-10-22,Pakistan,736,13,326216,6715
2020-10-23,Pakistan,847,12,327063,6727
2020-10-24,Pakistan,832,9,327895,6736
2020-10-25,Pakistan,707,3,328602,6739
2020-10-26,Pakistan,773,6,329375,6745
2020-10-27,Pakistan,825,14,330200,6759
2020-10-28,Pakistan,908,16,331108,6775
2020-10-29,Pakistan,1078,20,332186,6795
2020-10-30,Pakistan,807,11,332993,6806
2020-10-31,Pakistan,977,17,333970,6823
2020-11-01,Pakistan,1123,12,335093,6835
2020-11-02,Pakistan,1167,14,336260,6849
2020-11-03,Pakistan,1313,18,337573,6867
2020-11-04,Pakistan,1302,26,338875,6893
2020-11-05,Pakistan,1376,30,340251,6923
2020-11-06,Pakistan,1502,20,341753,6943
2020-11-07,Pakistan,1436,25,343189,6968
2020-11-08,Pakistan,1650,9,344839,6977
2020-11-09,Pakistan,1637,23,346476,7000
2020-11-10,Pakistan,1708,21,348184,7021
2020-11-11,Pakistan,1808,34,349992,7055
2020-11-12,Pakistan,2304,37,352296,7092
2020-11-13,Pakistan,2165,17,354461,7109
2020-11-14,Pakistan,2443,32,356904,7141
2020-11-15,Pakistan,2128,19,359032,7160
2020-11-16,Pakistan,2050,33,361082,7193
2020-11-17,Pakistan,2298,37,363380,7230
2020-11-18,Pakistan,2547,18,365927,7248
2020-11-19,Pakistan,2738,313,368665,7561
2020-11-20,Pakistan,2843,42,371508,7603
2020-11-21,Pakistan,2665,59,374173,7662
2020-11-22,Pakistan,2756,34,376929,7696
2020-11-23,Pakistan,2954,48,379883,7744
2020-11-24,Pakistan,3009,59,382892,7803
2020-11-25,Pakistan,3306,40,386198,7843
2020-11-26,Pakistan,3113,54,389311,7897
2020-11-27,Pakistan,3045,45,392356,7942
2020-11-28,Pakistan,2829,43,395185,7985
2020-11-29,Pakistan,2839,40,398024,8025
2020-11-30,Pakistan,2458,66,400482,8091
2020-12-01,Pakistan,2829,75,403311,8166
2020-12-02,Pakistan,3499,39,406810,8205
2020-12-03,Pakistan,3262,55,410072,8260
2020-12-04,Pakistan,3119,43,413191,8303
2020-12-05,Pakistan,3308,58,416499,8361
2020-12-06,Pakistan,3795,37,420294,8398
2020-12-07,Pakistan,2885,89,423179,8487
2020-12-08,Pakistan,2963,60,426142,8547
2020-12-09,Pakistan,3138,56,429280,8603
2020-12-10,Pakistan,3047,50,432327,8653
2020-12-11,Pakistan,2729,71,435056,8724
2020-12-12,Pakistan,3369,72,438425,8796
2020-12-13,Pakistan,2362,36,440787,8832
2020-12-14,Pakistan,2459,73,443246,8905
2020-12-15,Pakistan,2731,105,445977,9010
2020-12-16,Pakistan,2545,70,448522,9080
2020-12-17,Pakistan,2972,84,451494,9164
2020-12-18,Pakistan,3179,86,454673,9250
2020-12-19,Pakistan,2615,80,457288,9330
2020-12-20,Pakistan,1680,62,458968,9392
2020-12-21,Pakistan,1704,82,460672,9474
2020-12-22,Pakistan,2142,83,462814,9557
2020-12-23,Pakistan,2256,111,465070,9668
2020-12-24,Pakistan,2152,85,467222,9753
2020-12-25,Pakistan,2260,63,469482,9816
2020-12-26,Pakistan,1853,58,471335,9874
2020-12-27,Pakistan,1974,55,473309,9929
2020-12-28,Pakistan,1776,63,475085,9992
2020-12-29,Pakistan,2155,55,477240,10047
2020-12-30,Pakistan,2475,58,479715,10105
2020-12-31,Pakistan,2463,71,482178,10176
2021-01-01,Pakistan,2184,82,484362,10258
2021-01-02,Pakistan,2272,53,486634,10311
2021-01-03,Pakistan,1895,39,488529,10350
2021-01-04,Pakistan,1947,59,490476,10409
2021-01-05,Pakistan,2118,52,492594,10461
2021-01-06,Pakistan,2481,50,495075,10511
2021-01-07,Pakistan,2435,47,497510,10558
2021-01-08,Pakistan,2007,40,499517,10598
2021-01-09,Pakistan,2899,46,502416,10644
2021-01-10,Pakistan,1877,32,504293,10676
2021-01-11,Pakistan,2408,41,506701,10717
2021-01-12,Pakistan,2123,55,508824,10772
2021-01-13,Pakistan,3097,46,511921,10818
2021-01-14,Pakistan,2417,45,514338,10863
2021-01-15,Pakistan,2432,45,516770,10908
2021-01-16,Pakistan,2521,43,519291,10951
2021-01-17,Pakistan,1920,46,521211,10997
2021-01-18,Pakistan,1800,58,523011,11055
2021-01-19,Pakistan,1772,48,524783,11103
2021-01-20,Pakistan,2363,54,527146,11157
2021-01-21,Pakistan,1745,47,528891,11204
2021-01-22,Pakistan,1927,43,530818,11247
2021-01-23,Pakistan,1594,48,532412,11295
2021-01-24,Pakistan,1629,23,534041,11318
2021-01-25,Pakistan,1873,58,535914,11376
2021-01-26,Pakistan,1563,74,537477,11450
2021-01-27,Pakistan,1910,64,539387,11514
2021-01-28,Pakistan,1644,46,541031,11560
2021-01-29,Pakistan,2183,63,543214,11623
2021-01-30,Pakistan,1599,34,544813,11657
2021-01-31,Pakistan,1615,26,546428,11683
2021-02-01,Pakistan,1220,63,547648,11746
2021-02-02,Pakistan,1384,56,549032,11802
2021-02-03,Pakistan,1508,31,550540,11833
2021-02-04,Pakistan,1302,53,551842,11886
2021-02-05,Pakistan,1286,28,553128,11914
2021-02-06,Pakistan,1346,53,554474,11967
2021-02-07,Pakistan,1037,59,555511,12026
2021-02-08,Pakistan,1008,40,556519,12066
2021-02-09,Pakistan,1072,62,557591,12128
2021-02-10,Pakistan,1502,57,559093,12185
2021-02-11,Pakistan,1270,33,560363,12218
2021-02-12,Pakistan,1262,58,561625,12276
2021-02-13,Pakistan,1404,31,563029,12307
2021-02-14,Pakistan,1048,26,564077,12333
2021-02-15,Pakistan,0,0,564077,12333
2021-02-16,Pakistan,1912,103,565989,12436
2021-02-17,Pakistan,1272,52,567261,12488
2021-02-18,Pakistan,1245,39,568506,12527
2021-02-19,Pakistan,1340,36,569846,12563
2021-02-20,Pakistan,1328,38,571174,12601
2021-02-21,Pakistan,1160,16,572334,12617
2021-02-22,Pakistan,1050,41,573384,12658
2021-02-23,Pakistan,1196,50,574580,12708
2021-02-24,Pakistan,1361,64,575941,12772
2021-02-25,Pakistan,1541,32,577482,12804
2021-02-26,Pakistan,1315,33,578797,12837
2021-02-27,Pakistan,1176,23,579973,12860
2021-02-28,Pakistan,1392,36,581365,12896
2021-03-01,Pakistan,1163,42,582528,12938
2021-03-02,Pakistan,1388,75,583916,13013
2021-03-03,Pakistan,1519,63,585435,13076
2021-03-04,Pakistan,1579,52,587014,13128
2021-03-05,Pakistan,1714,38,588728,13166
2021-03-06,Pakistan,1780,39,590508,13205
2021-03-07,Pakistan,1592,22,592100,13227
2021-03-08,Pakistan,1353,54,593453,13281
2021-03-09,Pakistan,1786,43,595239,13324
2021-03-10,Pakistan,2258,53,597497,13377
2021-03-11,Pakistan,2701,53,600198,13430
2021-03-12,Pakistan,2338,46,602536,13476
2021-03-13,Pakistan,2664,32,605200,13508
2021-03-14,Pakistan,2253,29,607453,13537
2021-03-15,Pakistan,2511,58,609964,13595
2021-03-16,Pakistan,2351,61,612315,13656
2021-03-17,Pakistan,3495,61,615810,13717
2021-03-18,Pakistan,3449,40,619259,13757
2021-03-19,Pakistan,3876,42,623135,13799
2021-03-20,Pakistan,3667,44,626802,13843
2021-03-21,Pakistan,3669,20,630471,13863
2021-03-22,Pakistan,3270,72,633741,13935
2021-03-23,Pakistan,3301,30,637042,13965
2021-03-24,Pakistan,3946,63,640988,14028
2021-03-25,Pakistan,4368,63,645356,14091
2021-03-26,Pakistan,4468,67,649824,14158
2021-03-27,Pakistan,4767,57,654591,14215
2021-03-28,Pakistan,4525,41,659116,14256
2021-03-29,Pakistan,4084,100,663200,14356
2021-03-30,Pakistan,4757,78,667957,14434
2021-03-31,Pakistan,4974,96,672931,14530
2021-04-01,Pakistan,5234,83,678165,14613
2021-04-02,Pakistan,0,0,678165,14613
2021-04-03,Pakistan,9743,165,687908,14778
2021-04-04,Pakistan,4323,43,692231,14821
2021-04-05,Pakistan,3953,103,696184,14924
2021-04-06,Pakistan,4004,102,700188,15026
2021-04-07,Pakistan,5329,98,705517,15124
2021-04-08,Pakistan,5312,105,710829,15229
2020-03-05,Palestine,4,0,4,0
2020-03-06,Palestine,3,0,7,0
2020-03-07,Palestine,9,0,16,0
2020-03-08,Palestine,0,0,16,0
2020-03-09,Palestine,3,0,19,0
2020-03-10,Palestine,7,0,26,0
2020-03-11,Palestine,4,0,30,0
2020-03-12,Palestine,0,0,30,0
2020-03-13,Palestine,1,0,31,0
2020-03-14,Palestine,4,0,35,0
2020-03-15,Palestine,3,0,38,0
2020-03-16,Palestine,0,0,38,0
2020-03-17,Palestine,1,0,39,0
2020-03-18,Palestine,2,0,41,0
2020-03-19,Palestine,3,0,44,0
2020-03-20,Palestine,3,0,47,0
2020-03-21,Palestine,1,0,48,0
2020-03-22,Palestine,4,0,52,0
2020-03-23,Palestine,7,0,59,0
2020-03-24,Palestine,0,0,59,0
2020-03-25,Palestine,0,0,59,0
2020-03-26,Palestine,25,1,84,1
2020-03-27,Palestine,7,0,91,1
2020-03-28,Palestine,7,0,98,1
2020-03-29,Palestine,11,0,109,1
2020-03-30,Palestine,7,0,116,1
2020-03-31,Palestine,3,0,119,1
2020-04-01,Palestine,15,0,134,1
2020-04-02,Palestine,27,0,161,1
2020-04-03,Palestine,33,0,194,1
2020-04-04,Palestine,23,0,217,1
2020-04-05,Palestine,20,0,237,1
2020-04-06,Palestine,17,0,254,1
2020-04-07,Palestine,7,0,261,1
2020-04-08,Palestine,2,0,263,1
2020-04-09,Palestine,0,0,263,1
2020-04-10,Palestine,4,1,267,2
2020-04-11,Palestine,1,0,268,2
2020-04-12,Palestine,3,0,271,2
2020-04-13,Palestine,2,0,273,2
2020-04-14,Palestine,11,0,284,2
2020-04-15,Palestine,7,0,291,2
2020-04-16,Palestine,3,0,294,2
2020-04-17,Palestine,13,0,307,2
2020-04-18,Palestine,6,0,313,2
2020-04-19,Palestine,6,0,319,2
2020-04-20,Palestine,10,0,329,2
2020-04-21,Palestine,0,0,329,2
2020-04-22,Palestine,6,0,335,2
2020-04-23,Palestine,1,0,336,2
2020-04-24,Palestine,4,0,340,2
2020-04-25,Palestine,2,0,342,2
2020-04-26,Palestine,0,0,342,2
2020-04-27,Palestine,0,0,342,2
2020-04-28,Palestine,1,0,343,2
2020-04-29,Palestine,1,0,344,2
2020-04-30,Palestine,0,0,344,2
2020-05-01,Palestine,9,0,353,2
2020-05-02,Palestine,0,0,353,2
2020-05-03,Palestine,0,0,353,2
2020-05-04,Palestine,9,0,362,2
2020-05-05,Palestine,9,0,371,2
2020-05-06,Palestine,3,0,374,2
2020-05-07,Palestine,1,0,375,2
2020-05-08,Palestine,0,0,375,2
2020-05-09,Palestine,0,0,375,2
2020-05-10,Palestine,0,0,375,2
2020-05-11,Palestine,0,0,375,2
2020-05-12,Palestine,0,0,375,2
2020-05-13,Palestine,0,0,375,2
2020-05-14,Palestine,0,0,375,2
2020-05-15,Palestine,0,0,375,2
2020-05-16,Palestine,1,0,376,2
2020-05-17,Palestine,5,0,381,2
2020-05-18,Palestine,7,0,388,2
2020-05-19,Palestine,3,0,391,2
2020-05-20,Palestine,7,0,398,2
2020-05-21,Palestine,25,0,423,2
2020-05-22,Palestine,0,0,423,2
2020-05-23,Palestine,0,1,423,3
2020-05-24,Palestine,0,0,423,3
2020-05-25,Palestine,0,0,423,3
2020-05-26,Palestine,6,0,429,3
2020-05-27,Palestine,5,0,434,3
2020-05-28,Palestine,12,0,446,3
2020-05-29,Palestine,0,0,446,3
2020-05-30,Palestine,1,0,447,3
2020-05-31,Palestine,1,0,448,3
2020-06-01,Palestine,1,0,449,3
2020-06-02,Palestine,2,0,451,3
2020-06-03,Palestine,6,0,457,3
2020-06-04,Palestine,7,0,464,3
2020-06-05,Palestine,0,0,464,3
2020-06-06,Palestine,0,0,464,3
2020-06-07,Palestine,8,0,472,3
2020-06-08,Palestine,1,0,473,3
2020-06-09,Palestine,8,0,481,3
2020-06-10,Palestine,4,0,485,3
2020-06-11,Palestine,2,0,487,3
2020-06-12,Palestine,2,0,489,3
2020-06-13,Palestine,0,0,489,3
2020-06-14,Palestine,3,0,492,3
2020-06-15,Palestine,13,0,505,3
2020-06-16,Palestine,9,0,514,3
2020-06-17,Palestine,41,0,555,3
2020-06-18,Palestine,45,0,600,3
2020-06-19,Palestine,75,0,675,3
2020-06-20,Palestine,109,0,784,3
2020-06-21,Palestine,49,0,833,3
2020-06-22,Palestine,168,0,1001,3
2020-06-23,Palestine,168,0,1169,3
2020-06-24,Palestine,159,0,1328,3
2020-06-25,Palestine,54,0,1382,3
2020-06-26,Palestine,175,0,1557,3
2020-06-27,Palestine,258,1,1815,4
2020-06-28,Palestine,175,0,1990,4
2020-06-29,Palestine,195,1,2185,5
2020-06-30,Palestine,243,3,2428,8
2020-07-01,Palestine,330,0,2758,8
2020-07-02,Palestine,322,1,3080,9
2020-07-03,Palestine,254,2,3334,11
2020-07-04,Palestine,501,2,3835,13
2020-07-05,Palestine,442,3,4277,16
2020-07-06,Palestine,64,1,4341,17
2020-07-07,Palestine,306,1,4647,18
2020-07-08,Palestine,382,2,5029,20
2020-07-09,Palestine,191,4,5220,24
2020-07-10,Palestine,331,3,5551,27
2020-07-11,Palestine,380,6,5931,33
2020-07-12,Palestine,299,3,6230,36
2020-07-13,Palestine,336,3,6566,39
2020-07-14,Palestine,198,5,6764,44
2020-07-15,Palestine,300,0,7064,44
2020-07-16,Palestine,348,7,7412,51
2020-07-17,Palestine,352,2,7764,53
2020-07-18,Palestine,440,6,8204,59
2020-07-19,Palestine,345,3,8549,62
2020-07-20,Palestine,367,1,8916,63
2020-07-21,Palestine,312,1,9228,64
2020-07-22,Palestine,170,2,9398,66
2020-07-23,Palestine,346,1,9744,67
2020-07-24,Palestine,349,3,10093,70
2020-07-25,Palestine,213,5,10306,75
2020-07-26,Palestine,163,1,10469,76
2020-07-27,Palestine,152,2,10621,78
2020-07-28,Palestine,317,1,10938,79
2020-07-29,Palestine,346,1,11284,80
2020-07-30,Palestine,264,1,11548,81
2020-07-31,Palestine,289,1,11837,82
2020-08-01,Palestine,323,1,12160,83
2020-08-02,Palestine,137,1,12297,84
2020-08-03,Palestine,244,0,12541,84
2020-08-04,Palestine,229,2,12770,86
2020-08-05,Palestine,295,3,13065,89
2020-08-06,Palestine,333,3,13398,92
2020-08-07,Palestine,324,2,13722,94
2020-08-08,Palestine,206,2,13928,96
2020-08-09,Palestine,280,1,14208,97
2020-08-10,Palestine,302,3,14510,100
2020-08-11,Palestine,365,4,14875,104
2020-08-12,Palestine,309,1,15184,105
2020-08-13,Palestine,307,1,15491,106
2020-08-14,Palestine,343,0,15834,106
2020-08-15,Palestine,319,2,16153,108
2020-08-16,Palestine,381,2,16534,110
2020-08-17,Palestine,310,3,16844,113
2020-08-18,Palestine,462,0,17306,113
2020-08-19,Palestine,300,6,17606,119
2020-08-20,Palestine,383,1,17989,120
2020-08-21,Palestine,324,2,18313,122
2020-08-22,Palestine,163,3,18476,125
2020-08-23,Palestine,326,3,18802,128
2020-08-24,Palestine,411,5,19213,133
2020-08-25,Palestine,465,0,19678,133
2020-08-26,Palestine,477,4,20155,137
2020-08-27,Palestine,522,4,20677,141
2020-08-28,Palestine,574,4,21251,145
2020-08-29,Palestine,417,2,21668,147
2020-08-30,Palestine,536,5,22204,152
2020-08-31,Palestine,525,0,22729,152
2020-09-01,Palestine,552,7,23281,159
2020-09-02,Palestine,594,3,23875,162
2020-09-03,Palestine,596,5,24471,167
2020-09-04,Palestine,671,3,25142,170
2020-09-05,Palestine,433,7,25575,177
2020-09-06,Palestine,552,4,26127,181
2020-09-07,Palestine,652,3,26779,184
2020-09-08,Palestine,584,6,27363,190
2020-09-09,Palestine,556,2,27919,192
2020-09-10,Palestine,745,6,28664,198
2020-09-11,Palestine,592,6,29256,204
2020-09-12,Palestine,650,6,29906,210
2020-09-13,Palestine,668,11,30574,221
2020-09-14,Palestine,788,5,31362,226
2020-09-15,Palestine,888,3,32250,229
2020-09-16,Palestine,756,14,33006,243
2020-09-17,Palestine,837,1,33843,244
2020-09-18,Palestine,558,6,34401,250
2020-09-19,Palestine,602,3,35003,253
2020-09-20,Palestine,683,9,35686,262
2020-09-21,Palestine,465,3,36151,265
2020-09-22,Palestine,429,4,36580,269
2020-09-23,Palestine,503,3,37083,272
2020-09-24,Palestine,508,2,37591,274
2020-09-25,Palestine,372,4,37963,278
2020-09-26,Palestine,290,7,38253,285
2020-09-27,Palestine,450,6,38703,291
2020-09-28,Palestine,418,8,39121,299
2020-09-29,Palestine,420,7,39541,306
2020-09-30,Palestine,358,5,39899,311
2020-10-01,Palestine,423,7,40322,318
2020-10-02,Palestine,444,3,40766,321
2020-10-03,Palestine,312,8,41078,329
2020-10-04,Palestine,420,1,41498,330
2020-10-05,Palestine,459,9,41957,339
2020-10-06,Palestine,475,10,42432,349
2020-10-07,Palestine,408,6,42840,355
2020-10-08,Palestine,416,4,43256,359
2020-10-09,Palestine,408,8,43664,367
2020-10-10,Palestine,281,11,43945,378
2020-10-11,Palestine,354,3,44299,381
2020-10-12,Palestine,385,6,44684,387
2020-10-13,Palestine,516,4,45200,391
2020-10-14,Palestine,458,2,45658,393
2020-10-15,Palestine,442,8,46100,401
2020-10-16,Palestine,334,1,46434,402
2020-10-17,Palestine,312,0,46746,402
2020-10-18,Palestine,389,6,47135,408
2020-10-19,Palestine,481,5,47616,413
2020-10-20,Palestine,513,8,48129,421
2020-10-21,Palestine,499,6,48628,427
2020-10-22,Palestine,506,8,49134,435
2020-10-23,Palestine,445,4,49579,439
2020-10-24,Palestine,410,4,49989,443
2020-10-25,Palestine,453,5,50442,448
2020-10-26,Palestine,510,6,50952,454
2020-10-27,Palestine,576,4,51528,458
2020-10-28,Palestine,420,7,51948,465
2020-10-29,Palestine,623,8,52571,473
2020-10-30,Palestine,504,8,53075,481
2020-10-31,Palestine,445,2,53520,483
2020-11-01,Palestine,540,6,54060,489
2020-11-02,Palestine,715,4,54775,493
2020-11-03,Palestine,633,8,55408,501
2020-11-04,Palestine,682,3,56090,504
2020-11-05,Palestine,582,4,56672,508
2020-11-06,Palestine,554,3,57226,511
2020-11-07,Palestine,431,1,57657,512
2020-11-08,Palestine,501,3,58158,515
2020-11-09,Palestine,680,6,58838,521
2020-11-10,Palestine,584,12,59422,533
2020-11-11,Palestine,643,5,60065,538
2020-11-12,Palestine,719,4,60784,542
2020-11-13,Palestine,730,6,61514,548
2020-11-14,Palestine,653,10,62167,558
2020-11-15,Palestine,864,7,63031,565
2020-11-16,Palestine,836,7,63867,572
2020-11-17,Palestine,1068,8,64935,580
2020-11-18,Palestine,1251,9,66186,589
2020-11-19,Palestine,1110,9,67296,598
2020-11-20,Palestine,1472,8,68768,606
2020-11-21,Palestine,1486,14,70254,620
2020-11-22,Palestine,1390,16,71644,636
2020-11-23,Palestine,1552,9,73196,645
2020-11-24,Palestine,1811,11,75007,656
2020-11-25,Palestine,1720,9,76727,665
2020-11-26,Palestine,1766,15,78493,680
2020-11-27,Palestine,1936,9,80429,689
2020-11-28,Palestine,1461,15,81890,704
2020-11-29,Palestine,1695,13,83585,717
2020-11-30,Palestine,2062,15,85647,732
2020-12-01,Palestine,2357,15,88004,747
2020-12-02,Palestine,2188,16,90192,763
2020-12-03,Palestine,2516,17,92708,780
2020-12-04,Palestine,1968,17,94676,797
2020-12-05,Palestine,1422,15,96098,812
2020-12-06,Palestine,1940,16,98038,828
2020-12-07,Palestine,1720,20,99758,848
2020-12-08,Palestine,1351,19,101109,867
2020-12-09,Palestine,1883,23,102992,890
2020-12-10,Palestine,1887,20,104879,910
2020-12-11,Palestine,1743,21,106622,931
2020-12-12,Palestine,1477,30,108099,961
2020-12-13,Palestine,1639,17,109738,978
2020-12-14,Palestine,1364,22,111102,1000
2020-12-15,Palestine,2307,23,113409,1023
2020-12-16,Palestine,2197,25,115606,1048
2020-12-17,Palestine,2149,30,117755,1078
2020-12-18,Palestine,1857,19,119612,1097
2020-12-19,Palestine,1604,20,121216,1117
2020-12-20,Palestine,1427,24,122643,1141
2020-12-21,Palestine,1302,28,123945,1169
2020-12-22,Palestine,1561,29,125506,1198
2020-12-23,Palestine,1870,28,127376,1226
2020-12-24,Palestine,1704,17,129080,1243
2020-12-25,Palestine,1518,17,130598,1260
2020-12-26,Palestine,1306,21,131904,1281
2020-12-27,Palestine,1189,28,133093,1309
2020-12-28,Palestine,1217,23,134310,1332
2020-12-29,Palestine,1149,19,135459,1351
2020-12-30,Palestine,1277,20,136736,1371
2020-12-31,Palestine,1268,29,138004,1400
2021-01-01,Palestine,1219,18,139223,1418
2021-01-02,Palestine,1064,28,140287,1446
2021-01-03,Palestine,932,24,141219,1470
2021-01-04,Palestine,1009,20,142228,1490
2021-01-05,Palestine,941,15,143169,1505
2021-01-06,Palestine,1088,14,144257,1519
2021-01-07,Palestine,995,17,145252,1536
2021-01-08,Palestine,822,23,146074,1559
2021-01-09,Palestine,627,24,146701,1583
2021-01-10,Palestine,699,21,147400,1604
2021-01-11,Palestine,771,10,148171,1614
2021-01-12,Palestine,797,16,148968,1630
2021-01-13,Palestine,801,28,149769,1658
2021-01-14,Palestine,736,7,150505,1665
2021-01-15,Palestine,637,22,151142,1687
2021-01-16,Palestine,427,13,151569,1700
2021-01-17,Palestine,462,18,152031,1718
2021-01-18,Palestine,524,8,152555,1726
2021-01-19,Palestine,538,15,153093,1741
2021-01-20,Palestine,497,10,153590,1751
2021-01-21,Palestine,473,6,154063,1757
2021-01-22,Palestine,494,12,154557,1769
2021-01-23,Palestine,449,14,155006,1783
2021-01-24,Palestine,408,8,155414,1791
2021-01-25,Palestine,470,5,155884,1796
2021-01-26,Palestine,509,7,156393,1803
2021-01-27,Palestine,603,5,156996,1808
2021-01-28,Palestine,597,4,157593,1812
2021-01-29,Palestine,575,11,158168,1823
2021-01-30,Palestine,391,8,158559,1831
2021-01-31,Palestine,403,2,158962,1833
2021-02-01,Palestine,481,7,159443,1840
2021-02-02,Palestine,513,9,159956,1849
2021-02-03,Palestine,470,8,160426,1857
2021-02-04,Palestine,661,8,161087,1865
2021-02-05,Palestine,472,2,161559,1867
2021-02-06,Palestine,470,3,162029,1870
2021-02-07,Palestine,572,11,162601,1881
2021-02-08,Palestine,612,7,163213,1888
2021-02-09,Palestine,762,9,163975,1897
2021-02-10,Palestine,761,12,164736,1909
2021-02-11,Palestine,799,1,165535,1910
2021-02-12,Palestine,665,8,166200,1918
2021-02-13,Palestine,600,12,166800,1930
2021-02-14,Palestine,804,3,167604,1933
2021-02-15,Palestine,840,3,168444,1936
2021-02-16,Palestine,1043,6,169487,1942
2021-02-17,Palestine,1040,6,170527,1948
2021-02-18,Palestine,627,8,171154,1956
2021-02-19,Palestine,563,5,171717,1961
2021-02-20,Palestine,598,10,172315,1971
2021-02-21,Palestine,1320,5,173635,1976
2021-02-22,Palestine,1334,10,174969,1986
2021-02-23,Palestine,1408,8,176377,1994
2021-02-24,Palestine,1391,5,177768,1999
2021-02-25,Palestine,1525,9,179293,2008
2021-02-26,Palestine,1555,11,180848,2019
2021-02-27,Palestine,1061,6,181909,2025
2021-02-28,Palestine,1703,17,183612,2042
2021-03-01,Palestine,1724,16,185336,2058
2021-03-02,Palestine,1973,5,187309,2063
2021-03-03,Palestine,2017,15,189326,2078
2021-03-04,Palestine,1877,13,191203,2091
2021-03-05,Palestine,1826,19,193029,2110
2021-03-06,Palestine,1519,17,194548,2127
2021-03-07,Palestine,2264,13,196812,2140
2021-03-08,Palestine,1742,17,198554,2157
2021-03-09,Palestine,1828,13,200382,2170
2021-03-10,Palestine,1996,23,202378,2193
2021-03-11,Palestine,1291,18,203669,2211
2021-03-12,Palestine,1983,17,205652,2228
2021-03-13,Palestine,1784,27,207436,2255
2021-03-14,Palestine,1868,13,209304,2268
2021-03-15,Palestine,2298,25,211602,2293
2021-03-16,Palestine,2189,21,213791,2314
2021-03-17,Palestine,2193,29,215984,2343
2021-03-18,Palestine,2077,15,218061,2358
2021-03-19,Palestine,1851,21,219912,2379
2021-03-20,Palestine,1479,27,221391,2406
2021-03-21,Palestine,2247,21,223638,2427
2021-03-22,Palestine,2338,31,225976,2458
2021-03-23,Palestine,2068,20,228044,2478
2021-03-24,Palestine,2032,23,230076,2501
2021-03-25,Palestine,1962,20,232038,2521
2021-03-26,Palestine,1511,16,233549,2537
2021-03-27,Palestine,1199,20,234748,2557
2021-03-28,Palestine,1714,24,236462,2581
2021-03-29,Palestine,1786,18,238248,2599
2021-03-30,Palestine,1817,15,240065,2614
2021-03-31,Palestine,2288,13,242353,2627
2021-04-01,Palestine,2292,18,244645,2645
2021-04-02,Palestine,2248,16,246893,2661
2021-04-03,Palestine,1589,20,248482,2681
2021-04-04,Palestine,2806,25,251288,2706
2021-04-05,Palestine,2634,10,253922,2716
2021-04-06,Palestine,2539,19,256461,2735
2021-04-07,Palestine,2672,18,259133,2753
2021-04-08,Palestine,2884,28,262017,2781
2020-03-10,Panama,1,0,1,0
2020-03-11,Panama,7,1,8,1
2020-03-12,Panama,3,0,11,1
2020-03-13,Panama,16,0,27,1
2020-03-14,Panama,9,0,36,1
2020-03-15,Panama,7,0,43,1
2020-03-16,Panama,12,0,55,1
2020-03-17,Panama,14,0,69,1
2020-03-18,Panama,17,0,86,1
2020-03-19,Panama,23,0,109,1
2020-03-20,Panama,28,0,137,1
2020-03-21,Panama,63,0,200,1
2020-03-22,Panama,113,2,313,3
2020-03-23,Panama,32,3,345,6
2020-03-24,Panama,0,0,345,6
2020-03-25,Panama,98,2,443,8
2020-03-26,Panama,115,0,558,8
2020-03-27,Panama,116,1,674,9
2020-03-28,Panama,112,5,786,14
2020-03-29,Panama,115,3,901,17
2020-03-30,Panama,88,7,989,24
2020-03-31,Panama,192,6,1181,30
2020-04-01,Panama,0,0,1181,30
2020-04-02,Panama,136,2,1317,32
2020-04-03,Panama,158,5,1475,37
2020-04-04,Panama,198,4,1673,41
2020-04-05,Panama,128,5,1801,46
2020-04-06,Panama,187,8,1988,54
2020-04-07,Panama,112,1,2100,55
2020-04-08,Panama,149,4,2249,59
2020-04-09,Panama,279,4,2528,63
2020-04-10,Panama,224,3,2752,66
2020-04-11,Panama,222,8,2974,74
2020-04-12,Panama,260,5,3234,79
2020-04-13,Panama,166,8,3400,87
2020-04-14,Panama,72,7,3472,94
2020-04-15,Panama,102,1,3574,95
2020-04-16,Panama,177,8,3751,103
2020-04-17,Panama,265,6,4016,109
2020-04-18,Panama,194,7,4210,116
2020-04-19,Panama,63,4,4273,120
2020-04-20,Panama,194,6,4467,126
2020-04-21,Panama,191,10,4658,136
2020-04-22,Panama,163,5,4821,141
2020-04-23,Panama,345,5,5166,146
2020-04-24,Panama,172,8,5338,154
2020-04-25,Panama,200,5,5538,159
2020-04-26,Panama,241,6,5779,165
2020-04-27,Panama,242,2,6021,167
2020-04-28,Panama,0,0,6021,167
2020-04-29,Panama,357,11,6378,178
2020-04-30,Panama,154,10,6532,188
2020-05-01,Panama,188,4,6720,192
2020-05-02,Panama,370,5,7090,197
2020-05-03,Panama,0,0,7090,197
2020-05-04,Panama,107,3,7197,200
2020-05-05,Panama,326,10,7523,210
2020-05-06,Panama,208,8,7731,218
2020-05-07,Panama,137,7,7868,225
2020-05-08,Panama,202,6,8070,231
2020-05-09,Panama,212,6,8282,237
2020-05-10,Panama,166,7,8448,244
2020-05-11,Panama,168,5,8616,249
2020-05-12,Panama,167,3,8783,252
2020-05-13,Panama,161,4,8944,256
2020-05-14,Panama,174,4,9118,260
2020-05-15,Panama,150,6,9268,266
2020-05-16,Panama,181,3,9449,269
2020-05-17,Panama,157,6,9606,275
2020-05-18,Panama,120,4,9726,279
2020-05-19,Panama,141,2,9867,281
2020-05-20,Panama,110,6,9977,287
2020-05-21,Panama,139,4,10116,291
2020-05-22,Panama,151,4,10267,295
2020-05-23,Panama,310,4,10577,299
2020-05-24,Panama,349,7,10926,306
2020-05-25,Panama,257,4,11183,310
2020-05-26,Panama,264,3,11447,313
2020-05-27,Panama,281,2,11728,315
2020-05-28,Panama,403,5,12131,320
2020-05-29,Panama,400,6,12531,326
2020-05-30,Panama,487,4,13018,330
2020-05-31,Panama,445,6,13463,336
2020-06-01,Panama,374,8,13837,344
2020-06-02,Panama,258,8,14095,352
2020-06-03,Panama,514,5,14609,357
2020-06-04,Panama,435,6,15044,363
2020-06-05,Panama,419,7,15463,370
2020-06-06,Panama,541,16,16004,386
2020-06-07,Panama,421,7,16425,393
2020-06-08,Panama,429,5,16854,398
2020-06-09,Panama,379,5,17233,403
2020-06-10,Panama,656,10,17889,413
2020-06-11,Panama,697,5,18586,418
2020-06-12,Panama,625,3,19211,421
2020-06-13,Panama,848,8,20059,429
2020-06-14,Panama,1359,8,21418,437
2020-06-15,Panama,4,11,21422,448
2020-06-16,Panama,540,9,21962,457
2020-06-17,Panama,635,13,22597,470
2020-06-18,Panama,754,5,23351,475
2020-06-19,Panama,923,10,24274,485
2020-06-20,Panama,948,8,25222,493
2020-06-21,Panama,808,8,26030,501
2020-06-22,Panama,722,20,26752,521
2020-06-23,Panama,562,15,27314,536
2020-06-24,Panama,716,11,28030,547
2020-06-25,Panama,1007,17,29037,564
2020-06-26,Panama,868,11,29905,575
2020-06-27,Panama,753,17,30658,592
2020-06-28,Panama,1028,12,31686,604
2020-06-29,Panama,1099,16,32785,620
2020-06-30,Panama,765,11,33550,631
2020-07-01,Panama,913,14,34463,645
2020-07-02,Panama,774,22,35237,667
2020-07-03,Panama,758,31,35995,698
2020-07-04,Panama,988,22,36983,720
2020-07-05,Panama,1166,27,38149,747
2020-07-06,Panama,1185,23,39334,770
2020-07-07,Panama,957,29,40291,799
2020-07-08,Panama,960,20,41251,819
2020-07-09,Panama,965,20,42216,839
2020-07-10,Panama,1041,24,43257,863
2020-07-11,Panama,1075,30,44332,893
2020-07-12,Panama,1301,16,45633,909
2020-07-13,Panama,1540,23,47173,932
2020-07-14,Panama,923,28,48096,960
2020-07-15,Panama,1147,22,49243,982
2020-07-16,Panama,1130,18,50373,1000
2020-07-17,Panama,1035,38,51408,1038
2020-07-18,Panama,853,33,52261,1071
2020-07-19,Panama,1207,25,53468,1096
2020-07-20,Panama,958,31,54426,1127
2020-07-21,Panama,727,32,55153,1159
2020-07-22,Panama,753,21,55906,1180
2020-07-23,Panama,911,29,56817,1209
2020-07-24,Panama,1176,41,57993,1250
2020-07-25,Panama,871,25,58864,1275
2020-07-26,Panama,1432,19,60296,1294
2020-07-27,Panama,1146,28,61442,1322
2020-07-28,Panama,781,27,62223,1349
2020-07-29,Panama,1046,25,63269,1374
2020-07-30,Panama,922,23,64191,1397
2020-07-31,Panama,1065,24,65256,1421
2020-08-01,Panama,1127,28,66383,1449
2020-08-02,Panama,1070,22,67453,1471
2020-08-03,Panama,1003,26,68456,1497
2020-08-04,Panama,968,25,69424,1522
2020-08-05,Panama,807,31,70231,1553
2020-08-06,Panama,1187,21,71418,1574
2020-08-07,Panama,1142,17,72560,1591
2020-08-08,Panama,1091,18,73651,1609
2020-08-09,Panama,841,30,74492,1639
2020-08-10,Panama,902,25,75394,1664
2020-08-11,Panama,1070,16,76464,1680
2020-08-12,Panama,913,23,77377,1703
2020-08-13,Panama,1069,19,78446,1722
2020-08-14,Panama,956,12,79402,1734
2020-08-15,Panama,1263,12,80665,1746
2020-08-16,Panama,1275,21,81940,1767
2020-08-17,Panama,603,21,82543,1788
2020-08-18,Panama,247,21,82790,1809
2020-08-19,Panama,964,18,83754,1827
2020-08-20,Panama,101,17,83855,1844
2020-08-21,Panama,537,15,84392,1859
2020-08-22,Panama,1088,19,85480,1878
2020-08-23,Panama,1420,14,86900,1892
2020-08-24,Panama,585,14,87485,1906
2020-08-25,Panama,896,13,88381,1919
2020-08-26,Panama,701,13,89082,1932
2020-08-27,Panama,900,16,89982,1948
2020-08-28,Panama,642,18,90624,1966
2020-08-29,Panama,713,17,91337,1983
2020-08-30,Panama,728,12,92065,1995
2020-08-31,Panama,917,7,92982,2002
2020-09-01,Panama,570,16,93552,2018
2020-09-02,Panama,532,12,94084,2030
2020-09-03,Panama,830,16,94914,2046
2020-09-04,Panama,682,17,95596,2063
2020-09-05,Panama,709,12,96305,2075
2020-09-06,Panama,738,11,97043,2086
2020-09-07,Panama,535,13,97578,2099
2020-09-08,Panama,829,8,98407,2107
2020-09-09,Panama,635,9,99042,2116
2020-09-10,Panama,673,11,99715,2127
2020-09-11,Panama,615,13,100330,2140
2020-09-12,Panama,711,15,101041,2155
2020-09-13,Panama,704,11,101745,2166
2020-09-14,Panama,459,7,102204,2173
2020-09-15,Panama,628,14,102832,2187
2020-09-16,Panama,634,11,103466,2198
2020-09-17,Panama,672,15,104138,2213
2020-09-18,Panama,741,16,104879,2229
2020-09-19,Panama,722,18,105601,2247
2020-09-20,Panama,602,10,106203,2257
2020-09-21,Panama,607,15,106810,2272
2020-09-22,Panama,474,13,107284,2285
2020-09-23,Panama,706,6,107990,2291
2020-09-24,Panama,736,6,108726,2297
2020-09-25,Panama,705,14,109431,2311
2020-09-26,Panama,677,12,110108,2323
2020-09-27,Panama,447,17,110555,2340
2020-09-28,Panama,722,8,111277,2348
2020-09-29,Panama,576,16,111853,2364
2020-09-30,Panama,742,8,112595,2372
2020-10-01,Panama,747,15,113342,2387
2020-10-02,Panama,620,19,113962,2406
2020-10-03,Panama,691,8,114653,2414
2020-10-04,Panama,633,9,115286,2423
2020-10-05,Panama,633,7,115919,2430
2020-10-06,Panama,683,10,116602,2440
2020-10-07,Panama,698,8,117300,2448
2020-10-08,Panama,754,15,118054,2463
2020-10-09,Panama,787,11,118841,2474
2020-10-10,Panama,825,8,119666,2482
2020-10-11,Panama,647,9,120313,2491
2020-10-12,Panama,489,11,120802,2502
2020-10-13,Panama,494,9,121296,2511
2020-10-14,Panama,832,8,122128,2519
2020-10-15,Panama,755,10,122883,2529
2020-10-16,Panama,615,17,123498,2546
2020-10-17,Panama,609,11,124107,2557
2020-10-18,Panama,638,7,124745,2564
2020-10-19,Panama,436,10,125181,2574
2020-10-20,Panama,558,11,125739,2585
2020-10-21,Panama,696,12,126435,2597
2020-10-22,Panama,792,15,127227,2612
2020-10-23,Panama,639,10,127866,2622
2020-10-24,Panama,649,6,128515,2628
2020-10-25,Panama,685,5,129200,2633
2020-10-26,Panama,551,5,129751,2638
2020-10-27,Panama,671,12,130422,2650
2020-10-28,Panama,825,13,131247,2663
2020-10-29,Panama,798,15,132045,2678
2020-10-30,Panama,822,10,132867,2688
2020-10-31,Panama,731,12,133598,2700
2020-11-01,Panama,738,6,134336,2706
2020-11-02,Panama,579,14,134915,2720
2020-11-03,Panama,677,11,135592,2731
2020-11-04,Panama,432,13,136024,2744
2020-11-05,Panama,543,12,136567,2756
2020-11-06,Panama,1193,14,137760,2770
2020-11-07,Panama,746,11,138506,2781
2020-11-08,Panama,1021,17,139527,2798
2020-11-09,Panama,804,10,140331,2808
2020-11-10,Panama,971,9,141302,2817
2020-11-11,Panama,1163,6,142465,2823
2020-11-12,Panama,887,7,143352,2830
2020-11-13,Panama,1125,26,144477,2856
2020-11-14,Panama,832,11,145309,2867
2020-11-15,Panama,1344,6,146653,2873
2020-11-16,Panama,1014,8,147667,2881
2020-11-17,Panama,1054,12,148721,2893
2020-11-18,Panama,1112,14,149833,2907
2020-11-19,Panama,1256,15,151089,2922
2020-11-20,Panama,1200,10,152289,2932
2020-11-21,Panama,1288,14,153577,2946
2020-11-22,Panama,1206,11,154783,2957
2020-11-23,Panama,875,16,155658,2973
2020-11-24,Panama,1272,13,156930,2986
2020-11-25,Panama,1602,16,158532,3002
2020-11-26,Panama,1755,16,160287,3018
2020-11-27,Panama,1457,12,161744,3030
2020-11-28,Panama,1709,9,163453,3039
2020-11-29,Panama,1276,21,164729,3060
2020-11-30,Panama,1077,19,165806,3079
2020-12-01,Panama,1505,19,167311,3098
2020-12-02,Panama,2028,16,169339,3114
2020-12-03,Panama,1880,27,171219,3141
2020-12-04,Panama,2388,13,173607,3154
2020-12-05,Panama,2300,19,175907,3173
2020-12-06,Panama,1812,20,177719,3193
2020-12-07,Panama,1511,19,179230,3212
2020-12-08,Panama,1936,29,181166,3241
2020-12-09,Panama,1811,23,182977,3264
2020-12-10,Panama,2447,23,185424,3287
2020-12-11,Panama,2355,22,187779,3309
2020-12-12,Panama,2806,22,190585,3331
2020-12-13,Panama,2422,25,193007,3356
2020-12-14,Panama,1612,26,194619,3382
2020-12-15,Panama,2368,29,196987,3411
2020-12-16,Panama,2960,28,199947,3439
2020-12-17,Panama,3348,42,203295,3481
2020-12-18,Panama,3015,23,206310,3504
2020-12-19,Panama,3274,23,209584,3527
2020-12-20,Panama,2755,39,212339,3566
2020-12-21,Panama,1699,31,214038,3597
2020-12-22,Panama,3164,35,217202,3632
2020-12-23,Panama,3059,32,220261,3664
2020-12-24,Panama,3413,51,223674,3715
2020-12-25,Panama,2986,41,226660,3756
2020-12-26,Panama,2064,43,228724,3799
2020-12-27,Panama,2633,41,231357,3840
2020-12-28,Panama,2348,52,233705,3892
2020-12-29,Panama,4574,41,238279,3933
2020-12-30,Panama,4465,42,242744,3975
2020-12-31,Panama,4046,47,246790,4022
2021-01-01,Panama,2943,42,249733,4064
2021-01-02,Panama,2031,39,251764,4103
2021-01-03,Panama,1972,37,253736,4140
2021-01-04,Panama,2494,57,256230,4197
2021-01-05,Panama,3540,41,259770,4238
2021-01-06,Panama,5186,45,264956,4283
2021-01-07,Panama,4135,38,269091,4321
2021-01-08,Panama,3946,42,273037,4363
2021-01-09,Panama,3735,43,276772,4406
2021-01-10,Panama,2424,49,279196,4455
2021-01-11,Panama,2157,45,281353,4500
2021-01-12,Panama,3740,61,285093,4561
2021-01-13,Panama,3315,33,288408,4594
2021-01-14,Panama,2877,57,291285,4651
2021-01-15,Panama,2307,38,293592,4689
2021-01-16,Panama,2677,49,296269,4738
2021-01-17,Panama,1750,49,298019,4787
2021-01-18,Panama,1342,41,299361,4828
2021-01-19,Panama,2173,36,301534,4864
2021-01-20,Panama,2243,48,303777,4912
2021-01-21,Panama,1975,32,305752,4944
2021-01-22,Panama,2041,36,307793,4980
2021-01-23,Panama,2058,54,309851,5034
2021-01-24,Panama,1393,29,311244,5063
2021-01-25,Panama,914,35,312158,5098
2021-01-26,Panama,1676,39,313834,5137
2021-01-27,Panama,1566,39,315400,5176
2021-01-28,Panama,1408,20,316808,5196
2021-01-29,Panama,1445,25,318253,5221
2021-01-30,Panama,1200,23,319453,5244
2021-01-31,Panama,926,26,320379,5270
2021-02-01,Panama,724,26,321103,5296
2021-02-02,Panama,1098,43,322201,5339
2021-02-03,Panama,1181,27,323382,5366
2021-02-04,Panama,1107,25,324489,5391
2021-02-05,Panama,998,35,325487,5426
2021-02-06,Panama,977,29,326464,5455
2021-02-07,Panama,627,25,327091,5480
2021-02-08,Panama,563,26,327654,5506
2021-02-09,Panama,822,25,328476,5531
2021-02-10,Panama,891,19,329367,5550
2021-02-11,Panama,708,22,330075,5572
2021-02-12,Panama,910,23,330985,5595
2021-02-13,Panama,707,26,331692,5621
2021-02-14,Panama,487,15,332179,5636
2021-02-15,Panama,500,6,332679,5642
2021-02-16,Panama,572,13,333251,5655
2021-02-17,Panama,504,17,333755,5672
2021-02-18,Panama,708,22,334463,5694
2021-02-19,Panama,876,17,335339,5711
2021-02-20,Panama,698,16,336037,5727
2021-02-21,Panama,484,15,336521,5742
2021-02-22,Panama,566,14,337087,5756
2021-02-23,Panama,718,16,337805,5772
2021-02-24,Panama,896,17,338701,5789
2021-02-25,Panama,682,21,339383,5810
2021-02-26,Panama,398,10,339781,5820
2021-02-27,Panama,664,11,340445,5831
2021-02-28,Panama,470,14,340915,5845
2021-03-01,Panama,505,13,341420,5858
2021-03-02,Panama,599,13,342019,5871
2021-03-03,Panama,722,13,342741,5884
2021-03-04,Panama,540,11,343281,5895
2021-03-05,Panama,462,12,343743,5907
2021-03-06,Panama,734,3,344477,5910
2021-03-07,Panama,357,13,344834,5923
2021-03-08,Panama,402,11,345236,5934
2021-03-09,Panama,523,10,345759,5944
2021-03-10,Panama,542,13,346301,5957
2021-03-11,Panama,474,15,346775,5972
2021-03-12,Panama,451,9,347226,5981
2021-03-13,Panama,415,6,347641,5987
2021-03-14,Panama,278,7,347919,5994
2021-03-15,Panama,236,11,348155,6005
2021-03-16,Panama,425,4,348580,6009
2021-03-17,Panama,440,9,349020,6018
2021-03-18,Panama,485,7,349505,6025
2021-03-19,Panama,715,10,350220,6035
2021-03-20,Panama,445,7,350665,6042
2021-03-21,Panama,326,2,350991,6044
2021-03-22,Panama,222,8,351213,6052
2021-03-23,Panama,454,8,351667,6060
2021-03-24,Panama,415,5,352082,6065
2021-03-25,Panama,497,8,352579,6073
2021-03-26,Panama,438,14,353017,6087
2021-03-27,Panama,480,3,353497,6090
2021-03-28,Panama,342,10,353839,6100
2021-03-29,Panama,246,3,354085,6103
2021-03-30,Panama,519,6,354604,6109
2021-03-31,Panama,447,5,355051,6114
2021-04-01,Panama,448,5,355499,6119
2021-04-02,Panama,351,7,355850,6126
2021-04-03,Panama,223,5,356073,6131
2021-04-04,Panama,304,4,356377,6135
2021-04-05,Panama,179,3,356556,6138
2021-04-06,Panama,357,8,356913,6146
2021-04-07,Panama,364,2,357277,6148
2021-04-08,Panama,427,4,357704,6152
2020-03-20,Papua New Guinea,1,0,1,0
2020-03-21,Papua New Guinea,0,0,1,0
2020-03-22,Papua New Guinea,0,0,1,0
2020-03-23,Papua New Guinea,0,0,1,0
2020-03-24,Papua New Guinea,0,0,1,0
2020-03-25,Papua New Guinea,0,0,1,0
2020-03-26,Papua New Guinea,0,0,1,0
2020-03-27,Papua New Guinea,0,0,1,0
2020-03-28,Papua New Guinea,0,0,1,0
2020-03-29,Papua New Guinea,0,0,1,0
2020-03-30,Papua New Guinea,0,0,1,0
2020-03-31,Papua New Guinea,0,0,1,0
2020-04-01,Papua New Guinea,0,0,1,0
2020-04-02,Papua New Guinea,0,0,1,0
2020-04-03,Papua New Guinea,0,0,1,0
2020-04-04,Papua New Guinea,0,0,1,0
2020-04-05,Papua New Guinea,0,0,1,0
2020-04-06,Papua New Guinea,1,0,2,0
2020-04-07,Papua New Guinea,0,0,2,0
2020-04-08,Papua New Guinea,0,0,2,0
2020-04-09,Papua New Guinea,0,0,2,0
2020-04-10,Papua New Guinea,0,0,2,0
2020-04-11,Papua New Guinea,0,0,2,0
2020-04-12,Papua New Guinea,0,0,2,0
2020-04-13,Papua New Guinea,0,0,2,0
2020-04-14,Papua New Guinea,0,0,2,0
2020-04-15,Papua New Guinea,0,0,2,0
2020-04-16,Papua New Guinea,5,0,7,0
2020-04-17,Papua New Guinea,0,0,7,0
2020-04-18,Papua New Guinea,0,0,7,0
2020-04-19,Papua New Guinea,0,0,7,0
2020-04-20,Papua New Guinea,0,0,7,0
2020-04-21,Papua New Guinea,0,0,7,0
2020-04-22,Papua New Guinea,1,0,8,0
2020-04-23,Papua New Guinea,0,0,8,0
2020-04-24,Papua New Guinea,0,0,8,0
2020-04-25,Papua New Guinea,0,0,8,0
2020-04-26,Papua New Guinea,0,0,8,0
2020-04-27,Papua New Guinea,0,0,8,0
2020-04-28,Papua New Guinea,0,0,8,0
2020-04-29,Papua New Guinea,0,0,8,0
2020-04-30,Papua New Guinea,0,0,8,0
2020-05-01,Papua New Guinea,0,0,8,0
2020-05-02,Papua New Guinea,0,0,8,0
2020-05-03,Papua New Guinea,0,0,8,0
2020-05-04,Papua New Guinea,0,0,8,0
2020-05-05,Papua New Guinea,0,0,8,0
2020-05-06,Papua New Guinea,0,0,8,0
2020-05-07,Papua New Guinea,0,0,8,0
2020-05-08,Papua New Guinea,0,0,8,0
2020-05-09,Papua New Guinea,0,0,8,0
2020-05-10,Papua New Guinea,0,0,8,0
2020-05-11,Papua New Guinea,0,0,8,0
2020-05-12,Papua New Guinea,0,0,8,0
2020-05-13,Papua New Guinea,0,0,8,0
2020-05-14,Papua New Guinea,0,0,8,0
2020-05-15,Papua New Guinea,0,0,8,0
2020-05-16,Papua New Guinea,0,0,8,0
2020-05-17,Papua New Guinea,0,0,8,0
2020-05-18,Papua New Guinea,0,0,8,0
2020-05-19,Papua New Guinea,0,0,8,0
2020-05-20,Papua New Guinea,0,0,8,0
2020-05-21,Papua New Guinea,0,0,8,0
2020-05-22,Papua New Guinea,0,0,8,0
2020-05-23,Papua New Guinea,0,0,8,0
2020-05-24,Papua New Guinea,0,0,8,0
2020-05-25,Papua New Guinea,0,0,8,0
2020-05-26,Papua New Guinea,0,0,8,0
2020-05-27,Papua New Guinea,0,0,8,0
2020-05-28,Papua New Guinea,0,0,8,0
2020-05-29,Papua New Guinea,0,0,8,0
2020-05-30,Papua New Guinea,0,0,8,0
2020-05-31,Papua New Guinea,0,0,8,0
2020-06-01,Papua New Guinea,0,0,8,0
2020-06-02,Papua New Guinea,0,0,8,0
2020-06-03,Papua New Guinea,0,0,8,0
2020-06-04,Papua New Guinea,0,0,8,0
2020-06-05,Papua New Guinea,0,0,8,0
2020-06-06,Papua New Guinea,0,0,8,0
2020-06-07,Papua New Guinea,0,0,8,0
2020-06-08,Papua New Guinea,0,0,8,0
2020-06-09,Papua New Guinea,0,0,8,0
2020-06-10,Papua New Guinea,0,0,8,0
2020-06-11,Papua New Guinea,0,0,8,0
2020-06-12,Papua New Guinea,0,0,8,0
2020-06-13,Papua New Guinea,0,0,8,0
2020-06-14,Papua New Guinea,0,0,8,0
2020-06-15,Papua New Guinea,0,0,8,0
2020-06-16,Papua New Guinea,0,0,8,0
2020-06-17,Papua New Guinea,0,0,8,0
2020-06-18,Papua New Guinea,0,0,8,0
2020-06-19,Papua New Guinea,0,0,8,0
2020-06-20,Papua New Guinea,0,0,8,0
2020-06-21,Papua New Guinea,0,0,8,0
2020-06-22,Papua New Guinea,1,0,9,0
2020-06-23,Papua New Guinea,0,0,9,0
2020-06-24,Papua New Guinea,1,0,10,0
2020-06-25,Papua New Guinea,0,0,10,0
2020-06-26,Papua New Guinea,1,0,11,0
2020-06-27,Papua New Guinea,0,0,11,0
2020-06-28,Papua New Guinea,0,0,11,0
2020-06-29,Papua New Guinea,0,0,11,0
2020-06-30,Papua New Guinea,0,0,11,0
2020-07-01,Papua New Guinea,0,0,11,0
2020-07-02,Papua New Guinea,0,0,11,0
2020-07-03,Papua New Guinea,0,0,11,0
2020-07-04,Papua New Guinea,0,0,11,0
2020-07-05,Papua New Guinea,0,0,11,0
2020-07-06,Papua New Guinea,0,0,11,0
2020-07-07,Papua New Guinea,0,0,11,0
2020-07-08,Papua New Guinea,0,0,11,0
2020-07-09,Papua New Guinea,0,0,11,0
2020-07-10,Papua New Guinea,0,0,11,0
2020-07-11,Papua New Guinea,0,0,11,0
2020-07-12,Papua New Guinea,0,0,11,0
2020-07-13,Papua New Guinea,0,0,11,0
2020-07-14,Papua New Guinea,0,0,11,0
2020-07-15,Papua New Guinea,0,0,11,0
2020-07-16,Papua New Guinea,0,0,11,0
2020-07-17,Papua New Guinea,4,0,15,0
2020-07-18,Papua New Guinea,1,0,16,0
2020-07-19,Papua New Guinea,0,0,16,0
2020-07-20,Papua New Guinea,3,0,19,0
2020-07-21,Papua New Guinea,8,0,27,0
2020-07-22,Papua New Guinea,3,0,30,0
2020-07-23,Papua New Guinea,1,0,31,0
2020-07-24,Papua New Guinea,1,0,32,0
2020-07-25,Papua New Guinea,7,0,39,0
2020-07-26,Papua New Guinea,23,0,62,0
2020-07-27,Papua New Guinea,0,0,62,0
2020-07-28,Papua New Guinea,1,0,63,0
2020-07-29,Papua New Guinea,0,1,63,1
2020-07-30,Papua New Guinea,0,1,63,2
2020-07-31,Papua New Guinea,9,0,72,2
2020-08-01,Papua New Guinea,19,0,91,2
2020-08-02,Papua New Guinea,19,0,110,2
2020-08-03,Papua New Guinea,1,0,111,2
2020-08-04,Papua New Guinea,3,0,114,2
2020-08-05,Papua New Guinea,39,0,153,2
2020-08-06,Papua New Guinea,10,1,163,3
2020-08-07,Papua New Guinea,25,0,188,3
2020-08-08,Papua New Guinea,0,0,188,3
2020-08-09,Papua New Guinea,26,0,214,3
2020-08-10,Papua New Guinea,0,0,214,3
2020-08-11,Papua New Guinea,0,0,214,3
2020-08-12,Papua New Guinea,73,0,287,3
2020-08-13,Papua New Guinea,-16,0,271,3
2020-08-14,Papua New Guinea,0,0,271,3
2020-08-15,Papua New Guinea,0,0,271,3
2020-08-16,Papua New Guinea,52,0,323,3
2020-08-17,Papua New Guinea,10,0,333,3
2020-08-18,Papua New Guinea,14,0,347,3
2020-08-19,Papua New Guinea,0,0,347,3
2020-08-20,Papua New Guinea,14,1,361,4
2020-08-21,Papua New Guinea,0,0,361,4
2020-08-22,Papua New Guinea,0,0,361,4
2020-08-23,Papua New Guinea,40,0,401,4
2020-08-24,Papua New Guinea,0,0,401,4
2020-08-25,Papua New Guinea,18,0,419,4
2020-08-26,Papua New Guinea,0,0,419,4
2020-08-27,Papua New Guinea,5,0,424,4
2020-08-28,Papua New Guinea,29,1,453,5
2020-08-29,Papua New Guinea,0,0,453,5
2020-08-30,Papua New Guinea,6,0,459,5
2020-08-31,Papua New Guinea,0,0,459,5
2020-09-01,Papua New Guinea,1,0,460,5
2020-09-02,Papua New Guinea,11,0,471,5
2020-09-03,Papua New Guinea,0,0,471,5
2020-09-04,Papua New Guinea,8,0,479,5
2020-09-05,Papua New Guinea,9,0,488,5
2020-09-06,Papua New Guinea,9,0,497,5
2020-09-07,Papua New Guinea,0,0,497,5
2020-09-08,Papua New Guinea,6,0,503,5
2020-09-09,Papua New Guinea,1,0,504,5
2020-09-10,Papua New Guinea,3,0,507,5
2020-09-11,Papua New Guinea,1,0,508,5
2020-09-12,Papua New Guinea,0,0,508,5
2020-09-13,Papua New Guinea,2,1,510,6
2020-09-14,Papua New Guinea,1,0,511,6
2020-09-15,Papua New Guinea,0,0,511,6
2020-09-16,Papua New Guinea,5,0,516,6
2020-09-17,Papua New Guinea,0,0,516,6
2020-09-18,Papua New Guinea,0,0,516,6
2020-09-19,Papua New Guinea,0,0,516,6
2020-09-20,Papua New Guinea,1,1,517,7
2020-09-21,Papua New Guinea,0,0,517,7
2020-09-22,Papua New Guinea,10,0,527,7
2020-09-23,Papua New Guinea,0,0,527,7
2020-09-24,Papua New Guinea,4,0,531,7
2020-09-25,Papua New Guinea,1,0,532,7
2020-09-26,Papua New Guinea,0,0,532,7
2020-09-27,Papua New Guinea,0,0,532,7
2020-09-28,Papua New Guinea,0,0,532,7
2020-09-29,Papua New Guinea,2,0,534,7
2020-09-30,Papua New Guinea,0,0,534,7
2020-10-01,Papua New Guinea,5,0,539,7
2020-10-02,Papua New Guinea,0,0,539,7
2020-10-03,Papua New Guinea,1,0,540,7
2020-10-04,Papua New Guinea,0,0,540,7
2020-10-05,Papua New Guinea,0,0,540,7
2020-10-06,Papua New Guinea,1,0,541,7
2020-10-07,Papua New Guinea,0,0,541,7
2020-10-08,Papua New Guinea,8,0,549,7
2020-10-09,Papua New Guinea,0,0,549,7
2020-10-10,Papua New Guinea,0,0,549,7
2020-10-11,Papua New Guinea,5,0,554,7
2020-10-12,Papua New Guinea,11,0,565,7
2020-10-13,Papua New Guinea,0,0,565,7
2020-10-14,Papua New Guinea,13,0,578,7
2020-10-15,Papua New Guinea,0,0,578,7
2020-10-16,Papua New Guinea,0,0,578,7
2020-10-17,Papua New Guinea,3,0,581,7
2020-10-18,Papua New Guinea,0,0,581,7
2020-10-19,Papua New Guinea,0,0,581,7
2020-10-20,Papua New Guinea,0,0,581,7
2020-10-21,Papua New Guinea,0,0,581,7
2020-10-22,Papua New Guinea,2,0,583,7
2020-10-23,Papua New Guinea,0,0,583,7
2020-10-24,Papua New Guinea,0,0,583,7
2020-10-25,Papua New Guinea,0,0,583,7
2020-10-26,Papua New Guinea,5,0,588,7
2020-10-27,Papua New Guinea,0,0,588,7
2020-10-28,Papua New Guinea,0,0,588,7
2020-10-29,Papua New Guinea,1,0,589,7
2020-10-30,Papua New Guinea,0,0,589,7
2020-10-31,Papua New Guinea,0,0,589,7
2020-11-01,Papua New Guinea,0,0,589,7
2020-11-02,Papua New Guinea,1,0,590,7
2020-11-03,Papua New Guinea,7,0,597,7
2020-11-04,Papua New Guinea,0,0,597,7
2020-11-05,Papua New Guinea,0,0,597,7
2020-11-06,Papua New Guinea,0,0,597,7
2020-11-07,Papua New Guinea,0,0,597,7
2020-11-08,Papua New Guinea,2,0,599,7
2020-11-09,Papua New Guinea,0,0,599,7
2020-11-10,Papua New Guinea,0,0,599,7
2020-11-11,Papua New Guinea,0,0,599,7
2020-11-12,Papua New Guinea,0,0,599,7
2020-11-13,Papua New Guinea,1,0,600,7
2020-11-14,Papua New Guinea,0,0,600,7
2020-11-15,Papua New Guinea,2,0,602,7
2020-11-16,Papua New Guinea,0,0,602,7
2020-11-17,Papua New Guinea,0,0,602,7
2020-11-18,Papua New Guinea,2,0,604,7
2020-11-19,Papua New Guinea,0,0,604,7
2020-11-20,Papua New Guinea,0,0,604,7
2020-11-21,Papua New Guinea,0,0,604,7
2020-11-22,Papua New Guinea,0,0,604,7
2020-11-23,Papua New Guinea,26,0,630,7
2020-11-24,Papua New Guinea,0,0,630,7
2020-11-25,Papua New Guinea,15,0,645,7
2020-11-26,Papua New Guinea,0,0,645,7
2020-11-27,Papua New Guinea,0,0,645,7
2020-11-28,Papua New Guinea,0,0,645,7
2020-11-29,Papua New Guinea,0,0,645,7
2020-11-30,Papua New Guinea,11,0,656,7
2020-12-01,Papua New Guinea,13,0,669,7
2020-12-02,Papua New Guinea,0,0,669,7
2020-12-03,Papua New Guinea,2,0,671,7
2020-12-04,Papua New Guinea,0,0,671,7
2020-12-05,Papua New Guinea,0,0,671,7
2020-12-06,Papua New Guinea,0,0,671,7
2020-12-07,Papua New Guinea,0,0,671,7
2020-12-08,Papua New Guinea,13,0,684,7
2020-12-09,Papua New Guinea,0,0,684,7
2020-12-10,Papua New Guinea,0,0,684,7
2020-12-11,Papua New Guinea,36,1,720,8
2020-12-12,Papua New Guinea,0,0,720,8
2020-12-13,Papua New Guinea,5,0,725,8
2020-12-14,Papua New Guinea,0,0,725,8
2020-12-15,Papua New Guinea,4,0,729,8
2020-12-16,Papua New Guinea,0,0,729,8
2020-12-17,Papua New Guinea,31,0,760,8
2020-12-18,Papua New Guinea,0,0,760,8
2020-12-19,Papua New Guinea,0,0,760,8
2020-12-20,Papua New Guinea,0,0,760,8
2020-12-21,Papua New Guinea,1,1,761,9
2020-12-22,Papua New Guinea,0,0,761,9
2020-12-23,Papua New Guinea,0,0,761,9
2020-12-24,Papua New Guinea,19,0,780,9
2020-12-25,Papua New Guinea,0,0,780,9
2020-12-26,Papua New Guinea,0,0,780,9
2020-12-27,Papua New Guinea,0,0,780,9
2020-12-28,Papua New Guinea,0,0,780,9
2020-12-29,Papua New Guinea,0,0,780,9
2020-12-30,Papua New Guinea,0,0,780,9
2020-12-31,Papua New Guinea,0,0,780,9
2021-01-01,Papua New Guinea,0,0,780,9
2021-01-02,Papua New Guinea,0,0,780,9
2021-01-03,Papua New Guinea,19,0,799,9
2021-01-04,Papua New Guinea,0,0,799,9
2021-01-05,Papua New Guinea,0,0,799,9
2021-01-06,Papua New Guinea,0,0,799,9
2021-01-07,Papua New Guinea,0,0,799,9
2021-01-08,Papua New Guinea,12,0,811,9
2021-01-09,Papua New Guinea,0,0,811,9
2021-01-10,Papua New Guinea,0,0,811,9
2021-01-11,Papua New Guinea,8,0,819,9
2021-01-12,Papua New Guinea,4,0,823,9
2021-01-13,Papua New Guinea,10,0,833,9
2021-01-14,Papua New Guinea,1,0,834,9
2021-01-15,Papua New Guinea,0,0,834,9
2021-01-16,Papua New Guinea,0,0,834,9
2021-01-17,Papua New Guinea,0,0,834,9
2021-01-18,Papua New Guinea,0,0,834,9
2021-01-19,Papua New Guinea,0,0,834,9
2021-01-20,Papua New Guinea,1,0,835,9
2021-01-21,Papua New Guinea,0,0,835,9
2021-01-22,Papua New Guinea,0,0,835,9
2021-01-23,Papua New Guinea,0,0,835,9
2021-01-24,Papua New Guinea,0,0,835,9
2021-01-25,Papua New Guinea,0,0,835,9
2021-01-26,Papua New Guinea,15,0,850,9
2021-01-27,Papua New Guinea,1,0,851,9
2021-01-28,Papua New Guinea,0,0,851,9
2021-01-29,Papua New Guinea,0,0,851,9
2021-01-30,Papua New Guinea,0,0,851,9
2021-01-31,Papua New Guinea,0,0,851,9
2021-02-01,Papua New Guinea,16,0,867,9
2021-02-02,Papua New Guinea,0,0,867,9
2021-02-03,Papua New Guinea,0,0,867,9
2021-02-04,Papua New Guinea,0,0,867,9
2021-02-05,Papua New Guinea,24,0,891,9
2021-02-06,Papua New Guinea,0,0,891,9
2021-02-07,Papua New Guinea,4,0,895,9
2021-02-08,Papua New Guinea,5,0,900,9
2021-02-09,Papua New Guinea,0,0,900,9
2021-02-10,Papua New Guinea,0,0,900,9
2021-02-11,Papua New Guinea,14,0,914,9
2021-02-12,Papua New Guinea,0,0,914,9
2021-02-13,Papua New Guinea,0,0,914,9
2021-02-14,Papua New Guinea,0,0,914,9
2021-02-15,Papua New Guinea,0,0,914,9
2021-02-16,Papua New Guinea,41,1,955,10
2021-02-17,Papua New Guinea,0,0,955,10
2021-02-18,Papua New Guinea,0,0,955,10
2021-02-19,Papua New Guinea,0,0,955,10
2021-02-20,Papua New Guinea,15,0,970,10
2021-02-21,Papua New Guinea,0,0,970,10
2021-02-22,Papua New Guinea,86,0,1056,10
2021-02-23,Papua New Guinea,55,0,1111,10
2021-02-24,Papua New Guinea,28,1,1139,11
2021-02-25,Papua New Guinea,89,1,1228,12
2021-02-26,Papua New Guinea,0,0,1228,12
2021-02-27,Papua New Guinea,47,0,1275,12
2021-02-28,Papua New Guinea,0,0,1275,12
2021-03-01,Papua New Guinea,90,2,1365,14
2021-03-02,Papua New Guinea,0,0,1365,14
2021-03-03,Papua New Guinea,0,0,1365,14
2021-03-04,Papua New Guinea,0,0,1365,14
2021-03-05,Papua New Guinea,127,2,1492,16
2021-03-06,Papua New Guinea,0,0,1492,16
2021-03-07,Papua New Guinea,91,0,1583,16
2021-03-08,Papua New Guinea,87,0,1670,16
2021-03-09,Papua New Guinea,71,0,1741,16
2021-03-10,Papua New Guinea,0,0,1741,16
2021-03-11,Papua New Guinea,78,5,1819,21
2021-03-12,Papua New Guinea,0,0,1819,21
2021-03-13,Papua New Guinea,0,0,1819,21
2021-03-14,Papua New Guinea,354,0,2173,21
2021-03-15,Papua New Guinea,96,5,2269,26
2021-03-16,Papua New Guinea,82,0,2351,26
2021-03-17,Papua New Guinea,0,0,2351,26
2021-03-18,Papua New Guinea,128,5,2479,31
2021-03-19,Papua New Guinea,179,5,2658,36
2021-03-20,Papua New Guinea,427,0,3085,36
2021-03-21,Papua New Guinea,0,0,3085,36
2021-03-22,Papua New Guinea,274,0,3359,36
2021-03-23,Papua New Guinea,399,1,3758,37
2021-03-24,Papua New Guinea,351,2,4109,39
2021-03-25,Papua New Guinea,0,0,4109,39
2021-03-26,Papua New Guinea,551,0,4660,39
2021-03-27,Papua New Guinea,0,0,4660,39
2021-03-28,Papua New Guinea,524,6,5184,45
2021-03-29,Papua New Guinea,165,4,5349,49
2021-03-30,Papua New Guinea,271,7,5620,56
2021-03-31,Papua New Guinea,371,4,5991,60
2021-04-01,Papua New Guinea,121,0,6112,60
2021-04-02,Papua New Guinea,363,0,6475,60
2021-04-03,Papua New Guinea,144,0,6619,60
2021-04-04,Papua New Guinea,419,1,7038,61
2021-04-05,Papua New Guinea,368,6,7406,67
2021-04-06,Papua New Guinea,0,0,7406,67
2021-04-07,Papua New Guinea,228,1,7634,68
2021-04-08,Papua New Guinea,205,0,7839,68
2020-03-08,Paraguay,1,0,1,0
2020-03-09,Paraguay,0,0,1,0
2020-03-10,Paraguay,0,0,1,0
2020-03-11,Paraguay,4,0,5,0
2020-03-12,Paraguay,0,0,5,0
2020-03-13,Paraguay,1,0,6,0
2020-03-14,Paraguay,0,0,6,0
2020-03-15,Paraguay,0,0,6,0
2020-03-16,Paraguay,2,0,8,0
2020-03-17,Paraguay,1,0,9,0
2020-03-18,Paraguay,2,0,11,0
2020-03-19,Paraguay,0,0,11,0
2020-03-20,Paraguay,2,0,13,0
2020-03-21,Paraguay,5,1,18,1
2020-03-22,Paraguay,4,0,22,1
2020-03-23,Paraguay,0,0,22,1
2020-03-24,Paraguay,5,1,27,2
2020-03-25,Paraguay,10,1,37,3
2020-03-26,Paraguay,4,0,41,3
2020-03-27,Paraguay,11,0,52,3
2020-03-28,Paraguay,4,0,56,3
2020-03-29,Paraguay,3,0,59,3
2020-03-30,Paraguay,5,0,64,3
2020-03-31,Paraguay,1,0,65,3
2020-04-01,Paraguay,4,0,69,3
2020-04-02,Paraguay,8,0,77,3
2020-04-03,Paraguay,15,0,92,3
2020-04-04,Paraguay,4,0,96,3
2020-04-05,Paraguay,8,0,104,3
2020-04-06,Paraguay,9,2,113,5
2020-04-07,Paraguay,2,0,115,5
2020-04-08,Paraguay,4,0,119,5
2020-04-09,Paraguay,5,0,124,5
2020-04-10,Paraguay,5,1,129,6
2020-04-11,Paraguay,4,0,133,6
2020-04-12,Paraguay,1,0,134,6
2020-04-13,Paraguay,13,0,147,6
2020-04-14,Paraguay,12,1,159,7
2020-04-15,Paraguay,2,1,161,8
2020-04-16,Paraguay,13,0,174,8
2020-04-17,Paraguay,25,0,199,8
2020-04-18,Paraguay,3,0,202,8
2020-04-19,Paraguay,4,0,206,8
2020-04-20,Paraguay,2,0,208,8
2020-04-21,Paraguay,0,0,208,8
2020-04-22,Paraguay,5,1,213,9
2020-04-23,Paraguay,0,0,213,9
2020-04-24,Paraguay,10,0,223,9
2020-04-25,Paraguay,5,0,228,9
2020-04-26,Paraguay,0,0,228,9
2020-04-27,Paraguay,0,0,228,9
2020-04-28,Paraguay,11,0,239,9
2020-04-29,Paraguay,0,0,239,9
2020-04-30,Paraguay,27,1,266,10
2020-05-01,Paraguay,67,0,333,10
2020-05-02,Paraguay,37,0,370,10
2020-05-03,Paraguay,26,0,396,10
2020-05-04,Paraguay,19,0,415,10
2020-05-05,Paraguay,16,0,431,10
2020-05-06,Paraguay,9,0,440,10
2020-05-07,Paraguay,22,0,462,10
2020-05-08,Paraguay,101,0,563,10
2020-05-09,Paraguay,126,0,689,10
2020-05-10,Paraguay,24,0,713,10
2020-05-11,Paraguay,11,0,724,10
2020-05-12,Paraguay,13,0,737,10
2020-05-13,Paraguay,3,1,740,11
2020-05-14,Paraguay,14,0,754,11
2020-05-15,Paraguay,5,0,759,11
2020-05-16,Paraguay,19,0,778,11
2020-05-17,Paraguay,8,0,786,11
2020-05-18,Paraguay,2,0,788,11
2020-05-19,Paraguay,41,0,829,11
2020-05-20,Paraguay,4,0,833,11
2020-05-21,Paraguay,3,0,836,11
2020-05-22,Paraguay,2,0,838,11
2020-05-23,Paraguay,12,0,850,11
2020-05-24,Paraguay,12,0,862,11
2020-05-25,Paraguay,3,0,865,11
2020-05-26,Paraguay,12,0,877,11
2020-05-27,Paraguay,7,0,884,11
2020-05-28,Paraguay,16,0,900,11
2020-05-29,Paraguay,17,0,917,11
2020-05-30,Paraguay,47,0,964,11
2020-05-31,Paraguay,22,0,986,11
2020-06-01,Paraguay,9,0,995,11
2020-06-02,Paraguay,18,0,1013,11
2020-06-03,Paraguay,57,0,1070,11
2020-06-04,Paraguay,16,0,1086,11
2020-06-05,Paraguay,1,0,1087,11
2020-06-06,Paraguay,3,0,1090,11
2020-06-07,Paraguay,45,0,1135,11
2020-06-08,Paraguay,10,0,1145,11
2020-06-09,Paraguay,42,0,1187,11
2020-06-10,Paraguay,15,0,1202,11
2020-06-11,Paraguay,28,0,1230,11
2020-06-12,Paraguay,24,0,1254,11
2020-06-13,Paraguay,7,0,1261,11
2020-06-14,Paraguay,28,0,1289,11
2020-06-15,Paraguay,7,1,1296,12
2020-06-16,Paraguay,7,1,1303,13
2020-06-17,Paraguay,5,0,1308,13
2020-06-18,Paraguay,22,0,1330,13
2020-06-19,Paraguay,6,0,1336,13
2020-06-20,Paraguay,26,0,1362,13
2020-06-21,Paraguay,17,0,1379,13
2020-06-22,Paraguay,13,0,1392,13
2020-06-23,Paraguay,30,0,1422,13
2020-06-24,Paraguay,106,0,1528,13
2020-06-25,Paraguay,41,0,1569,13
2020-06-26,Paraguay,142,0,1711,13
2020-06-27,Paraguay,231,2,1942,15
2020-06-28,Paraguay,185,0,2127,15
2020-06-29,Paraguay,64,1,2191,16
2020-06-30,Paraguay,30,1,2221,17
2020-07-01,Paraguay,39,2,2260,19
2020-07-02,Paraguay,43,0,2303,19
2020-07-03,Paraguay,46,0,2349,19
2020-07-04,Paraguay,36,1,2385,20
2020-07-05,Paraguay,42,0,2427,20
2020-07-06,Paraguay,29,0,2456,20
2020-07-07,Paraguay,46,0,2502,20
2020-07-08,Paraguay,52,0,2554,20
2020-07-09,Paraguay,84,0,2638,20
2020-07-10,Paraguay,98,0,2736,20
2020-07-11,Paraguay,84,1,2820,21
2020-07-12,Paraguay,128,1,2948,22
2020-07-13,Paraguay,32,3,2980,25
2020-07-14,Paraguay,94,0,3074,25
2020-07-15,Paraguay,124,0,3198,25
2020-07-16,Paraguay,144,2,3342,27
2020-07-17,Paraguay,115,1,3457,28
2020-07-18,Paraguay,172,1,3629,29
2020-07-19,Paraguay,92,2,3721,31
2020-07-20,Paraguay,27,2,3748,33
2020-07-21,Paraguay,69,2,3817,35
2020-07-22,Paraguay,183,1,4000,36
2020-07-23,Paraguay,113,0,4113,36
2020-07-24,Paraguay,111,2,4224,38
2020-07-25,Paraguay,104,2,4328,40
2020-07-26,Paraguay,116,1,4444,41
2020-07-27,Paraguay,104,2,4548,43
2020-07-28,Paraguay,126,2,4674,45
2020-07-29,Paraguay,192,1,4866,46
2020-07-30,Paraguay,341,1,5207,47
2020-07-31,Paraguay,131,2,5338,49
2020-08-01,Paraguay,147,3,5485,52
2020-08-02,Paraguay,159,0,5644,52
2020-08-03,Paraguay,80,3,5724,55
2020-08-04,Paraguay,128,4,5852,59
2020-08-05,Paraguay,208,2,6060,61
2020-08-06,Paraguay,315,5,6375,66
2020-08-07,Paraguay,133,3,6508,69
2020-08-08,Paraguay,197,3,6705,72
2020-08-09,Paraguay,202,3,6907,75
2020-08-10,Paraguay,327,7,7234,82
2020-08-11,Paraguay,285,4,7519,86
2020-08-12,Paraguay,499,7,8018,93
2020-08-13,Paraguay,371,4,8389,97
2020-08-14,Paraguay,633,11,9022,108
2020-08-15,Paraguay,359,19,9381,127
2020-08-16,Paraguay,410,11,9791,138
2020-08-17,Paraguay,344,7,10135,145
2020-08-18,Paraguay,471,16,10606,161
2020-08-19,Paraguay,527,4,11133,165
2020-08-20,Paraguay,684,5,11817,170
2020-08-21,Paraguay,719,12,12536,182
2020-08-22,Paraguay,438,10,12974,192
2020-08-23,Paraguay,259,13,13233,205
2020-08-24,Paraguay,369,14,13602,219
2020-08-25,Paraguay,626,12,14228,231
2020-08-26,Paraguay,644,16,14872,247
2020-08-27,Paraguay,418,18,15290,265
2020-08-28,Paraguay,583,15,15873,280
2020-08-29,Paraguay,601,14,16474,294
2020-08-30,Paraguay,631,14,17105,308
2020-08-31,Paraguay,557,18,17662,326
2020-09-01,Paraguay,676,22,18338,348
2020-09-02,Paraguay,800,10,19138,358
2020-09-03,Paraguay,821,15,19959,373
2020-09-04,Paraguay,695,25,20654,398
2020-09-05,Paraguay,1217,14,21871,412
2020-09-06,Paraguay,615,23,22486,435
2020-09-07,Paraguay,867,14,23353,449
2020-09-08,Paraguay,861,14,24214,463
2020-09-09,Paraguay,812,11,25026,474
2020-09-10,Paraguay,605,11,25631,485
2020-09-11,Paraguay,881,11,26512,496
2020-09-12,Paraguay,812,18,27324,514
2020-09-13,Paraguay,493,11,27817,525
2020-09-14,Paraguay,550,14,28367,539
2020-09-15,Paraguay,931,13,29298,552
2020-09-16,Paraguay,1121,14,30419,566
2020-09-17,Paraguay,694,18,31113,584
2020-09-18,Paraguay,1014,27,32127,611
2020-09-19,Paraguay,888,25,33015,636
2020-09-20,Paraguay,505,23,33520,659
2020-09-21,Paraguay,740,17,34260,676
2020-09-22,Paraguay,568,29,34828,705
2020-09-23,Paraguay,743,22,35571,727
2020-09-24,Paraguay,833,16,36404,743
2020-09-25,Paraguay,822,18,37226,761
2020-09-26,Paraguay,696,21,37922,782
2020-09-27,Paraguay,762,21,38684,803
2020-09-28,Paraguay,748,15,39432,818
2020-09-29,Paraguay,669,23,40101,841
2020-09-30,Paraguay,657,16,40758,857
2020-10-01,Paraguay,1041,12,41799,869
2020-10-02,Paraguay,885,21,42684,890
2020-10-03,Paraguay,768,23,43452,913
2020-10-04,Paraguay,730,16,44182,929
2020-10-05,Paraguay,533,18,44715,947
2020-10-06,Paraguay,932,19,45647,966
2020-10-07,Paraguay,788,23,46435,989
2020-10-08,Paraguay,881,23,47316,1012
2020-10-09,Paraguay,959,33,48275,1045
2020-10-10,Paraguay,703,20,48978,1065
2020-10-11,Paraguay,697,12,49675,1077
2020-10-12,Paraguay,669,19,50344,1096
2020-10-13,Paraguay,853,12,51197,1108
2020-10-14,Paraguay,648,23,51845,1131
2020-10-15,Paraguay,751,19,52596,1150
2020-10-16,Paraguay,886,15,53482,1165
2020-10-17,Paraguay,533,14,54015,1179
2020-10-18,Paraguay,709,9,54724,1188
2020-10-19,Paraguay,728,19,55452,1207
2020-10-20,Paraguay,621,24,56073,1231
2020-10-21,Paraguay,746,19,56819,1250
2020-10-22,Paraguay,707,12,57526,1262
2020-10-23,Paraguay,733,16,58259,1278
2020-10-24,Paraguay,784,15,59043,1293
2020-10-25,Paraguay,551,16,59594,1309
2020-10-26,Paraguay,515,24,60109,1333
2020-10-27,Paraguay,448,14,60557,1347
2020-10-28,Paraguay,733,12,61290,1359
2020-10-29,Paraguay,760,14,62050,1373
2020-10-30,Paraguay,546,14,62596,1387
2020-10-31,Paraguay,589,17,63185,1404
2020-11-01,Paraguay,546,14,63731,1418
2020-11-02,Paraguay,425,11,64156,1429
2020-11-03,Paraguay,472,12,64628,1441
2020-11-04,Paraguay,630,13,65258,1454
2020-11-05,Paraguay,520,8,65778,1462
2020-11-06,Paraguay,703,10,66481,1472
2020-11-07,Paraguay,460,7,66941,1479
2020-11-08,Paraguay,648,11,67589,1490
2020-11-09,Paraguay,359,12,67948,1502
2020-11-10,Paraguay,549,14,68497,1516
2020-11-11,Paraguay,609,16,69106,1532
2020-11-12,Paraguay,547,11,69653,1543
2020-11-13,Paraguay,739,13,70392,1556
2020-11-14,Paraguay,673,13,71065,1569
2020-11-15,Paraguay,509,18,71574,1587
2020-11-16,Paraguay,525,15,72099,1602
2020-11-17,Paraguay,758,11,72857,1613
2020-11-18,Paraguay,782,11,73639,1624
2020-11-19,Paraguay,856,12,74495,1636
2020-11-20,Paraguay,563,11,75058,1647
2020-11-21,Paraguay,799,5,75857,1652
2020-11-22,Paraguay,619,5,76476,1657
2020-11-23,Paraguay,596,8,77072,1665
2020-11-24,Paraguay,819,12,77891,1677
2020-11-25,Paraguay,987,14,78878,1691
2020-11-26,Paraguay,639,13,79517,1704
2020-11-27,Paraguay,919,16,80436,1720
2020-11-28,Paraguay,695,11,81131,1731
2020-11-29,Paraguay,775,12,81906,1743
2020-11-30,Paraguay,518,13,82424,1756
2020-12-01,Paraguay,1055,15,83479,1771
2020-12-02,Paraguay,1003,12,84482,1783
2020-12-03,Paraguay,995,13,85477,1796
2020-12-04,Paraguay,1022,17,86499,1813
2020-12-05,Paraguay,714,20,87213,1833
2020-12-06,Paraguay,707,20,87920,1853
2020-12-07,Paraguay,803,19,88723,1872
2020-12-08,Paraguay,698,15,89421,1887
2020-12-09,Paraguay,725,14,90146,1901
2020-12-10,Paraguay,812,13,90958,1914
2020-12-11,Paraguay,1155,13,92113,1927
2020-12-12,Paraguay,800,10,92913,1937
2020-12-13,Paraguay,669,16,93582,1953
2020-12-14,Paraguay,641,18,94223,1971
2020-12-15,Paraguay,1130,20,95353,1991
2020-12-16,Paraguay,856,23,96209,2014
2020-12-17,Paraguay,819,18,97028,2032
2020-12-18,Paraguay,1268,18,98296,2050
2020-12-19,Paraguay,861,22,99157,2072
2020-12-20,Paraguay,632,16,99789,2088
2020-12-21,Paraguay,823,15,100612,2103
2020-12-22,Paraguay,932,17,101544,2120
2020-12-23,Paraguay,827,18,102371,2138
2020-12-24,Paraguay,958,16,103329,2154
2020-12-25,Paraguay,559,0,103888,2154
2020-12-26,Paraguay,274,20,104162,2174
2020-12-27,Paraguay,260,14,104422,2188
2020-12-28,Paraguay,952,14,105374,2202
2020-12-29,Paraguay,762,18,106136,2220
2020-12-30,Paraguay,822,22,106958,2242
2020-12-31,Paraguay,974,20,107932,2262
2021-01-01,Paraguay,417,0,108349,2262
2021-01-02,Paraguay,369,17,108718,2279
2021-01-03,Paraguay,355,13,109073,2292
2021-01-04,Paraguay,764,13,109837,2305
2021-01-05,Paraguay,959,16,110796,2321
2021-01-06,Paraguay,898,16,111694,2337
2021-01-07,Paraguay,1162,15,112856,2352
2021-01-08,Paraguay,1138,20,113994,2372
2021-01-09,Paraguay,1032,15,115026,2387
2021-01-10,Paraguay,707,18,115733,2405
2021-01-11,Paraguay,802,15,116535,2420
2021-01-12,Paraguay,1055,17,117590,2437
2021-01-13,Paraguay,1002,14,118592,2451
2021-01-14,Paraguay,1048,15,119640,2466
2021-01-15,Paraguay,1149,13,120789,2479
2021-01-16,Paraguay,859,16,121648,2495
2021-01-17,Paraguay,512,10,122160,2505
2021-01-18,Paraguay,428,13,122588,2518
2021-01-19,Paraguay,771,17,123359,2535
2021-01-20,Paraguay,1088,21,124447,2556
2021-01-21,Paraguay,1071,14,125518,2570
2021-01-22,Paraguay,852,15,126370,2585
2021-01-23,Paraguay,711,22,127081,2607
2021-01-24,Paraguay,571,10,127652,2617
2021-01-25,Paraguay,714,15,128366,2632
2021-01-26,Paraguay,1028,19,129394,2651
2021-01-27,Paraguay,769,17,130163,2668
2021-01-28,Paraguay,754,13,130917,2681
2021-01-29,Paraguay,969,12,131886,2693
2021-01-30,Paraguay,662,11,132548,2704
2021-01-31,Paraguay,679,14,133227,2718
2021-02-01,Paraguay,554,15,133781,2733
2021-02-02,Paraguay,701,17,134482,2750
2021-02-03,Paraguay,747,15,135229,2765
2021-02-04,Paraguay,794,14,136023,2779
2021-02-05,Paraguay,867,12,136890,2791
2021-02-06,Paraguay,713,16,137603,2807
2021-02-07,Paraguay,515,19,138118,2826
2021-02-08,Paraguay,827,20,138945,2846
2021-02-09,Paraguay,874,16,139819,2862
2021-02-10,Paraguay,978,14,140797,2876
2021-02-11,Paraguay,978,15,141775,2891
2021-02-12,Paraguay,823,13,142598,2904
2021-02-13,Paraguay,845,16,143443,2920
2021-02-14,Paraguay,599,16,144042,2936
2021-02-15,Paraguay,1053,17,145095,2953
2021-02-16,Paraguay,1121,18,146216,2971
2021-02-17,Paraguay,1037,20,147253,2991
2021-02-18,Paraguay,1369,17,148622,3008
2021-02-19,Paraguay,1062,18,149684,3026
2021-02-20,Paraguay,1047,19,150731,3045
2021-02-21,Paraguay,987,20,151718,3065
2021-02-22,Paraguay,940,15,152658,3080
2021-02-23,Paraguay,1132,21,153790,3101
2021-02-24,Paraguay,1114,18,154904,3119
2021-02-25,Paraguay,1285,16,156189,3135
2021-02-26,Paraguay,1414,17,157603,3152
2021-02-27,Paraguay,934,15,158537,3167
2021-02-28,Paraguay,937,14,159474,3181
2021-03-01,Paraguay,974,17,160448,3198
2021-03-02,Paraguay,1082,20,161530,3218
2021-03-03,Paraguay,1341,21,162871,3239
2021-03-04,Paraguay,1439,17,164310,3256
2021-03-05,Paraguay,1501,22,165811,3278
2021-03-06,Paraguay,1158,16,166969,3294
2021-03-07,Paraguay,1074,24,168043,3318
2021-03-08,Paraguay,1817,25,169860,3343
2021-03-09,Paraguay,2125,17,171985,3360
2021-03-10,Paraguay,2028,27,174013,3387
2021-03-11,Paraguay,1814,24,175827,3411
2021-03-12,Paraguay,1766,25,177593,3436
2021-03-13,Paraguay,1479,20,179072,3456
2021-03-14,Paraguay,942,20,180014,3476
2021-03-15,Paraguay,1400,41,181414,3517
2021-03-16,Paraguay,1934,37,183348,3554
2021-03-17,Paraguay,2540,34,185888,3588
2021-03-18,Paraguay,2605,32,188493,3620
2021-03-19,Paraguay,2006,42,190499,3662
2021-03-20,Paraguay,2100,33,192599,3695
2021-03-21,Paraguay,1523,35,194122,3730
2021-03-22,Paraguay,1990,39,196112,3769
2021-03-23,Paraguay,2023,49,198135,3818
2021-03-24,Paraguay,2688,51,200823,3869
2021-03-25,Paraguay,1877,41,202700,3910
2021-03-26,Paraguay,2004,48,204704,3958
2021-03-27,Paraguay,1893,45,206597,4003
2021-03-28,Paraguay,2058,60,208655,4063
2021-03-29,Paraguay,1770,50,210425,4113
2021-03-30,Paraguay,2266,48,212691,4161
2021-03-31,Paraguay,1976,45,214667,4206
2021-04-01,Paraguay,1611,44,216278,4250
2021-04-02,Paraguay,1608,44,217886,4294
2021-04-03,Paraguay,1507,50,219393,4344
2021-04-04,Paraguay,1814,55,221207,4399
2021-04-05,Paraguay,1456,64,222663,4463
2021-04-06,Paraguay,2073,59,224736,4522
2021-04-07,Paraguay,2380,62,227116,4584
2021-04-08,Paraguay,2479,60,229595,4644
2020-03-06,Peru,1,0,1,0
2020-03-07,Peru,0,0,1,0
2020-03-08,Peru,5,0,6,0
2020-03-09,Peru,1,0,7,0
2020-03-10,Peru,4,0,11,0
2020-03-11,Peru,0,0,11,0
2020-03-12,Peru,4,0,15,0
2020-03-13,Peru,13,0,28,0
2020-03-14,Peru,10,0,38,0
2020-03-15,Peru,5,0,43,0
2020-03-16,Peru,43,0,86,0
2020-03-17,Peru,31,0,117,0
2020-03-18,Peru,28,0,145,0
2020-03-19,Peru,89,0,234,0
2020-03-20,Peru,0,3,234,3
2020-03-21,Peru,84,2,318,5
2020-03-22,Peru,45,0,363,5
2020-03-23,Peru,32,0,395,5
2020-03-24,Peru,21,2,416,7
2020-03-25,Peru,64,2,480,9
2020-03-26,Peru,100,0,580,9
2020-03-27,Peru,55,2,635,11
2020-03-28,Peru,36,5,671,16
2020-03-29,Peru,181,2,852,18
2020-03-30,Peru,98,6,950,24
2020-03-31,Peru,115,6,1065,30
2020-04-01,Peru,258,8,1323,38
2020-04-02,Peru,91,17,1414,55
2020-04-03,Peru,181,6,1595,61
2020-04-04,Peru,151,12,1746,73
2020-04-05,Peru,535,10,2281,83
2020-04-06,Peru,280,9,2561,92
2020-04-07,Peru,393,15,2954,107
2020-04-08,Peru,1388,14,4342,121
2020-04-09,Peru,914,17,5256,138
2020-04-10,Peru,641,31,5897,169
2020-04-11,Peru,951,12,6848,181
2020-04-12,Peru,671,12,7519,193
2020-04-13,Peru,2265,23,9784,216
2020-04-14,Peru,519,14,10303,230
2020-04-15,Peru,1172,24,11475,254
2020-04-16,Peru,1016,20,12491,274
2020-04-17,Peru,998,26,13489,300
2020-04-18,Peru,931,48,14420,348
2020-04-19,Peru,1208,52,15628,400
2020-04-20,Peru,697,45,16325,445
2020-04-21,Peru,1512,39,17837,484
2020-04-22,Peru,1413,46,19250,530
2020-04-23,Peru,1664,42,20914,572
2020-04-24,Peru,734,62,21648,634
2020-04-25,Peru,3683,66,25331,700
2020-04-26,Peru,2186,28,27517,728
2020-04-27,Peru,1182,54,28699,782
2020-04-28,Peru,2491,72,31190,854
2020-04-29,Peru,2741,89,33931,943
2020-04-30,Peru,3045,108,36976,1051
2020-05-01,Peru,3483,73,40459,1124
2020-05-02,Peru,2075,76,42534,1200
2020-05-03,Peru,3394,86,45928,1286
2020-05-04,Peru,1444,58,47372,1344
2020-05-05,Peru,3817,100,51189,1444
2020-05-06,Peru,3628,89,54817,1533
2020-05-07,Peru,3709,94,58526,1627
2020-05-08,Peru,3321,87,61847,1714
2020-05-09,Peru,3168,100,65015,1814
2020-05-10,Peru,2292,75,67307,1889
2020-05-11,Peru,1515,72,68822,1961
2020-05-12,Peru,3237,96,72059,2057
2020-05-13,Peru,4247,112,76306,2169
2020-05-14,Peru,4298,98,80604,2267
2020-05-15,Peru,3891,125,84495,2392
2020-05-16,Peru,4046,131,88541,2523
2020-05-17,Peru,3732,125,92273,2648
2020-05-18,Peru,2660,141,94933,2789
2020-05-19,Peru,4550,125,99483,2914
2020-05-20,Peru,4537,110,104020,3024
2020-05-21,Peru,4749,124,108769,3148
2020-05-22,Peru,2929,96,111698,3244
2020-05-23,Peru,4056,129,115754,3373
2020-05-24,Peru,4205,83,119959,3456
2020-05-25,Peru,4020,173,123979,3629
2020-05-26,Peru,5772,159,129751,3788
2020-05-27,Peru,6154,195,135905,3983
2020-05-28,Peru,5874,116,141779,4099
2020-05-29,Peru,6506,131,148285,4230
2020-05-30,Peru,7386,141,155671,4371
2020-05-31,Peru,8805,135,164476,4506
2020-06-01,Peru,5563,128,170039,4634
2020-06-02,Peru,8126,133,178165,4767
2020-06-03,Peru,749,127,178914,4894
2020-06-04,Peru,4284,137,183198,5031
2020-06-05,Peru,4202,131,187400,5162
2020-06-06,Peru,4358,139,191758,5301
2020-06-07,Peru,4757,164,196515,5465
2020-06-08,Peru,3181,106,199696,5571
2020-06-09,Peru,4040,167,203736,5738
2020-06-10,Peru,5087,165,208823,5903
2020-06-11,Peru,5965,185,214788,6088
2020-06-12,Peru,0,0,214788,6088
2020-06-13,Peru,5961,220,220749,6308
2020-06-14,Peru,8987,380,229736,6688
2020-06-15,Peru,3256,172,232992,6860
2020-06-16,Peru,4164,196,237156,7056
2020-06-17,Peru,3752,201,240908,7257
2020-06-18,Peru,3480,204,244388,7461
2020-06-19,Peru,3537,199,247925,7660
2020-06-20,Peru,3413,201,251338,7861
2020-06-21,Peru,3598,184,254936,8045
2020-06-22,Peru,2511,178,257447,8223
2020-06-23,Peru,3363,181,260810,8404
2020-06-24,Peru,3879,182,264689,8586
2020-06-25,Peru,3913,175,268602,8761
2020-06-26,Peru,3762,178,272364,8939
2020-06-27,Peru,3625,196,275989,9135
2020-06-28,Peru,3430,182,279419,9317
2020-06-29,Peru,2946,187,282365,9504
2020-06-30,Peru,2848,173,285213,9677
2020-07-01,Peru,3264,183,288477,9860
2020-07-02,Peru,3527,185,292004,10045
2020-07-03,Peru,3595,181,295599,10226
2020-07-04,Peru,3481,186,299080,10412
2020-07-05,Peru,3638,177,302718,10589
2020-07-06,Peru,2985,183,305703,10772
2020-07-07,Peru,3575,180,309278,10952
2020-07-08,Peru,3633,181,312911,11133
2020-07-09,Peru,3537,181,316448,11314
2020-07-10,Peru,3198,186,319646,11500
2020-07-11,Peru,3064,182,322710,11682
2020-07-12,Peru,3616,188,326326,11870
2020-07-13,Peru,3797,184,330123,12054
2020-07-14,Peru,3744,175,333867,12229
2020-07-15,Peru,3884,188,337751,12417
2020-07-16,Peru,3835,198,341586,12615
2020-07-17,Peru,3951,184,345537,12799
2020-07-18,Peru,3963,199,349500,12998
2020-07-19,Peru,4090,189,353590,13187
2020-07-20,Peru,4091,197,357681,13384
2020-07-21,Peru,4406,195,362087,13579
2020-07-22,Peru,4463,188,366550,13767
2020-07-23,Peru,4546,3887,371096,17654
2020-07-24,Peru,4865,189,375961,17843
2020-07-25,Peru,0,0,375961,17843
2020-07-26,Peru,0,0,375961,17843
2020-07-27,Peru,13756,575,389717,18418
2020-07-28,Peru,5288,194,395005,18612
2020-07-29,Peru,5678,204,400683,18816
2020-07-30,Peru,0,0,400683,18816
2020-07-31,Peru,6809,205,407492,19021
2020-08-01,Peru,0,0,407492,19021
2020-08-02,Peru,21358,593,428850,19614
2020-08-03,Peru,4250,197,433100,19811
2020-08-04,Peru,6790,196,439890,20007
2020-08-05,Peru,7734,221,447624,20228
2020-08-06,Peru,7785,196,455409,20424
2020-08-07,Peru,8466,225,463875,20649
2020-08-08,Peru,0,0,463875,20649
2020-08-09,Peru,14149,423,478024,21072
2020-08-10,Peru,5109,204,483133,21276
2020-08-11,Peru,6547,225,489680,21501
2020-08-12,Peru,0,0,489680,21501
2020-08-13,Peru,8875,212,498555,21713
2020-08-14,Peru,17741,4143,516296,25856
2020-08-15,Peru,0,0,516296,25856
2020-08-16,Peru,9507,219,525803,26075
2020-08-17,Peru,10143,206,535946,26281
2020-08-18,Peru,5547,200,541493,26481
2020-08-19,Peru,7828,177,549321,26658
2020-08-20,Peru,9099,176,558420,26834
2020-08-21,Peru,8639,200,567059,27034
2020-08-22,Peru,9008,211,576067,27245
2020-08-23,Peru,9169,208,585236,27453
2020-08-24,Peru,9090,210,594326,27663
2020-08-25,Peru,6112,150,600438,27813
2020-08-26,Peru,6944,188,607382,28001
2020-08-27,Peru,5996,123,613378,28124
2020-08-28,Peru,8619,153,621997,28277
2020-08-29,Peru,7964,194,629961,28471
2020-08-30,Peru,9474,136,639435,28607
2020-08-31,Peru,7731,181,647166,28788
2020-09-01,Peru,4871,156,652037,28944
2020-09-02,Peru,5092,124,657129,29068
2020-09-03,Peru,0,0,657129,29068
2020-09-04,Peru,13016,337,670145,29405
2020-09-05,Peru,6703,149,676848,29554
2020-09-06,Peru,6854,133,683702,29687
2020-09-07,Peru,6275,151,689977,29838
2020-09-08,Peru,1598,138,691575,29976
2020-09-09,Peru,4615,147,696190,30123
2020-09-10,Peru,6586,113,702776,30236
2020-09-11,Peru,7291,108,710067,30344
2020-09-12,Peru,6603,126,716670,30470
2020-09-13,Peru,6162,56,722832,30526
2020-09-14,Peru,6787,184,729619,30710
2020-09-15,Peru,4241,102,733860,30812
2020-09-16,Peru,4160,115,738020,30927
2020-09-17,Peru,6380,124,744400,31051
2020-09-18,Peru,5698,95,750098,31146
2020-09-19,Peru,6314,137,756412,31283
2020-09-20,Peru,6453,86,762865,31369
2020-09-21,Peru,6030,0,768895,31369
2020-09-22,Peru,0,0,768895,31369
2020-09-23,Peru,7651,199,776546,31568
2020-09-24,Peru,6149,302,782695,31870
2020-09-25,Peru,11889,167,794584,32037
2020-09-26,Peru,0,0,794584,32037
2020-09-27,Peru,5558,105,800142,32142
2020-09-28,Peru,5160,120,805302,32262
2020-09-29,Peru,3412,62,808714,32324
2020-09-30,Peru,3054,72,811768,32396
2020-10-01,Peru,3061,67,814829,32463
2020-10-02,Peru,3468,72,818297,32535
2020-10-03,Peru,3267,74,821564,32609
2020-10-04,Peru,0,0,821564,32609
2020-10-05,Peru,6605,133,828169,32742
2020-10-06,Peru,1830,92,829999,32834
2020-10-07,Peru,2930,80,832929,32914
2020-10-08,Peru,2733,95,835662,33009
2020-10-09,Peru,2952,89,838614,33098
2020-10-10,Peru,7474,125,846088,33223
2020-10-11,Peru,3283,82,849371,33305
2020-10-12,Peru,1800,52,851171,33357
2020-10-13,Peru,2803,62,853974,33419
2020-10-14,Peru,0,0,853974,33419
2020-10-15,Peru,5766,158,859740,33577
2020-10-16,Peru,0,0,859740,33577
2020-10-17,Peru,2677,71,862417,33648
2020-10-18,Peru,3132,54,865549,33702
2020-10-19,Peru,3126,57,868675,33759
2020-10-20,Peru,2201,61,870876,33820
2020-10-21,Peru,3242,55,874118,33875
2020-10-22,Peru,5758,109,879876,33984
2020-10-23,Peru,0,0,879876,33984
2020-10-24,Peru,3240,49,883116,34033
2020-10-25,Peru,5599,116,888715,34149
2020-10-26,Peru,0,0,888715,34149
2020-10-27,Peru,1859,48,890574,34197
2020-10-28,Peru,1923,60,892497,34257
2020-10-29,Peru,2431,58,894928,34315
2020-10-30,Peru,2666,47,897594,34362
2020-10-31,Peru,2586,49,900180,34411
2020-11-01,Peru,2323,65,902503,34476
2020-11-02,Peru,0,0,902503,34476
2020-11-03,Peru,0,0,902503,34476
2020-11-04,Peru,9284,195,911787,34671
2020-11-05,Peru,2935,59,914722,34730
2020-11-06,Peru,0,0,914722,34730
2020-11-07,Peru,2781,53,917503,34783
2020-11-08,Peru,2507,38,920010,34821
2020-11-09,Peru,2323,58,922333,34879
2020-11-10,Peru,1194,64,923527,34943
2020-11-11,Peru,1904,49,925431,34992
2020-11-12,Peru,2575,39,928006,35031
2020-11-13,Peru,2231,36,930237,35067
2020-11-14,Peru,2413,39,932650,35106
2020-11-15,Peru,2249,71,934899,35177
2020-11-16,Peru,2112,54,937011,35231
2020-11-17,Peru,1257,40,938268,35271
2020-11-18,Peru,1663,46,939931,35317
2020-11-19,Peru,0,0,939931,35317
2020-11-20,Peru,3986,129,943917,35446
2020-11-21,Peru,4164,103,948081,35549
2020-11-22,Peru,0,0,948081,35549
2020-11-23,Peru,1589,46,949670,35595
2020-11-24,Peru,887,46,950557,35641
2020-11-25,Peru,1882,44,952439,35685
2020-11-26,Peru,0,0,952439,35685
2020-11-27,Peru,3908,100,956347,35785
2020-11-28,Peru,4021,94,960368,35879
2020-11-29,Peru,2162,44,962530,35923
2020-11-30,Peru,0,0,962530,35923
2020-12-01,Peru,1075,43,963605,35966
2020-12-02,Peru,0,0,963605,35966
2020-12-03,Peru,3470,110,967075,36076
2020-12-04,Peru,0,0,967075,36076
2020-12-05,Peru,3785,119,970860,36195
2020-12-06,Peru,1828,36,972688,36231
2020-12-07,Peru,1224,43,973912,36274
2020-12-08,Peru,0,0,973912,36274
2020-12-09,Peru,2709,127,976621,36401
2020-12-10,Peru,2490,98,979111,36499
2020-12-11,Peru,0,0,979111,36499
2020-12-12,Peru,1832,45,980943,36544
2020-12-13,Peru,0,0,980943,36544
2020-12-14,Peru,4030,133,984973,36677
2020-12-15,Peru,1157,77,986130,36754
2020-12-16,Peru,0,0,986130,36754
2020-12-17,Peru,3327,104,989457,36858
2020-12-18,Peru,0,0,989457,36858
2020-12-19,Peru,0,0,989457,36858
2020-12-20,Peru,6442,176,995899,37034
2020-12-21,Peru,1618,69,997517,37103
2020-12-22,Peru,958,70,998475,37173
2020-12-23,Peru,1678,45,1000153,37218
2020-12-24,Peru,0,0,1000153,37218
2020-12-25,Peru,3829,99,1003982,37317
2020-12-26,Peru,1564,51,1005546,37368
2020-12-27,Peru,0,0,1005546,37368
2020-12-28,Peru,2111,106,1007657,37474
2020-12-29,Peru,1251,51,1008908,37525
2020-12-30,Peru,1588,49,1010496,37574
2020-12-31,Peru,4641,106,1015137,37680
2021-01-01,Peru,0,0,1015137,37680
2021-01-02,Peru,0,0,1015137,37680
2021-01-03,Peru,2962,93,1018099,37773
2021-01-04,Peru,1376,57,1019475,37830
2021-01-05,Peru,0,0,1019475,37830
2021-01-06,Peru,2543,95,1022018,37925
2021-01-07,Peru,0,0,1022018,37925
2021-01-08,Peru,4162,124,1026180,38049
2021-01-09,Peru,0,0,1026180,38049
2021-01-10,Peru,0,0,1026180,38049
2021-01-11,Peru,9004,231,1035184,38280
2021-01-12,Peru,2166,55,1037350,38335
2021-01-13,Peru,2881,64,1040231,38399
2021-01-14,Peru,0,0,1040231,38399
2021-01-15,Peru,15792,255,1056023,38654
2021-01-16,Peru,0,0,1056023,38654
2021-01-17,Peru,4544,116,1060567,38770
2021-01-18,Peru,0,0,1060567,38770
2021-01-19,Peru,0,0,1060567,38770
2021-01-20,Peru,12647,274,1073214,39044
2021-01-21,Peru,0,0,1073214,39044
2021-01-22,Peru,9693,230,1082907,39274
2021-01-23,Peru,0,0,1082907,39274
2021-01-24,Peru,11031,334,1093938,39608
2021-01-25,Peru,0,0,1093938,39608
2021-01-26,Peru,13301,499,1107239,40107
2021-01-27,Peru,0,0,1107239,40107
2021-01-28,Peru,6731,165,1113970,40272
2021-01-29,Peru,5715,212,1119685,40484
2021-01-30,Peru,13337,373,1133022,40857
2021-01-31,Peru,5217,169,1138239,41026
2021-02-01,Peru,0,0,1138239,41026
2021-02-02,Peru,4477,155,1142716,41181
2021-02-03,Peru,15621,357,1158337,41538
2021-02-04,Peru,0,0,1158337,41538
2021-02-05,Peru,6715,215,1165052,41753
2021-02-06,Peru,7993,180,1173045,41933
2021-02-07,Peru,13653,375,1186698,42308
2021-02-08,Peru,0,0,1186698,42308
2021-02-09,Peru,10080,318,1196778,42626
2021-02-10,Peru,0,0,1196778,42626
2021-02-11,Peru,6724,419,1203502,43045
2021-02-12,Peru,8807,0,1212309,43045
2021-02-13,Peru,8439,210,1220748,43255
2021-02-14,Peru,14550,448,1235298,43703
2021-02-15,Peru,3203,177,1238501,43880
2021-02-16,Peru,0,0,1238501,43880
2021-02-17,Peru,6228,176,1244729,44056
2021-02-18,Peru,7408,252,1252137,44308
2021-02-19,Peru,9667,181,1261804,44489
2021-02-20,Peru,7719,201,1269523,44690
2021-02-21,Peru,13786,407,1283309,45097
2021-02-22,Peru,0,0,1283309,45097
2021-02-23,Peru,3448,166,1286757,45263
2021-02-24,Peru,6740,224,1293497,45487
2021-02-25,Peru,7302,196,1300799,45683
2021-02-26,Peru,15564,411,1316363,46094
2021-02-27,Peru,7500,205,1323863,46299
2021-02-28,Peru,0,0,1323863,46299
2021-03-01,Peru,5942,195,1329805,46494
2021-03-02,Peru,8492,400,1338297,46894
2021-03-03,Peru,0,0,1338297,46894
2021-03-04,Peru,6672,195,1344969,47089
2021-03-05,Peru,4878,217,1349847,47306
2021-03-06,Peru,8447,185,1358294,47491
2021-03-07,Peru,6670,190,1364964,47681
2021-03-08,Peru,6212,173,1371176,47854
2021-03-09,Peru,8847,309,1380023,48163
2021-03-10,Peru,0,0,1380023,48163
2021-03-11,Peru,7434,160,1387457,48323
2021-03-12,Peru,7114,161,1394571,48484
2021-03-13,Peru,8039,180,1402610,48664
2021-03-14,Peru,5353,177,1407963,48841
2021-03-15,Peru,4443,162,1412406,49003
2021-03-16,Peru,6568,174,1418974,49177
2021-03-17,Peru,16624,346,1435598,49523
2021-03-18,Peru,0,0,1435598,49523
2021-03-19,Peru,16047,374,1451645,49897
2021-03-20,Peru,0,0,1451645,49897
2021-03-21,Peru,14681,301,1466326,50198
2021-03-22,Peru,0,0,1466326,50198
2021-03-23,Peru,14933,276,1481259,50474
2021-03-24,Peru,0,0,1481259,50474
2021-03-25,Peru,19206,357,1500465,50831
2021-03-26,Peru,11919,201,1512384,51032
2021-03-27,Peru,8589,206,1520973,51238
2021-03-28,Peru,8909,231,1529882,51469
2021-03-29,Peru,3239,166,1533121,51635
2021-03-30,Peru,0,0,1533121,51635
2021-03-31,Peru,15686,373,1548807,52008
2021-04-01,Peru,12916,153,1561723,52161
2021-04-02,Peru,6622,170,1568345,52331
2021-04-03,Peru,5616,294,1573961,52625
2021-04-04,Peru,8406,252,1582367,52877
2021-04-05,Peru,7842,261,1590209,53138
2021-04-06,Peru,0,0,1590209,53138
2021-04-07,Peru,8384,273,1598593,53411
2021-04-08,Peru,19271,567,1617864,53978
2020-01-30,Philippines,1,0,1,0
2020-01-31,Philippines,0,0,1,0
2020-02-01,Philippines,0,0,1,0
2020-02-02,Philippines,1,1,2,1
2020-02-03,Philippines,0,0,2,1
2020-02-04,Philippines,0,0,2,1
2020-02-05,Philippines,0,0,2,1
2020-02-06,Philippines,0,0,2,1
2020-02-07,Philippines,1,0,3,1
2020-02-08,Philippines,0,0,3,1
2020-02-09,Philippines,0,0,3,1
2020-02-10,Philippines,0,0,3,1
2020-02-11,Philippines,0,0,3,1
2020-02-12,Philippines,0,0,3,1
2020-02-13,Philippines,0,0,3,1
2020-02-14,Philippines,0,0,3,1
2020-02-15,Philippines,0,0,3,1
2020-02-16,Philippines,0,0,3,1
2020-02-17,Philippines,0,0,3,1
2020-02-18,Philippines,0,0,3,1
2020-02-19,Philippines,0,0,3,1
2020-02-20,Philippines,0,0,3,1
2020-02-21,Philippines,0,0,3,1
2020-02-22,Philippines,0,0,3,1
2020-02-23,Philippines,0,0,3,1
2020-02-24,Philippines,0,0,3,1
2020-02-25,Philippines,0,0,3,1
2020-02-26,Philippines,0,0,3,1
2020-02-27,Philippines,0,0,3,1
2020-02-28,Philippines,0,0,3,1
2020-02-29,Philippines,0,0,3,1
2020-03-01,Philippines,0,0,3,1
2020-03-02,Philippines,0,0,3,1
2020-03-03,Philippines,0,0,3,1
2020-03-04,Philippines,0,0,3,1
2020-03-05,Philippines,0,0,3,1
2020-03-06,Philippines,2,0,5,1
2020-03-07,Philippines,1,0,6,1
2020-03-08,Philippines,4,0,10,1
2020-03-09,Philippines,10,0,20,1
2020-03-10,Philippines,13,0,33,1
2020-03-11,Philippines,16,0,49,1
2020-03-12,Philippines,3,1,52,2
2020-03-13,Philippines,12,3,64,5
2020-03-14,Philippines,47,3,111,8
2020-03-15,Philippines,29,3,140,11
2020-03-16,Philippines,2,1,142,12
2020-03-17,Philippines,45,0,187,12
2020-03-18,Philippines,15,7,202,19
2020-03-19,Philippines,15,-2,217,17
2020-03-20,Philippines,13,1,230,18
2020-03-21,Philippines,77,1,307,19
2020-03-22,Philippines,73,6,380,25
2020-03-23,Philippines,82,8,462,33
2020-03-24,Philippines,90,2,552,35
2020-03-25,Philippines,84,3,636,38
2020-03-26,Philippines,71,7,707,45
2020-03-27,Philippines,96,9,803,54
2020-03-28,Philippines,272,14,1075,68
2020-03-29,Philippines,343,3,1418,71
2020-03-30,Philippines,128,7,1546,78
2020-03-31,Philippines,538,10,2084,88
2020-04-01,Philippines,227,8,2311,96
2020-04-02,Philippines,322,11,2633,107
2020-04-03,Philippines,385,29,3018,136
2020-04-04,Philippines,76,8,3094,144
2020-04-05,Philippines,152,8,3246,152
2020-04-06,Philippines,414,11,3660,163
2020-04-07,Philippines,104,14,3764,177
2020-04-08,Philippines,106,5,3870,182
2020-04-09,Philippines,206,21,4076,203
2020-04-10,Philippines,119,18,4195,221
2020-04-11,Philippines,233,26,4428,247
2020-04-12,Philippines,220,50,4648,297
2020-04-13,Philippines,284,18,4932,315
2020-04-14,Philippines,291,20,5223,335
2020-04-15,Philippines,230,14,5453,349
2020-04-16,Philippines,207,13,5660,362
2020-04-17,Philippines,218,25,5878,387
2020-04-18,Philippines,209,10,6087,397
2020-04-19,Philippines,172,12,6259,409
2020-04-20,Philippines,200,19,6459,428
2020-04-21,Philippines,140,9,6599,437
2020-04-22,Philippines,111,9,6710,446
2020-04-23,Philippines,271,16,6981,462
2020-04-24,Philippines,211,15,7192,477
2020-04-25,Philippines,102,17,7294,494
2020-04-26,Philippines,285,7,7579,501
2020-04-27,Philippines,198,10,7777,511
2020-04-28,Philippines,181,19,7958,530
2020-04-29,Philippines,254,28,8212,558
2020-04-30,Philippines,276,10,8488,568
2020-05-01,Philippines,284,11,8772,579
2020-05-02,Philippines,156,24,8928,603
2020-05-03,Philippines,295,4,9223,607
2020-05-04,Philippines,262,16,9485,623
2020-05-05,Philippines,199,14,9684,637
2020-05-06,Philippines,320,21,10004,658
2020-05-07,Philippines,339,27,10343,685
2020-05-08,Philippines,120,11,10463,696
2020-05-09,Philippines,147,8,10610,704
2020-05-10,Philippines,184,15,10794,719
2020-05-11,Philippines,292,7,11086,726
2020-05-12,Philippines,264,25,11350,751
2020-05-13,Philippines,268,21,11618,772
2020-05-14,Philippines,258,18,11876,790
2020-05-15,Philippines,215,16,12091,806
2020-05-16,Philippines,214,11,12305,817
2020-05-17,Philippines,208,7,12513,824
2020-05-18,Philippines,205,7,12718,831
2020-05-19,Philippines,224,6,12942,837
2020-05-20,Philippines,279,5,13221,842
2020-05-21,Philippines,213,4,13434,846
2020-05-22,Philippines,163,11,13597,857
2020-05-23,Philippines,180,6,13777,863
2020-05-24,Philippines,258,5,14035,868
2020-05-25,Philippines,284,5,14319,873
2020-05-26,Philippines,350,13,14669,886
2020-05-27,Philippines,380,18,15049,904
2020-05-28,Philippines,539,17,15588,921
2020-05-29,Philippines,1046,21,16634,942
2020-05-30,Philippines,590,8,17224,950
2020-05-31,Philippines,862,7,18086,957
2020-06-01,Philippines,552,3,18638,960
2020-06-02,Philippines,359,6,18997,966
2020-06-03,Philippines,751,8,19748,974
2020-06-04,Philippines,634,10,20382,984
2020-06-05,Philippines,244,3,20626,987
2020-06-06,Philippines,714,7,21340,994
2020-06-07,Philippines,555,9,21895,1003
2020-06-08,Philippines,579,8,22474,1011
2020-06-09,Philippines,518,6,22992,1017
2020-06-10,Philippines,740,10,23732,1027
2020-06-11,Philippines,443,9,24175,1036
2020-06-12,Philippines,612,16,24787,1052
2020-06-13,Philippines,605,22,25392,1074
2020-06-14,Philippines,538,14,25930,1088
2020-06-15,Philippines,490,10,26420,1098
2020-06-16,Philippines,361,5,26781,1103
2020-06-17,Philippines,457,5,27238,1108
2020-06-18,Philippines,561,8,27799,1116
2020-06-19,Philippines,660,14,28459,1130
2020-06-20,Philippines,941,20,29400,1150
2020-06-21,Philippines,652,19,30052,1169
2020-06-22,Philippines,630,8,30682,1177
2020-06-23,Philippines,1143,9,31825,1186
2020-06-24,Philippines,470,18,32295,1204
2020-06-25,Philippines,774,8,33069,1212
2020-06-26,Philippines,1004,12,34073,1224
2020-06-27,Philippines,730,12,34803,1236
2020-06-28,Philippines,652,8,35455,1244
2020-06-29,Philippines,983,11,36438,1255
2020-06-30,Philippines,1076,11,37514,1266
2020-07-01,Philippines,997,4,38511,1270
2020-07-02,Philippines,294,4,38805,1274
2020-07-03,Philippines,1531,6,40336,1280
2020-07-04,Philippines,1494,10,41830,1290
2020-07-05,Philippines,2424,7,44254,1297
2020-07-06,Philippines,2079,6,46333,1303
2020-07-07,Philippines,1540,6,47873,1309
2020-07-08,Philippines,2486,5,50359,1314
2020-07-09,Philippines,1395,0,51754,1314
2020-07-10,Philippines,1160,46,52914,1360
2020-07-11,Philippines,1308,12,54222,1372
2020-07-12,Philippines,2037,162,56259,1534
2020-07-13,Philippines,747,65,57006,1599
2020-07-14,Philippines,539,4,57545,1603
2020-07-15,Philippines,1305,11,58850,1614
2020-07-16,Philippines,2416,29,61266,1643
2020-07-17,Philippines,1735,17,63001,1660
2020-07-18,Philippines,2303,113,65304,1773
2020-07-19,Philippines,2152,58,67456,1831
2020-07-20,Philippines,1442,4,68898,1835
2020-07-21,Philippines,1866,2,70764,1837
2020-07-22,Philippines,1505,6,72269,1843
2020-07-23,Philippines,2121,28,74390,1871
2020-07-24,Philippines,2054,8,76444,1879
2020-07-25,Philippines,1968,18,78412,1897
2020-07-26,Philippines,2036,35,80448,1932
2020-07-27,Philippines,1592,13,82040,1945
2020-07-28,Philippines,1633,2,83673,1947
2020-07-29,Philippines,1813,15,85486,1962
2020-07-30,Philippines,3888,21,89374,1983
2020-07-31,Philippines,3980,40,93354,2023
2020-08-01,Philippines,4878,16,98232,2039
2020-08-02,Philippines,4953,20,103185,2059
2020-08-03,Philippines,3145,45,106330,2104
2020-08-04,Philippines,6263,11,112593,2115
2020-08-05,Philippines,3387,8,115980,2123
2020-08-06,Philippines,3480,27,119460,2150
2020-08-07,Philippines,3294,18,122754,2168
2020-08-08,Philippines,4131,41,126885,2209
2020-08-09,Philippines,3028,61,129913,2270
2020-08-10,Philippines,6725,24,136638,2294
2020-08-11,Philippines,2900,18,139538,2312
2020-08-12,Philippines,4211,92,143749,2404
2020-08-13,Philippines,3777,22,147526,2426
2020-08-14,Philippines,6134,16,153660,2442
2020-08-15,Philippines,4258,158,157918,2600
2020-08-16,Philippines,3335,65,161253,2665
2020-08-17,Philippines,3221,16,164474,2681
2020-08-18,Philippines,4739,6,169213,2687
2020-08-19,Philippines,4561,108,173774,2795
2020-08-20,Philippines,4248,88,178022,2883
2020-08-21,Philippines,4343,57,182365,2940
2020-08-22,Philippines,4884,26,187249,2966
2020-08-23,Philippines,2352,32,189601,2998
2020-08-24,Philippines,4651,12,194252,3010
2020-08-25,Philippines,2912,28,197164,3038
2020-08-26,Philippines,5197,99,202361,3137
2020-08-27,Philippines,3220,97,205581,3234
2020-08-28,Philippines,3963,91,209544,3325
2020-08-29,Philippines,3587,94,213131,3419
2020-08-30,Philippines,4265,101,217396,3520
2020-08-31,Philippines,3423,38,220819,3558
2020-09-01,Philippines,3445,39,224264,3597
2020-09-02,Philippines,2176,26,226440,3623
2020-09-03,Philippines,1963,65,228403,3688
2020-09-04,Philippines,3669,49,232072,3737
2020-09-05,Philippines,2498,53,234570,3790
2020-09-06,Philippines,2795,85,237365,3875
2020-09-07,Philippines,1362,15,238727,3890
2020-09-08,Philippines,3260,26,241987,3916
2020-09-09,Philippines,3156,70,245143,3986
2020-09-10,Philippines,3804,80,248947,4066
2020-09-11,Philippines,4017,42,252964,4108
2020-09-12,Philippines,4899,184,257863,4292
2020-09-13,Philippines,3353,79,261216,4371
2020-09-14,Philippines,4672,259,265888,4630
2020-09-15,Philippines,3519,33,269407,4663
2020-09-16,Philippines,3527,69,272934,4732
2020-09-17,Philippines,3355,53,276289,4785
2020-09-18,Philippines,3237,45,279526,4830
2020-09-19,Philippines,3934,100,283460,4930
2020-09-20,Philippines,3283,54,286743,4984
2020-09-21,Philippines,3447,15,290190,4999
2020-09-22,Philippines,1599,50,291789,5049
2020-09-23,Philippines,2802,42,294591,5091
2020-09-24,Philippines,2164,36,296755,5127
2020-09-25,Philippines,2606,69,299361,5196
2020-09-26,Philippines,1895,88,301256,5284
2020-09-27,Philippines,2970,60,304226,5344
2020-09-28,Philippines,3062,37,307288,5381
2020-09-29,Philippines,2015,67,309303,5448
2020-09-30,Philippines,2391,56,311694,5504
2020-10-01,Philippines,2385,58,314079,5562
2020-10-02,Philippines,2599,54,316678,5616
2020-10-03,Philippines,2652,62,319330,5678
2020-10-04,Philippines,3167,98,322497,5776
2020-10-05,Philippines,2265,64,324762,5840
2020-10-06,Philippines,2071,25,326833,5865
2020-10-07,Philippines,2804,60,329637,5925
2020-10-08,Philippines,2232,144,331869,6069
2020-10-09,Philippines,2901,83,334770,6152
2020-10-10,Philippines,2156,86,336926,6238
2020-10-11,Philippines,2415,83,339341,6321
2020-10-12,Philippines,3475,11,342816,6332
2020-10-13,Philippines,1897,40,344713,6372
2020-10-14,Philippines,1823,77,346536,6449
2020-10-15,Philippines,2162,48,348698,6497
2020-10-16,Philippines,3052,34,351750,6531
2020-10-17,Philippines,2588,72,354338,6603
2020-10-18,Philippines,2280,49,356618,6652
2020-10-19,Philippines,2551,23,359169,6675
2020-10-20,Philippines,1606,15,360775,6690
2020-10-21,Philippines,1468,57,362243,6747
2020-10-22,Philippines,1645,36,363888,6783
2020-10-23,Philippines,1911,132,365799,6915
2020-10-24,Philippines,2020,19,367819,6934
2020-10-25,Philippines,2209,43,370028,6977
2020-10-26,Philippines,1602,62,371630,7039
2020-10-27,Philippines,1514,14,373144,7053
2020-10-28,Philippines,2036,61,375180,7114
2020-10-29,Philippines,1755,33,376935,7147
2020-10-30,Philippines,1998,38,378933,7185
2020-10-31,Philippines,1796,36,380729,7221
2020-11-01,Philippines,2384,17,383113,7238
2020-11-02,Philippines,2287,31,385400,7269
2020-11-03,Philippines,1761,49,387161,7318
2020-11-04,Philippines,976,49,388137,7367
2020-11-05,Philippines,1588,42,389725,7409
2020-11-06,Philippines,2084,52,391809,7461
2020-11-07,Philippines,2152,24,393961,7485
2020-11-08,Philippines,2434,54,396395,7539
2020-11-09,Philippines,2054,108,398449,7647
2020-11-10,Philippines,1300,14,399749,7661
2020-11-11,Philippines,1667,49,401416,7710
2020-11-12,Philippines,1404,11,402820,7721
2020-11-13,Philippines,1893,31,404713,7752
2020-11-14,Philippines,1624,39,406337,7791
2020-11-15,Philippines,1501,41,407838,7832
2020-11-16,Philippines,1736,7,409574,7839
2020-11-17,Philippines,1144,23,410718,7862
2020-11-18,Philippines,1379,95,412097,7957
2020-11-19,Philippines,1333,41,413430,7998
2020-11-20,Philippines,1637,27,415067,8025
2020-11-21,Philippines,1785,55,416852,8080
2020-11-22,Philippines,1966,43,418818,8123
2020-11-23,Philippines,1796,50,420614,8173
2020-11-24,Philippines,1108,12,421722,8185
2020-11-25,Philippines,1193,30,422915,8215
2020-11-26,Philippines,1382,27,424297,8242
2020-11-27,Philippines,1621,13,425918,8255
2020-11-28,Philippines,1879,78,427797,8333
2020-11-29,Philippines,2067,40,429864,8373
2020-11-30,Philippines,1766,19,431630,8392
2020-12-01,Philippines,1295,26,432925,8418
2020-12-02,Philippines,1432,18,434357,8436
2020-12-03,Philippines,1056,10,435413,8446
2020-12-04,Philippines,932,63,436345,8509
2020-12-05,Philippines,1724,17,438069,8526
2020-12-06,Philippines,1765,28,439834,8554
2020-12-07,Philippines,1565,18,441399,8572
2020-12-08,Philippines,1386,98,442785,8670
2020-12-09,Philippines,1379,7,444164,8677
2020-12-10,Philippines,1376,24,445540,8701
2020-12-11,Philippines,1499,8,447039,8709
2020-12-12,Philippines,1292,21,448331,8730
2020-12-13,Philippines,1069,3,449400,8733
2020-12-14,Philippines,1333,24,450733,8757
2020-12-15,Philippines,1106,55,451839,8812
2020-12-16,Philippines,1149,21,452988,8833
2020-12-17,Philippines,1459,17,454447,8850
2020-12-18,Philippines,2115,25,456562,8875
2020-12-19,Philippines,1482,36,458044,8911
2020-12-20,Philippines,1745,36,459789,8947
2020-12-21,Philippines,1716,10,461505,8957
2020-12-22,Philippines,1310,64,462815,9021
2020-12-23,Philippines,1189,27,464004,9048
2020-12-24,Philippines,1720,7,465724,9055
2020-12-25,Philippines,1877,7,467601,9062
2020-12-26,Philippines,1404,5,469005,9067
2020-12-27,Philippines,881,42,469886,9109
2020-12-28,Philippines,764,15,470650,9124
2020-12-29,Philippines,876,38,471526,9162
2020-12-30,Philippines,1006,68,472532,9230
2020-12-31,Philippines,1532,14,474064,9244
2021-01-01,Philippines,1756,4,475820,9248
2021-01-02,Philippines,1096,5,476916,9253
2021-01-03,Philippines,891,4,477807,9257
2021-01-04,Philippines,954,6,478761,9263
2021-01-05,Philippines,932,58,479693,9321
2021-01-06,Philippines,1044,26,480737,9347
2021-01-07,Philippines,1346,9,482083,9356
2021-01-08,Philippines,1769,8,483852,9364
2021-01-09,Philippines,1945,34,485797,9398
2021-01-10,Philippines,1893,7,487690,9405
2021-01-11,Philippines,2046,11,489736,9416
2021-01-12,Philippines,1522,138,491258,9554
2021-01-13,Philippines,1442,145,492700,9699
2021-01-14,Philippines,1905,40,494605,9739
2021-01-15,Philippines,2041,137,496646,9876
2021-01-16,Philippines,2045,8,498691,9884
2021-01-17,Philippines,1886,11,500577,9895
2021-01-18,Philippines,2159,14,502736,9909
2021-01-19,Philippines,1348,69,504084,9978
2021-01-20,Philippines,1855,64,505939,10042
2021-01-21,Philippines,1778,74,507717,10116
2021-01-22,Philippines,2170,20,509887,10136
2021-01-23,Philippines,1792,54,511679,10190
2021-01-24,Philippines,1940,52,513619,10242
2021-01-25,Philippines,1377,50,514996,10292
2021-01-26,Philippines,1170,94,516166,10386
2021-01-27,Philippines,2241,95,518407,10481
2021-01-28,Philippines,1168,71,519575,10552
2021-01-29,Philippines,1838,48,521413,10600
2021-01-30,Philippines,2103,69,523516,10669
2021-01-31,Philippines,2102,80,525618,10749
2021-02-01,Philippines,1654,58,527272,10807
2021-02-02,Philippines,1581,67,528853,10874
2021-02-03,Philippines,1265,68,530118,10942
2021-02-04,Philippines,1581,55,531699,10997
2021-02-05,Philippines,1888,61,533587,11058
2021-02-06,Philippines,1934,52,535521,11110
2021-02-07,Philippines,1789,69,537310,11179
2021-02-08,Philippines,1685,52,538995,11231
2021-02-09,Philippines,1232,65,540227,11296
2021-02-10,Philippines,1333,105,541560,11401
2021-02-11,Philippines,1722,68,543282,11469
2021-02-12,Philippines,2018,26,545300,11495
2021-02-13,Philippines,1955,12,547255,11507
2021-02-14,Philippines,1921,8,549176,11515
2021-02-15,Philippines,1684,2,550860,11517
2021-02-16,Philippines,1386,7,552246,11524
2021-02-17,Philippines,1178,53,553424,11577
2021-02-18,Philippines,1739,96,555163,11673
2021-02-19,Philippines,1895,156,557058,11829
2021-02-20,Philippines,2230,239,559288,12068
2021-02-21,Philippines,1881,20,561169,12088
2021-02-22,Philippines,2287,6,563456,12094
2021-02-23,Philippines,1409,13,564865,12107
2021-02-24,Philippines,1555,22,566420,12129
2021-02-25,Philippines,2260,72,568680,12201
2021-02-26,Philippines,2647,46,571327,12247
2021-02-27,Philippines,2920,42,574247,12289
2021-02-28,Philippines,2105,29,576352,12318
2021-03-01,Philippines,2029,4,578381,12322
2021-03-02,Philippines,2061,47,580442,12369
2021-03-03,Philippines,1781,20,582223,12389
2021-03-04,Philippines,2444,15,584667,12404
2021-03-05,Philippines,3037,19,587704,12423
2021-03-06,Philippines,3434,42,591138,12465
2021-03-07,Philippines,3274,51,594412,12516
2021-03-08,Philippines,3351,5,597763,12521
2021-03-09,Philippines,2665,7,600428,12528
2021-03-10,Philippines,2880,17,603308,12545
2021-03-11,Philippines,3740,63,607048,12608
2021-03-12,Philippines,4570,86,611618,12694
2021-03-13,Philippines,4993,72,616611,12766
2021-03-14,Philippines,4887,63,621498,12829
2021-03-15,Philippines,5395,8,626893,12837
2021-03-16,Philippines,4427,11,631320,12848
2021-03-17,Philippines,4378,18,635698,12866
2021-03-18,Philippines,5286,21,640984,12887
2021-03-19,Philippines,7082,13,648066,12900
2021-03-20,Philippines,7990,30,656056,12930
2021-03-21,Philippines,7738,38,663794,12968
2021-03-22,Philippines,7998,4,671792,12972
2021-03-23,Philippines,5861,20,677653,12992
2021-03-24,Philippines,6658,47,684311,13039
2021-03-25,Philippines,8737,56,693048,13095
2021-03-26,Philippines,9808,54,702856,13149
2021-03-27,Philippines,9586,10,712442,13159
2021-03-28,Philippines,9450,11,721892,13170
2021-03-29,Philippines,10002,16,731894,13186
2021-03-30,Philippines,9287,5,741181,13191
2021-03-31,Philippines,6107,106,747288,13297
2021-04-01,Philippines,8911,6,756199,13303
2021-04-02,Philippines,15298,17,771497,13320
2021-04-03,Philippines,12546,103,784043,13423
2021-04-04,Philippines,11008,2,795051,13425
2021-04-05,Philippines,8347,10,803398,13435
2021-04-06,Philippines,9362,382,812760,13817
2021-04-07,Philippines,6404,242,819164,14059
2021-04-08,Philippines,9202,60,828366,14119
2020-03-04,Poland,1,0,1,0
2020-03-05,Poland,0,0,1,0
2020-03-06,Poland,4,0,5,0
2020-03-07,Poland,0,0,5,0
2020-03-08,Poland,6,0,11,0
2020-03-09,Poland,5,0,16,0
2020-03-10,Poland,6,0,22,0
2020-03-11,Poland,9,0,31,0
2020-03-12,Poland,18,1,49,1
2020-03-13,Poland,19,1,68,2
2020-03-14,Poland,35,1,103,3
2020-03-15,Poland,16,0,119,3
2020-03-16,Poland,58,1,177,4
2020-03-17,Poland,61,1,238,5
2020-03-18,Poland,13,0,251,5
2020-03-19,Poland,104,0,355,5
2020-03-20,Poland,70,0,425,5
2020-03-21,Poland,111,0,536,5
2020-03-22,Poland,98,2,634,7
2020-03-23,Poland,115,1,749,8
2020-03-24,Poland,152,2,901,10
2020-03-25,Poland,150,4,1051,14
2020-03-26,Poland,170,2,1221,16
2020-03-27,Poland,168,0,1389,16
2020-03-28,Poland,249,2,1638,18
2020-03-29,Poland,224,4,1862,22
2020-03-30,Poland,193,9,2055,31
2020-03-31,Poland,256,2,2311,33
2020-04-01,Poland,243,10,2554,43
2020-04-02,Poland,392,14,2946,57
2020-04-03,Poland,437,14,3383,71
2020-04-04,Poland,244,8,3627,79
2020-04-05,Poland,475,15,4102,94
2020-04-06,Poland,311,13,4413,107
2020-04-07,Poland,435,22,4848,129
2020-04-08,Poland,357,30,5205,159
2020-04-09,Poland,370,15,5575,174
2020-04-10,Poland,380,7,5955,181
2020-04-11,Poland,401,27,6356,208
2020-04-12,Poland,318,24,6674,232
2020-04-13,Poland,260,13,6934,245
2020-04-14,Poland,268,18,7202,263
2020-04-15,Poland,380,23,7582,286
2020-04-16,Poland,336,28,7918,314
2020-04-17,Poland,461,18,8379,332
2020-04-18,Poland,363,15,8742,347
2020-04-19,Poland,545,13,9287,360
2020-04-20,Poland,306,20,9593,380
2020-04-21,Poland,263,21,9856,401
2020-04-22,Poland,313,25,10169,426
2020-04-23,Poland,342,28,10511,454
2020-04-24,Poland,381,40,10892,494
2020-04-25,Poland,381,30,11273,524
2020-04-26,Poland,344,11,11617,535
2020-04-27,Poland,285,27,11902,562
2020-04-28,Poland,316,34,12218,596
2020-04-29,Poland,422,28,12640,624
2020-04-30,Poland,237,20,12877,644
2020-05-01,Poland,228,7,13105,651
2020-05-02,Poland,270,13,13375,664
2020-05-03,Poland,318,14,13693,678
2020-05-04,Poland,313,20,14006,698
2020-05-05,Poland,425,18,14431,716
2020-05-06,Poland,309,17,14740,733
2020-05-07,Poland,307,22,15047,755
2020-05-08,Poland,319,21,15366,776
2020-05-09,Poland,285,9,15651,785
2020-05-10,Poland,345,15,15996,800
2020-05-11,Poland,330,11,16326,811
2020-05-12,Poland,595,28,16921,839
2020-05-13,Poland,283,22,17204,861
2020-05-14,Poland,411,22,17615,883
2020-05-15,Poland,401,24,18016,907
2020-05-16,Poland,241,8,18257,915
2020-05-17,Poland,272,10,18529,925
2020-05-18,Poland,356,11,18885,936
2020-05-19,Poland,383,12,19268,948
2020-05-20,Poland,471,14,19739,962
2020-05-21,Poland,404,10,20143,972
2020-05-22,Poland,476,10,20619,982
2020-05-23,Poland,312,11,20931,993
2020-05-24,Poland,395,3,21326,996
2020-05-25,Poland,305,11,21631,1007
2020-05-26,Poland,443,17,22074,1024
2020-05-27,Poland,399,4,22473,1028
2020-05-28,Poland,352,10,22825,1038
2020-05-29,Poland,330,13,23155,1051
2020-05-30,Poland,416,10,23571,1061
2020-05-31,Poland,215,3,23786,1064
2020-06-01,Poland,379,10,24165,1074
2020-06-02,Poland,230,18,24395,1092
2020-06-03,Poland,292,23,24687,1115
2020-06-04,Poland,361,2,25048,1117
2020-06-05,Poland,362,20,25410,1137
2020-06-06,Poland,576,16,25986,1153
2020-06-07,Poland,575,4,26561,1157
2020-06-08,Poland,599,9,27160,1166
2020-06-09,Poland,400,17,27560,1183
2020-06-10,Poland,282,23,27842,1206
2020-06-11,Poland,359,9,28201,1215
2020-06-12,Poland,376,7,28577,1222
2020-06-13,Poland,440,15,29017,1237
2020-06-14,Poland,375,10,29392,1247
2020-06-15,Poland,396,9,29788,1256
2020-06-16,Poland,407,16,30195,1272
2020-06-17,Poland,506,14,30701,1286
2020-06-18,Poland,314,30,31015,1316
2020-06-19,Poland,301,18,31316,1334
2020-06-20,Poland,304,12,31620,1346
2020-06-21,Poland,311,10,31931,1356
2020-06-22,Poland,296,3,32227,1359
2020-06-23,Poland,300,16,32527,1375
2020-06-24,Poland,294,21,32821,1396
2020-06-25,Poland,298,16,33119,1412
2020-06-26,Poland,276,17,33395,1429
2020-06-27,Poland,319,6,33714,1435
2020-06-28,Poland,193,3,33907,1438
2020-06-29,Poland,247,6,34154,1444
2020-06-30,Poland,239,19,34393,1463
2020-07-01,Poland,382,14,34775,1477
2020-07-02,Poland,371,15,35146,1492
2020-07-03,Poland,259,15,35405,1507
2020-07-04,Poland,314,5,35719,1512
2020-07-05,Poland,231,5,35950,1517
2020-07-06,Poland,205,4,36155,1521
2020-07-07,Poland,257,7,36412,1528
2020-07-08,Poland,277,14,36689,1542
2020-07-09,Poland,262,9,36951,1551
2020-07-10,Poland,265,11,37216,1562
2020-07-11,Poland,305,6,37521,1568
2020-07-12,Poland,370,3,37891,1571
2020-07-13,Poland,299,5,38190,1576
2020-07-14,Poland,267,12,38457,1588
2020-07-15,Poland,264,6,38721,1594
2020-07-16,Poland,333,11,39054,1605
2020-07-17,Poland,353,7,39407,1612
2020-07-18,Poland,339,6,39746,1618
2020-07-19,Poland,358,6,40104,1624
2020-07-20,Poland,279,3,40383,1627
2020-07-21,Poland,399,9,40782,1636
2020-07-22,Poland,380,6,41162,1642
2020-07-23,Poland,418,9,41580,1651
2020-07-24,Poland,458,4,42038,1655
2020-07-25,Poland,584,9,42622,1664
2020-07-26,Poland,443,7,43065,1671
2020-07-27,Poland,337,5,43402,1676
2020-07-28,Poland,502,6,43904,1682
2020-07-29,Poland,512,12,44416,1694
2020-07-30,Poland,615,15,45031,1709
2020-07-31,Poland,657,7,45688,1716
2020-08-01,Poland,658,5,46346,1721
2020-08-02,Poland,548,10,46894,1731
2020-08-03,Poland,575,1,47469,1732
2020-08-04,Poland,680,6,48149,1738
2020-08-05,Poland,640,18,48789,1756
2020-08-06,Poland,726,18,49515,1774
2020-08-07,Poland,809,13,50324,1787
2020-08-08,Poland,843,13,51167,1800
2020-08-09,Poland,624,7,51791,1807
2020-08-10,Poland,619,2,52410,1809
2020-08-11,Poland,551,12,52961,1821
2020-08-12,Poland,715,9,53676,1830
2020-08-13,Poland,811,14,54487,1844
2020-08-14,Poland,832,14,55319,1858
2020-08-15,Poland,771,11,56090,1869
2020-08-16,Poland,594,8,56684,1877
2020-08-17,Poland,595,8,57279,1885
2020-08-18,Poland,597,11,57876,1896
2020-08-19,Poland,735,17,58611,1913
2020-08-20,Poland,767,12,59378,1925
2020-08-21,Poland,903,13,60281,1938
2020-08-22,Poland,900,13,61181,1951
2020-08-23,Poland,581,4,61762,1955
2020-08-24,Poland,548,5,62310,1960
2020-08-25,Poland,763,17,63073,1977
2020-08-26,Poland,729,17,63802,1994
2020-08-27,Poland,887,16,64689,2010
2020-08-28,Poland,791,8,65480,2018
2020-08-29,Poland,759,14,66239,2032
2020-08-30,Poland,631,1,66870,2033
2020-08-31,Poland,502,6,67372,2039
2020-09-01,Poland,550,19,67922,2058
2020-09-02,Poland,595,20,68517,2078
2020-09-03,Poland,612,14,69129,2092
2020-09-04,Poland,691,8,69820,2100
2020-09-05,Poland,567,13,70387,2113
2020-09-06,Poland,437,7,70824,2120
2020-09-07,Poland,302,4,71126,2124
2020-09-08,Poland,400,12,71526,2136
2020-09-09,Poland,421,11,71947,2147
2020-09-10,Poland,506,12,72453,2159
2020-09-11,Poland,594,10,73047,2169
2020-09-12,Poland,603,13,73650,2182
2020-09-13,Poland,502,6,74152,2188
2020-09-14,Poland,377,15,74529,2203
2020-09-15,Poland,605,24,75134,2227
2020-09-16,Poland,600,10,75734,2237
2020-09-17,Poland,837,16,76571,2253
2020-09-18,Poland,757,17,77328,2270
2020-09-19,Poland,1002,12,78330,2282
2020-09-20,Poland,910,11,79240,2293
2020-09-21,Poland,748,5,79988,2298
2020-09-22,Poland,711,18,80699,2316
2020-09-23,Poland,974,28,81673,2344
2020-09-24,Poland,1136,25,82809,2369
2020-09-25,Poland,1587,23,84396,2392
2020-09-26,Poland,1584,32,85980,2424
2020-09-27,Poland,1350,8,87330,2432
2020-09-28,Poland,1306,15,88636,2447
2020-09-29,Poland,1326,36,89962,2483
2020-09-30,Poland,1552,30,91514,2513
2020-10-01,Poland,1967,30,93481,2543
2020-10-02,Poland,2292,27,95773,2570
2020-10-03,Poland,2367,34,98140,2604
2020-10-04,Poland,1934,26,100074,2630
2020-10-05,Poland,2006,29,102080,2659
2020-10-06,Poland,2236,58,104316,2717
2020-10-07,Poland,3003,75,107319,2792
2020-10-08,Poland,4280,75,111599,2867
2020-10-09,Poland,4739,52,116338,2919
2020-10-10,Poland,5300,53,121638,2972
2020-10-11,Poland,4178,32,125816,3004
2020-10-12,Poland,4394,35,130210,3039
2020-10-13,Poland,5068,62,135278,3101
2020-10-14,Poland,6526,116,141804,3217
2020-10-15,Poland,8099,91,149903,3308
2020-10-16,Poland,7705,132,157608,3440
2020-10-17,Poland,9622,84,167230,3524
2020-10-18,Poland,8536,49,175766,3573
2020-10-19,Poland,7482,41,183248,3614
2020-10-20,Poland,9291,107,192539,3721
2020-10-21,Poland,10040,130,202579,3851
2020-10-22,Poland,12107,168,214686,4019
2020-10-23,Poland,13632,153,228318,4172
2020-10-24,Poland,13628,179,241946,4351
2020-10-25,Poland,11742,87,253688,4438
2020-10-26,Poland,10241,45,263929,4483
2020-10-27,Poland,16300,132,280229,4615
2020-10-28,Poland,18820,234,299049,4849
2020-10-29,Poland,20156,300,319205,5149
2020-10-30,Poland,21629,202,340834,5351
2020-10-31,Poland,21897,280,362731,5631
2020-11-01,Poland,17171,152,379902,5783
2020-11-02,Poland,15578,92,395480,5875
2020-11-03,Poland,19364,227,414844,6102
2020-11-04,Poland,24692,373,439536,6475
2020-11-05,Poland,27143,367,466679,6842
2020-11-06,Poland,27086,445,493765,7287
2020-11-07,Poland,27875,349,521640,7636
2020-11-08,Poland,24785,236,546425,7872
2020-11-09,Poland,21713,173,568138,8045
2020-11-10,Poland,25454,330,593592,8375
2020-11-11,Poland,25221,430,618813,8805
2020-11-12,Poland,22683,275,641496,9080
2020-11-13,Poland,24051,419,665547,9499
2020-11-14,Poland,25571,546,691118,10045
2020-11-15,Poland,21854,303,712972,10348
2020-11-16,Poland,20816,143,733788,10491
2020-11-17,Poland,19152,357,752940,10848
2020-11-18,Poland,19883,603,772823,11451
2020-11-19,Poland,23975,637,796798,12088
2020-11-20,Poland,22464,626,819262,12714
2020-11-21,Poland,24213,574,843475,13288
2020-11-22,Poland,17856,330,861331,13618
2020-11-23,Poland,15002,156,876333,13774
2020-11-24,Poland,32733,540,909066,14314
2020-11-25,Poland,15356,674,924422,14988
2020-11-26,Poland,16690,580,941112,15568
2020-11-27,Poland,17304,579,958416,16147
2020-11-28,Poland,15177,599,973593,16746
2020-11-29,Poland,11482,283,985075,17029
2020-11-30,Poland,5736,121,990811,17150
2020-12-01,Poland,9113,449,999924,17599
2020-12-02,Poland,13823,609,1013747,18208
2020-12-03,Poland,14863,620,1028610,18828
2020-12-04,Poland,13236,531,1041846,19359
2020-12-05,Poland,12427,502,1054273,19861
2020-12-06,Poland,9176,228,1063449,20089
2020-12-07,Poland,4421,92,1067870,20181
2020-12-08,Poland,8310,411,1076180,20592
2020-12-09,Poland,12166,568,1088346,21160
2020-12-10,Poland,13750,470,1102096,21630
2020-12-11,Poland,13105,544,1115201,22174
2020-12-12,Poland,11499,502,1126700,22676
2020-12-13,Poland,8976,188,1135676,22864
2020-12-14,Poland,4896,96,1140572,22960
2020-12-15,Poland,6874,349,1147446,23309
2020-12-16,Poland,12455,605,1159901,23914
2020-12-17,Poland,11953,431,1171854,24345
2020-12-18,Poland,11010,426,1182864,24771
2020-12-19,Poland,11246,483,1194110,25254
2020-12-20,Poland,8590,143,1202700,25397
2020-12-21,Poland,4633,77,1207333,25474
2020-12-22,Poland,7192,309,1214525,25783
2020-12-23,Poland,12358,472,1226883,26255
2020-12-24,Poland,13115,497,1239998,26752
2020-12-25,Poland,9081,240,1249079,26992
2020-12-26,Poland,4878,69,1253957,27061
2020-12-27,Poland,3842,57,1257799,27118
2020-12-28,Poland,3211,29,1261010,27147
2020-12-29,Poland,7624,307,1268634,27454
2020-12-30,Poland,12780,565,1281414,28019
2020-12-31,Poland,13464,535,1294878,28554
2021-01-01,Poland,10896,402,1305774,28956
2021-01-02,Poland,7006,102,1312780,29058
2021-01-03,Poland,5782,61,1318562,29119
2021-01-04,Poland,4385,42,1322947,29161
2021-01-05,Poland,7596,341,1330543,29502
2021-01-06,Poland,14220,553,1344763,30055
2021-01-07,Poland,12119,186,1356882,30241
2021-01-08,Poland,8763,333,1365645,30574
2021-01-09,Poland,10744,437,1376389,31011
2021-01-10,Poland,9133,178,1385522,31189
2021-01-11,Poland,4863,75,1390385,31264
2021-01-12,Poland,5394,329,1395779,31593
2021-01-13,Poland,9126,481,1404905,32074
2021-01-14,Poland,9457,382,1414362,32456
2021-01-15,Poland,7958,388,1422320,32844
2021-01-16,Poland,7292,369,1429612,33213
2021-01-17,Poland,5970,142,1435582,33355
2021-01-18,Poland,3332,52,1438914,33407
2021-01-19,Poland,4890,291,1443804,33698
2021-01-20,Poland,6943,443,1450747,34141
2021-01-21,Poland,7008,420,1457755,34561
2021-01-22,Poland,6693,347,1464448,34908
2021-01-23,Poland,6431,345,1470879,35253
2021-01-24,Poland,4566,110,1475445,35363
2021-01-25,Poland,2674,38,1478119,35401
2021-01-26,Poland,4603,264,1482722,35665
2021-01-27,Poland,6790,389,1489512,36054
2021-01-28,Poland,7153,389,1496665,36443
2021-01-29,Poland,6145,337,1502810,36780
2021-01-30,Poland,5864,302,1508674,37082
2021-01-31,Poland,4711,98,1513385,37180
2021-02-01,Poland,2504,42,1515889,37222
2021-02-02,Poland,4326,254,1520215,37476
2021-02-03,Poland,6801,421,1527016,37897
2021-02-04,Poland,6495,447,1533511,38344
2021-02-05,Poland,6053,368,1539564,38712
2021-02-06,Poland,5966,282,1545530,38994
2021-02-07,Poland,4725,93,1550255,39087
2021-02-08,Poland,2431,45,1552686,39132
2021-02-09,Poland,3999,228,1556685,39360
2021-02-10,Poland,6960,361,1563645,39721
2021-02-11,Poland,7013,456,1570658,40177
2021-02-12,Poland,6378,247,1577036,40424
2021-02-13,Poland,6585,285,1583621,40709
2021-02-14,Poland,5334,98,1588955,40807
2021-02-15,Poland,2542,25,1591497,40832
2021-02-16,Poland,5176,196,1596673,41028
2021-02-17,Poland,8699,280,1605372,41308
2021-02-18,Poland,9074,274,1614446,41582
2021-02-19,Poland,8772,241,1623218,41823
2021-02-20,Poland,8509,254,1631727,42077
2021-02-21,Poland,7040,94,1638767,42171
2021-02-22,Poland,3891,17,1642658,42188
2021-02-23,Poland,6304,248,1648962,42436
2021-02-24,Poland,12147,372,1661109,42808
2021-02-25,Poland,12143,286,1673252,43094
2021-02-26,Poland,11536,259,1684788,43353
2021-02-27,Poland,12097,303,1696885,43656
2021-02-28,Poland,10101,113,1706986,43769
2021-03-01,Poland,4786,24,1711772,43793
2021-03-02,Poland,7936,215,1719708,44008
2021-03-03,Poland,15698,352,1735406,44360
2021-03-04,Poland,15253,289,1750659,44649
2021-03-05,Poland,15831,263,1766490,44912
2021-03-06,Poland,14855,247,1781345,45159
2021-03-07,Poland,13569,126,1794914,45285
2021-03-08,Poland,6169,32,1801083,45317
2021-03-09,Poland,9953,282,1811036,45599
2021-03-10,Poland,17277,398,1828313,45997
2021-03-11,Poland,21111,376,1849424,46373
2021-03-12,Poland,18873,351,1868297,46724
2021-03-13,Poland,21063,344,1889360,47068
2021-03-14,Poland,17272,110,1906632,47178
2021-03-15,Poland,10895,28,1917527,47206
2021-03-16,Poland,14394,372,1931921,47578
2021-03-17,Poland,25053,454,1956974,48032
2021-03-18,Poland,27274,356,1984248,48388
2021-03-19,Poland,25996,419,2010244,48807
2021-03-20,Poland,26456,352,2036700,49159
2021-03-21,Poland,21850,141,2058550,49300
2021-03-22,Poland,14579,65,2073129,49365
2021-03-23,Poland,16740,396,2089869,49761
2021-03-24,Poland,30802,579,2120671,50340
2021-03-25,Poland,34150,520,2154821,50860
2021-03-26,Poland,35145,445,2189966,51305
2021-03-27,Poland,31759,448,2221725,51753
2021-03-28,Poland,29266,131,2250991,51884
2021-03-29,Poland,16973,48,2267964,51932
2021-03-30,Poland,20862,460,2288826,52392
2021-03-31,Poland,32891,653,2321717,53045
2021-04-01,Poland,35253,620,2356970,53665
2021-04-02,Poland,30541,500,2387511,54165
2021-04-03,Poland,28073,572,2415584,54737
2021-04-04,Poland,22958,204,2438542,54941
2021-04-05,Poland,9921,64,2448463,55005
2021-04-06,Poland,8246,60,2456709,55065
2021-04-07,Poland,14908,638,2471617,55703
2021-04-08,Poland,27890,956,2499507,56659
2020-03-02,Portugal,2,0,2,0
2020-03-03,Portugal,0,0,2,0
2020-03-04,Portugal,3,0,5,0
2020-03-05,Portugal,3,0,8,0
2020-03-06,Portugal,5,0,13,0
2020-03-07,Portugal,7,0,20,0
2020-03-08,Portugal,10,0,30,0
2020-03-09,Portugal,0,0,30,0
2020-03-10,Portugal,11,0,41,0
2020-03-11,Portugal,18,0,59,0
2020-03-12,Portugal,0,0,59,0
2020-03-13,Portugal,53,0,112,0
2020-03-14,Portugal,57,0,169,0
2020-03-15,Portugal,76,0,245,0
2020-03-16,Portugal,86,0,331,0
2020-03-17,Portugal,117,1,448,1
2020-03-18,Portugal,0,1,448,2
2020-03-19,Portugal,337,1,785,3
2020-03-20,Portugal,235,3,1020,6
2020-03-21,Portugal,260,6,1280,12
2020-03-22,Portugal,320,2,1600,14
2020-03-23,Portugal,460,9,2060,23
2020-03-24,Portugal,302,10,2362,33
2020-03-25,Portugal,633,10,2995,43
2020-03-26,Portugal,549,17,3544,60
2020-03-27,Portugal,724,16,4268,76
2020-03-28,Portugal,902,24,5170,100
2020-03-29,Portugal,792,19,5962,119
2020-03-30,Portugal,446,21,6408,140
2020-03-31,Portugal,1035,20,7443,160
2020-04-01,Portugal,808,27,8251,187
2020-04-02,Portugal,783,22,9034,209
2020-04-03,Portugal,852,37,9886,246
2020-04-04,Portugal,638,20,10524,266
2020-04-05,Portugal,754,29,11278,295
2020-04-06,Portugal,452,16,11730,311
2020-04-07,Portugal,712,34,12442,345
2020-04-08,Portugal,699,35,13141,380
2020-04-09,Portugal,815,29,13956,409
2020-04-10,Portugal,1516,26,15472,435
2020-04-11,Portugal,515,35,15987,470
2020-04-12,Portugal,598,34,16585,504
2020-04-13,Portugal,349,31,16934,535
2020-04-14,Portugal,514,32,17448,567
2020-04-15,Portugal,643,32,18091,599
2020-04-16,Portugal,750,30,18841,629
2020-04-17,Portugal,181,28,19022,657
2020-04-18,Portugal,663,30,19685,687
2020-04-19,Portugal,521,27,20206,714
2020-04-20,Portugal,657,21,20863,735
2020-04-21,Portugal,516,27,21379,762
2020-04-22,Portugal,603,23,21982,785
2020-04-23,Portugal,371,35,22353,820
2020-04-24,Portugal,444,34,22797,854
2020-04-25,Portugal,595,26,23392,880
2020-04-26,Portugal,472,23,23864,903
2020-04-27,Portugal,163,25,24027,928
2020-04-28,Portugal,295,20,24322,948
2020-04-29,Portugal,183,25,24505,973
2020-04-30,Portugal,540,16,25045,989
2020-05-01,Portugal,306,18,25351,1007
2020-05-02,Portugal,-161,16,25190,1023
2020-05-03,Portugal,92,20,25282,1043
2020-05-04,Portugal,242,20,25524,1063
2020-05-05,Portugal,178,11,25702,1074
2020-05-06,Portugal,480,15,26182,1089
2020-05-07,Portugal,533,16,26715,1105
2020-05-08,Portugal,553,9,27268,1114
2020-05-09,Portugal,138,12,27406,1126
2020-05-10,Portugal,175,9,27581,1135
2020-05-11,Portugal,98,9,27679,1144
2020-05-12,Portugal,234,19,27913,1163
2020-05-13,Portugal,219,12,28132,1175
2020-05-14,Portugal,187,9,28319,1184
2020-05-15,Portugal,264,6,28583,1190
2020-05-16,Portugal,227,13,28810,1203
2020-05-17,Portugal,226,15,29036,1218
2020-05-18,Portugal,173,13,29209,1231
2020-05-19,Portugal,223,16,29432,1247
2020-05-20,Portugal,228,16,29660,1263
2020-05-21,Portugal,252,14,29912,1277
2020-05-22,Portugal,288,12,30200,1289
2020-05-23,Portugal,271,13,30471,1302
2020-05-24,Portugal,152,14,30623,1316
2020-05-25,Portugal,165,14,30788,1330
2020-05-26,Portugal,219,12,31007,1342
2020-05-27,Portugal,285,14,31292,1356
2020-05-28,Portugal,304,13,31596,1369
2020-05-29,Portugal,350,14,31946,1383
2020-05-30,Portugal,257,13,32203,1396
2020-05-31,Portugal,297,14,32500,1410
2020-06-01,Portugal,200,14,32700,1424
2020-06-02,Portugal,195,12,32895,1436
2020-06-03,Portugal,366,11,33261,1447
2020-06-04,Portugal,331,8,33592,1455
2020-06-05,Portugal,377,10,33969,1465
2020-06-06,Portugal,382,9,34351,1474
2020-06-07,Portugal,342,5,34693,1479
2020-06-08,Portugal,192,6,34885,1485
2020-06-09,Portugal,421,7,35306,1492
2020-06-10,Portugal,294,5,35600,1497
2020-06-11,Portugal,310,7,35910,1504
2020-06-12,Portugal,270,1,36180,1505
2020-06-13,Portugal,283,7,36463,1512
2020-06-14,Portugal,227,5,36690,1517
2020-06-15,Portugal,346,3,37036,1520
2020-06-16,Portugal,300,2,37336,1522
2020-06-17,Portugal,336,1,37672,1523
2020-06-18,Portugal,417,1,38089,1524
2020-06-19,Portugal,375,3,38464,1527
2020-06-20,Portugal,377,1,38841,1528
2020-06-21,Portugal,292,2,39133,1530
2020-06-22,Portugal,259,4,39392,1534
2020-06-23,Portugal,345,6,39737,1540
2020-06-24,Portugal,367,3,40104,1543
2020-06-25,Portugal,311,6,40415,1549
2020-06-26,Portugal,451,6,40866,1555
2020-06-27,Portugal,323,6,41189,1561
2020-06-28,Portugal,457,3,41646,1564
2020-06-29,Portugal,266,4,41912,1568
2020-06-30,Portugal,229,8,42141,1576
2020-07-01,Portugal,313,3,42454,1579
2020-07-02,Portugal,328,8,42782,1587
2020-07-03,Portugal,374,11,43156,1598
2020-07-04,Portugal,413,7,43569,1605
2020-07-05,Portugal,328,9,43897,1614
2020-07-06,Portugal,232,6,44129,1620
2020-07-07,Portugal,287,9,44416,1629
2020-07-08,Portugal,443,2,44859,1631
2020-07-09,Portugal,418,13,45277,1644
2020-07-10,Portugal,402,2,45679,1646
2020-07-11,Portugal,542,8,46221,1654
2020-07-12,Portugal,291,6,46512,1660
2020-07-13,Portugal,306,2,46818,1662
2020-07-14,Portugal,233,6,47051,1668
2020-07-15,Portugal,375,8,47426,1676
2020-07-16,Portugal,339,3,47765,1679
2020-07-17,Portugal,312,3,48077,1682
2020-07-18,Portugal,313,2,48390,1684
2020-07-19,Portugal,246,5,48636,1689
2020-07-20,Portugal,135,2,48771,1691
2020-07-21,Portugal,127,6,48898,1697
2020-07-22,Portugal,252,5,49150,1702
2020-07-23,Portugal,229,3,49379,1705
2020-07-24,Portugal,313,7,49692,1712
2020-07-25,Portugal,263,4,49955,1716
2020-07-26,Portugal,209,1,50164,1717
2020-07-27,Portugal,135,2,50299,1719
2020-07-28,Portugal,111,3,50410,1722
2020-07-29,Portugal,203,3,50613,1725
2020-07-30,Portugal,255,2,50868,1727
2020-07-31,Portugal,204,8,51072,1735
2020-08-01,Portugal,238,2,51310,1737
2020-08-02,Portugal,153,1,51463,1738
2020-08-03,Portugal,106,0,51569,1738
2020-08-04,Portugal,112,1,51681,1739
2020-08-05,Portugal,167,1,51848,1740
2020-08-06,Portugal,213,3,52061,1743
2020-08-07,Portugal,290,3,52351,1746
2020-08-08,Portugal,186,4,52537,1750
2020-08-09,Portugal,131,6,52668,1756
2020-08-10,Portugal,157,3,52825,1759
2020-08-11,Portugal,120,2,52945,1761
2020-08-12,Portugal,278,3,53223,1764
2020-08-13,Portugal,325,6,53548,1770
2020-08-14,Portugal,235,2,53783,1772
2020-08-15,Portugal,198,3,53981,1775
2020-08-16,Portugal,121,3,54102,1778
2020-08-17,Portugal,132,1,54234,1779
2020-08-18,Portugal,214,5,54448,1784
2020-08-19,Portugal,253,2,54701,1786
2020-08-20,Portugal,291,2,54992,1788
2020-08-21,Portugal,219,4,55211,1792
2020-08-22,Portugal,241,2,55452,1794
2020-08-23,Portugal,145,2,55597,1796
2020-08-24,Portugal,123,5,55720,1801
2020-08-25,Portugal,192,4,55912,1805
2020-08-26,Portugal,362,2,56274,1807
2020-08-27,Portugal,399,2,56673,1809
2020-08-28,Portugal,401,6,57074,1815
2020-08-29,Portugal,374,3,57448,1818
2020-08-30,Portugal,320,1,57768,1819
2020-08-31,Portugal,244,3,58012,1822
2020-09-01,Portugal,231,2,58243,1824
2020-09-02,Portugal,390,3,58633,1827
2020-09-03,Portugal,418,2,59051,1829
2020-09-04,Portugal,406,4,59457,1833
2020-09-05,Portugal,486,5,59943,1838
2020-09-06,Portugal,315,2,60258,1840
2020-09-07,Portugal,249,3,60507,1843
2020-09-08,Portugal,388,3,60895,1846
2020-09-09,Portugal,646,3,61541,1849
2020-09-10,Portugal,585,3,62126,1852
2020-09-11,Portugal,687,3,62813,1855
2020-09-12,Portugal,497,5,63310,1860
2020-09-13,Portugal,673,7,63983,1867
2020-09-14,Portugal,613,4,64596,1871
2020-09-15,Portugal,425,4,65021,1875
2020-09-16,Portugal,605,3,65626,1878
2020-09-17,Portugal,770,10,66396,1888
2020-09-18,Portugal,780,6,67176,1894
2020-09-19,Portugal,849,5,68025,1899
2020-09-20,Portugal,552,13,68577,1912
2020-09-21,Portugal,623,8,69200,1920
2020-09-22,Portugal,463,5,69663,1925
2020-09-23,Portugal,802,3,70465,1928
2020-09-24,Portugal,691,3,71156,1931
2020-09-25,Portugal,899,5,72055,1936
2020-09-26,Portugal,884,8,72939,1944
2020-09-27,Portugal,665,9,73604,1953
2020-09-28,Portugal,425,4,74029,1957
2020-09-29,Portugal,688,6,74717,1963
2020-09-30,Portugal,825,8,75542,1971
2020-10-01,Portugal,854,6,76396,1977
2020-10-02,Portugal,888,6,77284,1983
2020-10-03,Portugal,963,12,78247,1995
2020-10-04,Portugal,904,10,79151,2005
2020-10-05,Portugal,734,13,79885,2018
2020-10-06,Portugal,427,14,80312,2032
2020-10-07,Portugal,944,8,81256,2040
2020-10-08,Portugal,1278,10,82534,2050
2020-10-09,Portugal,1394,12,83928,2062
2020-10-10,Portugal,1646,5,85574,2067
2020-10-11,Portugal,1090,13,86664,2080
2020-10-12,Portugal,1249,14,87913,2094
2020-10-13,Portugal,1208,16,89121,2110
2020-10-14,Portugal,2072,7,91193,2117
2020-10-15,Portugal,2101,11,93294,2128
2020-10-16,Portugal,2608,21,95902,2149
2020-10-17,Portugal,2153,13,98055,2162
2020-10-18,Portugal,1856,19,99911,2181
2020-10-19,Portugal,1949,17,101860,2198
2020-10-20,Portugal,1876,15,103736,2213
2020-10-21,Portugal,2535,16,106271,2229
2020-10-22,Portugal,3270,16,109541,2245
2020-10-23,Portugal,2899,31,112440,2276
2020-10-24,Portugal,3669,21,116109,2297
2020-10-25,Portugal,2577,19,118686,2316
2020-10-26,Portugal,2447,27,121133,2343
2020-10-27,Portugal,3299,28,124432,2371
2020-10-28,Portugal,3960,24,128392,2395
2020-10-29,Portugal,4224,33,132616,2428
2020-10-30,Portugal,4656,40,137272,2468
2020-10-31,Portugal,4007,39,141279,2507
2020-11-01,Portugal,3062,37,144341,2544
2020-11-02,Portugal,2506,46,146847,2590
2020-11-03,Portugal,2596,45,149443,2635
2020-11-04,Portugal,7497,59,156940,2694
2020-11-05,Portugal,4410,46,161350,2740
2020-11-06,Portugal,5550,52,166900,2792
2020-11-07,Portugal,6640,56,173540,2848
2020-11-08,Portugal,5784,48,179324,2896
2020-11-09,Portugal,4096,63,183420,2959
2020-11-10,Portugal,3817,62,187237,3021
2020-11-11,Portugal,4935,82,192172,3103
2020-11-12,Portugal,5839,78,198011,3181
2020-11-13,Portugal,6653,69,204664,3250
2020-11-14,Portugal,6602,55,211266,3305
2020-11-15,Portugal,6035,76,217301,3381
2020-11-16,Portugal,8371,91,225672,3472
2020-11-17,Portugal,4452,81,230124,3553
2020-11-18,Portugal,5891,79,236015,3632
2020-11-19,Portugal,6994,69,243009,3701
2020-11-20,Portugal,6489,61,249498,3762
2020-11-21,Portugal,6472,62,255970,3824
2020-11-22,Portugal,4788,73,260758,3897
2020-11-23,Portugal,4044,74,264802,3971
2020-11-24,Portugal,3919,85,268721,4056
2020-11-25,Portugal,5290,71,274011,4127
2020-11-26,Portugal,6383,82,280394,4209
2020-11-27,Portugal,5444,67,285838,4276
2020-11-28,Portugal,4868,87,290706,4363
2020-11-29,Portugal,4093,64,294799,4427
2020-11-30,Portugal,3262,78,298061,4505
2020-12-01,Portugal,2401,72,300462,4577
2020-12-02,Portugal,3384,68,303846,4645
2020-12-03,Portugal,3772,79,307618,4724
2020-12-04,Portugal,4935,79,312553,4803
2020-12-05,Portugal,6087,73,318640,4876
2020-12-06,Portugal,3834,87,322474,4963
2020-12-07,Portugal,2597,78,325071,5041
2020-12-08,Portugal,2905,81,327976,5122
2020-12-09,Portugal,4097,70,332073,5192
2020-12-10,Portugal,3134,86,335207,5278
2020-12-11,Portugal,5080,95,340287,5373
2020-12-12,Portugal,4413,88,344700,5461
2020-12-13,Portugal,4044,98,348744,5559
2020-12-14,Portugal,2194,90,350938,5649
2020-12-15,Portugal,2638,84,353576,5733
2020-12-16,Portugal,4720,82,358296,5815
2020-12-17,Portugal,4320,87,362616,5902
2020-12-18,Portugal,4336,75,366952,5977
2020-12-19,Portugal,3835,86,370787,6063
2020-12-20,Portugal,3334,71,374121,6134
2020-12-21,Portugal,2099,57,376220,6191
2020-12-22,Portugal,2436,63,378656,6254
2020-12-23,Portugal,4602,89,383258,6343
2020-12-24,Portugal,4378,70,387636,6413
2020-12-25,Portugal,4146,65,391782,6478
2020-12-26,Portugal,1214,78,392996,6556
2020-12-27,Portugal,1577,63,394573,6619
2020-12-28,Portugal,2093,58,396666,6677
2020-12-29,Portugal,3336,74,400002,6751
2020-12-30,Portugal,6049,79,406051,6830
2020-12-31,Portugal,7627,76,413678,6906
2021-01-01,Portugal,6951,66,420629,6972
2021-01-02,Portugal,3241,73,423870,7045
2021-01-03,Portugal,3384,73,427254,7118
2021-01-04,Portugal,4369,78,431623,7196
2021-01-05,Portugal,4956,90,436579,7286
2021-01-06,Portugal,10027,91,446606,7377
2021-01-07,Portugal,9927,95,456533,7472
2021-01-08,Portugal,10176,118,466709,7590
2021-01-09,Portugal,9478,111,476187,7701
2021-01-10,Portugal,7502,102,483689,7803
2021-01-11,Portugal,5604,122,489293,7925
2021-01-12,Portugal,7259,155,496552,8080
2021-01-13,Portugal,10556,156,507108,8236
2021-01-14,Portugal,10698,148,517806,8384
2021-01-15,Portugal,10663,159,528469,8543
2021-01-16,Portugal,10947,166,539416,8709
2021-01-17,Portugal,10385,152,549801,8861
2021-01-18,Portugal,6702,167,556503,9028
2021-01-19,Portugal,10455,218,566958,9246
2021-01-20,Portugal,14647,219,581605,9465
2021-01-21,Portugal,13544,221,595149,9686
2021-01-22,Portugal,13987,234,609136,9920
2021-01-23,Portugal,15333,274,624469,10194
2021-01-24,Portugal,11721,275,636190,10469
2021-01-25,Portugal,6923,252,643113,10721
2021-01-26,Portugal,10765,291,653878,11012
2021-01-27,Portugal,15073,293,668951,11305
2021-01-28,Portugal,16432,303,685383,11608
2021-01-29,Portugal,13200,278,698583,11886
2021-01-30,Portugal,12435,293,711018,12179
2021-01-31,Portugal,9498,303,720516,12482
2021-02-01,Portugal,5805,275,726321,12757
2021-02-02,Portugal,5540,260,731861,13017
2021-02-03,Portugal,9083,240,740944,13257
2021-02-04,Portugal,7914,225,748858,13482
2021-02-05,Portugal,6916,258,755774,13740
2021-02-06,Portugal,6132,214,761906,13954
2021-02-07,Portugal,3508,204,765414,14158
2021-02-08,Portugal,2505,196,767919,14354
2021-02-09,Portugal,2583,203,770502,14557
2021-02-10,Portugal,4387,161,774889,14718
2021-02-11,Portugal,3480,167,778369,14885
2021-02-12,Portugal,2854,149,781223,15034
2021-02-13,Portugal,2856,149,784079,15183
2021-02-14,Portugal,1677,138,785756,15321
2021-02-15,Portugal,1303,90,787059,15411
2021-02-16,Portugal,1502,111,788561,15522
2021-02-17,Portugal,2324,127,790885,15649
2021-02-18,Portugal,1944,105,792829,15754
2021-02-19,Portugal,1940,67,794769,15821
2021-02-20,Portugal,1570,76,796339,15897
2021-02-21,Portugal,1186,65,797525,15962
2021-02-22,Portugal,549,61,798074,16023
2021-02-23,Portugal,1032,63,799106,16086
2021-02-24,Portugal,1480,50,800586,16136
2021-02-25,Portugal,1160,49,801746,16185
2021-02-26,Portugal,1027,58,802773,16243
2021-02-27,Portugal,1071,33,803844,16276
2021-02-28,Portugal,718,41,804562,16317
2021-03-01,Portugal,394,34,804956,16351
2021-03-02,Portugal,691,38,805647,16389
2021-03-03,Portugal,979,41,806626,16430
2021-03-04,Portugal,830,28,807456,16458
2021-03-05,Portugal,949,28,808405,16486
2021-03-06,Portugal,1007,26,809412,16512
2021-03-07,Portugal,682,28,810094,16540
2021-03-08,Portugal,365,25,810459,16565
2021-03-09,Portugal,847,30,811306,16595
2021-03-10,Portugal,642,22,811948,16617
2021-03-11,Portugal,627,18,812575,16635
2021-03-12,Portugal,577,15,813152,16650
2021-03-13,Portugal,564,19,813716,16669
2021-03-14,Portugal,541,15,814257,16684
2021-03-15,Portugal,256,10,814513,16694
2021-03-16,Portugal,384,13,814897,16707
2021-03-17,Portugal,673,15,815570,16722
2021-03-18,Portugal,485,21,816055,16743
2021-03-19,Portugal,568,11,816623,16754
2021-03-20,Portugal,457,8,817080,16762
2021-03-21,Portugal,450,6,817530,16768
2021-03-22,Portugal,248,16,817778,16784
2021-03-23,Portugal,434,10,818212,16794
2021-03-24,Portugal,575,11,818787,16805
2021-03-25,Portugal,423,9,819210,16814
2021-03-26,Portugal,488,5,819698,16819
2021-03-27,Portugal,344,8,820042,16827
2021-03-28,Portugal,365,10,820407,16837
2021-03-29,Portugal,309,6,820716,16843
2021-03-30,Portugal,388,2,821104,16845
2021-03-31,Portugal,618,3,821722,16848
2021-04-01,Portugal,592,11,822314,16859
2021-04-02,Portugal,548,9,822862,16868
2021-04-03,Portugal,280,7,823142,16875
2021-04-04,Portugal,193,4,823335,16879
2021-04-05,Portugal,159,6,823494,16885
2021-04-06,Portugal,874,2,824368,16887
2021-04-07,Portugal,663,3,825031,16890
2021-04-08,Portugal,602,9,825633,16899
2020-02-29,Qatar,1,0,1,0
2020-03-01,Qatar,2,0,3,0
2020-03-02,Qatar,0,0,3,0
2020-03-03,Qatar,4,0,7,0
2020-03-04,Qatar,1,0,8,0
2020-03-05,Qatar,0,0,8,0
2020-03-06,Qatar,0,0,8,0
2020-03-07,Qatar,0,0,8,0
2020-03-08,Qatar,7,0,15,0
2020-03-09,Qatar,3,0,18,0
2020-03-10,Qatar,6,0,24,0
2020-03-11,Qatar,238,0,262,0
2020-03-12,Qatar,0,0,262,0
2020-03-13,Qatar,58,0,320,0
2020-03-14,Qatar,17,0,337,0
2020-03-15,Qatar,64,0,401,0
2020-03-16,Qatar,38,0,439,0
2020-03-17,Qatar,0,0,439,0
2020-03-18,Qatar,13,0,452,0
2020-03-19,Qatar,8,0,460,0
2020-03-20,Qatar,10,0,470,0
2020-03-21,Qatar,11,0,481,0
2020-03-22,Qatar,13,0,494,0
2020-03-23,Qatar,7,0,501,0
2020-03-24,Qatar,25,0,526,0
2020-03-25,Qatar,11,0,537,0
2020-03-26,Qatar,12,0,549,0
2020-03-27,Qatar,13,0,562,0
2020-03-28,Qatar,28,1,590,1
2020-03-29,Qatar,44,0,634,1
2020-03-30,Qatar,59,0,693,1
2020-03-31,Qatar,88,1,781,2
2020-04-01,Qatar,54,0,835,2
2020-04-02,Qatar,114,1,949,3
2020-04-03,Qatar,126,0,1075,3
2020-04-04,Qatar,250,0,1325,3
2020-04-05,Qatar,279,1,1604,4
2020-04-06,Qatar,228,0,1832,4
2020-04-07,Qatar,225,2,2057,6
2020-04-08,Qatar,153,0,2210,6
2020-04-09,Qatar,166,0,2376,6
2020-04-10,Qatar,136,0,2512,6
2020-04-11,Qatar,216,0,2728,6
2020-04-12,Qatar,251,1,2979,7
2020-04-13,Qatar,252,0,3231,7
2020-04-14,Qatar,197,0,3428,7
2020-04-15,Qatar,283,0,3711,7
2020-04-16,Qatar,392,0,4103,7
2020-04-17,Qatar,560,0,4663,7
2020-04-18,Qatar,345,1,5008,8
2020-04-19,Qatar,440,0,5448,8
2020-04-20,Qatar,567,1,6015,9
2020-04-21,Qatar,518,0,6533,9
2020-04-22,Qatar,608,1,7141,10
2020-04-23,Qatar,623,0,7764,10
2020-04-24,Qatar,761,0,8525,10
2020-04-25,Qatar,833,0,9358,10
2020-04-26,Qatar,929,0,10287,10
2020-04-27,Qatar,957,0,11244,10
2020-04-28,Qatar,677,0,11921,10
2020-04-29,Qatar,643,0,12564,10
2020-04-30,Qatar,845,0,13409,10
2020-05-01,Qatar,687,2,14096,12
2020-05-02,Qatar,776,0,14872,12
2020-05-03,Qatar,679,0,15551,12
2020-05-04,Qatar,640,0,16191,12
2020-05-05,Qatar,951,0,17142,12
2020-05-06,Qatar,830,0,17972,12
2020-05-07,Qatar,918,0,18890,12
2020-05-08,Qatar,1311,0,20201,12
2020-05-09,Qatar,1130,1,21331,13
2020-05-10,Qatar,1189,1,22520,14
2020-05-11,Qatar,1103,0,23623,14
2020-05-12,Qatar,1526,0,25149,14
2020-05-13,Qatar,1390,0,26539,14
2020-05-14,Qatar,1733,0,28272,14
2020-05-15,Qatar,1153,0,29425,14
2020-05-16,Qatar,1547,1,30972,15
2020-05-17,Qatar,1632,0,32604,15
2020-05-18,Qatar,1365,0,33969,15
2020-05-19,Qatar,1637,0,35606,15
2020-05-20,Qatar,1491,1,37097,16
2020-05-21,Qatar,1554,1,38651,17
2020-05-22,Qatar,1830,2,40481,19
2020-05-23,Qatar,1732,2,42213,21
2020-05-24,Qatar,1501,2,43714,23
2020-05-25,Qatar,1751,3,45465,26
2020-05-26,Qatar,1742,2,47207,28
2020-05-27,Qatar,1740,2,48947,30
2020-05-28,Qatar,1967,3,50914,33
2020-05-29,Qatar,1993,3,52907,36
2020-05-30,Qatar,2355,0,55262,36
2020-05-31,Qatar,1648,2,56910,38
2020-06-01,Qatar,1523,2,58433,40
2020-06-02,Qatar,1826,3,60259,43
2020-06-03,Qatar,1901,2,62160,45
2020-06-04,Qatar,1581,0,63741,45
2020-06-05,Qatar,1754,4,65495,49
2020-06-06,Qatar,1700,2,67195,51
2020-06-07,Qatar,1595,3,68790,54
2020-06-08,Qatar,1368,3,70158,57
2020-06-09,Qatar,1721,5,71879,62
2020-06-10,Qatar,1716,4,73595,66
2020-06-11,Qatar,1476,3,75071,69
2020-06-12,Qatar,1517,1,76588,70
2020-06-13,Qatar,1828,0,78416,70
2020-06-14,Qatar,1186,3,79602,73
2020-06-15,Qatar,1274,3,80876,76
2020-06-16,Qatar,1201,4,82077,80
2020-06-17,Qatar,1097,2,83174,82
2020-06-18,Qatar,1267,4,84441,86
2020-06-19,Qatar,1021,7,85462,93
2020-06-20,Qatar,1026,1,86488,94
2020-06-21,Qatar,881,4,87369,98
2020-06-22,Qatar,1034,1,88403,99
2020-06-23,Qatar,1176,0,89579,99
2020-06-24,Qatar,1199,5,90778,104
2020-06-25,Qatar,1060,2,91838,106
2020-06-26,Qatar,946,3,92784,109
2020-06-27,Qatar,879,1,93663,110
2020-06-28,Qatar,750,0,94413,110
2020-06-29,Qatar,693,3,95106,113
2020-06-30,Qatar,982,0,96088,113
2020-07-01,Qatar,915,2,97003,115
2020-07-02,Qatar,894,3,97897,118
2020-07-03,Qatar,756,3,98653,121
2020-07-04,Qatar,530,2,99183,123
2020-07-05,Qatar,616,5,99799,128
2020-07-06,Qatar,546,5,100345,133
2020-07-07,Qatar,600,1,100945,134
2020-07-08,Qatar,608,4,101553,138
2020-07-09,Qatar,557,4,102110,142
2020-07-10,Qatar,520,4,102630,146
2020-07-11,Qatar,498,0,103128,146
2020-07-12,Qatar,470,1,103598,147
2020-07-13,Qatar,418,2,104016,149
2020-07-14,Qatar,517,1,104533,150
2020-07-15,Qatar,450,1,104983,151
2020-07-16,Qatar,494,1,105477,152
2020-07-17,Qatar,421,1,105898,153
2020-07-18,Qatar,410,1,106308,154
2020-07-19,Qatar,340,3,106648,157
2020-07-20,Qatar,389,2,107037,159
2020-07-21,Qatar,393,1,107430,160
2020-07-22,Qatar,441,3,107871,163
2020-07-23,Qatar,373,1,108244,164
2020-07-24,Qatar,394,0,108638,164
2020-07-25,Qatar,398,0,109036,164
2020-07-26,Qatar,269,1,109305,165
2020-07-27,Qatar,292,0,109597,165
2020-07-28,Qatar,283,2,109880,167
2020-07-29,Qatar,273,2,110153,169
2020-07-30,Qatar,307,2,110460,171
2020-07-31,Qatar,235,3,110695,174
2020-08-01,Qatar,216,0,110911,174
2020-08-02,Qatar,196,3,111107,177
2020-08-03,Qatar,215,0,111322,177
2020-08-04,Qatar,216,0,111538,177
2020-08-05,Qatar,267,1,111805,178
2020-08-06,Qatar,287,0,112092,178
2020-08-07,Qatar,291,2,112383,180
2020-08-08,Qatar,267,2,112650,182
2020-08-09,Qatar,297,2,112947,184
2020-08-10,Qatar,315,4,113262,188
2020-08-11,Qatar,384,0,113646,188
2020-08-12,Qatar,292,2,113938,190
2020-08-13,Qatar,343,0,114281,190
2020-08-14,Qatar,251,0,114532,190
2020-08-15,Qatar,277,2,114809,192
2020-08-16,Qatar,271,1,115080,193
2020-08-17,Qatar,288,0,115368,193
2020-08-18,Qatar,293,0,115661,193
2020-08-19,Qatar,295,0,115956,193
2020-08-20,Qatar,268,0,116224,193
2020-08-21,Qatar,257,0,116481,193
2020-08-22,Qatar,284,0,116765,193
2020-08-23,Qatar,243,0,117008,193
2020-08-24,Qatar,258,1,117266,194
2020-08-25,Qatar,232,0,117498,194
2020-08-26,Qatar,244,0,117742,194
2020-08-27,Qatar,246,1,117988,195
2020-08-28,Qatar,208,1,118196,196
2020-08-29,Qatar,211,0,118407,196
2020-08-30,Qatar,168,1,118575,197
2020-08-31,Qatar,203,0,118778,197
2020-09-01,Qatar,216,1,118994,198
2020-09-02,Qatar,212,1,119206,199
2020-09-03,Qatar,214,2,119420,201
2020-09-04,Qatar,217,0,119637,201
2020-09-05,Qatar,227,1,119864,202
2020-09-06,Qatar,231,1,120095,203
2020-09-07,Qatar,253,2,120348,205
2020-09-08,Qatar,231,0,120579,205
2020-09-09,Qatar,267,0,120846,205
2020-09-10,Qatar,206,0,121052,205
2020-09-11,Qatar,235,0,121287,205
2020-09-12,Qatar,236,0,121523,205
2020-09-13,Qatar,217,0,121740,205
2020-09-14,Qatar,235,2,121975,207
2020-09-15,Qatar,239,1,122214,208
2020-09-16,Qatar,235,0,122449,208
2020-09-17,Qatar,244,0,122693,208
2020-09-18,Qatar,224,1,122917,209
2020-09-19,Qatar,229,0,123146,209
2020-09-20,Qatar,230,1,123376,210
2020-09-21,Qatar,228,1,123604,211
2020-09-22,Qatar,313,0,123917,211
2020-09-23,Qatar,258,1,124175,212
2020-09-24,Qatar,250,0,124425,212
2020-09-25,Qatar,225,0,124650,212
2020-09-26,Qatar,200,2,124850,214
2020-09-27,Qatar,234,0,125084,214
2020-09-28,Qatar,227,0,125311,214
2020-09-29,Qatar,222,0,125533,214
2020-09-30,Qatar,227,0,125760,214
2020-10-01,Qatar,199,0,125959,214
2020-10-02,Qatar,205,1,126164,215
2020-10-03,Qatar,175,1,126339,216
2020-10-04,Qatar,159,0,126498,216
2020-10-05,Qatar,194,0,126692,216
2020-10-06,Qatar,251,0,126943,216
2020-10-07,Qatar,238,2,127181,218
2020-10-08,Qatar,213,0,127394,218
2020-10-09,Qatar,206,1,127600,219
2020-10-10,Qatar,178,0,127778,219
2020-10-11,Qatar,207,1,127985,220
2020-10-12,Qatar,206,0,128191,220
2020-10-13,Qatar,214,0,128405,220
2020-10-14,Qatar,198,0,128603,220
2020-10-15,Qatar,200,2,128803,222
2020-10-16,Qatar,189,0,128992,222
2020-10-17,Qatar,235,1,129227,223
2020-10-18,Qatar,204,1,129431,224
2020-10-19,Qatar,240,0,129671,224
2020-10-20,Qatar,273,0,129944,224
2020-10-21,Qatar,266,1,130210,225
2020-10-22,Qatar,252,3,130462,228
2020-10-23,Qatar,249,1,130711,229
2020-10-24,Qatar,254,0,130965,229
2020-10-25,Qatar,205,1,131170,230
2020-10-26,Qatar,262,0,131432,230
2020-10-27,Qatar,257,0,131689,230
2020-10-28,Qatar,250,0,131939,230
2020-10-29,Qatar,211,1,132150,231
2020-10-30,Qatar,193,1,132343,232
2020-10-31,Qatar,213,0,132556,232
2020-11-01,Qatar,164,0,132720,232
2020-11-02,Qatar,197,0,132917,232
2020-11-03,Qatar,226,0,133143,232
2020-11-04,Qatar,227,0,133370,232
2020-11-05,Qatar,249,0,133619,232
2020-11-06,Qatar,192,0,133811,232
2020-11-07,Qatar,202,0,134013,232
2020-11-08,Qatar,190,0,134203,232
2020-11-09,Qatar,230,0,134433,232
2020-11-10,Qatar,230,1,134663,233
2020-11-11,Qatar,224,0,134887,233
2020-11-12,Qatar,245,1,135132,234
2020-11-13,Qatar,235,0,135367,234
2020-11-14,Qatar,203,0,135570,234
2020-11-15,Qatar,215,0,135785,234
2020-11-16,Qatar,243,1,136028,235
2020-11-17,Qatar,194,0,136222,235
2020-11-18,Qatar,219,0,136441,235
2020-11-19,Qatar,208,0,136649,235
2020-11-20,Qatar,239,0,136888,235
2020-11-21,Qatar,174,0,137062,235
2020-11-22,Qatar,167,1,137229,236
2020-11-23,Qatar,186,0,137415,236
2020-11-24,Qatar,227,0,137642,236
2020-11-25,Qatar,209,1,137851,237
2020-11-26,Qatar,215,0,138066,237
2020-11-27,Qatar,184,0,138250,237
2020-11-28,Qatar,227,0,138477,237
2020-11-29,Qatar,171,0,138648,237
2020-11-30,Qatar,185,0,138833,237
2020-12-01,Qatar,168,1,139001,238
2020-12-02,Qatar,255,1,139256,239
2020-12-03,Qatar,221,0,139477,239
2020-12-04,Qatar,166,0,139643,239
2020-12-05,Qatar,140,0,139783,239
2020-12-06,Qatar,125,0,139908,239
2020-12-07,Qatar,178,0,140086,239
2020-12-08,Qatar,117,0,140203,239
2020-12-09,Qatar,150,1,140353,240
2020-12-10,Qatar,163,0,140516,240
2020-12-11,Qatar,164,0,140680,240
2020-12-12,Qatar,147,0,140827,240
2020-12-13,Qatar,134,0,140961,240
2020-12-14,Qatar,160,1,141121,241
2020-12-15,Qatar,151,0,141272,241
2020-12-16,Qatar,145,1,141417,242
2020-12-17,Qatar,140,0,141557,242
2020-12-18,Qatar,159,0,141716,242
2020-12-19,Qatar,142,1,141858,243
2020-12-20,Qatar,143,0,142001,243
2020-12-21,Qatar,158,0,142159,243
2020-12-22,Qatar,149,0,142308,243
2020-12-23,Qatar,140,0,142448,243
2020-12-24,Qatar,157,0,142605,243
2020-12-25,Qatar,129,1,142734,244
2020-12-26,Qatar,169,0,142903,244
2020-12-27,Qatar,159,0,143062,244
2020-12-28,Qatar,160,0,143222,244
2020-12-29,Qatar,206,1,143428,245
2020-12-30,Qatar,193,0,143621,245
2020-12-31,Qatar,213,0,143834,245
2021-01-01,Qatar,208,0,144042,245
2021-01-02,Qatar,198,0,144240,245
2021-01-03,Qatar,197,0,144437,245
2021-01-04,Qatar,207,0,144644,245
2021-01-05,Qatar,208,0,144852,245
2021-01-06,Qatar,209,0,145061,245
2021-01-07,Qatar,210,0,145271,245
2021-01-08,Qatar,195,1,145466,246
2021-01-09,Qatar,206,0,145672,246
2021-01-10,Qatar,193,0,145865,246
2021-01-11,Qatar,203,0,146068,246
2021-01-12,Qatar,211,0,146279,246
2021-01-13,Qatar,201,0,146480,246
2021-01-14,Qatar,209,0,146689,246
2021-01-15,Qatar,196,0,146885,246
2021-01-16,Qatar,204,0,147089,246
2021-01-17,Qatar,188,0,147277,246
2021-01-18,Qatar,227,2,147504,248
2021-01-19,Qatar,225,0,147729,248
2021-01-20,Qatar,271,0,148000,248
2021-01-21,Qatar,258,0,148258,248
2021-01-22,Qatar,263,0,148521,248
2021-01-23,Qatar,251,0,148772,248
2021-01-24,Qatar,247,0,149019,248
2021-01-25,Qatar,277,0,149296,248
2021-01-26,Qatar,299,0,149595,248
2021-01-27,Qatar,338,0,149933,248
2021-01-28,Qatar,347,0,150280,248
2021-01-29,Qatar,341,0,150621,248
2021-01-30,Qatar,363,0,150984,248
2021-01-31,Qatar,351,0,151335,248
2021-02-01,Qatar,385,1,151720,249
2021-02-02,Qatar,375,0,152095,249
2021-02-03,Qatar,396,0,152491,249
2021-02-04,Qatar,407,0,152898,249
2021-02-05,Qatar,398,1,153296,250
2021-02-06,Qatar,394,0,153690,250
2021-02-07,Qatar,408,0,154098,250
2021-02-08,Qatar,427,1,154525,251
2021-02-09,Qatar,477,2,155002,253
2021-02-10,Qatar,451,0,155453,253
2021-02-11,Qatar,448,1,155901,254
2021-02-12,Qatar,450,0,156351,254
2021-02-13,Qatar,453,1,156804,255
2021-02-14,Qatar,440,0,157244,255
2021-02-15,Qatar,888,0,158132,255
2021-02-16,Qatar,6,1,158138,256
2021-02-17,Qatar,453,0,158591,256
2021-02-18,Qatar,462,0,159053,256
2021-02-19,Qatar,465,0,159518,256
2021-02-20,Qatar,449,0,159967,256
2021-02-21,Qatar,459,0,160426,256
2021-02-22,Qatar,463,1,160889,257
2021-02-23,Qatar,455,0,161344,257
2021-02-24,Qatar,459,0,161803,257
2021-02-25,Qatar,465,0,162268,257
2021-02-26,Qatar,469,0,162737,257
2021-02-27,Qatar,460,0,163197,257
2021-02-28,Qatar,467,1,163664,258
2021-03-01,Qatar,473,1,164137,259
2021-03-02,Qatar,463,0,164600,259
2021-03-03,Qatar,471,1,165071,260
2021-03-04,Qatar,475,0,165546,260
2021-03-05,Qatar,469,1,166015,261
2021-03-06,Qatar,460,1,166475,262
2021-03-07,Qatar,474,0,166949,262
2021-03-08,Qatar,468,1,167417,263
2021-03-09,Qatar,471,1,167888,264
2021-03-10,Qatar,473,0,168361,264
2021-03-11,Qatar,468,0,168829,264
2021-03-12,Qatar,455,1,169284,265
2021-03-13,Qatar,483,0,169767,265
2021-03-14,Qatar,485,1,170252,266
2021-03-15,Qatar,481,1,170733,267
2021-03-16,Qatar,479,1,171212,268
2021-03-17,Qatar,489,2,171701,270
2021-03-18,Qatar,499,0,172200,270
2021-03-19,Qatar,497,1,172697,271
2021-03-20,Qatar,509,1,173206,272
2021-03-21,Qatar,503,1,173709,273
2021-03-22,Qatar,519,1,174228,274
2021-03-23,Qatar,534,1,174762,275
2021-03-24,Qatar,570,3,175332,278
2021-03-25,Qatar,587,3,175919,281
2021-03-26,Qatar,602,1,176521,282
2021-03-27,Qatar,614,2,177135,284
2021-03-28,Qatar,639,0,177774,284
2021-03-29,Qatar,690,2,178464,286
2021-03-30,Qatar,720,3,179184,289
2021-03-31,Qatar,780,2,179964,291
2021-04-01,Qatar,840,4,180804,295
2021-04-02,Qatar,874,3,181678,298
2021-04-03,Qatar,870,3,182548,301
2021-04-04,Qatar,876,2,183424,303
2021-04-05,Qatar,910,3,184334,306
2021-04-06,Qatar,927,6,185261,312
2021-04-07,Qatar,940,8,186201,320
2021-04-08,Qatar,949,2,187150,322
2020-02-26,Romania,1,0,1,0
2020-02-27,Romania,0,0,1,0
2020-02-28,Romania,2,0,3,0
2020-02-29,Romania,0,0,3,0
2020-03-01,Romania,0,0,3,0
2020-03-02,Romania,0,0,3,0
2020-03-03,Romania,0,0,3,0
2020-03-04,Romania,1,0,4,0
2020-03-05,Romania,2,0,6,0
2020-03-06,Romania,3,0,9,0
2020-03-07,Romania,0,0,9,0
2020-03-08,Romania,6,0,15,0
2020-03-09,Romania,0,0,15,0
2020-03-10,Romania,10,0,25,0
2020-03-11,Romania,20,0,45,0
2020-03-12,Romania,4,0,49,0
2020-03-13,Romania,40,0,89,0
2020-03-14,Romania,34,0,123,0
2020-03-15,Romania,8,0,131,0
2020-03-16,Romania,27,0,158,0
2020-03-17,Romania,26,0,184,0
2020-03-18,Romania,76,0,260,0
2020-03-19,Romania,17,0,277,0
2020-03-20,Romania,31,0,308,0
2020-03-21,Romania,59,0,367,0
2020-03-22,Romania,66,3,433,3
2020-03-23,Romania,143,4,576,7
2020-03-24,Romania,218,4,794,11
2020-03-25,Romania,112,6,906,17
2020-03-26,Romania,123,6,1029,23
2020-03-27,Romania,263,3,1292,26
2020-03-28,Romania,160,11,1452,37
2020-03-29,Romania,363,6,1815,43
2020-03-30,Romania,294,22,2109,65
2020-03-31,Romania,136,17,2245,82
2020-04-01,Romania,215,10,2460,92
2020-04-02,Romania,278,23,2738,115
2020-04-03,Romania,445,18,3183,133
2020-04-04,Romania,430,13,3613,146
2020-04-05,Romania,251,5,3864,151
2020-04-06,Romania,193,25,4057,176
2020-04-07,Romania,360,21,4417,197
2020-04-08,Romania,344,23,4761,220
2020-04-09,Romania,441,28,5202,248
2020-04-10,Romania,265,22,5467,270
2020-04-11,Romania,523,21,5990,291
2020-04-12,Romania,310,25,6300,316
2020-04-13,Romania,333,15,6633,331
2020-04-14,Romania,246,20,6879,351
2020-04-15,Romania,337,21,7216,372
2020-04-16,Romania,491,20,7707,392
2020-04-17,Romania,360,19,8067,411
2020-04-18,Romania,351,10,8418,421
2020-04-19,Romania,328,30,8746,451
2020-04-20,Romania,190,27,8936,478
2020-04-21,Romania,306,20,9242,498
2020-04-22,Romania,468,26,9710,524
2020-04-23,Romania,386,21,10096,545
2020-04-24,Romania,321,22,10417,567
2020-04-25,Romania,218,34,10635,601
2020-04-26,Romania,401,18,11036,619
2020-04-27,Romania,303,22,11339,641
2020-04-28,Romania,277,22,11616,663
2020-04-29,Romania,362,30,11978,693
2020-04-30,Romania,262,24,12240,717
2020-05-01,Romania,327,27,12567,744
2020-05-02,Romania,165,27,12732,771
2020-05-03,Romania,431,19,13163,790
2020-05-04,Romania,349,28,13512,818
2020-05-05,Romania,325,23,13837,841
2020-05-06,Romania,270,23,14107,864
2020-05-07,Romania,392,24,14499,888
2020-05-08,Romania,312,35,14811,923
2020-05-09,Romania,320,16,15131,939
2020-05-10,Romania,231,22,15362,961
2020-05-11,Romania,226,21,15588,982
2020-05-12,Romania,190,20,15778,1002
2020-05-13,Romania,224,34,16002,1036
2020-05-14,Romania,245,17,16247,1053
2020-05-15,Romania,190,17,16437,1070
2020-05-16,Romania,267,24,16704,1094
2020-05-17,Romania,167,13,16871,1107
2020-05-18,Romania,165,13,17036,1120
2020-05-19,Romania,155,17,17191,1137
2020-05-20,Romania,196,10,17387,1147
2020-05-21,Romania,198,9,17585,1156
2020-05-22,Romania,127,10,17712,1166
2020-05-23,Romania,145,10,17857,1176
2020-05-24,Romania,213,9,18070,1185
2020-05-25,Romania,213,20,18283,1205
2020-05-26,Romania,146,11,18429,1216
2020-05-27,Romania,165,11,18594,1227
2020-05-28,Romania,197,8,18791,1235
2020-05-29,Romania,191,13,18982,1248
2020-05-30,Romania,151,11,19133,1259
2020-05-31,Romania,124,7,19257,1266
2020-06-01,Romania,141,10,19398,1276
2020-06-02,Romania,119,12,19517,1288
2020-06-03,Romania,152,8,19669,1296
2020-06-04,Romania,238,9,19907,1305
2020-06-05,Romania,196,11,20103,1316
2020-06-06,Romania,187,6,20290,1322
2020-06-07,Romania,189,11,20479,1333
2020-06-08,Romania,125,6,20604,1339
2020-06-09,Romania,145,15,20749,1354
2020-06-10,Romania,196,6,20945,1360
2020-06-11,Romania,237,9,21182,1369
2020-06-12,Romania,222,11,21404,1380
2020-06-13,Romania,275,14,21679,1394
2020-06-14,Romania,320,16,21999,1410
2020-06-15,Romania,166,17,22165,1427
2020-06-16,Romania,250,10,22415,1437
2020-06-17,Romania,345,14,22760,1451
2020-06-18,Romania,320,22,23080,1473
2020-06-19,Romania,320,11,23400,1484
2020-06-20,Romania,330,16,23730,1500
2020-06-21,Romania,315,12,24045,1512
2020-06-22,Romania,246,11,24291,1523
2020-06-23,Romania,214,16,24505,1539
2020-06-24,Romania,321,16,24826,1555
2020-06-25,Romania,460,10,25286,1565
2020-06-26,Romania,411,14,25697,1579
2020-06-27,Romania,325,10,26022,1589
2020-06-28,Romania,291,23,26313,1612
2020-06-29,Romania,269,22,26582,1634
2020-06-30,Romania,388,17,26970,1651
2020-07-01,Romania,326,16,27296,1667
2020-07-02,Romania,450,20,27746,1687
2020-07-03,Romania,420,21,28166,1708
2020-07-04,Romania,416,23,28582,1731
2020-07-05,Romania,391,19,28973,1750
2020-07-06,Romania,250,18,29223,1768
2020-07-07,Romania,397,31,29620,1799
2020-07-08,Romania,555,18,30175,1817
2020-07-09,Romania,614,17,30789,1834
2020-07-10,Romania,592,13,31381,1847
2020-07-11,Romania,698,24,32079,1871
2020-07-12,Romania,456,13,32535,1884
2020-07-13,Romania,413,17,32948,1901
2020-07-14,Romania,637,30,33585,1931
2020-07-15,Romania,641,21,34226,1952
2020-07-16,Romania,777,19,35003,1971
2020-07-17,Romania,799,17,35802,1988
2020-07-18,Romania,889,21,36691,2009
2020-07-19,Romania,767,17,37458,2026
2020-07-20,Romania,681,12,38139,2038
2020-07-21,Romania,994,36,39133,2074
2020-07-22,Romania,1030,27,40163,2101
2020-07-23,Romania,1112,25,41275,2126
2020-07-24,Romania,1119,24,42394,2150
2020-07-25,Romania,1284,15,43678,2165
2020-07-26,Romania,1120,22,44798,2187
2020-07-27,Romania,1104,19,45902,2206
2020-07-28,Romania,1151,33,47053,2239
2020-07-29,Romania,1182,30,48235,2269
2020-07-30,Romania,1356,35,49591,2304
2020-07-31,Romania,1295,39,50886,2343
2020-08-01,Romania,1225,36,52111,2379
2020-08-02,Romania,1075,34,53186,2413
2020-08-03,Romania,823,19,54009,2432
2020-08-04,Romania,1232,48,55241,2480
2020-08-05,Romania,1309,41,56550,2521
2020-08-06,Romania,1345,45,57895,2566
2020-08-07,Romania,1378,50,59273,2616
2020-08-08,Romania,1350,43,60623,2659
2020-08-09,Romania,1145,41,61768,2700
2020-08-10,Romania,779,29,62547,2729
2020-08-11,Romania,1215,35,63762,2764
2020-08-12,Romania,1415,43,65177,2807
2020-08-13,Romania,1454,53,66631,2860
2020-08-14,Romania,1415,44,68046,2904
2020-08-15,Romania,1328,50,69374,2954
2020-08-16,Romania,1087,37,70461,2991
2020-08-17,Romania,733,38,71194,3029
2020-08-18,Romania,1014,45,72208,3074
2020-08-19,Romania,1409,32,73617,3106
2020-08-20,Romania,1346,48,74963,3154
2020-08-21,Romania,1392,42,76355,3196
2020-08-22,Romania,1189,37,77544,3233
2020-08-23,Romania,961,39,78505,3272
2020-08-24,Romania,825,37,79330,3309
2020-08-25,Romania,1060,58,80390,3367
2020-08-26,Romania,1256,54,81646,3421
2020-08-27,Romania,1504,38,83150,3459
2020-08-28,Romania,1318,48,84468,3507
2020-08-29,Romania,1365,32,85833,3539
2020-08-30,Romania,952,39,86785,3578
2020-08-31,Romania,755,43,87540,3621
2020-09-01,Romania,1053,60,88593,3681
2020-09-02,Romania,1298,40,89891,3721
2020-09-03,Romania,1365,44,91256,3765
2020-09-04,Romania,1339,47,92595,3812
2020-09-05,Romania,1269,38,93864,3850
2020-09-06,Romania,1150,43,95014,3893
2020-09-07,Romania,883,33,95897,3926
2020-09-08,Romania,1136,41,97033,3967
2020-09-09,Romania,1271,51,98304,4018
2020-09-10,Romania,1380,47,99684,4065
2020-09-11,Romania,1391,35,101075,4100
2020-09-12,Romania,1311,27,102386,4127
2020-09-13,Romania,1109,36,103495,4163
2020-09-14,Romania,692,22,104187,4185
2020-09-15,Romania,1111,51,105298,4236
2020-09-16,Romania,1713,49,107011,4285
2020-09-17,Romania,1679,27,108690,4312
2020-09-18,Romania,1527,48,110217,4360
2020-09-19,Romania,1333,42,111550,4402
2020-09-20,Romania,1231,33,112781,4435
2020-09-21,Romania,808,23,113589,4458
2020-09-22,Romania,1059,45,114648,4503
2020-09-23,Romania,1767,47,116415,4550
2020-09-24,Romania,1639,41,118054,4591
2020-09-25,Romania,1629,42,119683,4633
2020-09-26,Romania,1552,54,121235,4687
2020-09-27,Romania,1438,31,122673,4718
2020-09-28,Romania,1271,30,123944,4748
2020-09-29,Romania,1470,44,125414,4792
2020-09-30,Romania,2158,33,127572,4825
2020-10-01,Romania,2086,37,129658,4862
2020-10-02,Romania,2343,53,132001,4915
2020-10-03,Romania,2064,32,134065,4947
2020-10-04,Romania,1835,56,135900,5003
2020-10-05,Romania,1591,45,137491,5048
2020-10-06,Romania,2121,73,139612,5121
2020-10-07,Romania,2958,82,142570,5203
2020-10-08,Romania,3130,44,145700,5247
2020-10-09,Romania,3186,52,148886,5299
2020-10-10,Romania,3517,59,152403,5358
2020-10-11,Romania,2880,53,155283,5411
2020-10-12,Romania,2069,56,157352,5467
2020-10-13,Romania,3109,68,160461,5535
2020-10-14,Romania,4016,66,164477,5601
2020-10-15,Romania,4013,73,168490,5674
2020-10-16,Romania,4026,75,172516,5749
2020-10-17,Romania,3952,63,176468,5812
2020-10-18,Romania,3920,60,180388,5872
2020-10-19,Romania,2466,59,182854,5931
2020-10-20,Romania,3400,65,186254,5996
2020-10-21,Romania,4848,69,191102,6065
2020-10-22,Romania,4902,98,196004,6163
2020-10-23,Romania,5028,82,201032,6245
2020-10-24,Romania,4761,73,205793,6318
2020-10-25,Romania,3855,73,209648,6391
2020-10-26,Romania,2844,79,212492,6470
2020-10-27,Romania,4724,104,217216,6574
2020-10-28,Romania,5343,107,222559,6681
2020-10-29,Romania,6481,83,229040,6764
2020-10-30,Romania,6546,103,235586,6867
2020-10-31,Romania,5753,101,241339,6968
2020-11-01,Romania,5324,99,246663,7067
2020-11-02,Romania,4041,86,250704,7153
2020-11-03,Romania,7733,120,258437,7273
2020-11-04,Romania,8651,146,267088,7419
2020-11-05,Romania,9714,121,276802,7540
2020-11-06,Romania,10260,123,287062,7663
2020-11-07,Romania,9937,130,296999,7793
2020-11-08,Romania,6752,86,303751,7879
2020-11-09,Romania,3240,130,306991,8009
2020-11-10,Romania,7304,177,314295,8186
2020-11-11,Romania,9799,203,324094,8389
2020-11-12,Romania,10142,121,334236,8510
2020-11-13,Romania,9489,174,343725,8684
2020-11-14,Romania,9460,129,353185,8813
2020-11-15,Romania,7096,113,360281,8926
2020-11-16,Romania,4931,149,365212,9075
2020-11-17,Romania,8262,186,373474,9261
2020-11-18,Romania,10269,168,383743,9429
2020-11-19,Romania,10108,167,393851,9596
2020-11-20,Romania,9272,160,403123,9756
2020-11-21,Romania,9685,160,412808,9916
2020-11-22,Romania,5837,131,418645,10047
2020-11-23,Romania,4207,130,422852,10177
2020-11-24,Romania,7753,196,430605,10373
2020-11-25,Romania,9739,168,440344,10541
2020-11-26,Romania,9005,171,449349,10712
2020-11-27,Romania,8499,172,457848,10884
2020-11-28,Romania,8134,161,465982,11045
2020-11-29,Romania,5554,148,471536,11193
2020-11-30,Romania,3826,138,475362,11331
2020-12-01,Romania,4272,199,479634,11530
2020-12-02,Romania,4916,135,484550,11665
2020-12-03,Romania,7661,211,492211,11876
2020-12-04,Romania,8062,176,500273,12052
2020-12-05,Romania,8072,134,508345,12186
2020-12-06,Romania,5231,134,513576,12320
2020-12-07,Romania,3660,127,517236,12447
2020-12-08,Romania,7439,213,524675,12660
2020-12-09,Romania,7365,161,532040,12821
2020-12-10,Romania,7067,127,539107,12948
2020-12-11,Romania,6460,168,545567,13116
2020-12-12,Romania,6333,148,551900,13264
2020-12-13,Romania,4435,121,556335,13385
2020-12-14,Romania,3252,109,559587,13494
2020-12-15,Romania,6171,204,565758,13698
2020-12-16,Romania,5991,164,571749,13862
2020-12-17,Romania,5697,107,577446,13969
2020-12-18,Romania,5340,188,582786,14157
2020-12-19,Romania,5158,139,587944,14296
2020-12-20,Romania,3350,98,591294,14394
2020-12-21,Romania,2489,87,593783,14481
2020-12-22,Romania,5009,155,598792,14636
2020-12-23,Romania,5459,130,604251,14766
2020-12-24,Romania,4310,146,608561,14912
2020-12-25,Romania,3812,111,612373,15023
2020-12-26,Romania,1387,85,613760,15108
2020-12-27,Romania,2049,122,615809,15230
2020-12-28,Romania,2620,104,618429,15334
2020-12-29,Romania,4637,135,623066,15469
2020-12-30,Romania,4875,127,627941,15596
2020-12-31,Romania,4322,171,632263,15767
2021-01-01,Romania,3938,74,636201,15841
2021-01-02,Romania,1194,78,637395,15919
2021-01-03,Romania,3034,60,640429,15979
2021-01-04,Romania,3130,78,643559,16057
2021-01-05,Romania,4729,121,648288,16178
2021-01-06,Romania,5719,121,654007,16299
2021-01-07,Romania,4951,111,658958,16410
2021-01-08,Romania,4841,96,663799,16506
2021-01-09,Romania,4403,86,668202,16592
2021-01-10,Romania,3082,62,671284,16654
2021-01-11,Romania,1987,71,673271,16725
2021-01-12,Romania,3697,156,676968,16881
2021-01-13,Romania,4424,88,681392,16969
2021-01-14,Romania,3525,66,684917,17035
2021-01-15,Romania,3353,63,688270,17098
2021-01-16,Romania,3218,66,691488,17164
2021-01-17,Romania,2156,57,693644,17221
2021-01-18,Romania,1509,50,695153,17271
2021-01-19,Romania,2745,98,697898,17369
2021-01-20,Romania,3000,116,700898,17485
2021-01-21,Romania,2878,69,703776,17554
2021-01-22,Romania,2699,74,706475,17628
2021-01-23,Romania,2719,94,709194,17722
2021-01-24,Romania,1816,54,711010,17776
2021-01-25,Romania,1551,65,712561,17841
2021-01-26,Romania,2877,97,715438,17938
2021-01-27,Romania,3174,77,718612,18015
2021-01-28,Romania,2901,90,721513,18105
2021-01-29,Romania,2737,91,724250,18196
2021-01-30,Romania,2668,68,726918,18264
2021-01-31,Romania,1825,71,728743,18335
2021-02-01,Romania,1313,67,730056,18402
2021-02-02,Romania,2676,111,732732,18513
2021-02-03,Romania,2752,87,735484,18600
2021-02-04,Romania,2668,75,738152,18675
2021-02-05,Romania,2580,73,740732,18748
2021-02-06,Romania,2611,61,743343,18809
2021-02-07,Romania,1975,72,745318,18881
2021-02-08,Romania,1319,80,746637,18961
2021-02-09,Romania,2797,95,749434,19056
2021-02-10,Romania,3048,79,752482,19135
2021-02-11,Romania,2644,65,755126,19200
2021-02-12,Romania,2550,77,757676,19277
2021-02-13,Romania,2415,48,760091,19325
2021-02-14,Romania,1872,41,761963,19366
2021-02-15,Romania,1331,79,763294,19445
2021-02-16,Romania,2676,81,765970,19526
2021-02-17,Romania,2815,62,768785,19588
2021-02-18,Romania,3058,71,771843,19659
2021-02-19,Romania,2712,79,774555,19738
2021-02-20,Romania,2721,57,777276,19795
2021-02-21,Romania,2419,52,779695,19847
2021-02-22,Romania,1634,47,781329,19894
2021-02-23,Romania,3382,119,784711,20013
2021-02-24,Romania,3337,73,788048,20086
2021-02-25,Romania,3923,81,791971,20167
2021-02-26,Romania,3761,66,795732,20233
2021-02-27,Romania,3432,54,799164,20287
2021-02-28,Romania,2830,63,801994,20350
2021-03-01,Romania,2096,53,804090,20403
2021-03-02,Romania,3950,106,808040,20509
2021-03-03,Romania,4278,77,812318,20586
2021-03-04,Romania,4271,98,816589,20684
2021-03-05,Romania,4342,101,820931,20785
2021-03-06,Romania,4064,69,824995,20854
2021-03-07,Romania,3288,46,828283,20900
2021-03-08,Romania,2280,63,830563,20963
2021-03-09,Romania,4989,93,835552,21056
2021-03-10,Romania,4564,100,840116,21156
2021-03-11,Romania,5236,96,845352,21252
2021-03-12,Romania,5010,108,850362,21360
2021-03-13,Romania,4964,79,855326,21439
2021-03-14,Romania,4383,44,859709,21483
2021-03-15,Romania,2972,82,862681,21565
2021-03-16,Romania,6118,133,868799,21698
2021-03-17,Romania,6186,89,874985,21787
2021-03-18,Romania,6174,90,881159,21877
2021-03-19,Romania,5593,143,886752,22020
2021-03-20,Romania,6096,112,892848,22132
2021-03-21,Romania,4267,76,897115,22208
2021-03-22,Romania,3743,60,900858,22268
2021-03-23,Romania,6149,174,907007,22442
2021-03-24,Romania,6136,137,913143,22579
2021-03-25,Romania,6651,140,919794,22719
2021-03-26,Romania,6516,116,926310,22835
2021-03-27,Romania,5869,162,932179,22997
2021-03-28,Romania,4439,117,936618,23114
2021-03-29,Romania,3825,120,940443,23234
2021-03-30,Romania,6204,175,946647,23409
2021-03-31,Romania,6156,129,952803,23538
2021-04-01,Romania,6115,136,958918,23674
2021-04-02,Romania,5808,145,964726,23819
2021-04-03,Romania,5498,154,970224,23973
2021-04-04,Romania,4151,97,974375,24070
2021-04-05,Romania,3611,120,977986,24190
2021-04-06,Romania,5231,196,983217,24386
2021-04-07,Romania,5407,175,988624,24561
2021-04-08,Romania,4989,172,993613,24733
2020-01-31,Russia,2,0,2,0
2020-02-01,Russia,0,0,2,0
2020-02-02,Russia,0,0,2,0
2020-02-03,Russia,0,0,2,0
2020-02-04,Russia,0,0,2,0
2020-02-05,Russia,0,0,2,0
2020-02-06,Russia,0,0,2,0
2020-02-07,Russia,0,0,2,0
2020-02-08,Russia,0,0,2,0
2020-02-09,Russia,0,0,2,0
2020-02-10,Russia,0,0,2,0
2020-02-11,Russia,0,0,2,0
2020-02-12,Russia,0,0,2,0
2020-02-13,Russia,0,0,2,0
2020-02-14,Russia,0,0,2,0
2020-02-15,Russia,0,0,2,0
2020-02-16,Russia,0,0,2,0
2020-02-17,Russia,0,0,2,0
2020-02-18,Russia,0,0,2,0
2020-02-19,Russia,0,0,2,0
2020-02-20,Russia,0,0,2,0
2020-02-21,Russia,0,0,2,0
2020-02-22,Russia,0,0,2,0
2020-02-23,Russia,0,0,2,0
2020-02-24,Russia,0,0,2,0
2020-02-25,Russia,0,0,2,0
2020-02-26,Russia,0,0,2,0
2020-02-27,Russia,0,0,2,0
2020-02-28,Russia,0,0,2,0
2020-02-29,Russia,0,0,2,0
2020-03-01,Russia,0,0,2,0
2020-03-02,Russia,1,0,3,0
2020-03-03,Russia,0,0,3,0
2020-03-04,Russia,0,0,3,0
2020-03-05,Russia,1,0,4,0
2020-03-06,Russia,9,0,13,0
2020-03-07,Russia,0,0,13,0
2020-03-08,Russia,4,0,17,0
2020-03-09,Russia,0,0,17,0
2020-03-10,Russia,3,0,20,0
2020-03-11,Russia,0,0,20,0
2020-03-12,Russia,8,0,28,0
2020-03-13,Russia,17,0,45,0
2020-03-14,Russia,14,0,59,0
2020-03-15,Russia,4,0,63,0
2020-03-16,Russia,27,0,90,0
2020-03-17,Russia,24,0,114,0
2020-03-18,Russia,33,0,147,0
2020-03-19,Russia,52,1,199,1
2020-03-20,Russia,54,0,253,1
2020-03-21,Russia,53,0,306,1
2020-03-22,Russia,61,0,367,1
2020-03-23,Russia,71,0,438,1
2020-03-24,Russia,57,0,495,1
2020-03-25,Russia,163,2,658,3
2020-03-26,Russia,182,0,840,3
2020-03-27,Russia,196,1,1036,4
2020-03-28,Russia,228,0,1264,4
2020-03-29,Russia,270,4,1534,8
2020-03-30,Russia,302,1,1836,9
2020-03-31,Russia,501,8,2337,17
2020-04-01,Russia,440,7,2777,24
2020-04-02,Russia,771,6,3548,30
2020-04-03,Russia,601,4,4149,34
2020-04-04,Russia,582,9,4731,43
2020-04-05,Russia,658,2,5389,45
2020-04-06,Russia,954,2,6343,47
2020-04-07,Russia,1154,11,7497,58
2020-04-08,Russia,1175,5,8672,63
2020-04-09,Russia,1459,13,10131,76
2020-04-10,Russia,1786,18,11917,94
2020-04-11,Russia,1667,12,13584,106
2020-04-12,Russia,2186,24,15770,130
2020-04-13,Russia,2558,18,18328,148
2020-04-14,Russia,2774,22,21102,170
2020-04-15,Russia,3388,28,24490,198
2020-04-16,Russia,3448,34,27938,232
2020-04-17,Russia,4070,41,32008,273
2020-04-18,Russia,4785,40,36793,313
2020-04-19,Russia,6060,48,42853,361
2020-04-20,Russia,4268,44,47121,405
2020-04-21,Russia,5642,51,52763,456
2020-04-22,Russia,5236,57,57999,513
2020-04-23,Russia,4774,42,62773,555
2020-04-24,Russia,5849,60,68622,615
2020-04-25,Russia,5966,66,74588,681
2020-04-26,Russia,6361,66,80949,747
2020-04-27,Russia,6198,47,87147,794
2020-04-28,Russia,6411,73,93558,867
2020-04-29,Russia,5841,105,99399,972
2020-04-30,Russia,7099,101,106498,1073
2020-05-01,Russia,7933,96,114431,1169
2020-05-02,Russia,9623,53,124054,1222
2020-05-03,Russia,10633,58,134687,1280
2020-05-04,Russia,10581,76,145268,1356
2020-05-05,Russia,10102,95,155370,1451
2020-05-06,Russia,10559,86,165929,1537
2020-05-07,Russia,11231,88,177160,1625
2020-05-08,Russia,10699,98,187859,1723
2020-05-09,Russia,10817,104,198676,1827
2020-05-10,Russia,11012,88,209688,1915
2020-05-11,Russia,11656,94,221344,2009
2020-05-12,Russia,10899,107,232243,2116
2020-05-13,Russia,10028,96,242271,2212
2020-05-14,Russia,9974,93,252245,2305
2020-05-15,Russia,10598,113,262843,2418
2020-05-16,Russia,9200,119,272043,2537
2020-05-17,Russia,9709,94,281752,2631
2020-05-18,Russia,8926,91,290678,2722
2020-05-19,Russia,9263,115,299941,2837
2020-05-20,Russia,8764,135,308705,2972
2020-05-21,Russia,8849,127,317554,3099
2020-05-22,Russia,8894,150,326448,3249
2020-05-23,Russia,9434,139,335882,3388
2020-05-24,Russia,8599,153,344481,3541
2020-05-25,Russia,8946,92,353427,3633
2020-05-26,Russia,8915,174,362342,3807
2020-05-27,Russia,8338,161,370680,3968
2020-05-28,Russia,8371,174,379051,4142
2020-05-29,Russia,8572,232,387623,4374
2020-05-30,Russia,8952,181,396575,4555
2020-05-31,Russia,9268,138,405843,4693
2020-06-01,Russia,8485,156,414328,4849
2020-06-02,Russia,8858,182,423186,5031
2020-06-03,Russia,8529,177,431715,5208
2020-06-04,Russia,8823,168,440538,5376
2020-06-05,Russia,8718,144,449256,5520
2020-06-06,Russia,8846,197,458102,5717
2020-06-07,Russia,8971,134,467073,5851
2020-06-08,Russia,8970,112,476043,5963
2020-06-09,Russia,8587,171,484630,6134
2020-06-10,Russia,8393,216,493023,6350
2020-06-11,Russia,8777,172,501800,6522
2020-06-12,Russia,8961,183,510761,6705
2020-06-13,Russia,8697,114,519458,6819
2020-06-14,Russia,8809,119,528267,6938
2020-06-15,Russia,8217,143,536484,7081
2020-06-16,Russia,8241,193,544725,7274
2020-06-17,Russia,7824,194,552549,7468
2020-06-18,Russia,7772,182,560321,7650
2020-06-19,Russia,7971,181,568292,7831
2020-06-20,Russia,7870,161,576162,7992
2020-06-21,Russia,7717,109,583879,8101
2020-06-22,Russia,7586,95,591465,8196
2020-06-23,Russia,7413,153,598878,8349
2020-06-24,Russia,7165,154,606043,8503
2020-06-25,Russia,7105,91,613148,8594
2020-06-26,Russia,6788,176,619936,8770
2020-06-27,Russia,6843,188,626779,8958
2020-06-28,Russia,6784,102,633563,9060
2020-06-29,Russia,6683,92,640246,9152
2020-06-30,Russia,6683,154,646929,9306
2020-07-01,Russia,6550,215,653479,9521
2020-07-02,Russia,6752,147,660231,9668
2020-07-03,Russia,6710,176,666941,9844
2020-07-04,Russia,6623,167,673564,10011
2020-07-05,Russia,6719,134,680283,10145
2020-07-06,Russia,6569,135,686852,10280
2020-07-07,Russia,6363,198,693215,10478
2020-07-08,Russia,6534,172,699749,10650
2020-07-09,Russia,6491,176,706240,10826
2020-07-10,Russia,6623,174,712863,11000
2020-07-11,Russia,6586,188,719449,11188
2020-07-12,Russia,6587,130,726036,11318
2020-07-13,Russia,6511,104,732547,11422
2020-07-14,Russia,6240,175,738787,11597
2020-07-15,Russia,6410,156,745197,11753
2020-07-16,Russia,6415,167,751612,11920
2020-07-17,Russia,6389,186,758001,12106
2020-07-18,Russia,6214,122,764215,12228
2020-07-19,Russia,6096,95,770311,12323
2020-07-20,Russia,5901,85,776212,12408
2020-07-21,Russia,5828,153,782040,12561
2020-07-22,Russia,5850,165,787890,12726
2020-07-23,Russia,5830,147,793720,12873
2020-07-24,Russia,5779,153,799499,13026
2020-07-25,Russia,5833,146,805332,13172
2020-07-26,Russia,5741,77,811073,13249
2020-07-27,Russia,5607,85,816680,13334
2020-07-28,Russia,5380,149,822060,13483
2020-07-29,Russia,5449,167,827509,13650
2020-07-30,Russia,5484,128,832993,13778
2020-07-31,Russia,5468,161,838461,13939
2020-08-01,Russia,5429,95,843890,14034
2020-08-02,Russia,5387,70,849277,14104
2020-08-03,Russia,5364,79,854641,14183
2020-08-04,Russia,5121,144,859762,14327
2020-08-05,Russia,5186,138,864948,14465
2020-08-06,Russia,5239,114,870187,14579
2020-08-07,Russia,5191,119,875378,14698
2020-08-08,Russia,5185,129,880563,14827
2020-08-09,Russia,5155,76,885718,14903
2020-08-10,Russia,5081,70,890799,14973
2020-08-11,Russia,4892,130,895691,15103
2020-08-12,Russia,5054,128,900745,15231
2020-08-13,Russia,5017,122,905762,15353
2020-08-14,Russia,5016,114,910778,15467
2020-08-15,Russia,5030,118,915808,15585
2020-08-16,Russia,4911,68,920719,15653
2020-08-17,Russia,4839,54,925558,15707
2020-08-18,Russia,4718,129,930276,15836
2020-08-19,Russia,4790,115,935066,15951
2020-08-20,Russia,4767,107,939833,16058
2020-08-21,Russia,4838,90,944671,16148
2020-08-22,Russia,4860,120,949531,16268
2020-08-23,Russia,4797,73,954328,16341
2020-08-24,Russia,4688,65,959016,16406
2020-08-25,Russia,4639,118,963655,16524
2020-08-26,Russia,4642,114,968297,16638
2020-08-27,Russia,4675,120,972972,16758
2020-08-28,Russia,4758,108,977730,16866
2020-08-29,Russia,4843,111,982573,16977
2020-08-30,Russia,4897,68,987470,17045
2020-08-31,Russia,4932,83,992402,17128
2020-09-01,Russia,4670,122,997072,17250
2020-09-02,Russia,4893,115,1001965,17365
2020-09-03,Russia,4958,114,1006923,17479
2020-09-04,Russia,5064,119,1011987,17598
2020-09-05,Russia,5144,109,1017131,17707
2020-09-06,Russia,5097,61,1022228,17768
2020-09-07,Russia,5106,50,1027334,17818
2020-09-08,Russia,5020,121,1032354,17939
2020-09-09,Russia,5172,141,1037526,18080
2020-09-10,Russia,5310,127,1042836,18207
2020-09-11,Russia,5421,102,1048257,18309
2020-09-12,Russia,5406,117,1053663,18426
2020-09-13,Russia,5361,91,1059024,18517
2020-09-14,Russia,5414,56,1064438,18573
2020-09-15,Russia,5435,150,1069873,18723
2020-09-16,Russia,5612,130,1075485,18853
2020-09-17,Russia,5667,143,1081152,18996
2020-09-18,Russia,5803,132,1086955,19128
2020-09-19,Russia,5960,142,1092915,19270
2020-09-20,Russia,6043,79,1098958,19349
2020-09-21,Russia,6090,71,1105048,19420
2020-09-22,Russia,6109,155,1111157,19575
2020-09-23,Russia,6330,145,1117487,19720
2020-09-24,Russia,6489,147,1123976,19867
2020-09-25,Russia,7112,106,1131088,19973
2020-09-26,Russia,7421,167,1138509,20140
2020-09-27,Russia,7764,99,1146273,20239
2020-09-28,Russia,8026,60,1154299,20299
2020-09-29,Russia,8129,157,1162428,20456
2020-09-30,Russia,8371,174,1170799,20630
2020-10-01,Russia,8835,166,1179634,20796
2020-10-02,Russia,9294,185,1188928,20981
2020-10-03,Russia,9735,172,1198663,21153
2020-10-04,Russia,10376,107,1209039,21260
2020-10-05,Russia,10757,115,1219796,21375
2020-10-06,Russia,11481,184,1231277,21559
2020-10-07,Russia,10981,196,1242258,21755
2020-10-08,Russia,11345,184,1253603,21939
2020-10-09,Russia,11969,198,1265572,22137
2020-10-10,Russia,12673,194,1278245,22331
2020-10-11,Russia,13442,140,1291687,22471
2020-10-12,Russia,13406,123,1305093,22594
2020-10-13,Russia,13690,240,1318783,22834
2020-10-14,Russia,14041,235,1332824,23069
2020-10-15,Russia,13556,281,1346380,23350
2020-10-16,Russia,14937,230,1361317,23580
2020-10-17,Russia,14703,277,1376020,23857
2020-10-18,Russia,14804,182,1390824,24039
2020-10-19,Russia,15843,166,1406667,24205
2020-10-20,Russia,16108,268,1422775,24473
2020-10-21,Russia,15444,313,1438219,24786
2020-10-22,Russia,15704,286,1453923,25072
2020-10-23,Russia,17077,281,1471000,25353
2020-10-24,Russia,16260,294,1487260,25647
2020-10-25,Russia,16392,228,1503652,25875
2020-10-26,Russia,17148,217,1520800,26092
2020-10-27,Russia,16342,317,1537142,26409
2020-10-28,Russia,15886,343,1553028,26752
2020-10-29,Russia,17418,359,1570446,27111
2020-10-30,Russia,17987,351,1588433,27462
2020-10-31,Russia,17834,325,1606267,27787
2020-11-01,Russia,18381,239,1624648,28026
2020-11-02,Russia,18017,238,1642665,28264
2020-11-03,Russia,18431,347,1661096,28611
2020-11-04,Russia,19483,385,1680579,28996
2020-11-05,Russia,19116,289,1699695,29285
2020-11-06,Russia,20368,369,1720063,29654
2020-11-07,Russia,20109,356,1740172,30010
2020-11-08,Russia,20248,282,1760420,30292
2020-11-09,Russia,21577,254,1781997,30546
2020-11-10,Russia,20765,353,1802762,30899
2020-11-11,Russia,19583,427,1822345,31326
2020-11-12,Russia,21333,429,1843678,31755
2020-11-13,Russia,21717,401,1865395,32156
2020-11-14,Russia,22441,380,1887836,32536
2020-11-15,Russia,22313,349,1910149,32885
2020-11-16,Russia,22562,299,1932711,33184
2020-11-17,Russia,22201,435,1954912,33619
2020-11-18,Russia,20717,449,1975629,34068
2020-11-19,Russia,23337,457,1998966,34525
2020-11-20,Russia,24059,455,2023025,34980
2020-11-21,Russia,24538,462,2047563,35442
2020-11-22,Russia,24295,396,2071858,35838
2020-11-23,Russia,24891,354,2096749,36192
2020-11-24,Russia,24087,483,2120836,36675
2020-11-25,Russia,23393,498,2144229,37173
2020-11-26,Russia,25195,515,2169424,37688
2020-11-27,Russia,27267,487,2196691,38175
2020-11-28,Russia,26809,501,2223500,38676
2020-11-29,Russia,26390,451,2249890,39127
2020-11-30,Russia,26046,364,2275936,39491
2020-12-01,Russia,26126,559,2302062,40050
2020-12-02,Russia,25043,580,2327105,40630
2020-12-03,Russia,27829,543,2354934,41173
2020-12-04,Russia,27078,557,2382012,41730
2020-12-05,Russia,28450,498,2410462,42228
2020-12-06,Russia,28701,447,2439163,42675
2020-12-07,Russia,27798,447,2466961,43122
2020-12-08,Russia,25752,552,2492713,43674
2020-12-09,Russia,25838,546,2518551,44220
2020-12-10,Russia,27562,549,2546113,44769
2020-12-11,Russia,28206,601,2574319,45370
2020-12-12,Russia,27729,553,2602048,45923
2020-12-13,Russia,27651,481,2629699,46404
2020-12-14,Russia,26902,442,2656601,46846
2020-12-15,Russia,26265,564,2682866,47410
2020-12-16,Russia,26074,584,2708940,47994
2020-12-17,Russia,27787,574,2736727,48568
2020-12-18,Russia,28116,602,2764843,49170
2020-12-19,Russia,27772,574,2792615,49744
2020-12-20,Russia,28510,498,2821125,50242
2020-12-21,Russia,28917,481,2850042,50723
2020-12-22,Russia,28340,551,2878382,51274
2020-12-23,Russia,26814,536,2905196,51810
2020-12-24,Russia,29499,624,2934695,52434
2020-12-25,Russia,28595,551,2963290,52985
2020-12-26,Russia,28833,554,2992123,53539
2020-12-27,Russia,27849,541,3019972,54080
2020-12-28,Russia,27363,479,3047335,54559
2020-12-29,Russia,26588,548,3073923,55107
2020-12-30,Russia,26095,585,3100018,55692
2020-12-31,Russia,27329,579,3127347,56271
2021-01-01,Russia,26613,527,3153960,56798
2021-01-02,Russia,25938,437,3179898,57235
2021-01-03,Russia,23845,495,3203743,57730
2021-01-04,Russia,23015,473,3226758,58203
2021-01-05,Russia,23955,503,3250713,58706
2021-01-06,Russia,23902,431,3274615,59137
2021-01-07,Russia,23218,491,3297833,59628
2021-01-08,Russia,23330,439,3321163,60067
2021-01-09,Russia,23012,456,3344175,60523
2021-01-10,Russia,22540,440,3366715,60963
2021-01-11,Russia,23018,426,3389733,61389
2021-01-12,Russia,22657,519,3412390,61908
2021-01-13,Russia,22544,555,3434934,62463
2021-01-14,Russia,24303,553,3459237,63016
2021-01-15,Russia,24294,542,3483531,63558
2021-01-16,Russia,23670,576,3507201,64134
2021-01-17,Russia,23178,467,3530379,64601
2021-01-18,Russia,22509,458,3552888,65059
2021-01-19,Russia,21442,573,3574330,65632
2021-01-20,Russia,20806,582,3595136,66214
2021-01-21,Russia,21544,596,3616680,66810
2021-01-22,Russia,21182,566,3637862,67376
2021-01-23,Russia,20585,543,3658447,67919
2021-01-24,Russia,20800,478,3679247,68397
2021-01-25,Russia,18999,444,3698246,68841
2021-01-26,Russia,17982,550,3716228,69391
2021-01-27,Russia,17464,580,3733692,69971
2021-01-28,Russia,18856,562,3752548,70533
2021-01-29,Russia,18966,521,3771514,71054
2021-01-30,Russia,18751,502,3790265,71556
2021-01-31,Russia,18083,473,3808348,72029
2021-02-01,Russia,17391,427,3825739,72456
2021-02-02,Russia,16406,526,3842145,72982
2021-02-03,Russia,16222,515,3858367,73497
2021-02-04,Russia,16463,508,3874830,74005
2021-02-05,Russia,16444,515,3891274,74520
2021-02-06,Russia,16379,490,3907653,75010
2021-02-07,Russia,15808,420,3923461,75430
2021-02-08,Russia,15701,398,3939162,75828
2021-02-09,Russia,14808,519,3953970,76347
2021-02-10,Russia,14258,526,3968228,76873
2021-02-11,Russia,14803,542,3983031,77415
2021-02-12,Russia,14867,496,3997898,77911
2021-02-13,Russia,14640,492,4012538,78403
2021-02-14,Russia,13968,422,4026506,78825
2021-02-15,Russia,13999,385,4040505,79210
2021-02-16,Russia,13030,449,4053535,79659
2021-02-17,Russia,12629,459,4066164,80118
2021-02-18,Russia,13243,469,4079407,80587
2021-02-19,Russia,13242,461,4092649,81048
2021-02-20,Russia,12775,469,4105424,81517
2021-02-21,Russia,12568,409,4117992,81926
2021-02-22,Russia,12455,329,4130447,82255
2021-02-23,Russia,11679,411,4142126,82666
2021-02-24,Russia,11609,378,4153735,83044
2021-02-25,Russia,11067,437,4164802,83481
2021-02-26,Russia,10955,419,4175757,83900
2021-02-27,Russia,11409,430,4187166,84330
2021-02-28,Russia,11234,370,4198400,84700
2021-03-01,Russia,11450,325,4209850,85025
2021-03-02,Russia,10441,433,4220291,85458
2021-03-03,Russia,10416,443,4230707,85901
2021-03-04,Russia,11263,467,4241970,86368
2021-03-05,Russia,10906,453,4252876,86821
2021-03-06,Russia,10909,432,4263785,87253
2021-03-07,Russia,10478,361,4274263,87614
2021-03-08,Russia,10145,371,4284408,87985
2021-03-09,Russia,9342,330,4293750,88315
2021-03-10,Russia,8976,458,4302726,88773
2021-03-11,Russia,9167,451,4311893,89224
2021-03-12,Russia,9695,477,4321588,89701
2021-03-13,Russia,9808,468,4331396,90169
2021-03-14,Russia,9985,389,4341381,90558
2021-03-15,Russia,9347,400,4350728,90958
2021-03-16,Russia,9305,437,4360033,91395
2021-03-17,Russia,8910,420,4368943,91815
2021-03-18,Russia,9713,451,4378656,92266
2021-03-19,Russia,9612,438,4388268,92704
2021-03-20,Russia,9548,386,4397816,93090
2021-03-21,Russia,9215,367,4407031,93457
2021-03-22,Russia,9195,355,4416226,93812
2021-03-23,Russia,8369,419,4424595,94231
2021-03-24,Russia,8769,393,4433364,94624
2021-03-25,Russia,9128,386,4442492,95010
2021-03-26,Russia,9073,400,4451565,95410
2021-03-27,Russia,8783,382,4460348,95792
2021-03-28,Russia,8979,331,4469327,96123
2021-03-29,Russia,8589,290,4477916,96413
2021-03-30,Russia,8162,404,4486078,96817
2021-03-31,Russia,8156,402,4494234,97219
2021-04-01,Russia,9057,375,4503291,97594
2021-04-02,Russia,8682,392,4511973,97986
2021-04-03,Russia,8906,377,4520879,98363
2021-04-04,Russia,8697,350,4529576,98713
2021-04-05,Russia,8525,336,4538101,99049
2021-04-06,Russia,8206,382,4546307,99431
2021-04-07,Russia,8174,369,4554481,99800
2021-04-08,Russia,8545,358,4563026,100158
2020-03-14,Rwanda,1,0,1,0
2020-03-15,Rwanda,0,0,1,0
2020-03-16,Rwanda,4,0,5,0
2020-03-17,Rwanda,2,0,7,0
2020-03-18,Rwanda,1,0,8,0
2020-03-19,Rwanda,0,0,8,0
2020-03-20,Rwanda,9,0,17,0
2020-03-21,Rwanda,0,0,17,0
2020-03-22,Rwanda,2,0,19,0
2020-03-23,Rwanda,17,0,36,0
2020-03-24,Rwanda,4,0,40,0
2020-03-25,Rwanda,1,0,41,0
2020-03-26,Rwanda,9,0,50,0
2020-03-27,Rwanda,4,0,54,0
2020-03-28,Rwanda,6,0,60,0
2020-03-29,Rwanda,10,0,70,0
2020-03-30,Rwanda,0,0,70,0
2020-03-31,Rwanda,5,0,75,0
2020-04-01,Rwanda,7,0,82,0
2020-04-02,Rwanda,2,0,84,0
2020-04-03,Rwanda,5,0,89,0
2020-04-04,Rwanda,13,0,102,0
2020-04-05,Rwanda,2,0,104,0
2020-04-06,Rwanda,1,0,105,0
2020-04-07,Rwanda,0,0,105,0
2020-04-08,Rwanda,5,0,110,0
2020-04-09,Rwanda,0,0,110,0
2020-04-10,Rwanda,8,0,118,0
2020-04-11,Rwanda,2,0,120,0
2020-04-12,Rwanda,6,0,126,0
2020-04-13,Rwanda,1,0,127,0
2020-04-14,Rwanda,7,0,134,0
2020-04-15,Rwanda,2,0,136,0
2020-04-16,Rwanda,2,0,138,0
2020-04-17,Rwanda,5,0,143,0
2020-04-18,Rwanda,1,0,144,0
2020-04-19,Rwanda,3,0,147,0
2020-04-20,Rwanda,0,0,147,0
2020-04-21,Rwanda,3,0,150,0
2020-04-22,Rwanda,3,0,153,0
2020-04-23,Rwanda,1,0,154,0
2020-04-24,Rwanda,22,0,176,0
2020-04-25,Rwanda,7,0,183,0
2020-04-26,Rwanda,8,0,191,0
2020-04-27,Rwanda,16,0,207,0
2020-04-28,Rwanda,5,0,212,0
2020-04-29,Rwanda,13,0,225,0
2020-04-30,Rwanda,18,0,243,0
2020-05-01,Rwanda,6,0,249,0
2020-05-02,Rwanda,6,0,255,0
2020-05-03,Rwanda,4,0,259,0
2020-05-04,Rwanda,2,0,261,0
2020-05-05,Rwanda,0,0,261,0
2020-05-06,Rwanda,7,0,268,0
2020-05-07,Rwanda,3,0,271,0
2020-05-08,Rwanda,2,0,273,0
2020-05-09,Rwanda,7,0,280,0
2020-05-10,Rwanda,4,0,284,0
2020-05-11,Rwanda,1,0,285,0
2020-05-12,Rwanda,1,0,286,0
2020-05-13,Rwanda,1,0,287,0
2020-05-14,Rwanda,0,0,287,0
2020-05-15,Rwanda,0,0,287,0
2020-05-16,Rwanda,2,0,289,0
2020-05-17,Rwanda,3,0,292,0
2020-05-18,Rwanda,5,0,297,0
2020-05-19,Rwanda,11,0,308,0
2020-05-20,Rwanda,6,0,314,0
2020-05-21,Rwanda,6,0,320,0
2020-05-22,Rwanda,1,0,321,0
2020-05-23,Rwanda,4,0,325,0
2020-05-24,Rwanda,2,0,327,0
2020-05-25,Rwanda,9,0,336,0
2020-05-26,Rwanda,3,0,339,0
2020-05-27,Rwanda,7,0,346,0
2020-05-28,Rwanda,3,0,349,0
2020-05-29,Rwanda,6,0,355,0
2020-05-30,Rwanda,4,1,359,1
2020-05-31,Rwanda,11,0,370,1
2020-06-01,Rwanda,7,0,377,1
2020-06-02,Rwanda,7,1,384,2
2020-06-03,Rwanda,13,0,397,2
2020-06-04,Rwanda,13,0,410,2
2020-06-05,Rwanda,10,0,420,2
2020-06-06,Rwanda,11,0,431,2
2020-06-07,Rwanda,8,0,439,2
2020-06-08,Rwanda,12,0,451,2
2020-06-09,Rwanda,12,0,463,2
2020-06-10,Rwanda,13,0,476,2
2020-06-11,Rwanda,18,0,494,2
2020-06-12,Rwanda,16,0,510,2
2020-06-13,Rwanda,31,0,541,2
2020-06-14,Rwanda,41,0,582,2
2020-06-15,Rwanda,30,0,612,2
2020-06-16,Rwanda,24,0,636,2
2020-06-17,Rwanda,3,0,639,2
2020-06-18,Rwanda,7,0,646,2
2020-06-19,Rwanda,15,0,661,2
2020-06-20,Rwanda,41,0,702,2
2020-06-21,Rwanda,26,0,728,2
2020-06-22,Rwanda,59,0,787,2
2020-06-23,Rwanda,11,0,798,2
2020-06-24,Rwanda,32,0,830,2
2020-06-25,Rwanda,20,0,850,2
2020-06-26,Rwanda,8,0,858,2
2020-06-27,Rwanda,20,0,878,2
2020-06-28,Rwanda,22,0,900,2
2020-06-29,Rwanda,101,0,1001,2
2020-06-30,Rwanda,24,0,1025,2
2020-07-01,Rwanda,17,1,1042,3
2020-07-02,Rwanda,21,0,1063,3
2020-07-03,Rwanda,18,0,1081,3
2020-07-04,Rwanda,11,0,1092,3
2020-07-05,Rwanda,13,0,1105,3
2020-07-06,Rwanda,8,0,1113,3
2020-07-07,Rwanda,59,0,1172,3
2020-07-08,Rwanda,22,0,1194,3
2020-07-09,Rwanda,16,0,1210,3
2020-07-10,Rwanda,42,0,1252,3
2020-07-11,Rwanda,47,1,1299,4
2020-07-12,Rwanda,38,0,1337,4
2020-07-13,Rwanda,41,0,1378,4
2020-07-14,Rwanda,38,0,1416,4
2020-07-15,Rwanda,19,0,1435,4
2020-07-16,Rwanda,38,0,1473,4
2020-07-17,Rwanda,12,0,1485,4
2020-07-18,Rwanda,54,1,1539,5
2020-07-19,Rwanda,43,0,1582,5
2020-07-20,Rwanda,47,0,1629,5
2020-07-21,Rwanda,26,0,1655,5
2020-07-22,Rwanda,34,0,1689,5
2020-07-23,Rwanda,21,0,1710,5
2020-07-24,Rwanda,19,0,1729,5
2020-07-25,Rwanda,23,0,1752,5
2020-07-26,Rwanda,69,0,1821,5
2020-07-27,Rwanda,58,0,1879,5
2020-07-28,Rwanda,47,0,1926,5
2020-07-29,Rwanda,37,0,1963,5
2020-07-30,Rwanda,31,0,1994,5
2020-07-31,Rwanda,28,0,2022,5
2020-08-01,Rwanda,20,0,2042,5
2020-08-02,Rwanda,20,0,2062,5
2020-08-03,Rwanda,30,0,2092,5
2020-08-04,Rwanda,7,0,2099,5
2020-08-05,Rwanda,5,0,2104,5
2020-08-06,Rwanda,7,0,2111,5
2020-08-07,Rwanda,17,0,2128,5
2020-08-08,Rwanda,6,1,2134,6
2020-08-09,Rwanda,6,1,2140,7
2020-08-10,Rwanda,12,0,2152,7
2020-08-11,Rwanda,19,0,2171,7
2020-08-12,Rwanda,18,1,2189,8
2020-08-13,Rwanda,11,0,2200,8
2020-08-14,Rwanda,93,0,2293,8
2020-08-15,Rwanda,59,0,2352,8
2020-08-16,Rwanda,101,0,2453,8
2020-08-17,Rwanda,87,0,2540,8
2020-08-18,Rwanda,37,2,2577,10
2020-08-19,Rwanda,67,0,2644,10
2020-08-20,Rwanda,73,1,2717,11
2020-08-21,Rwanda,63,0,2780,11
2020-08-22,Rwanda,109,0,2889,11
2020-08-23,Rwanda,200,1,3089,12
2020-08-24,Rwanda,217,2,3306,14
2020-08-25,Rwanda,231,1,3537,15
2020-08-26,Rwanda,88,0,3625,15
2020-08-27,Rwanda,47,0,3672,15
2020-08-28,Rwanda,70,1,3742,16
2020-08-29,Rwanda,101,0,3843,16
2020-08-30,Rwanda,177,0,4020,16
2020-08-31,Rwanda,43,0,4063,16
2020-09-01,Rwanda,79,0,4142,16
2020-09-02,Rwanda,76,1,4218,17
2020-09-03,Rwanda,37,1,4255,18
2020-09-04,Rwanda,49,0,4304,18
2020-09-05,Rwanda,45,0,4349,18
2020-09-06,Rwanda,25,1,4374,19
2020-09-07,Rwanda,35,0,4409,19
2020-09-08,Rwanda,30,1,4439,20
2020-09-09,Rwanda,21,1,4460,21
2020-09-10,Rwanda,19,1,4479,22
2020-09-11,Rwanda,55,0,4534,22
2020-09-12,Rwanda,31,0,4565,22
2020-09-13,Rwanda,26,0,4591,22
2020-09-14,Rwanda,11,0,4602,22
2020-09-15,Rwanda,22,0,4624,22
2020-09-16,Rwanda,10,0,4634,22
2020-09-17,Rwanda,19,1,4653,23
2020-09-18,Rwanda,18,2,4671,25
2020-09-19,Rwanda,18,1,4689,26
2020-09-20,Rwanda,22,0,4711,26
2020-09-21,Rwanda,11,1,4722,27
2020-09-22,Rwanda,16,0,4738,27
2020-09-23,Rwanda,41,0,4779,27
2020-09-24,Rwanda,10,0,4789,27
2020-09-25,Rwanda,9,2,4798,29
2020-09-26,Rwanda,13,0,4811,29
2020-09-27,Rwanda,9,0,4820,29
2020-09-28,Rwanda,12,0,4832,29
2020-09-29,Rwanda,4,0,4836,29
2020-09-30,Rwanda,4,0,4840,29
2020-10-01,Rwanda,3,0,4843,29
2020-10-02,Rwanda,4,0,4847,29
2020-10-03,Rwanda,5,0,4852,29
2020-10-04,Rwanda,14,0,4866,29
2020-10-05,Rwanda,1,0,4867,29
2020-10-06,Rwanda,6,0,4873,29
2020-10-07,Rwanda,10,0,4883,29
2020-10-08,Rwanda,2,0,4885,29
2020-10-09,Rwanda,5,1,4890,30
2020-10-10,Rwanda,2,0,4892,30
2020-10-11,Rwanda,4,1,4896,31
2020-10-12,Rwanda,9,1,4905,32
2020-10-13,Rwanda,3,0,4908,32
2020-10-14,Rwanda,32,1,4940,33
2020-10-15,Rwanda,13,0,4953,33
2020-10-16,Rwanda,12,1,4965,34
2020-10-17,Rwanda,6,0,4971,34
2020-10-18,Rwanda,3,0,4974,34
2020-10-19,Rwanda,18,0,4992,34
2020-10-20,Rwanda,4,0,4996,34
2020-10-21,Rwanda,16,0,5012,34
2020-10-22,Rwanda,5,0,5017,34
2020-10-23,Rwanda,35,0,5052,34
2020-10-24,Rwanda,8,0,5060,34
2020-10-25,Rwanda,6,0,5066,34
2020-10-26,Rwanda,7,0,5073,34
2020-10-27,Rwanda,11,1,5084,35
2020-10-28,Rwanda,45,0,5129,35
2020-10-29,Rwanda,2,0,5131,35
2020-10-30,Rwanda,3,0,5134,35
2020-10-31,Rwanda,3,0,5137,35
2020-11-01,Rwanda,9,0,5146,35
2020-11-02,Rwanda,9,0,5155,35
2020-11-03,Rwanda,7,0,5162,35
2020-11-04,Rwanda,12,0,5174,35
2020-11-05,Rwanda,18,1,5192,36
2020-11-06,Rwanda,16,0,5208,36
2020-11-07,Rwanda,5,0,5213,36
2020-11-08,Rwanda,9,0,5222,36
2020-11-09,Rwanda,20,2,5242,38
2020-11-10,Rwanda,20,2,5262,40
2020-11-11,Rwanda,50,1,5312,41
2020-11-12,Rwanda,7,0,5319,41
2020-11-13,Rwanda,43,1,5362,42
2020-11-14,Rwanda,32,0,5394,42
2020-11-15,Rwanda,61,3,5455,45
2020-11-16,Rwanda,36,0,5491,45
2020-11-17,Rwanda,16,1,5507,46
2020-11-18,Rwanda,36,0,5543,46
2020-11-19,Rwanda,29,0,5572,46
2020-11-20,Rwanda,14,0,5586,46
2020-11-21,Rwanda,34,0,5620,46
2020-11-22,Rwanda,45,1,5665,47
2020-11-23,Rwanda,61,0,5726,47
2020-11-24,Rwanda,24,0,5750,47
2020-11-25,Rwanda,29,0,5779,47
2020-11-26,Rwanda,72,0,5851,47
2020-11-27,Rwanda,21,0,5872,47
2020-11-28,Rwanda,19,0,5891,47
2020-11-29,Rwanda,28,1,5919,48
2020-11-30,Rwanda,15,1,5934,49
2020-12-01,Rwanda,14,0,5948,49
2020-12-02,Rwanda,46,1,5994,50
2020-12-03,Rwanda,17,0,6011,50
2020-12-04,Rwanda,32,1,6043,51
2020-12-05,Rwanda,41,0,6084,51
2020-12-06,Rwanda,45,0,6129,51
2020-12-07,Rwanda,62,0,6191,51
2020-12-08,Rwanda,46,0,6237,51
2020-12-09,Rwanda,41,2,6278,53
2020-12-10,Rwanda,71,0,6349,53
2020-12-11,Rwanda,79,1,6428,54
2020-12-12,Rwanda,100,2,6528,56
2020-12-13,Rwanda,131,0,6659,56
2020-12-14,Rwanda,88,0,6747,56
2020-12-15,Rwanda,85,1,6832,57
2020-12-16,Rwanda,122,0,6954,57
2020-12-17,Rwanda,78,0,7032,57
2020-12-18,Rwanda,73,0,7105,57
2020-12-19,Rwanda,127,2,7232,59
2020-12-20,Rwanda,61,4,7293,63
2020-12-21,Rwanda,109,2,7402,65
2020-12-22,Rwanda,109,1,7511,66
2020-12-23,Rwanda,87,0,7598,66
2020-12-24,Rwanda,72,3,7670,69
2020-12-25,Rwanda,73,0,7743,69
2020-12-26,Rwanda,74,3,7817,72
2020-12-27,Rwanda,153,2,7970,74
2020-12-28,Rwanda,51,1,8021,75
2020-12-29,Rwanda,107,4,8128,79
2020-12-30,Rwanda,122,7,8250,86
2020-12-31,Rwanda,133,6,8383,92
2021-01-01,Rwanda,77,2,8460,94
2021-01-02,Rwanda,107,4,8567,98
2021-01-03,Rwanda,109,3,8676,101
2021-01-04,Rwanda,172,4,8848,105
2021-01-05,Rwanda,107,5,8955,110
2021-01-06,Rwanda,103,2,9058,112
2021-01-07,Rwanda,167,1,9225,113
2021-01-08,Rwanda,143,2,9368,115
2021-01-09,Rwanda,93,3,9461,118
2021-01-10,Rwanda,169,2,9630,120
2021-01-11,Rwanda,154,4,9784,124
2021-01-12,Rwanda,166,1,9950,125
2021-01-13,Rwanda,172,3,10122,128
2021-01-14,Rwanda,194,5,10316,133
2021-01-15,Rwanda,257,5,10573,138
2021-01-16,Rwanda,277,2,10850,140
2021-01-17,Rwanda,182,2,11032,142
2021-01-18,Rwanda,227,4,11259,146
2021-01-19,Rwanda,289,2,11548,148
2021-01-20,Rwanda,312,5,11860,153
2021-01-21,Rwanda,310,9,12170,162
2021-01-22,Rwanda,273,3,12443,165
2021-01-23,Rwanda,204,7,12647,172
2021-01-24,Rwanda,328,2,12975,174
2021-01-25,Rwanda,336,3,13311,177
2021-01-26,Rwanda,574,4,13885,181
2021-01-27,Rwanda,281,2,14166,183
2021-01-28,Rwanda,363,3,14529,186
2021-01-29,Rwanda,255,2,14784,188
2021-01-30,Rwanda,334,5,15118,193
2021-01-31,Rwanda,186,3,15304,196
2021-02-01,Rwanda,155,2,15459,198
2021-02-02,Rwanda,229,7,15688,205
2021-02-03,Rwanda,146,3,15834,208
2021-02-04,Rwanda,154,2,15988,210
2021-02-05,Rwanda,198,3,16186,213
2021-02-06,Rwanda,151,4,16337,217
2021-02-07,Rwanda,114,3,16451,220
2021-02-08,Rwanda,170,3,16621,223
2021-02-09,Rwanda,190,3,16811,226
2021-02-10,Rwanda,130,3,16941,229
2021-02-11,Rwanda,127,2,17068,231
2021-02-12,Rwanda,132,5,17200,236
2021-02-13,Rwanda,67,0,17267,236
2021-02-14,Rwanda,76,3,17343,239
2021-02-15,Rwanda,141,0,17484,239
2021-02-16,Rwanda,110,1,17594,240
2021-02-17,Rwanda,122,3,17716,243
2021-02-18,Rwanda,119,0,17835,243
2021-02-19,Rwanda,94,2,17929,245
2021-02-20,Rwanda,59,2,17988,247
2021-02-21,Rwanda,65,2,18053,249
2021-02-22,Rwanda,146,3,18199,252
2021-02-23,Rwanda,126,1,18325,253
2021-02-24,Rwanda,118,1,18443,254
2021-02-25,Rwanda,110,4,18553,258
2021-02-26,Rwanda,136,0,18689,258
2021-02-27,Rwanda,101,3,18790,261
2021-02-28,Rwanda,60,0,18850,261
2021-03-01,Rwanda,136,3,18986,264
2021-03-02,Rwanda,125,1,19111,265
2021-03-03,Rwanda,87,0,19198,265
2021-03-04,Rwanda,136,1,19334,266
2021-03-05,Rwanda,92,1,19426,267
2021-03-06,Rwanda,83,0,19509,267
2021-03-07,Rwanda,42,1,19551,268
2021-03-08,Rwanda,108,0,19659,268
2021-03-09,Rwanda,120,2,19779,270
2021-03-10,Rwanda,67,1,19846,271
2021-03-11,Rwanda,99,2,19945,273
2021-03-12,Rwanda,112,2,20057,275
2021-03-13,Rwanda,86,1,20143,276
2021-03-14,Rwanda,43,4,20186,280
2021-03-15,Rwanda,116,2,20302,282
2021-03-16,Rwanda,110,0,20412,282
2021-03-17,Rwanda,68,1,20480,283
2021-03-18,Rwanda,71,1,20551,284
2021-03-19,Rwanda,130,3,20681,287
2021-03-20,Rwanda,80,0,20761,287
2021-03-21,Rwanda,67,3,20828,290
2021-03-22,Rwanda,68,2,20896,292
2021-03-23,Rwanda,79,3,20975,295
2021-03-24,Rwanda,131,2,21106,297
2021-03-25,Rwanda,104,1,21210,298
2021-03-26,Rwanda,99,2,21309,300
2021-03-27,Rwanda,61,1,21370,301
2021-03-28,Rwanda,49,0,21419,301
2021-03-29,Rwanda,71,4,21490,305
2021-03-30,Rwanda,155,1,21645,306
2021-03-31,Rwanda,138,1,21783,307
2021-04-01,Rwanda,135,1,21918,308
2021-04-02,Rwanda,249,2,22167,310
2021-04-03,Rwanda,76,1,22243,311
2021-04-04,Rwanda,239,0,22482,311
2021-04-05,Rwanda,202,0,22684,311
2021-04-06,Rwanda,178,3,22862,314
2021-04-07,Rwanda,179,0,23041,314
2021-04-08,Rwanda,111,0,23152,314
2020-03-25,Saint Kitts and Nevis,2,0,2,0
2020-03-26,Saint Kitts and Nevis,0,0,2,0
2020-03-27,Saint Kitts and Nevis,0,0,2,0
2020-03-28,Saint Kitts and Nevis,0,0,2,0
2020-03-29,Saint Kitts and Nevis,0,0,2,0
2020-03-30,Saint Kitts and Nevis,5,0,7,0
2020-03-31,Saint Kitts and Nevis,1,0,8,0
2020-04-01,Saint Kitts and Nevis,0,0,8,0
2020-04-02,Saint Kitts and Nevis,1,0,9,0
2020-04-03,Saint Kitts and Nevis,0,0,9,0
2020-04-04,Saint Kitts and Nevis,0,0,9,0
2020-04-05,Saint Kitts and Nevis,1,0,10,0
2020-04-06,Saint Kitts and Nevis,0,0,10,0
2020-04-07,Saint Kitts and Nevis,1,0,11,0
2020-04-08,Saint Kitts and Nevis,0,0,11,0
2020-04-09,Saint Kitts and Nevis,0,0,11,0
2020-04-10,Saint Kitts and Nevis,1,0,12,0
2020-04-11,Saint Kitts and Nevis,0,0,12,0
2020-04-12,Saint Kitts and Nevis,0,0,12,0
2020-04-13,Saint Kitts and Nevis,0,0,12,0
2020-04-14,Saint Kitts and Nevis,2,0,14,0
2020-04-15,Saint Kitts and Nevis,0,0,14,0
2020-04-16,Saint Kitts and Nevis,0,0,14,0
2020-04-17,Saint Kitts and Nevis,0,0,14,0
2020-04-18,Saint Kitts and Nevis,0,0,14,0
2020-04-19,Saint Kitts and Nevis,0,0,14,0
2020-04-20,Saint Kitts and Nevis,1,0,15,0
2020-04-21,Saint Kitts and Nevis,0,0,15,0
2020-04-22,Saint Kitts and Nevis,0,0,15,0
2020-04-23,Saint Kitts and Nevis,0,0,15,0
2020-04-24,Saint Kitts and Nevis,0,0,15,0
2020-04-25,Saint Kitts and Nevis,0,0,15,0
2020-04-26,Saint Kitts and Nevis,0,0,15,0
2020-04-27,Saint Kitts and Nevis,0,0,15,0
2020-04-28,Saint Kitts and Nevis,0,0,15,0
2020-04-29,Saint Kitts and Nevis,0,0,15,0
2020-04-30,Saint Kitts and Nevis,0,0,15,0
2020-05-01,Saint Kitts and Nevis,0,0,15,0
2020-05-02,Saint Kitts and Nevis,0,0,15,0
2020-05-03,Saint Kitts and Nevis,0,0,15,0
2020-05-04,Saint Kitts and Nevis,0,0,15,0
2020-05-05,Saint Kitts and Nevis,0,0,15,0
2020-05-06,Saint Kitts and Nevis,0,0,15,0
2020-05-07,Saint Kitts and Nevis,0,0,15,0
2020-05-08,Saint Kitts and Nevis,0,0,15,0
2020-05-09,Saint Kitts and Nevis,0,0,15,0
2020-05-10,Saint Kitts and Nevis,0,0,15,0
2020-05-11,Saint Kitts and Nevis,0,0,15,0
2020-05-12,Saint Kitts and Nevis,0,0,15,0
2020-05-13,Saint Kitts and Nevis,0,0,15,0
2020-05-14,Saint Kitts and Nevis,0,0,15,0
2020-05-15,Saint Kitts and Nevis,0,0,15,0
2020-05-16,Saint Kitts and Nevis,0,0,15,0
2020-05-17,Saint Kitts and Nevis,0,0,15,0
2020-05-18,Saint Kitts and Nevis,0,0,15,0
2020-05-19,Saint Kitts and Nevis,0,0,15,0
2020-05-20,Saint Kitts and Nevis,0,0,15,0
2020-05-21,Saint Kitts and Nevis,0,0,15,0
2020-05-22,Saint Kitts and Nevis,0,0,15,0
2020-05-23,Saint Kitts and Nevis,0,0,15,0
2020-05-24,Saint Kitts and Nevis,0,0,15,0
2020-05-25,Saint Kitts and Nevis,0,0,15,0
2020-05-26,Saint Kitts and Nevis,0,0,15,0
2020-05-27,Saint Kitts and Nevis,0,0,15,0
2020-05-28,Saint Kitts and Nevis,0,0,15,0
2020-05-29,Saint Kitts and Nevis,0,0,15,0
2020-05-30,Saint Kitts and Nevis,0,0,15,0
2020-05-31,Saint Kitts and Nevis,0,0,15,0
2020-06-01,Saint Kitts and Nevis,0,0,15,0
2020-06-02,Saint Kitts and Nevis,0,0,15,0
2020-06-03,Saint Kitts and Nevis,0,0,15,0
2020-06-04,Saint Kitts and Nevis,0,0,15,0
2020-06-05,Saint Kitts and Nevis,0,0,15,0
2020-06-06,Saint Kitts and Nevis,0,0,15,0
2020-06-07,Saint Kitts and Nevis,0,0,15,0
2020-06-08,Saint Kitts and Nevis,0,0,15,0
2020-06-09,Saint Kitts and Nevis,0,0,15,0
2020-06-10,Saint Kitts and Nevis,0,0,15,0
2020-06-11,Saint Kitts and Nevis,0,0,15,0
2020-06-12,Saint Kitts and Nevis,0,0,15,0
2020-06-13,Saint Kitts and Nevis,0,0,15,0
2020-06-14,Saint Kitts and Nevis,0,0,15,0
2020-06-15,Saint Kitts and Nevis,0,0,15,0
2020-06-16,Saint Kitts and Nevis,0,0,15,0
2020-06-17,Saint Kitts and Nevis,0,0,15,0
2020-06-18,Saint Kitts and Nevis,0,0,15,0
2020-06-19,Saint Kitts and Nevis,0,0,15,0
2020-06-20,Saint Kitts and Nevis,0,0,15,0
2020-06-21,Saint Kitts and Nevis,0,0,15,0
2020-06-22,Saint Kitts and Nevis,0,0,15,0
2020-06-23,Saint Kitts and Nevis,0,0,15,0
2020-06-24,Saint Kitts and Nevis,0,0,15,0
2020-06-25,Saint Kitts and Nevis,0,0,15,0
2020-06-26,Saint Kitts and Nevis,0,0,15,0
2020-06-27,Saint Kitts and Nevis,0,0,15,0
2020-06-28,Saint Kitts and Nevis,0,0,15,0
2020-06-29,Saint Kitts and Nevis,0,0,15,0
2020-06-30,Saint Kitts and Nevis,0,0,15,0
2020-07-01,Saint Kitts and Nevis,0,0,15,0
2020-07-02,Saint Kitts and Nevis,0,0,15,0
2020-07-03,Saint Kitts and Nevis,0,0,15,0
2020-07-04,Saint Kitts and Nevis,1,0,16,0
2020-07-05,Saint Kitts and Nevis,0,0,16,0
2020-07-06,Saint Kitts and Nevis,0,0,16,0
2020-07-07,Saint Kitts and Nevis,0,0,16,0
2020-07-08,Saint Kitts and Nevis,0,0,16,0
2020-07-09,Saint Kitts and Nevis,0,0,16,0
2020-07-10,Saint Kitts and Nevis,1,0,17,0
2020-07-11,Saint Kitts and Nevis,0,0,17,0
2020-07-12,Saint Kitts and Nevis,0,0,17,0
2020-07-13,Saint Kitts and Nevis,0,0,17,0
2020-07-14,Saint Kitts and Nevis,0,0,17,0
2020-07-15,Saint Kitts and Nevis,0,0,17,0
2020-07-16,Saint Kitts and Nevis,0,0,17,0
2020-07-17,Saint Kitts and Nevis,0,0,17,0
2020-07-18,Saint Kitts and Nevis,0,0,17,0
2020-07-19,Saint Kitts and Nevis,0,0,17,0
2020-07-20,Saint Kitts and Nevis,0,0,17,0
2020-07-21,Saint Kitts and Nevis,0,0,17,0
2020-07-22,Saint Kitts and Nevis,0,0,17,0
2020-07-23,Saint Kitts and Nevis,0,0,17,0
2020-07-24,Saint Kitts and Nevis,0,0,17,0
2020-07-25,Saint Kitts and Nevis,0,0,17,0
2020-07-26,Saint Kitts and Nevis,0,0,17,0
2020-07-27,Saint Kitts and Nevis,0,0,17,0
2020-07-28,Saint Kitts and Nevis,0,0,17,0
2020-07-29,Saint Kitts and Nevis,0,0,17,0
2020-07-30,Saint Kitts and Nevis,0,0,17,0
2020-07-31,Saint Kitts and Nevis,0,0,17,0
2020-08-01,Saint Kitts and Nevis,0,0,17,0
2020-08-02,Saint Kitts and Nevis,0,0,17,0
2020-08-03,Saint Kitts and Nevis,0,0,17,0
2020-08-04,Saint Kitts and Nevis,0,0,17,0
2020-08-05,Saint Kitts and Nevis,0,0,17,0
2020-08-06,Saint Kitts and Nevis,0,0,17,0
2020-08-07,Saint Kitts and Nevis,0,0,17,0
2020-08-08,Saint Kitts and Nevis,0,0,17,0
2020-08-09,Saint Kitts and Nevis,0,0,17,0
2020-08-10,Saint Kitts and Nevis,0,0,17,0
2020-08-11,Saint Kitts and Nevis,0,0,17,0
2020-08-12,Saint Kitts and Nevis,0,0,17,0
2020-08-13,Saint Kitts and Nevis,0,0,17,0
2020-08-14,Saint Kitts and Nevis,0,0,17,0
2020-08-15,Saint Kitts and Nevis,0,0,17,0
2020-08-16,Saint Kitts and Nevis,0,0,17,0
2020-08-17,Saint Kitts and Nevis,0,0,17,0
2020-08-18,Saint Kitts and Nevis,0,0,17,0
2020-08-19,Saint Kitts and Nevis,0,0,17,0
2020-08-20,Saint Kitts and Nevis,0,0,17,0
2020-08-21,Saint Kitts and Nevis,0,0,17,0
2020-08-22,Saint Kitts and Nevis,0,0,17,0
2020-08-23,Saint Kitts and Nevis,0,0,17,0
2020-08-24,Saint Kitts and Nevis,0,0,17,0
2020-08-25,Saint Kitts and Nevis,0,0,17,0
2020-08-26,Saint Kitts and Nevis,0,0,17,0
2020-08-27,Saint Kitts and Nevis,0,0,17,0
2020-08-28,Saint Kitts and Nevis,0,0,17,0
2020-08-29,Saint Kitts and Nevis,0,0,17,0
2020-08-30,Saint Kitts and Nevis,0,0,17,0
2020-08-31,Saint Kitts and Nevis,0,0,17,0
2020-09-01,Saint Kitts and Nevis,0,0,17,0
2020-09-02,Saint Kitts and Nevis,0,0,17,0
2020-09-03,Saint Kitts and Nevis,0,0,17,0
2020-09-04,Saint Kitts and Nevis,0,0,17,0
2020-09-05,Saint Kitts and Nevis,0,0,17,0
2020-09-06,Saint Kitts and Nevis,0,0,17,0
2020-09-07,Saint Kitts and Nevis,0,0,17,0
2020-09-08,Saint Kitts and Nevis,0,0,17,0
2020-09-09,Saint Kitts and Nevis,0,0,17,0
2020-09-10,Saint Kitts and Nevis,0,0,17,0
2020-09-11,Saint Kitts and Nevis,0,0,17,0
2020-09-12,Saint Kitts and Nevis,0,0,17,0
2020-09-13,Saint Kitts and Nevis,0,0,17,0
2020-09-14,Saint Kitts and Nevis,0,0,17,0
2020-09-15,Saint Kitts and Nevis,0,0,17,0
2020-09-16,Saint Kitts and Nevis,0,0,17,0
2020-09-17,Saint Kitts and Nevis,0,0,17,0
2020-09-18,Saint Kitts and Nevis,0,0,17,0
2020-09-19,Saint Kitts and Nevis,0,0,17,0
2020-09-20,Saint Kitts and Nevis,0,0,17,0
2020-09-21,Saint Kitts and Nevis,2,0,19,0
2020-09-22,Saint Kitts and Nevis,0,0,19,0
2020-09-23,Saint Kitts and Nevis,0,0,19,0
2020-09-24,Saint Kitts and Nevis,0,0,19,0
2020-09-25,Saint Kitts and Nevis,0,0,19,0
2020-09-26,Saint Kitts and Nevis,0,0,19,0
2020-09-27,Saint Kitts and Nevis,0,0,19,0
2020-09-28,Saint Kitts and Nevis,0,0,19,0
2020-09-29,Saint Kitts and Nevis,0,0,19,0
2020-09-30,Saint Kitts and Nevis,0,0,19,0
2020-10-01,Saint Kitts and Nevis,0,0,19,0
2020-10-02,Saint Kitts and Nevis,0,0,19,0
2020-10-03,Saint Kitts and Nevis,0,0,19,0
2020-10-04,Saint Kitts and Nevis,0,0,19,0
2020-10-05,Saint Kitts and Nevis,0,0,19,0
2020-10-06,Saint Kitts and Nevis,0,0,19,0
2020-10-07,Saint Kitts and Nevis,0,0,19,0
2020-10-08,Saint Kitts and Nevis,0,0,19,0
2020-10-09,Saint Kitts and Nevis,0,0,19,0
2020-10-10,Saint Kitts and Nevis,0,0,19,0
2020-10-11,Saint Kitts and Nevis,0,0,19,0
2020-10-12,Saint Kitts and Nevis,0,0,19,0
2020-10-13,Saint Kitts and Nevis,0,0,19,0
2020-10-14,Saint Kitts and Nevis,0,0,19,0
2020-10-15,Saint Kitts and Nevis,0,0,19,0
2020-10-16,Saint Kitts and Nevis,0,0,19,0
2020-10-17,Saint Kitts and Nevis,0,0,19,0
2020-10-18,Saint Kitts and Nevis,0,0,19,0
2020-10-19,Saint Kitts and Nevis,0,0,19,0
2020-10-20,Saint Kitts and Nevis,0,0,19,0
2020-10-21,Saint Kitts and Nevis,0,0,19,0
2020-10-22,Saint Kitts and Nevis,0,0,19,0
2020-10-23,Saint Kitts and Nevis,0,0,19,0
2020-10-24,Saint Kitts and Nevis,0,0,19,0
2020-10-25,Saint Kitts and Nevis,0,0,19,0
2020-10-26,Saint Kitts and Nevis,0,0,19,0
2020-10-27,Saint Kitts and Nevis,0,0,19,0
2020-10-28,Saint Kitts and Nevis,0,0,19,0
2020-10-29,Saint Kitts and Nevis,0,0,19,0
2020-10-30,Saint Kitts and Nevis,0,0,19,0
2020-10-31,Saint Kitts and Nevis,0,0,19,0
2020-11-01,Saint Kitts and Nevis,0,0,19,0
2020-11-02,Saint Kitts and Nevis,0,0,19,0
2020-11-03,Saint Kitts and Nevis,0,0,19,0
2020-11-04,Saint Kitts and Nevis,0,0,19,0
2020-11-05,Saint Kitts and Nevis,0,0,19,0
2020-11-06,Saint Kitts and Nevis,0,0,19,0
2020-11-07,Saint Kitts and Nevis,0,0,19,0
2020-11-08,Saint Kitts and Nevis,0,0,19,0
2020-11-09,Saint Kitts and Nevis,0,0,19,0
2020-11-10,Saint Kitts and Nevis,0,0,19,0
2020-11-11,Saint Kitts and Nevis,0,0,19,0
2020-11-12,Saint Kitts and Nevis,0,0,19,0
2020-11-13,Saint Kitts and Nevis,0,0,19,0
2020-11-14,Saint Kitts and Nevis,0,0,19,0
2020-11-15,Saint Kitts and Nevis,0,0,19,0
2020-11-16,Saint Kitts and Nevis,0,0,19,0
2020-11-17,Saint Kitts and Nevis,0,0,19,0
2020-11-18,Saint Kitts and Nevis,0,0,19,0
2020-11-19,Saint Kitts and Nevis,0,0,19,0
2020-11-20,Saint Kitts and Nevis,0,0,19,0
2020-11-21,Saint Kitts and Nevis,0,0,19,0
2020-11-22,Saint Kitts and Nevis,1,0,20,0
2020-11-23,Saint Kitts and Nevis,0,0,20,0
2020-11-24,Saint Kitts and Nevis,2,0,22,0
2020-11-25,Saint Kitts and Nevis,0,0,22,0
2020-11-26,Saint Kitts and Nevis,0,0,22,0
2020-11-27,Saint Kitts and Nevis,0,0,22,0
2020-11-28,Saint Kitts and Nevis,0,0,22,0
2020-11-29,Saint Kitts and Nevis,0,0,22,0
2020-11-30,Saint Kitts and Nevis,0,0,22,0
2020-12-01,Saint Kitts and Nevis,0,0,22,0
2020-12-02,Saint Kitts and Nevis,0,0,22,0
2020-12-03,Saint Kitts and Nevis,0,0,22,0
2020-12-04,Saint Kitts and Nevis,0,0,22,0
2020-12-05,Saint Kitts and Nevis,3,0,25,0
2020-12-06,Saint Kitts and Nevis,0,0,25,0
2020-12-07,Saint Kitts and Nevis,0,0,25,0
2020-12-08,Saint Kitts and Nevis,0,0,25,0
2020-12-09,Saint Kitts and Nevis,0,0,25,0
2020-12-10,Saint Kitts and Nevis,1,0,26,0
2020-12-11,Saint Kitts and Nevis,1,0,27,0
2020-12-12,Saint Kitts and Nevis,0,0,27,0
2020-12-13,Saint Kitts and Nevis,0,0,27,0
2020-12-14,Saint Kitts and Nevis,1,0,28,0
2020-12-15,Saint Kitts and Nevis,0,0,28,0
2020-12-16,Saint Kitts and Nevis,0,0,28,0
2020-12-17,Saint Kitts and Nevis,0,0,28,0
2020-12-18,Saint Kitts and Nevis,2,0,30,0
2020-12-19,Saint Kitts and Nevis,0,0,30,0
2020-12-20,Saint Kitts and Nevis,0,0,30,0
2020-12-21,Saint Kitts and Nevis,0,0,30,0
2020-12-22,Saint Kitts and Nevis,0,0,30,0
2020-12-23,Saint Kitts and Nevis,0,0,30,0
2020-12-24,Saint Kitts and Nevis,0,0,30,0
2020-12-25,Saint Kitts and Nevis,0,0,30,0
2020-12-26,Saint Kitts and Nevis,0,0,30,0
2020-12-27,Saint Kitts and Nevis,2,0,32,0
2020-12-28,Saint Kitts and Nevis,0,0,32,0
2020-12-29,Saint Kitts and Nevis,0,0,32,0
2020-12-30,Saint Kitts and Nevis,0,0,32,0
2020-12-31,Saint Kitts and Nevis,0,0,32,0
2021-01-01,Saint Kitts and Nevis,0,0,32,0
2021-01-02,Saint Kitts and Nevis,1,0,33,0
2021-01-03,Saint Kitts and Nevis,0,0,33,0
2021-01-04,Saint Kitts and Nevis,0,0,33,0
2021-01-05,Saint Kitts and Nevis,0,0,33,0
2021-01-06,Saint Kitts and Nevis,0,0,33,0
2021-01-07,Saint Kitts and Nevis,0,0,33,0
2021-01-08,Saint Kitts and Nevis,1,0,34,0
2021-01-09,Saint Kitts and Nevis,0,0,34,0
2021-01-10,Saint Kitts and Nevis,0,0,34,0
2021-01-11,Saint Kitts and Nevis,0,0,34,0
2021-01-12,Saint Kitts and Nevis,0,0,34,0
2021-01-13,Saint Kitts and Nevis,0,0,34,0
2021-01-14,Saint Kitts and Nevis,0,0,34,0
2021-01-15,Saint Kitts and Nevis,0,0,34,0
2021-01-16,Saint Kitts and Nevis,0,0,34,0
2021-01-17,Saint Kitts and Nevis,0,0,34,0
2021-01-18,Saint Kitts and Nevis,1,0,35,0
2021-01-19,Saint Kitts and Nevis,0,0,35,0
2021-01-20,Saint Kitts and Nevis,0,0,35,0
2021-01-21,Saint Kitts and Nevis,0,0,35,0
2021-01-22,Saint Kitts and Nevis,0,0,35,0
2021-01-23,Saint Kitts and Nevis,0,0,35,0
2021-01-24,Saint Kitts and Nevis,0,0,35,0
2021-01-25,Saint Kitts and Nevis,0,0,35,0
2021-01-26,Saint Kitts and Nevis,2,0,37,0
2021-01-27,Saint Kitts and Nevis,0,0,37,0
2021-01-28,Saint Kitts and Nevis,0,0,37,0
2021-01-29,Saint Kitts and Nevis,0,0,37,0
2021-01-30,Saint Kitts and Nevis,0,0,37,0
2021-01-31,Saint Kitts and Nevis,0,0,37,0
2021-02-01,Saint Kitts and Nevis,1,0,38,0
2021-02-02,Saint Kitts and Nevis,1,0,39,0
2021-02-03,Saint Kitts and Nevis,0,0,39,0
2021-02-04,Saint Kitts and Nevis,0,0,39,0
2021-02-05,Saint Kitts and Nevis,1,0,40,0
2021-02-06,Saint Kitts and Nevis,0,0,40,0
2021-02-07,Saint Kitts and Nevis,0,0,40,0
2021-02-08,Saint Kitts and Nevis,0,0,40,0
2021-02-09,Saint Kitts and Nevis,0,0,40,0
2021-02-10,Saint Kitts and Nevis,0,0,40,0
2021-02-11,Saint Kitts and Nevis,0,0,40,0
2021-02-12,Saint Kitts and Nevis,0,0,40,0
2021-02-13,Saint Kitts and Nevis,0,0,40,0
2021-02-14,Saint Kitts and Nevis,1,0,41,0
2021-02-15,Saint Kitts and Nevis,0,0,41,0
2021-02-16,Saint Kitts and Nevis,0,0,41,0
2021-02-17,Saint Kitts and Nevis,0,0,41,0
2021-02-18,Saint Kitts and Nevis,0,0,41,0
2021-02-19,Saint Kitts and Nevis,0,0,41,0
2021-02-20,Saint Kitts and Nevis,0,0,41,0
2021-02-21,Saint Kitts and Nevis,0,0,41,0
2021-02-22,Saint Kitts and Nevis,0,0,41,0
2021-02-23,Saint Kitts and Nevis,0,0,41,0
2021-02-24,Saint Kitts and Nevis,0,0,41,0
2021-02-25,Saint Kitts and Nevis,0,0,41,0
2021-02-26,Saint Kitts and Nevis,0,0,41,0
2021-02-27,Saint Kitts and Nevis,0,0,41,0
2021-02-28,Saint Kitts and Nevis,0,0,41,0
2021-03-01,Saint Kitts and Nevis,0,0,41,0
2021-03-02,Saint Kitts and Nevis,0,0,41,0
2021-03-03,Saint Kitts and Nevis,0,0,41,0
2021-03-04,Saint Kitts and Nevis,0,0,41,0
2021-03-05,Saint Kitts and Nevis,0,0,41,0
2021-03-06,Saint Kitts and Nevis,0,0,41,0
2021-03-07,Saint Kitts and Nevis,0,0,41,0
2021-03-08,Saint Kitts and Nevis,0,0,41,0
2021-03-09,Saint Kitts and Nevis,0,0,41,0
2021-03-10,Saint Kitts and Nevis,0,0,41,0
2021-03-11,Saint Kitts and Nevis,1,0,42,0
2021-03-12,Saint Kitts and Nevis,0,0,42,0
2021-03-13,Saint Kitts and Nevis,1,0,43,0
2021-03-14,Saint Kitts and Nevis,0,0,43,0
2021-03-15,Saint Kitts and Nevis,0,0,43,0
2021-03-16,Saint Kitts and Nevis,0,0,43,0
2021-03-17,Saint Kitts and Nevis,0,0,43,0
2021-03-18,Saint Kitts and Nevis,1,0,44,0
2021-03-19,Saint Kitts and Nevis,0,0,44,0
2021-03-20,Saint Kitts and Nevis,0,0,44,0
2021-03-21,Saint Kitts and Nevis,0,0,44,0
2021-03-22,Saint Kitts and Nevis,0,0,44,0
2021-03-23,Saint Kitts and Nevis,0,0,44,0
2021-03-24,Saint Kitts and Nevis,0,0,44,0
2021-03-25,Saint Kitts and Nevis,0,0,44,0
2021-03-26,Saint Kitts and Nevis,0,0,44,0
2021-03-27,Saint Kitts and Nevis,0,0,44,0
2021-03-28,Saint Kitts and Nevis,0,0,44,0
2021-03-29,Saint Kitts and Nevis,0,0,44,0
2021-03-30,Saint Kitts and Nevis,0,0,44,0
2021-03-31,Saint Kitts and Nevis,0,0,44,0
2021-04-01,Saint Kitts and Nevis,0,0,44,0
2021-04-02,Saint Kitts and Nevis,0,0,44,0
2021-04-03,Saint Kitts and Nevis,0,0,44,0
2021-04-04,Saint Kitts and Nevis,0,0,44,0
2021-04-05,Saint Kitts and Nevis,0,0,44,0
2021-04-06,Saint Kitts and Nevis,0,0,44,0
2021-04-07,Saint Kitts and Nevis,0,0,44,0
2021-04-08,Saint Kitts and Nevis,0,0,44,0
2020-03-14,Saint Lucia,1,0,1,0
2020-03-15,Saint Lucia,1,0,2,0
2020-03-16,Saint Lucia,0,0,2,0
2020-03-17,Saint Lucia,0,0,2,0
2020-03-18,Saint Lucia,0,0,2,0
2020-03-19,Saint Lucia,0,0,2,0
2020-03-20,Saint Lucia,0,0,2,0
2020-03-21,Saint Lucia,0,0,2,0
2020-03-22,Saint Lucia,0,0,2,0
2020-03-23,Saint Lucia,1,0,3,0
2020-03-24,Saint Lucia,0,0,3,0
2020-03-25,Saint Lucia,0,0,3,0
2020-03-26,Saint Lucia,0,0,3,0
2020-03-27,Saint Lucia,0,0,3,0
2020-03-28,Saint Lucia,0,0,3,0
2020-03-29,Saint Lucia,6,0,9,0
2020-03-30,Saint Lucia,0,0,9,0
2020-03-31,Saint Lucia,4,0,13,0
2020-04-01,Saint Lucia,0,0,13,0
2020-04-02,Saint Lucia,0,0,13,0
2020-04-03,Saint Lucia,0,0,13,0
2020-04-04,Saint Lucia,1,0,14,0
2020-04-05,Saint Lucia,0,0,14,0
2020-04-06,Saint Lucia,0,0,14,0
2020-04-07,Saint Lucia,0,0,14,0
2020-04-08,Saint Lucia,0,0,14,0
2020-04-09,Saint Lucia,0,0,14,0
2020-04-10,Saint Lucia,1,0,15,0
2020-04-11,Saint Lucia,0,0,15,0
2020-04-12,Saint Lucia,0,0,15,0
2020-04-13,Saint Lucia,0,0,15,0
2020-04-14,Saint Lucia,0,0,15,0
2020-04-15,Saint Lucia,0,0,15,0
2020-04-16,Saint Lucia,0,0,15,0
2020-04-17,Saint Lucia,0,0,15,0
2020-04-18,Saint Lucia,0,0,15,0
2020-04-19,Saint Lucia,0,0,15,0
2020-04-20,Saint Lucia,0,0,15,0
2020-04-21,Saint Lucia,0,0,15,0
2020-04-22,Saint Lucia,0,0,15,0
2020-04-23,Saint Lucia,0,0,15,0
2020-04-24,Saint Lucia,0,0,15,0
2020-04-25,Saint Lucia,0,0,15,0
2020-04-26,Saint Lucia,0,0,15,0
2020-04-27,Saint Lucia,0,0,15,0
2020-04-28,Saint Lucia,0,0,15,0
2020-04-29,Saint Lucia,2,0,17,0
2020-04-30,Saint Lucia,0,0,17,0
2020-05-01,Saint Lucia,0,0,17,0
2020-05-02,Saint Lucia,0,0,17,0
2020-05-03,Saint Lucia,1,0,18,0
2020-05-04,Saint Lucia,0,0,18,0
2020-05-05,Saint Lucia,0,0,18,0
2020-05-06,Saint Lucia,0,0,18,0
2020-05-07,Saint Lucia,0,0,18,0
2020-05-08,Saint Lucia,0,0,18,0
2020-05-09,Saint Lucia,0,0,18,0
2020-05-10,Saint Lucia,0,0,18,0
2020-05-11,Saint Lucia,0,0,18,0
2020-05-12,Saint Lucia,0,0,18,0
2020-05-13,Saint Lucia,0,0,18,0
2020-05-14,Saint Lucia,0,0,18,0
2020-05-15,Saint Lucia,0,0,18,0
2020-05-16,Saint Lucia,0,0,18,0
2020-05-17,Saint Lucia,0,0,18,0
2020-05-18,Saint Lucia,0,0,18,0
2020-05-19,Saint Lucia,0,0,18,0
2020-05-20,Saint Lucia,0,0,18,0
2020-05-21,Saint Lucia,0,0,18,0
2020-05-22,Saint Lucia,0,0,18,0
2020-05-23,Saint Lucia,0,0,18,0
2020-05-24,Saint Lucia,0,0,18,0
2020-05-25,Saint Lucia,0,0,18,0
2020-05-26,Saint Lucia,0,0,18,0
2020-05-27,Saint Lucia,0,0,18,0
2020-05-28,Saint Lucia,0,0,18,0
2020-05-29,Saint Lucia,0,0,18,0
2020-05-30,Saint Lucia,0,0,18,0
2020-05-31,Saint Lucia,0,0,18,0
2020-06-01,Saint Lucia,0,0,18,0
2020-06-02,Saint Lucia,0,0,18,0
2020-06-03,Saint Lucia,0,0,18,0
2020-06-04,Saint Lucia,1,0,19,0
2020-06-05,Saint Lucia,0,0,19,0
2020-06-06,Saint Lucia,0,0,19,0
2020-06-07,Saint Lucia,0,0,19,0
2020-06-08,Saint Lucia,0,0,19,0
2020-06-09,Saint Lucia,0,0,19,0
2020-06-10,Saint Lucia,0,0,19,0
2020-06-11,Saint Lucia,0,0,19,0
2020-06-12,Saint Lucia,0,0,19,0
2020-06-13,Saint Lucia,0,0,19,0
2020-06-14,Saint Lucia,0,0,19,0
2020-06-15,Saint Lucia,0,0,19,0
2020-06-16,Saint Lucia,0,0,19,0
2020-06-17,Saint Lucia,0,0,19,0
2020-06-18,Saint Lucia,0,0,19,0
2020-06-19,Saint Lucia,0,0,19,0
2020-06-20,Saint Lucia,0,0,19,0
2020-06-21,Saint Lucia,0,0,19,0
2020-06-22,Saint Lucia,0,0,19,0
2020-06-23,Saint Lucia,0,0,19,0
2020-06-24,Saint Lucia,0,0,19,0
2020-06-25,Saint Lucia,0,0,19,0
2020-06-26,Saint Lucia,0,0,19,0
2020-06-27,Saint Lucia,0,0,19,0
2020-06-28,Saint Lucia,0,0,19,0
2020-06-29,Saint Lucia,0,0,19,0
2020-06-30,Saint Lucia,0,0,19,0
2020-07-01,Saint Lucia,0,0,19,0
2020-07-02,Saint Lucia,0,0,19,0
2020-07-03,Saint Lucia,3,0,22,0
2020-07-04,Saint Lucia,0,0,22,0
2020-07-05,Saint Lucia,0,0,22,0
2020-07-06,Saint Lucia,0,0,22,0
2020-07-07,Saint Lucia,0,0,22,0
2020-07-08,Saint Lucia,0,0,22,0
2020-07-09,Saint Lucia,0,0,22,0
2020-07-10,Saint Lucia,0,0,22,0
2020-07-11,Saint Lucia,0,0,22,0
2020-07-12,Saint Lucia,0,0,22,0
2020-07-13,Saint Lucia,0,0,22,0
2020-07-14,Saint Lucia,0,0,22,0
2020-07-15,Saint Lucia,0,0,22,0
2020-07-16,Saint Lucia,1,0,23,0
2020-07-17,Saint Lucia,0,0,23,0
2020-07-18,Saint Lucia,0,0,23,0
2020-07-19,Saint Lucia,0,0,23,0
2020-07-20,Saint Lucia,0,0,23,0
2020-07-21,Saint Lucia,0,0,23,0
2020-07-22,Saint Lucia,0,0,23,0
2020-07-23,Saint Lucia,1,0,24,0
2020-07-24,Saint Lucia,0,0,24,0
2020-07-25,Saint Lucia,0,0,24,0
2020-07-26,Saint Lucia,0,0,24,0
2020-07-27,Saint Lucia,0,0,24,0
2020-07-28,Saint Lucia,0,0,24,0
2020-07-29,Saint Lucia,0,0,24,0
2020-07-30,Saint Lucia,1,0,25,0
2020-07-31,Saint Lucia,0,0,25,0
2020-08-01,Saint Lucia,0,0,25,0
2020-08-02,Saint Lucia,0,0,25,0
2020-08-03,Saint Lucia,0,0,25,0
2020-08-04,Saint Lucia,0,0,25,0
2020-08-05,Saint Lucia,0,0,25,0
2020-08-06,Saint Lucia,0,0,25,0
2020-08-07,Saint Lucia,0,0,25,0
2020-08-08,Saint Lucia,0,0,25,0
2020-08-09,Saint Lucia,0,0,25,0
2020-08-10,Saint Lucia,0,0,25,0
2020-08-11,Saint Lucia,0,0,25,0
2020-08-12,Saint Lucia,0,0,25,0
2020-08-13,Saint Lucia,0,0,25,0
2020-08-14,Saint Lucia,0,0,25,0
2020-08-15,Saint Lucia,0,0,25,0
2020-08-16,Saint Lucia,0,0,25,0
2020-08-17,Saint Lucia,0,0,25,0
2020-08-18,Saint Lucia,1,0,26,0
2020-08-19,Saint Lucia,0,0,26,0
2020-08-20,Saint Lucia,0,0,26,0
2020-08-21,Saint Lucia,0,0,26,0
2020-08-22,Saint Lucia,0,0,26,0
2020-08-23,Saint Lucia,0,0,26,0
2020-08-24,Saint Lucia,0,0,26,0
2020-08-25,Saint Lucia,0,0,26,0
2020-08-26,Saint Lucia,0,0,26,0
2020-08-27,Saint Lucia,0,0,26,0
2020-08-28,Saint Lucia,0,0,26,0
2020-08-29,Saint Lucia,0,0,26,0
2020-08-30,Saint Lucia,0,0,26,0
2020-08-31,Saint Lucia,0,0,26,0
2020-09-01,Saint Lucia,0,0,26,0
2020-09-02,Saint Lucia,0,0,26,0
2020-09-03,Saint Lucia,0,0,26,0
2020-09-04,Saint Lucia,0,0,26,0
2020-09-05,Saint Lucia,0,0,26,0
2020-09-06,Saint Lucia,0,0,26,0
2020-09-07,Saint Lucia,0,0,26,0
2020-09-08,Saint Lucia,0,0,26,0
2020-09-09,Saint Lucia,1,0,27,0
2020-09-10,Saint Lucia,0,0,27,0
2020-09-11,Saint Lucia,0,0,27,0
2020-09-12,Saint Lucia,0,0,27,0
2020-09-13,Saint Lucia,0,0,27,0
2020-09-14,Saint Lucia,0,0,27,0
2020-09-15,Saint Lucia,0,0,27,0
2020-09-16,Saint Lucia,0,0,27,0
2020-09-17,Saint Lucia,0,0,27,0
2020-09-18,Saint Lucia,0,0,27,0
2020-09-19,Saint Lucia,0,0,27,0
2020-09-20,Saint Lucia,0,0,27,0
2020-09-21,Saint Lucia,0,0,27,0
2020-09-22,Saint Lucia,0,0,27,0
2020-09-23,Saint Lucia,0,0,27,0
2020-09-24,Saint Lucia,0,0,27,0
2020-09-25,Saint Lucia,0,0,27,0
2020-09-26,Saint Lucia,0,0,27,0
2020-09-27,Saint Lucia,0,0,27,0
2020-09-28,Saint Lucia,0,0,27,0
2020-09-29,Saint Lucia,0,0,27,0
2020-09-30,Saint Lucia,0,0,27,0
2020-10-01,Saint Lucia,0,0,27,0
2020-10-02,Saint Lucia,0,0,27,0
2020-10-03,Saint Lucia,0,0,27,0
2020-10-04,Saint Lucia,0,0,27,0
2020-10-05,Saint Lucia,0,0,27,0
2020-10-06,Saint Lucia,0,0,27,0
2020-10-07,Saint Lucia,0,0,27,0
2020-10-08,Saint Lucia,1,0,28,0
2020-10-09,Saint Lucia,0,0,28,0
2020-10-10,Saint Lucia,1,0,29,0
2020-10-11,Saint Lucia,0,0,29,0
2020-10-12,Saint Lucia,0,0,29,0
2020-10-13,Saint Lucia,0,0,29,0
2020-10-14,Saint Lucia,2,0,31,0
2020-10-15,Saint Lucia,0,0,31,0
2020-10-16,Saint Lucia,1,0,32,0
2020-10-17,Saint Lucia,1,0,33,0
2020-10-18,Saint Lucia,0,0,33,0
2020-10-19,Saint Lucia,3,0,36,0
2020-10-20,Saint Lucia,0,0,36,0
2020-10-21,Saint Lucia,2,0,38,0
2020-10-22,Saint Lucia,4,0,42,0
2020-10-23,Saint Lucia,6,0,48,0
2020-10-24,Saint Lucia,4,0,52,0
2020-10-25,Saint Lucia,2,0,54,0
2020-10-26,Saint Lucia,9,0,63,0
2020-10-27,Saint Lucia,2,0,65,0
2020-10-28,Saint Lucia,2,0,67,0
2020-10-29,Saint Lucia,9,0,76,0
2020-10-30,Saint Lucia,2,0,78,0
2020-10-31,Saint Lucia,0,0,78,0
2020-11-01,Saint Lucia,6,0,84,0
2020-11-02,Saint Lucia,0,0,84,0
2020-11-03,Saint Lucia,13,0,97,0
2020-11-04,Saint Lucia,8,0,105,0
2020-11-05,Saint Lucia,1,0,106,0
2020-11-06,Saint Lucia,4,0,110,0
2020-11-07,Saint Lucia,13,0,123,0
2020-11-08,Saint Lucia,8,0,131,0
2020-11-09,Saint Lucia,10,0,141,0
2020-11-10,Saint Lucia,7,1,148,1
2020-11-11,Saint Lucia,0,1,148,2
2020-11-12,Saint Lucia,0,0,148,2
2020-11-13,Saint Lucia,8,0,156,2
2020-11-14,Saint Lucia,4,0,160,2
2020-11-15,Saint Lucia,2,0,162,2
2020-11-16,Saint Lucia,9,0,171,2
2020-11-17,Saint Lucia,7,0,178,2
2020-11-18,Saint Lucia,5,0,183,2
2020-11-19,Saint Lucia,20,0,203,2
2020-11-20,Saint Lucia,0,0,203,2
2020-11-21,Saint Lucia,1,0,204,2
2020-11-22,Saint Lucia,16,0,220,2
2020-11-23,Saint Lucia,3,0,223,2
2020-11-24,Saint Lucia,3,0,226,2
2020-11-25,Saint Lucia,9,0,235,2
2020-11-26,Saint Lucia,3,0,238,2
2020-11-27,Saint Lucia,8,0,246,2
2020-11-28,Saint Lucia,6,0,252,2
2020-11-29,Saint Lucia,5,0,257,2
2020-11-30,Saint Lucia,2,0,259,2
2020-12-01,Saint Lucia,0,0,259,2
2020-12-02,Saint Lucia,2,0,261,2
2020-12-03,Saint Lucia,1,0,262,2
2020-12-04,Saint Lucia,0,0,262,2
2020-12-05,Saint Lucia,3,0,265,2
2020-12-06,Saint Lucia,0,0,265,2
2020-12-07,Saint Lucia,5,0,270,2
2020-12-08,Saint Lucia,0,0,270,2
2020-12-09,Saint Lucia,0,0,270,2
2020-12-10,Saint Lucia,0,0,270,2
2020-12-11,Saint Lucia,4,2,274,4
2020-12-12,Saint Lucia,0,0,274,4
2020-12-13,Saint Lucia,1,0,275,4
2020-12-14,Saint Lucia,3,0,278,4
2020-12-15,Saint Lucia,0,0,278,4
2020-12-16,Saint Lucia,0,0,278,4
2020-12-17,Saint Lucia,1,1,279,5
2020-12-18,Saint Lucia,1,0,280,5
2020-12-19,Saint Lucia,2,0,282,5
2020-12-20,Saint Lucia,5,0,287,5
2020-12-21,Saint Lucia,0,0,287,5
2020-12-22,Saint Lucia,16,0,303,5
2020-12-23,Saint Lucia,2,0,305,5
2020-12-24,Saint Lucia,0,0,305,5
2020-12-25,Saint Lucia,0,0,305,5
2020-12-26,Saint Lucia,0,0,305,5
2020-12-27,Saint Lucia,0,0,305,5
2020-12-28,Saint Lucia,26,0,331,5
2020-12-29,Saint Lucia,0,0,331,5
2020-12-30,Saint Lucia,9,0,340,5
2020-12-31,Saint Lucia,13,0,353,5
2021-01-01,Saint Lucia,0,0,353,5
2021-01-02,Saint Lucia,0,0,353,5
2021-01-03,Saint Lucia,0,0,353,5
2021-01-04,Saint Lucia,7,0,360,5
2021-01-05,Saint Lucia,20,0,380,5
2021-01-06,Saint Lucia,2,0,382,5
2021-01-07,Saint Lucia,1,0,383,5
2021-01-08,Saint Lucia,12,0,395,5
2021-01-09,Saint Lucia,43,0,438,5
2021-01-10,Saint Lucia,0,0,438,5
2021-01-11,Saint Lucia,24,0,462,5
2021-01-12,Saint Lucia,28,0,490,5
2021-01-13,Saint Lucia,12,1,502,6
2021-01-14,Saint Lucia,41,0,543,6
2021-01-15,Saint Lucia,33,0,576,6
2021-01-16,Saint Lucia,35,2,611,8
2021-01-17,Saint Lucia,0,0,611,8
2021-01-18,Saint Lucia,10,0,621,8
2021-01-19,Saint Lucia,35,0,656,8
2021-01-20,Saint Lucia,57,0,713,8
2021-01-21,Saint Lucia,5,1,718,9
2021-01-22,Saint Lucia,37,1,755,10
2021-01-23,Saint Lucia,15,0,770,10
2021-01-24,Saint Lucia,40,1,810,11
2021-01-25,Saint Lucia,76,0,886,11
2021-01-26,Saint Lucia,35,2,921,13
2021-01-27,Saint Lucia,48,0,969,13
2021-01-28,Saint Lucia,60,0,1029,13
2021-01-29,Saint Lucia,166,0,1195,13
2021-01-30,Saint Lucia,0,0,1195,13
2021-01-31,Saint Lucia,0,0,1195,13
2021-02-01,Saint Lucia,216,2,1411,15
2021-02-02,Saint Lucia,59,1,1470,16
2021-02-03,Saint Lucia,9,0,1479,16
2021-02-04,Saint Lucia,77,2,1556,18
2021-02-05,Saint Lucia,0,0,1556,18
2021-02-06,Saint Lucia,257,0,1813,18
2021-02-07,Saint Lucia,0,0,1813,18
2021-02-08,Saint Lucia,214,1,2027,19
2021-02-09,Saint Lucia,0,0,2027,19
2021-02-10,Saint Lucia,0,0,2027,19
2021-02-11,Saint Lucia,388,3,2415,22
2021-02-12,Saint Lucia,72,1,2487,23
2021-02-13,Saint Lucia,0,0,2487,23
2021-02-14,Saint Lucia,32,0,2519,23
2021-02-15,Saint Lucia,0,0,2519,23
2021-02-16,Saint Lucia,30,0,2549,23
2021-02-17,Saint Lucia,27,1,2576,24
2021-02-18,Saint Lucia,44,1,2620,25
2021-02-19,Saint Lucia,0,0,2620,25
2021-02-20,Saint Lucia,240,3,2860,28
2021-02-21,Saint Lucia,218,3,3078,31
2021-02-22,Saint Lucia,57,1,3135,32
2021-02-23,Saint Lucia,7,0,3142,32
2021-02-24,Saint Lucia,7,2,3149,34
2021-02-25,Saint Lucia,0,0,3149,34
2021-02-26,Saint Lucia,207,1,3356,35
2021-02-27,Saint Lucia,0,0,3356,35
2021-02-28,Saint Lucia,34,0,3390,35
2021-03-01,Saint Lucia,0,1,3390,36
2021-03-02,Saint Lucia,389,1,3779,37
2021-03-03,Saint Lucia,24,2,3803,39
2021-03-04,Saint Lucia,11,4,3814,43
2021-03-05,Saint Lucia,0,0,3814,43
2021-03-06,Saint Lucia,29,0,3843,43
2021-03-07,Saint Lucia,23,0,3866,43
2021-03-08,Saint Lucia,5,3,3871,46
2021-03-09,Saint Lucia,31,0,3902,46
2021-03-10,Saint Lucia,39,1,3941,47
2021-03-11,Saint Lucia,25,0,3966,47
2021-03-12,Saint Lucia,23,1,3989,48
2021-03-13,Saint Lucia,0,0,3989,48
2021-03-14,Saint Lucia,42,3,4031,51
2021-03-15,Saint Lucia,22,4,4053,55
2021-03-16,Saint Lucia,16,0,4069,55
2021-03-17,Saint Lucia,14,0,4083,55
2021-03-18,Saint Lucia,14,0,4097,55
2021-03-19,Saint Lucia,16,0,4113,55
2021-03-20,Saint Lucia,0,0,4113,55
2021-03-21,Saint Lucia,8,0,4121,55
2021-03-22,Saint Lucia,11,0,4132,55
2021-03-23,Saint Lucia,17,2,4149,57
2021-03-24,Saint Lucia,12,1,4161,58
2021-03-25,Saint Lucia,11,0,4172,58
2021-03-26,Saint Lucia,19,0,4191,58
2021-03-27,Saint Lucia,0,0,4191,58
2021-03-28,Saint Lucia,0,0,4191,58
2021-03-29,Saint Lucia,11,0,4202,58
2021-03-30,Saint Lucia,26,1,4228,59
2021-03-31,Saint Lucia,10,1,4238,60
2021-04-01,Saint Lucia,7,1,4245,61
2021-04-02,Saint Lucia,20,0,4265,61
2021-04-03,Saint Lucia,8,0,4273,61
2021-04-04,Saint Lucia,0,0,4273,61
2021-04-05,Saint Lucia,0,0,4273,61
2021-04-06,Saint Lucia,24,2,4297,63
2021-04-07,Saint Lucia,7,0,4304,63
2021-04-08,Saint Lucia,8,0,4312,63
2020-03-14,Saint Vincent and the Grenadines,1,0,1,0
2020-03-15,Saint Vincent and the Grenadines,0,0,1,0
2020-03-16,Saint Vincent and the Grenadines,0,0,1,0
2020-03-17,Saint Vincent and the Grenadines,0,0,1,0
2020-03-18,Saint Vincent and the Grenadines,0,0,1,0
2020-03-19,Saint Vincent and the Grenadines,0,0,1,0
2020-03-20,Saint Vincent and the Grenadines,0,0,1,0
2020-03-21,Saint Vincent and the Grenadines,0,0,1,0
2020-03-22,Saint Vincent and the Grenadines,0,0,1,0
2020-03-23,Saint Vincent and the Grenadines,0,0,1,0
2020-03-24,Saint Vincent and the Grenadines,0,0,1,0
2020-03-25,Saint Vincent and the Grenadines,0,0,1,0
2020-03-26,Saint Vincent and the Grenadines,0,0,1,0
2020-03-27,Saint Vincent and the Grenadines,0,0,1,0
2020-03-28,Saint Vincent and the Grenadines,0,0,1,0
2020-03-29,Saint Vincent and the Grenadines,0,0,1,0
2020-03-30,Saint Vincent and the Grenadines,0,0,1,0
2020-03-31,Saint Vincent and the Grenadines,0,0,1,0
2020-04-01,Saint Vincent and the Grenadines,0,0,1,0
2020-04-02,Saint Vincent and the Grenadines,1,0,2,0
2020-04-03,Saint Vincent and the Grenadines,1,0,3,0
2020-04-04,Saint Vincent and the Grenadines,4,0,7,0
2020-04-05,Saint Vincent and the Grenadines,0,0,7,0
2020-04-06,Saint Vincent and the Grenadines,0,0,7,0
2020-04-07,Saint Vincent and the Grenadines,1,0,8,0
2020-04-08,Saint Vincent and the Grenadines,0,0,8,0
2020-04-09,Saint Vincent and the Grenadines,4,0,12,0
2020-04-10,Saint Vincent and the Grenadines,0,0,12,0
2020-04-11,Saint Vincent and the Grenadines,0,0,12,0
2020-04-12,Saint Vincent and the Grenadines,0,0,12,0
2020-04-13,Saint Vincent and the Grenadines,0,0,12,0
2020-04-14,Saint Vincent and the Grenadines,0,0,12,0
2020-04-15,Saint Vincent and the Grenadines,0,0,12,0
2020-04-16,Saint Vincent and the Grenadines,0,0,12,0
2020-04-17,Saint Vincent and the Grenadines,0,0,12,0
2020-04-18,Saint Vincent and the Grenadines,0,0,12,0
2020-04-19,Saint Vincent and the Grenadines,0,0,12,0
2020-04-20,Saint Vincent and the Grenadines,0,0,12,0
2020-04-21,Saint Vincent and the Grenadines,0,0,12,0
2020-04-22,Saint Vincent and the Grenadines,1,0,13,0
2020-04-23,Saint Vincent and the Grenadines,0,0,13,0
2020-04-24,Saint Vincent and the Grenadines,1,0,14,0
2020-04-25,Saint Vincent and the Grenadines,0,0,14,0
2020-04-26,Saint Vincent and the Grenadines,0,0,14,0
2020-04-27,Saint Vincent and the Grenadines,1,0,15,0
2020-04-28,Saint Vincent and the Grenadines,0,0,15,0
2020-04-29,Saint Vincent and the Grenadines,1,0,16,0
2020-04-30,Saint Vincent and the Grenadines,0,0,16,0
2020-05-01,Saint Vincent and the Grenadines,0,0,16,0
2020-05-02,Saint Vincent and the Grenadines,0,0,16,0
2020-05-03,Saint Vincent and the Grenadines,0,0,16,0
2020-05-04,Saint Vincent and the Grenadines,1,0,17,0
2020-05-05,Saint Vincent and the Grenadines,0,0,17,0
2020-05-06,Saint Vincent and the Grenadines,0,0,17,0
2020-05-07,Saint Vincent and the Grenadines,0,0,17,0
2020-05-08,Saint Vincent and the Grenadines,0,0,17,0
2020-05-09,Saint Vincent and the Grenadines,0,0,17,0
2020-05-10,Saint Vincent and the Grenadines,0,0,17,0
2020-05-11,Saint Vincent and the Grenadines,0,0,17,0
2020-05-12,Saint Vincent and the Grenadines,0,0,17,0
2020-05-13,Saint Vincent and the Grenadines,0,0,17,0
2020-05-14,Saint Vincent and the Grenadines,0,0,17,0
2020-05-15,Saint Vincent and the Grenadines,0,0,17,0
2020-05-16,Saint Vincent and the Grenadines,0,0,17,0
2020-05-17,Saint Vincent and the Grenadines,0,0,17,0
2020-05-18,Saint Vincent and the Grenadines,0,0,17,0
2020-05-19,Saint Vincent and the Grenadines,0,0,17,0
2020-05-20,Saint Vincent and the Grenadines,1,0,18,0
2020-05-21,Saint Vincent and the Grenadines,0,0,18,0
2020-05-22,Saint Vincent and the Grenadines,0,0,18,0
2020-05-23,Saint Vincent and the Grenadines,0,0,18,0
2020-05-24,Saint Vincent and the Grenadines,0,0,18,0
2020-05-25,Saint Vincent and the Grenadines,0,0,18,0
2020-05-26,Saint Vincent and the Grenadines,0,0,18,0
2020-05-27,Saint Vincent and the Grenadines,0,0,18,0
2020-05-28,Saint Vincent and the Grenadines,7,0,25,0
2020-05-29,Saint Vincent and the Grenadines,1,0,26,0
2020-05-30,Saint Vincent and the Grenadines,0,0,26,0
2020-05-31,Saint Vincent and the Grenadines,0,0,26,0
2020-06-01,Saint Vincent and the Grenadines,0,0,26,0
2020-06-02,Saint Vincent and the Grenadines,0,0,26,0
2020-06-03,Saint Vincent and the Grenadines,0,0,26,0
2020-06-04,Saint Vincent and the Grenadines,0,0,26,0
2020-06-05,Saint Vincent and the Grenadines,0,0,26,0
2020-06-06,Saint Vincent and the Grenadines,0,0,26,0
2020-06-07,Saint Vincent and the Grenadines,1,0,27,0
2020-06-08,Saint Vincent and the Grenadines,0,0,27,0
2020-06-09,Saint Vincent and the Grenadines,0,0,27,0
2020-06-10,Saint Vincent and the Grenadines,0,0,27,0
2020-06-11,Saint Vincent and the Grenadines,0,0,27,0
2020-06-12,Saint Vincent and the Grenadines,0,0,27,0
2020-06-13,Saint Vincent and the Grenadines,0,0,27,0
2020-06-14,Saint Vincent and the Grenadines,0,0,27,0
2020-06-15,Saint Vincent and the Grenadines,0,0,27,0
2020-06-16,Saint Vincent and the Grenadines,2,0,29,0
2020-06-17,Saint Vincent and the Grenadines,0,0,29,0
2020-06-18,Saint Vincent and the Grenadines,0,0,29,0
2020-06-19,Saint Vincent and the Grenadines,0,0,29,0
2020-06-20,Saint Vincent and the Grenadines,0,0,29,0
2020-06-21,Saint Vincent and the Grenadines,0,0,29,0
2020-06-22,Saint Vincent and the Grenadines,0,0,29,0
2020-06-23,Saint Vincent and the Grenadines,0,0,29,0
2020-06-24,Saint Vincent and the Grenadines,0,0,29,0
2020-06-25,Saint Vincent and the Grenadines,0,0,29,0
2020-06-26,Saint Vincent and the Grenadines,0,0,29,0
2020-06-27,Saint Vincent and the Grenadines,0,0,29,0
2020-06-28,Saint Vincent and the Grenadines,0,0,29,0
2020-06-29,Saint Vincent and the Grenadines,0,0,29,0
2020-06-30,Saint Vincent and the Grenadines,0,0,29,0
2020-07-01,Saint Vincent and the Grenadines,0,0,29,0
2020-07-02,Saint Vincent and the Grenadines,0,0,29,0
2020-07-03,Saint Vincent and the Grenadines,0,0,29,0
2020-07-04,Saint Vincent and the Grenadines,0,0,29,0
2020-07-05,Saint Vincent and the Grenadines,0,0,29,0
2020-07-06,Saint Vincent and the Grenadines,0,0,29,0
2020-07-07,Saint Vincent and the Grenadines,0,0,29,0
2020-07-08,Saint Vincent and the Grenadines,0,0,29,0
2020-07-09,Saint Vincent and the Grenadines,0,0,29,0
2020-07-10,Saint Vincent and the Grenadines,0,0,29,0
2020-07-11,Saint Vincent and the Grenadines,0,0,29,0
2020-07-12,Saint Vincent and the Grenadines,6,0,35,0
2020-07-13,Saint Vincent and the Grenadines,0,0,35,0
2020-07-14,Saint Vincent and the Grenadines,0,0,35,0
2020-07-15,Saint Vincent and the Grenadines,0,0,35,0
2020-07-16,Saint Vincent and the Grenadines,0,0,35,0
2020-07-17,Saint Vincent and the Grenadines,0,0,35,0
2020-07-18,Saint Vincent and the Grenadines,3,0,38,0
2020-07-19,Saint Vincent and the Grenadines,6,0,44,0
2020-07-20,Saint Vincent and the Grenadines,6,0,50,0
2020-07-21,Saint Vincent and the Grenadines,0,0,50,0
2020-07-22,Saint Vincent and the Grenadines,2,0,52,0
2020-07-23,Saint Vincent and the Grenadines,0,0,52,0
2020-07-24,Saint Vincent and the Grenadines,0,0,52,0
2020-07-25,Saint Vincent and the Grenadines,0,0,52,0
2020-07-26,Saint Vincent and the Grenadines,0,0,52,0
2020-07-27,Saint Vincent and the Grenadines,0,0,52,0
2020-07-28,Saint Vincent and the Grenadines,0,0,52,0
2020-07-29,Saint Vincent and the Grenadines,0,0,52,0
2020-07-30,Saint Vincent and the Grenadines,0,0,52,0
2020-07-31,Saint Vincent and the Grenadines,2,0,54,0
2020-08-01,Saint Vincent and the Grenadines,0,0,54,0
2020-08-02,Saint Vincent and the Grenadines,1,0,55,0
2020-08-03,Saint Vincent and the Grenadines,0,0,55,0
2020-08-04,Saint Vincent and the Grenadines,0,0,55,0
2020-08-05,Saint Vincent and the Grenadines,1,0,56,0
2020-08-06,Saint Vincent and the Grenadines,0,0,56,0
2020-08-07,Saint Vincent and the Grenadines,0,0,56,0
2020-08-08,Saint Vincent and the Grenadines,0,0,56,0
2020-08-09,Saint Vincent and the Grenadines,1,0,57,0
2020-08-10,Saint Vincent and the Grenadines,0,0,57,0
2020-08-11,Saint Vincent and the Grenadines,0,0,57,0
2020-08-12,Saint Vincent and the Grenadines,0,0,57,0
2020-08-13,Saint Vincent and the Grenadines,0,0,57,0
2020-08-14,Saint Vincent and the Grenadines,0,0,57,0
2020-08-15,Saint Vincent and the Grenadines,0,0,57,0
2020-08-16,Saint Vincent and the Grenadines,0,0,57,0
2020-08-17,Saint Vincent and the Grenadines,1,0,58,0
2020-08-18,Saint Vincent and the Grenadines,0,0,58,0
2020-08-19,Saint Vincent and the Grenadines,0,0,58,0
2020-08-20,Saint Vincent and the Grenadines,0,0,58,0
2020-08-21,Saint Vincent and the Grenadines,0,0,58,0
2020-08-22,Saint Vincent and the Grenadines,0,0,58,0
2020-08-23,Saint Vincent and the Grenadines,0,0,58,0
2020-08-24,Saint Vincent and the Grenadines,0,0,58,0
2020-08-25,Saint Vincent and the Grenadines,0,0,58,0
2020-08-26,Saint Vincent and the Grenadines,0,0,58,0
2020-08-27,Saint Vincent and the Grenadines,2,0,60,0
2020-08-28,Saint Vincent and the Grenadines,0,0,60,0
2020-08-29,Saint Vincent and the Grenadines,0,0,60,0
2020-08-30,Saint Vincent and the Grenadines,0,0,60,0
2020-08-31,Saint Vincent and the Grenadines,0,0,60,0
2020-09-01,Saint Vincent and the Grenadines,1,0,61,0
2020-09-02,Saint Vincent and the Grenadines,0,0,61,0
2020-09-03,Saint Vincent and the Grenadines,0,0,61,0
2020-09-04,Saint Vincent and the Grenadines,0,0,61,0
2020-09-05,Saint Vincent and the Grenadines,0,0,61,0
2020-09-06,Saint Vincent and the Grenadines,0,0,61,0
2020-09-07,Saint Vincent and the Grenadines,1,0,62,0
2020-09-08,Saint Vincent and the Grenadines,0,0,62,0
2020-09-09,Saint Vincent and the Grenadines,0,0,62,0
2020-09-10,Saint Vincent and the Grenadines,0,0,62,0
2020-09-11,Saint Vincent and the Grenadines,2,0,64,0
2020-09-12,Saint Vincent and the Grenadines,0,0,64,0
2020-09-13,Saint Vincent and the Grenadines,0,0,64,0
2020-09-14,Saint Vincent and the Grenadines,0,0,64,0
2020-09-15,Saint Vincent and the Grenadines,0,0,64,0
2020-09-16,Saint Vincent and the Grenadines,0,0,64,0
2020-09-17,Saint Vincent and the Grenadines,0,0,64,0
2020-09-18,Saint Vincent and the Grenadines,0,0,64,0
2020-09-19,Saint Vincent and the Grenadines,0,0,64,0
2020-09-20,Saint Vincent and the Grenadines,0,0,64,0
2020-09-21,Saint Vincent and the Grenadines,0,0,64,0
2020-09-22,Saint Vincent and the Grenadines,0,0,64,0
2020-09-23,Saint Vincent and the Grenadines,0,0,64,0
2020-09-24,Saint Vincent and the Grenadines,0,0,64,0
2020-09-25,Saint Vincent and the Grenadines,0,0,64,0
2020-09-26,Saint Vincent and the Grenadines,0,0,64,0
2020-09-27,Saint Vincent and the Grenadines,0,0,64,0
2020-09-28,Saint Vincent and the Grenadines,0,0,64,0
2020-09-29,Saint Vincent and the Grenadines,0,0,64,0
2020-09-30,Saint Vincent and the Grenadines,0,0,64,0
2020-10-01,Saint Vincent and the Grenadines,0,0,64,0
2020-10-02,Saint Vincent and the Grenadines,0,0,64,0
2020-10-03,Saint Vincent and the Grenadines,0,0,64,0
2020-10-04,Saint Vincent and the Grenadines,0,0,64,0
2020-10-05,Saint Vincent and the Grenadines,0,0,64,0
2020-10-06,Saint Vincent and the Grenadines,0,0,64,0
2020-10-07,Saint Vincent and the Grenadines,0,0,64,0
2020-10-08,Saint Vincent and the Grenadines,0,0,64,0
2020-10-09,Saint Vincent and the Grenadines,0,0,64,0
2020-10-10,Saint Vincent and the Grenadines,0,0,64,0
2020-10-11,Saint Vincent and the Grenadines,0,0,64,0
2020-10-12,Saint Vincent and the Grenadines,0,0,64,0
2020-10-13,Saint Vincent and the Grenadines,0,0,64,0
2020-10-14,Saint Vincent and the Grenadines,0,0,64,0
2020-10-15,Saint Vincent and the Grenadines,0,0,64,0
2020-10-16,Saint Vincent and the Grenadines,1,0,65,0
2020-10-17,Saint Vincent and the Grenadines,2,0,67,0
2020-10-18,Saint Vincent and the Grenadines,0,0,67,0
2020-10-19,Saint Vincent and the Grenadines,0,0,67,0
2020-10-20,Saint Vincent and the Grenadines,1,0,68,0
2020-10-21,Saint Vincent and the Grenadines,0,0,68,0
2020-10-22,Saint Vincent and the Grenadines,0,0,68,0
2020-10-23,Saint Vincent and the Grenadines,5,0,73,0
2020-10-24,Saint Vincent and the Grenadines,0,0,73,0
2020-10-25,Saint Vincent and the Grenadines,0,0,73,0
2020-10-26,Saint Vincent and the Grenadines,0,0,73,0
2020-10-27,Saint Vincent and the Grenadines,1,0,74,0
2020-10-28,Saint Vincent and the Grenadines,0,0,74,0
2020-10-29,Saint Vincent and the Grenadines,0,0,74,0
2020-10-30,Saint Vincent and the Grenadines,0,0,74,0
2020-10-31,Saint Vincent and the Grenadines,0,0,74,0
2020-11-01,Saint Vincent and the Grenadines,1,0,75,0
2020-11-02,Saint Vincent and the Grenadines,0,0,75,0
2020-11-03,Saint Vincent and the Grenadines,0,0,75,0
2020-11-04,Saint Vincent and the Grenadines,0,0,75,0
2020-11-05,Saint Vincent and the Grenadines,1,0,76,0
2020-11-06,Saint Vincent and the Grenadines,0,0,76,0
2020-11-07,Saint Vincent and the Grenadines,0,0,76,0
2020-11-08,Saint Vincent and the Grenadines,0,0,76,0
2020-11-09,Saint Vincent and the Grenadines,0,0,76,0
2020-11-10,Saint Vincent and the Grenadines,0,0,76,0
2020-11-11,Saint Vincent and the Grenadines,1,0,77,0
2020-11-12,Saint Vincent and the Grenadines,0,0,77,0
2020-11-13,Saint Vincent and the Grenadines,1,0,78,0
2020-11-14,Saint Vincent and the Grenadines,0,0,78,0
2020-11-15,Saint Vincent and the Grenadines,0,0,78,0
2020-11-16,Saint Vincent and the Grenadines,0,0,78,0
2020-11-17,Saint Vincent and the Grenadines,5,0,83,0
2020-11-18,Saint Vincent and the Grenadines,0,0,83,0
2020-11-19,Saint Vincent and the Grenadines,1,0,84,0
2020-11-20,Saint Vincent and the Grenadines,0,0,84,0
2020-11-21,Saint Vincent and the Grenadines,0,0,84,0
2020-11-22,Saint Vincent and the Grenadines,0,0,84,0
2020-11-23,Saint Vincent and the Grenadines,0,0,84,0
2020-11-24,Saint Vincent and the Grenadines,0,0,84,0
2020-11-25,Saint Vincent and the Grenadines,0,0,84,0
2020-11-26,Saint Vincent and the Grenadines,0,0,84,0
2020-11-27,Saint Vincent and the Grenadines,1,0,85,0
2020-11-28,Saint Vincent and the Grenadines,0,0,85,0
2020-11-29,Saint Vincent and the Grenadines,0,0,85,0
2020-11-30,Saint Vincent and the Grenadines,0,0,85,0
2020-12-01,Saint Vincent and the Grenadines,0,0,85,0
2020-12-02,Saint Vincent and the Grenadines,0,0,85,0
2020-12-03,Saint Vincent and the Grenadines,2,0,87,0
2020-12-04,Saint Vincent and the Grenadines,0,0,87,0
2020-12-05,Saint Vincent and the Grenadines,0,0,87,0
2020-12-06,Saint Vincent and the Grenadines,0,0,87,0
2020-12-07,Saint Vincent and the Grenadines,0,0,87,0
2020-12-08,Saint Vincent and the Grenadines,0,0,87,0
2020-12-09,Saint Vincent and the Grenadines,3,0,90,0
2020-12-10,Saint Vincent and the Grenadines,1,0,91,0
2020-12-11,Saint Vincent and the Grenadines,3,0,94,0
2020-12-12,Saint Vincent and the Grenadines,0,0,94,0
2020-12-13,Saint Vincent and the Grenadines,4,0,98,0
2020-12-14,Saint Vincent and the Grenadines,0,0,98,0
2020-12-15,Saint Vincent and the Grenadines,0,0,98,0
2020-12-16,Saint Vincent and the Grenadines,2,0,100,0
2020-12-17,Saint Vincent and the Grenadines,0,0,100,0
2020-12-18,Saint Vincent and the Grenadines,0,0,100,0
2020-12-19,Saint Vincent and the Grenadines,0,0,100,0
2020-12-20,Saint Vincent and the Grenadines,4,0,104,0
2020-12-21,Saint Vincent and the Grenadines,0,0,104,0
2020-12-22,Saint Vincent and the Grenadines,3,0,107,0
2020-12-23,Saint Vincent and the Grenadines,1,0,108,0
2020-12-24,Saint Vincent and the Grenadines,0,0,108,0
2020-12-25,Saint Vincent and the Grenadines,0,0,108,0
2020-12-26,Saint Vincent and the Grenadines,1,0,109,0
2020-12-27,Saint Vincent and the Grenadines,0,0,109,0
2020-12-28,Saint Vincent and the Grenadines,0,0,109,0
2020-12-29,Saint Vincent and the Grenadines,4,0,113,0
2020-12-30,Saint Vincent and the Grenadines,2,0,115,0
2020-12-31,Saint Vincent and the Grenadines,6,0,121,0
2021-01-01,Saint Vincent and the Grenadines,0,0,121,0
2021-01-02,Saint Vincent and the Grenadines,1,0,122,0
2021-01-03,Saint Vincent and the Grenadines,2,0,124,0
2021-01-04,Saint Vincent and the Grenadines,0,0,124,0
2021-01-05,Saint Vincent and the Grenadines,9,0,133,0
2021-01-06,Saint Vincent and the Grenadines,16,0,149,0
2021-01-07,Saint Vincent and the Grenadines,0,0,149,0
2021-01-08,Saint Vincent and the Grenadines,0,0,149,0
2021-01-09,Saint Vincent and the Grenadines,76,0,225,0
2021-01-10,Saint Vincent and the Grenadines,24,0,249,0
2021-01-11,Saint Vincent and the Grenadines,0,0,249,0
2021-01-12,Saint Vincent and the Grenadines,35,0,284,0
2021-01-13,Saint Vincent and the Grenadines,0,0,284,0
2021-01-14,Saint Vincent and the Grenadines,56,0,340,0
2021-01-15,Saint Vincent and the Grenadines,110,1,450,1
2021-01-16,Saint Vincent and the Grenadines,0,0,450,1
2021-01-17,Saint Vincent and the Grenadines,28,0,478,1
2021-01-18,Saint Vincent and the Grenadines,16,0,494,1
2021-01-19,Saint Vincent and the Grenadines,108,1,602,2
2021-01-20,Saint Vincent and the Grenadines,0,0,602,2
2021-01-21,Saint Vincent and the Grenadines,88,0,690,2
2021-01-22,Saint Vincent and the Grenadines,0,0,690,2
2021-01-23,Saint Vincent and the Grenadines,30,0,720,2
2021-01-24,Saint Vincent and the Grenadines,18,0,738,2
2021-01-25,Saint Vincent and the Grenadines,8,0,746,2
2021-01-26,Saint Vincent and the Grenadines,0,0,746,2
2021-01-27,Saint Vincent and the Grenadines,81,0,827,2
2021-01-28,Saint Vincent and the Grenadines,0,0,827,2
2021-01-29,Saint Vincent and the Grenadines,69,0,896,2
2021-01-30,Saint Vincent and the Grenadines,0,0,896,2
2021-01-31,Saint Vincent and the Grenadines,5,0,901,2
2021-02-01,Saint Vincent and the Grenadines,0,0,901,2
2021-02-02,Saint Vincent and the Grenadines,158,0,1059,2
2021-02-03,Saint Vincent and the Grenadines,0,0,1059,2
2021-02-04,Saint Vincent and the Grenadines,8,1,1067,3
2021-02-05,Saint Vincent and the Grenadines,103,0,1170,3
2021-02-06,Saint Vincent and the Grenadines,32,0,1202,3
2021-02-07,Saint Vincent and the Grenadines,67,1,1269,4
2021-02-08,Saint Vincent and the Grenadines,14,0,1283,4
2021-02-09,Saint Vincent and the Grenadines,0,0,1283,4
2021-02-10,Saint Vincent and the Grenadines,57,2,1340,6
2021-02-11,Saint Vincent and the Grenadines,30,0,1370,6
2021-02-12,Saint Vincent and the Grenadines,0,0,1370,6
2021-02-13,Saint Vincent and the Grenadines,48,0,1418,6
2021-02-14,Saint Vincent and the Grenadines,0,0,1418,6
2021-02-15,Saint Vincent and the Grenadines,35,0,1453,6
2021-02-16,Saint Vincent and the Grenadines,4,0,1457,6
2021-02-17,Saint Vincent and the Grenadines,5,0,1462,6
2021-02-18,Saint Vincent and the Grenadines,0,0,1462,6
2021-02-19,Saint Vincent and the Grenadines,32,0,1494,6
2021-02-20,Saint Vincent and the Grenadines,4,0,1498,6
2021-02-21,Saint Vincent and the Grenadines,5,0,1503,6
2021-02-22,Saint Vincent and the Grenadines,0,0,1503,6
2021-02-23,Saint Vincent and the Grenadines,8,0,1511,6
2021-02-24,Saint Vincent and the Grenadines,8,0,1519,6
2021-02-25,Saint Vincent and the Grenadines,0,0,1519,6
2021-02-26,Saint Vincent and the Grenadines,0,0,1519,6
2021-02-27,Saint Vincent and the Grenadines,37,2,1556,8
2021-02-28,Saint Vincent and the Grenadines,0,0,1556,8
2021-03-01,Saint Vincent and the Grenadines,72,0,1628,8
2021-03-02,Saint Vincent and the Grenadines,0,0,1628,8
2021-03-03,Saint Vincent and the Grenadines,17,0,1645,8
2021-03-04,Saint Vincent and the Grenadines,0,0,1645,8
2021-03-05,Saint Vincent and the Grenadines,0,0,1645,8
2021-03-06,Saint Vincent and the Grenadines,0,0,1645,8
2021-03-07,Saint Vincent and the Grenadines,18,0,1663,8
2021-03-08,Saint Vincent and the Grenadines,0,0,1663,8
2021-03-09,Saint Vincent and the Grenadines,0,0,1663,8
2021-03-10,Saint Vincent and the Grenadines,7,0,1670,8
2021-03-11,Saint Vincent and the Grenadines,4,0,1674,8
2021-03-12,Saint Vincent and the Grenadines,0,0,1674,8
2021-03-13,Saint Vincent and the Grenadines,6,0,1680,8
2021-03-14,Saint Vincent and the Grenadines,0,1,1680,9
2021-03-15,Saint Vincent and the Grenadines,0,0,1680,9
2021-03-16,Saint Vincent and the Grenadines,1,0,1681,9
2021-03-17,Saint Vincent and the Grenadines,0,0,1681,9
2021-03-18,Saint Vincent and the Grenadines,3,0,1684,9
2021-03-19,Saint Vincent and the Grenadines,8,0,1692,9
2021-03-20,Saint Vincent and the Grenadines,4,0,1696,9
2021-03-21,Saint Vincent and the Grenadines,0,0,1696,9
2021-03-22,Saint Vincent and the Grenadines,0,0,1696,9
2021-03-23,Saint Vincent and the Grenadines,0,0,1696,9
2021-03-24,Saint Vincent and the Grenadines,7,1,1703,10
2021-03-25,Saint Vincent and the Grenadines,12,0,1715,10
2021-03-26,Saint Vincent and the Grenadines,6,0,1721,10
2021-03-27,Saint Vincent and the Grenadines,2,0,1723,10
2021-03-28,Saint Vincent and the Grenadines,15,0,1738,10
2021-03-29,Saint Vincent and the Grenadines,1,0,1739,10
2021-03-30,Saint Vincent and the Grenadines,0,0,1739,10
2021-03-31,Saint Vincent and the Grenadines,9,0,1748,10
2021-04-01,Saint Vincent and the Grenadines,2,0,1750,10
2021-04-02,Saint Vincent and the Grenadines,4,0,1754,10
2021-04-03,Saint Vincent and the Grenadines,1,0,1755,10
2021-04-04,Saint Vincent and the Grenadines,3,0,1758,10
2021-04-05,Saint Vincent and the Grenadines,6,0,1764,10
2021-04-06,Saint Vincent and the Grenadines,1,0,1765,10
2021-04-07,Saint Vincent and the Grenadines,1,0,1766,10
2021-04-08,Saint Vincent and the Grenadines,8,0,1774,10
2020-11-18,Samoa,1,0,1,0
2020-11-19,Samoa,0,0,1,0
2020-11-20,Samoa,0,0,1,0
2020-11-21,Samoa,0,0,1,0
2020-11-22,Samoa,0,0,1,0
2020-11-23,Samoa,0,0,1,0
2020-11-24,Samoa,0,0,1,0
2020-11-25,Samoa,0,0,1,0
2020-11-26,Samoa,0,0,1,0
2020-11-27,Samoa,1,0,2,0
2020-11-28,Samoa,0,0,2,0
2020-11-29,Samoa,0,0,2,0
2020-11-30,Samoa,0,0,2,0
2020-12-01,Samoa,0,0,2,0
2020-12-02,Samoa,0,0,2,0
2020-12-03,Samoa,0,0,2,0
2020-12-04,Samoa,0,0,2,0
2020-12-05,Samoa,0,0,2,0
2020-12-06,Samoa,0,0,2,0
2020-12-07,Samoa,0,0,2,0
2020-12-08,Samoa,0,0,2,0
2020-12-09,Samoa,0,0,2,0
2020-12-10,Samoa,0,0,2,0
2020-12-11,Samoa,0,0,2,0
2020-12-12,Samoa,0,0,2,0
2020-12-13,Samoa,0,0,2,0
2020-12-14,Samoa,0,0,2,0
2020-12-15,Samoa,0,0,2,0
2020-12-16,Samoa,0,0,2,0
2020-12-17,Samoa,0,0,2,0
2020-12-18,Samoa,0,0,2,0
2020-12-19,Samoa,0,0,2,0
2020-12-20,Samoa,0,0,2,0
2020-12-21,Samoa,0,0,2,0
2020-12-22,Samoa,0,0,2,0
2020-12-23,Samoa,0,0,2,0
2020-12-24,Samoa,0,0,2,0
2020-12-25,Samoa,0,0,2,0
2020-12-26,Samoa,0,0,2,0
2020-12-27,Samoa,0,0,2,0
2020-12-28,Samoa,0,0,2,0
2020-12-29,Samoa,0,0,2,0
2020-12-30,Samoa,0,0,2,0
2020-12-31,Samoa,0,0,2,0
2021-01-01,Samoa,0,0,2,0
2021-01-02,Samoa,0,0,2,0
2021-01-03,Samoa,0,0,2,0
2021-01-04,Samoa,0,0,2,0
2021-01-05,Samoa,0,0,2,0
2021-01-06,Samoa,0,0,2,0
2021-01-07,Samoa,0,0,2,0
2021-01-08,Samoa,0,0,2,0
2021-01-09,Samoa,0,0,2,0
2021-01-10,Samoa,0,0,2,0
2021-01-11,Samoa,0,0,2,0
2021-01-12,Samoa,0,0,2,0
2021-01-13,Samoa,0,0,2,0
2021-01-14,Samoa,0,0,2,0
2021-01-15,Samoa,0,0,2,0
2021-01-16,Samoa,0,0,2,0
2021-01-17,Samoa,0,0,2,0
2021-01-18,Samoa,0,0,2,0
2021-01-19,Samoa,0,0,2,0
2021-01-20,Samoa,0,0,2,0
2021-01-21,Samoa,0,0,2,0
2021-01-22,Samoa,0,0,2,0
2021-01-23,Samoa,0,0,2,0
2021-01-24,Samoa,0,0,2,0
2021-01-25,Samoa,0,0,2,0
2021-01-26,Samoa,0,0,2,0
2021-01-27,Samoa,0,0,2,0
2021-01-28,Samoa,0,0,2,0
2021-01-29,Samoa,0,0,2,0
2021-01-30,Samoa,0,0,2,0
2021-01-31,Samoa,0,0,2,0
2021-02-01,Samoa,0,0,2,0
2021-02-02,Samoa,0,0,2,0
2021-02-03,Samoa,0,0,2,0
2021-02-04,Samoa,0,0,2,0
2021-02-05,Samoa,0,0,2,0
2021-02-06,Samoa,0,0,2,0
2021-02-07,Samoa,0,0,2,0
2021-02-08,Samoa,0,0,2,0
2021-02-09,Samoa,0,0,2,0
2021-02-10,Samoa,0,0,2,0
2021-02-11,Samoa,0,0,2,0
2021-02-12,Samoa,0,0,2,0
2021-02-13,Samoa,0,0,2,0
2021-02-14,Samoa,0,0,2,0
2021-02-15,Samoa,1,0,3,0
2021-02-16,Samoa,0,0,3,0
2021-02-17,Samoa,0,0,3,0
2021-02-18,Samoa,0,0,3,0
2021-02-19,Samoa,0,0,3,0
2021-02-20,Samoa,0,0,3,0
2021-02-21,Samoa,0,0,3,0
2021-02-22,Samoa,0,0,3,0
2021-02-23,Samoa,0,0,3,0
2021-02-24,Samoa,0,0,3,0
2021-02-25,Samoa,0,0,3,0
2021-02-26,Samoa,0,0,3,0
2021-02-27,Samoa,0,0,3,0
2021-02-28,Samoa,0,0,3,0
2021-03-01,Samoa,0,0,3,0
2021-03-02,Samoa,0,0,3,0
2021-03-03,Samoa,0,0,3,0
2021-03-04,Samoa,0,0,3,0
2021-03-05,Samoa,0,0,3,0
2021-03-06,Samoa,0,0,3,0
2021-03-07,Samoa,0,0,3,0
2021-03-08,Samoa,0,0,3,0
2021-03-09,Samoa,0,0,3,0
2021-03-10,Samoa,0,0,3,0
2021-03-11,Samoa,0,0,3,0
2021-03-12,Samoa,0,0,3,0
2021-03-13,Samoa,0,0,3,0
2021-03-14,Samoa,0,0,3,0
2021-03-15,Samoa,0,0,3,0
2021-03-16,Samoa,0,0,3,0
2021-03-17,Samoa,0,0,3,0
2021-03-18,Samoa,0,0,3,0
2021-03-19,Samoa,0,0,3,0
2021-03-20,Samoa,0,0,3,0
2021-03-21,Samoa,0,0,3,0
2021-03-22,Samoa,0,0,3,0
2021-03-23,Samoa,0,0,3,0
2021-03-24,Samoa,0,0,3,0
2021-03-25,Samoa,0,0,3,0
2021-03-26,Samoa,0,0,3,0
2021-03-27,Samoa,0,0,3,0
2021-03-28,Samoa,0,0,3,0
2021-03-29,Samoa,0,0,3,0
2021-03-30,Samoa,0,0,3,0
2021-03-31,Samoa,0,0,3,0
2021-04-01,Samoa,0,0,3,0
2021-04-02,Samoa,0,0,3,0
2021-04-03,Samoa,0,0,3,0
2021-04-04,Samoa,0,0,3,0
2021-04-05,Samoa,0,0,3,0
2021-04-06,Samoa,0,0,3,0
2021-04-07,Samoa,0,0,3,0
2021-04-08,Samoa,0,0,3,0
2020-02-27,San Marino,1,0,1,0
2020-02-28,San Marino,0,0,1,0
2020-02-29,San Marino,0,0,1,0
2020-03-01,San Marino,0,0,1,0
2020-03-02,San Marino,7,0,8,0
2020-03-03,San Marino,2,1,10,1
2020-03-04,San Marino,6,0,16,1
2020-03-05,San Marino,5,0,21,1
2020-03-06,San Marino,0,0,21,1
2020-03-07,San Marino,2,0,23,1
2020-03-08,San Marino,13,0,36,1
2020-03-09,San Marino,0,0,36,1
2020-03-10,San Marino,15,1,51,2
2020-03-11,San Marino,11,0,62,2
2020-03-12,San Marino,7,1,69,3
2020-03-13,San Marino,11,2,80,5
2020-03-14,San Marino,0,0,80,5
2020-03-15,San Marino,21,0,101,5
2020-03-16,San Marino,8,2,109,7
2020-03-17,San Marino,0,0,109,7
2020-03-18,San Marino,10,4,119,11
2020-03-19,San Marino,0,0,119,11
2020-03-20,San Marino,25,3,144,14
2020-03-21,San Marino,0,6,144,20
2020-03-22,San Marino,31,0,175,20
2020-03-23,San Marino,12,0,187,20
2020-03-24,San Marino,0,1,187,21
2020-03-25,San Marino,21,0,208,21
2020-03-26,San Marino,0,0,208,21
2020-03-27,San Marino,15,0,223,21
2020-03-28,San Marino,1,1,224,22
2020-03-29,San Marino,0,0,224,22
2020-03-30,San Marino,6,3,230,25
2020-03-31,San Marino,6,1,236,26
2020-04-01,San Marino,0,0,236,26
2020-04-02,San Marino,9,4,245,30
2020-04-03,San Marino,0,0,245,30
2020-04-04,San Marino,14,2,259,32
2020-04-05,San Marino,7,0,266,32
2020-04-06,San Marino,0,0,266,32
2020-04-07,San Marino,13,2,279,34
2020-04-08,San Marino,0,0,279,34
2020-04-09,San Marino,54,0,333,34
2020-04-10,San Marino,11,0,344,34
2020-04-11,San Marino,12,1,356,35
2020-04-12,San Marino,0,0,356,35
2020-04-13,San Marino,0,0,356,35
2020-04-14,San Marino,15,1,371,36
2020-04-15,San Marino,1,0,372,36
2020-04-16,San Marino,54,2,426,38
2020-04-17,San Marino,9,1,435,39
2020-04-18,San Marino,20,0,455,39
2020-04-19,San Marino,6,0,461,39
2020-04-20,San Marino,1,0,462,39
2020-04-21,San Marino,14,1,476,40
2020-04-22,San Marino,12,0,488,40
2020-04-23,San Marino,13,0,501,40
2020-04-24,San Marino,12,0,513,40
2020-04-25,San Marino,0,0,513,40
2020-04-26,San Marino,25,1,538,41
2020-04-27,San Marino,0,0,538,41
2020-04-28,San Marino,15,0,553,41
2020-04-29,San Marino,10,0,563,41
2020-04-30,San Marino,6,0,569,41
2020-05-01,San Marino,11,0,580,41
2020-05-02,San Marino,0,0,580,41
2020-05-03,San Marino,2,0,582,41
2020-05-04,San Marino,0,0,582,41
2020-05-05,San Marino,7,0,589,41
2020-05-06,San Marino,19,0,608,41
2020-05-07,San Marino,14,0,622,41
2020-05-08,San Marino,1,0,623,41
2020-05-09,San Marino,14,0,637,41
2020-05-10,San Marino,-9,0,628,41
2020-05-11,San Marino,0,0,628,41
2020-05-12,San Marino,10,0,638,41
2020-05-13,San Marino,5,0,643,41
2020-05-14,San Marino,5,0,648,41
2020-05-15,San Marino,4,0,652,41
2020-05-16,San Marino,1,0,653,41
2020-05-17,San Marino,1,0,654,41
2020-05-18,San Marino,0,0,654,41
2020-05-19,San Marino,1,0,655,41
2020-05-20,San Marino,1,0,656,41
2020-05-21,San Marino,2,0,658,41
2020-05-22,San Marino,3,0,661,41
2020-05-23,San Marino,4,1,665,42
2020-05-24,San Marino,0,0,665,42
2020-05-25,San Marino,1,0,666,42
2020-05-26,San Marino,0,0,666,42
2020-05-27,San Marino,1,0,667,42
2020-05-28,San Marino,3,0,670,42
2020-05-29,San Marino,1,0,671,42
2020-05-30,San Marino,0,0,671,42
2020-05-31,San Marino,0,0,671,42
2020-06-01,San Marino,0,0,671,42
2020-06-02,San Marino,1,0,672,42
2020-06-03,San Marino,2,0,674,42
2020-06-04,San Marino,4,0,678,42
2020-06-05,San Marino,2,0,680,42
2020-06-06,San Marino,0,0,680,42
2020-06-07,San Marino,0,0,680,42
2020-06-08,San Marino,7,0,687,42
2020-06-09,San Marino,1,0,688,42
2020-06-10,San Marino,3,0,691,42
2020-06-11,San Marino,0,0,691,42
2020-06-12,San Marino,3,0,694,42
2020-06-13,San Marino,0,0,694,42
2020-06-14,San Marino,0,0,694,42
2020-06-15,San Marino,0,0,694,42
2020-06-16,San Marino,0,0,694,42
2020-06-17,San Marino,2,0,696,42
2020-06-18,San Marino,0,0,696,42
2020-06-19,San Marino,0,0,696,42
2020-06-20,San Marino,0,0,696,42
2020-06-21,San Marino,0,0,696,42
2020-06-22,San Marino,1,0,697,42
2020-06-23,San Marino,1,0,698,42
2020-06-24,San Marino,0,0,698,42
2020-06-25,San Marino,0,0,698,42
2020-06-26,San Marino,0,0,698,42
2020-06-27,San Marino,0,0,698,42
2020-06-28,San Marino,0,0,698,42
2020-06-29,San Marino,0,0,698,42
2020-06-30,San Marino,0,0,698,42
2020-07-01,San Marino,0,0,698,42
2020-07-02,San Marino,0,0,698,42
2020-07-03,San Marino,0,0,698,42
2020-07-04,San Marino,0,0,698,42
2020-07-05,San Marino,0,0,698,42
2020-07-06,San Marino,0,0,698,42
2020-07-07,San Marino,0,0,698,42
2020-07-08,San Marino,0,0,698,42
2020-07-09,San Marino,1,0,699,42
2020-07-10,San Marino,0,0,699,42
2020-07-11,San Marino,0,0,699,42
2020-07-12,San Marino,0,0,699,42
2020-07-13,San Marino,0,0,699,42
2020-07-14,San Marino,0,0,699,42
2020-07-15,San Marino,0,0,699,42
2020-07-16,San Marino,0,0,699,42
2020-07-17,San Marino,0,0,699,42
2020-07-18,San Marino,0,0,699,42
2020-07-19,San Marino,0,0,699,42
2020-07-20,San Marino,0,0,699,42
2020-07-21,San Marino,0,0,699,42
2020-07-22,San Marino,0,0,699,42
2020-07-23,San Marino,0,0,699,42
2020-07-24,San Marino,0,0,699,42
2020-07-25,San Marino,0,0,699,42
2020-07-26,San Marino,0,0,699,42
2020-07-27,San Marino,0,0,699,42
2020-07-28,San Marino,0,0,699,42
2020-07-29,San Marino,0,0,699,42
2020-07-30,San Marino,0,0,699,42
2020-07-31,San Marino,0,0,699,42
2020-08-01,San Marino,0,0,699,42
2020-08-02,San Marino,0,0,699,42
2020-08-03,San Marino,0,0,699,42
2020-08-04,San Marino,0,0,699,42
2020-08-05,San Marino,0,0,699,42
2020-08-06,San Marino,0,0,699,42
2020-08-07,San Marino,0,0,699,42
2020-08-08,San Marino,0,0,699,42
2020-08-09,San Marino,0,0,699,42
2020-08-10,San Marino,0,0,699,42
2020-08-11,San Marino,0,0,699,42
2020-08-12,San Marino,0,0,699,42
2020-08-13,San Marino,0,0,699,42
2020-08-14,San Marino,0,0,699,42
2020-08-15,San Marino,0,0,699,42
2020-08-16,San Marino,0,0,699,42
2020-08-17,San Marino,0,0,699,42
2020-08-18,San Marino,3,0,702,42
2020-08-19,San Marino,2,0,704,42
2020-08-20,San Marino,0,0,704,42
2020-08-21,San Marino,0,0,704,42
2020-08-22,San Marino,0,0,704,42
2020-08-23,San Marino,0,0,704,42
2020-08-24,San Marino,0,0,704,42
2020-08-25,San Marino,6,0,710,42
2020-08-26,San Marino,0,0,710,42
2020-08-27,San Marino,0,0,710,42
2020-08-28,San Marino,0,0,710,42
2020-08-29,San Marino,0,0,710,42
2020-08-30,San Marino,0,0,710,42
2020-08-31,San Marino,5,0,715,42
2020-09-01,San Marino,0,0,715,42
2020-09-02,San Marino,20,0,735,42
2020-09-03,San Marino,0,0,735,42
2020-09-04,San Marino,0,0,735,42
2020-09-05,San Marino,-19,0,716,42
2020-09-06,San Marino,0,0,716,42
2020-09-07,San Marino,0,0,716,42
2020-09-08,San Marino,0,0,716,42
2020-09-09,San Marino,6,0,722,42
2020-09-10,San Marino,0,0,722,42
2020-09-11,San Marino,0,0,722,42
2020-09-12,San Marino,0,0,722,42
2020-09-13,San Marino,0,0,722,42
2020-09-14,San Marino,0,0,722,42
2020-09-15,San Marino,1,0,723,42
2020-09-16,San Marino,0,0,723,42
2020-09-17,San Marino,0,0,723,42
2020-09-18,San Marino,0,0,723,42
2020-09-19,San Marino,0,0,723,42
2020-09-20,San Marino,0,0,723,42
2020-09-21,San Marino,0,0,723,42
2020-09-22,San Marino,0,0,723,42
2020-09-23,San Marino,0,0,723,42
2020-09-24,San Marino,4,0,727,42
2020-09-25,San Marino,0,0,727,42
2020-09-26,San Marino,0,0,727,42
2020-09-27,San Marino,0,0,727,42
2020-09-28,San Marino,0,0,727,42
2020-09-29,San Marino,0,0,727,42
2020-09-30,San Marino,5,0,732,42
2020-10-01,San Marino,0,0,732,42
2020-10-02,San Marino,0,0,732,42
2020-10-03,San Marino,0,0,732,42
2020-10-04,San Marino,0,0,732,42
2020-10-05,San Marino,0,0,732,42
2020-10-06,San Marino,0,0,732,42
2020-10-07,San Marino,0,0,732,42
2020-10-08,San Marino,9,0,741,42
2020-10-09,San Marino,0,0,741,42
2020-10-10,San Marino,0,0,741,42
2020-10-11,San Marino,0,0,741,42
2020-10-12,San Marino,0,0,741,42
2020-10-13,San Marino,0,0,741,42
2020-10-14,San Marino,0,0,741,42
2020-10-15,San Marino,18,0,759,42
2020-10-16,San Marino,0,0,759,42
2020-10-17,San Marino,0,0,759,42
2020-10-18,San Marino,0,0,759,42
2020-10-19,San Marino,7,0,766,42
2020-10-20,San Marino,0,0,766,42
2020-10-21,San Marino,8,0,774,42
2020-10-22,San Marino,28,0,802,42
2020-10-23,San Marino,17,0,819,42
2020-10-24,San Marino,0,0,819,42
2020-10-25,San Marino,0,0,819,42
2020-10-26,San Marino,33,0,852,42
2020-10-27,San Marino,0,0,852,42
2020-10-28,San Marino,0,0,852,42
2020-10-29,San Marino,76,0,928,42
2020-10-30,San Marino,0,0,928,42
2020-10-31,San Marino,0,0,928,42
2020-11-01,San Marino,0,0,928,42
2020-11-02,San Marino,0,0,928,42
2020-11-03,San Marino,66,0,994,42
2020-11-04,San Marino,0,0,994,42
2020-11-05,San Marino,49,0,1043,42
2020-11-06,San Marino,0,0,1043,42
2020-11-07,San Marino,0,0,1043,42
2020-11-08,San Marino,0,0,1043,42
2020-11-09,San Marino,71,0,1114,42
2020-11-10,San Marino,0,0,1114,42
2020-11-11,San Marino,76,0,1190,42
2020-11-12,San Marino,0,0,1190,42
2020-11-13,San Marino,63,0,1253,42
2020-11-14,San Marino,0,0,1253,42
2020-11-15,San Marino,0,0,1253,42
2020-11-16,San Marino,37,0,1290,42
2020-11-17,San Marino,0,0,1290,42
2020-11-18,San Marino,68,1,1358,43
2020-11-19,San Marino,0,0,1358,43
2020-11-20,San Marino,37,0,1395,43
2020-11-21,San Marino,0,0,1395,43
2020-11-22,San Marino,0,0,1395,43
2020-11-23,San Marino,33,1,1428,44
2020-11-24,San Marino,0,0,1428,44
2020-11-25,San Marino,64,0,1492,44
2020-11-26,San Marino,22,0,1514,44
2020-11-27,San Marino,40,0,1554,44
2020-11-28,San Marino,32,1,1586,45
2020-11-29,San Marino,0,0,1586,45
2020-11-30,San Marino,26,1,1612,46
2020-12-01,San Marino,38,0,1650,46
2020-12-02,San Marino,37,0,1687,46
2020-12-03,San Marino,27,0,1714,46
2020-12-04,San Marino,42,1,1756,47
2020-12-05,San Marino,33,1,1789,48
2020-12-06,San Marino,0,0,1789,48
2020-12-07,San Marino,11,0,1800,48
2020-12-08,San Marino,0,0,1800,48
2020-12-09,San Marino,34,1,1834,49
2020-12-10,San Marino,34,0,1868,49
2020-12-11,San Marino,40,1,1908,50
2020-12-12,San Marino,24,1,1932,51
2020-12-13,San Marino,0,0,1932,51
2020-12-14,San Marino,2,0,1934,51
2020-12-15,San Marino,48,1,1982,52
2020-12-16,San Marino,43,2,2025,54
2020-12-17,San Marino,24,0,2049,54
2020-12-18,San Marino,23,1,2072,55
2020-12-19,San Marino,35,0,2107,55
2020-12-20,San Marino,0,0,2107,55
2020-12-21,San Marino,28,0,2135,55
2020-12-22,San Marino,41,1,2176,56
2020-12-23,San Marino,29,0,2205,56
2020-12-24,San Marino,26,0,2231,56
2020-12-25,San Marino,0,0,2231,56
2020-12-26,San Marino,0,0,2231,56
2020-12-27,San Marino,0,0,2231,56
2020-12-28,San Marino,44,1,2275,57
2020-12-29,San Marino,58,2,2333,59
2020-12-30,San Marino,51,0,2384,59
2020-12-31,San Marino,44,0,2428,59
2021-01-01,San Marino,0,0,2428,59
2021-01-02,San Marino,0,0,2428,59
2021-01-03,San Marino,0,0,2428,59
2021-01-04,San Marino,65,3,2493,62
2021-01-05,San Marino,56,0,2549,62
2021-01-06,San Marino,0,0,2549,62
2021-01-07,San Marino,34,2,2583,64
2021-01-08,San Marino,45,0,2628,64
2021-01-09,San Marino,0,0,2628,64
2021-01-10,San Marino,0,0,2628,64
2021-01-11,San Marino,39,0,2667,64
2021-01-12,San Marino,39,1,2706,65
2021-01-13,San Marino,17,0,2723,65
2021-01-14,San Marino,14,0,2737,65
2021-01-15,San Marino,30,0,2767,65
2021-01-16,San Marino,11,0,2778,65
2021-01-17,San Marino,0,0,2778,65
2021-01-18,San Marino,9,0,2787,65
2021-01-19,San Marino,16,0,2803,65
2021-01-20,San Marino,12,0,2815,65
2021-01-21,San Marino,18,0,2833,65
2021-01-22,San Marino,28,0,2861,65
2021-01-23,San Marino,13,0,2874,65
2021-01-24,San Marino,0,0,2874,65
2021-01-25,San Marino,15,0,2889,65
2021-01-26,San Marino,26,0,2915,65
2021-01-27,San Marino,26,0,2941,65
2021-01-28,San Marino,28,0,2969,65
2021-01-29,San Marino,27,0,2996,65
2021-01-30,San Marino,0,0,2996,65
2021-01-31,San Marino,29,2,3025,67
2021-02-01,San Marino,0,0,3025,67
2021-02-02,San Marino,41,0,3066,67
2021-02-03,San Marino,28,1,3094,68
2021-02-04,San Marino,17,0,3111,68
2021-02-05,San Marino,0,0,3111,68
2021-02-06,San Marino,16,1,3127,69
2021-02-07,San Marino,0,0,3127,69
2021-02-08,San Marino,10,0,3137,69
2021-02-09,San Marino,50,2,3187,71
2021-02-10,San Marino,26,0,3213,71
2021-02-11,San Marino,34,1,3247,72
2021-02-12,San Marino,31,0,3278,72
2021-02-13,San Marino,0,0,3278,72
2021-02-14,San Marino,0,0,3278,72
2021-02-15,San Marino,39,0,3317,72
2021-02-16,San Marino,35,0,3352,72
2021-02-17,San Marino,42,0,3394,72
2021-02-18,San Marino,26,0,3420,72
2021-02-19,San Marino,20,0,3440,72
2021-02-20,San Marino,32,0,3472,72
2021-02-21,San Marino,0,0,3472,72
2021-02-22,San Marino,22,0,3494,72
2021-02-23,San Marino,44,1,3538,73
2021-02-24,San Marino,47,0,3585,73
2021-02-25,San Marino,36,0,3621,73
2021-02-26,San Marino,50,0,3671,73
2021-02-27,San Marino,45,1,3716,74
2021-02-28,San Marino,0,0,3716,74
2021-03-01,San Marino,30,0,3746,74
2021-03-02,San Marino,45,0,3791,74
2021-03-03,San Marino,38,1,3829,75
2021-03-04,San Marino,38,0,3867,75
2021-03-05,San Marino,29,1,3896,76
2021-03-06,San Marino,26,0,3922,76
2021-03-07,San Marino,0,0,3922,76
2021-03-08,San Marino,13,0,3935,76
2021-03-09,San Marino,49,1,3984,77
2021-03-10,San Marino,46,0,4030,77
2021-03-11,San Marino,32,0,4062,77
2021-03-12,San Marino,34,0,4096,77
2021-03-13,San Marino,30,0,4126,77
2021-03-14,San Marino,0,0,4126,77
2021-03-15,San Marino,25,0,4151,77
2021-03-16,San Marino,53,0,4204,77
2021-03-17,San Marino,45,0,4249,77
2021-03-18,San Marino,43,1,4292,78
2021-03-19,San Marino,36,1,4328,79
2021-03-20,San Marino,28,0,4356,79
2021-03-21,San Marino,0,0,4356,79
2021-03-22,San Marino,32,0,4388,79
2021-03-23,San Marino,44,1,4432,80
2021-03-24,San Marino,52,2,4484,82
2021-03-25,San Marino,0,0,4484,82
2021-03-26,San Marino,63,2,4547,84
2021-03-27,San Marino,56,0,4603,84
2021-03-28,San Marino,0,0,4603,84
2021-03-29,San Marino,28,0,4631,84
2021-03-30,San Marino,47,0,4678,84
2021-03-31,San Marino,52,0,4730,84
2021-04-01,San Marino,0,0,4730,84
2021-04-02,San Marino,45,0,4775,84
2021-04-03,San Marino,0,0,4775,84
2021-04-04,San Marino,0,0,4775,84
2021-04-05,San Marino,0,0,4775,84
2021-04-06,San Marino,89,1,4864,85
2021-04-07,San Marino,40,0,4904,85
2021-04-08,San Marino,28,0,4932,85
2020-04-06,Sao Tome and Principe,4,0,4,0
2020-04-07,Sao Tome and Principe,0,0,4,0
2020-04-08,Sao Tome and Principe,0,0,4,0
2020-04-09,Sao Tome and Principe,0,0,4,0
2020-04-10,Sao Tome and Principe,0,0,4,0
2020-04-11,Sao Tome and Principe,0,0,4,0
2020-04-12,Sao Tome and Principe,0,0,4,0
2020-04-13,Sao Tome and Principe,0,0,4,0
2020-04-14,Sao Tome and Principe,0,0,4,0
2020-04-15,Sao Tome and Principe,0,0,4,0
2020-04-16,Sao Tome and Principe,0,0,4,0
2020-04-17,Sao Tome and Principe,0,0,4,0
2020-04-18,Sao Tome and Principe,0,0,4,0
2020-04-19,Sao Tome and Principe,0,0,4,0
2020-04-20,Sao Tome and Principe,0,0,4,0
2020-04-21,Sao Tome and Principe,0,0,4,0
2020-04-22,Sao Tome and Principe,0,0,4,0
2020-04-23,Sao Tome and Principe,0,0,4,0
2020-04-24,Sao Tome and Principe,0,0,4,0
2020-04-25,Sao Tome and Principe,0,0,4,0
2020-04-26,Sao Tome and Principe,0,0,4,0
2020-04-27,Sao Tome and Principe,0,0,4,0
2020-04-28,Sao Tome and Principe,4,0,8,0
2020-04-29,Sao Tome and Principe,0,0,8,0
2020-04-30,Sao Tome and Principe,6,0,14,0
2020-05-01,Sao Tome and Principe,2,1,16,1
2020-05-02,Sao Tome and Principe,0,0,16,1
2020-05-03,Sao Tome and Principe,0,0,16,1
2020-05-04,Sao Tome and Principe,7,2,23,3
2020-05-05,Sao Tome and Principe,151,0,174,3
2020-05-06,Sao Tome and Principe,0,0,174,3
2020-05-07,Sao Tome and Principe,13,1,187,4
2020-05-08,Sao Tome and Principe,21,1,208,5
2020-05-09,Sao Tome and Principe,0,0,208,5
2020-05-10,Sao Tome and Principe,0,0,208,5
2020-05-11,Sao Tome and Principe,0,0,208,5
2020-05-12,Sao Tome and Principe,0,0,208,5
2020-05-13,Sao Tome and Principe,12,1,220,6
2020-05-14,Sao Tome and Principe,15,1,235,7
2020-05-15,Sao Tome and Principe,0,0,235,7
2020-05-16,Sao Tome and Principe,0,0,235,7
2020-05-17,Sao Tome and Principe,0,0,235,7
2020-05-18,Sao Tome and Principe,11,0,246,7
2020-05-19,Sao Tome and Principe,5,1,251,8
2020-05-20,Sao Tome and Principe,0,0,251,8
2020-05-21,Sao Tome and Principe,0,0,251,8
2020-05-22,Sao Tome and Principe,0,0,251,8
2020-05-23,Sao Tome and Principe,0,0,251,8
2020-05-24,Sao Tome and Principe,0,0,251,8
2020-05-25,Sao Tome and Principe,48,3,299,11
2020-05-26,Sao Tome and Principe,142,1,441,12
2020-05-27,Sao Tome and Principe,2,0,443,12
2020-05-28,Sao Tome and Principe,15,0,458,12
2020-05-29,Sao Tome and Principe,5,0,463,12
2020-05-30,Sao Tome and Principe,16,0,479,12
2020-05-31,Sao Tome and Principe,4,0,483,12
2020-06-01,Sao Tome and Principe,1,0,484,12
2020-06-02,Sao Tome and Principe,0,0,484,12
2020-06-03,Sao Tome and Principe,0,0,484,12
2020-06-04,Sao Tome and Principe,1,0,485,12
2020-06-05,Sao Tome and Principe,14,0,499,12
2020-06-06,Sao Tome and Principe,0,0,499,12
2020-06-07,Sao Tome and Principe,14,0,513,12
2020-06-08,Sao Tome and Principe,0,0,513,12
2020-06-09,Sao Tome and Principe,1,0,514,12
2020-06-10,Sao Tome and Principe,97,0,611,12
2020-06-11,Sao Tome and Principe,21,0,632,12
2020-06-12,Sao Tome and Principe,7,0,639,12
2020-06-13,Sao Tome and Principe,20,0,659,12
2020-06-14,Sao Tome and Principe,2,0,661,12
2020-06-15,Sao Tome and Principe,1,0,662,12
2020-06-16,Sao Tome and Principe,9,0,671,12
2020-06-17,Sao Tome and Principe,12,0,683,12
2020-06-18,Sao Tome and Principe,5,0,688,12
2020-06-19,Sao Tome and Principe,5,0,693,12
2020-06-20,Sao Tome and Principe,5,0,698,12
2020-06-21,Sao Tome and Principe,0,0,698,12
2020-06-22,Sao Tome and Principe,4,0,702,12
2020-06-23,Sao Tome and Principe,5,0,707,12
2020-06-24,Sao Tome and Principe,3,1,710,13
2020-06-25,Sao Tome and Principe,1,0,711,13
2020-06-26,Sao Tome and Principe,1,0,712,13
2020-06-27,Sao Tome and Principe,1,0,713,13
2020-06-28,Sao Tome and Principe,0,0,713,13
2020-06-29,Sao Tome and Principe,0,0,713,13
2020-06-30,Sao Tome and Principe,1,0,714,13
2020-07-01,Sao Tome and Principe,1,0,715,13
2020-07-02,Sao Tome and Principe,2,0,717,13
2020-07-03,Sao Tome and Principe,2,0,719,13
2020-07-04,Sao Tome and Principe,0,0,719,13
2020-07-05,Sao Tome and Principe,1,0,720,13
2020-07-06,Sao Tome and Principe,1,0,721,13
2020-07-07,Sao Tome and Principe,3,0,724,13
2020-07-08,Sao Tome and Principe,0,0,724,13
2020-07-09,Sao Tome and Principe,2,1,726,14
2020-07-10,Sao Tome and Principe,1,0,727,14
2020-07-11,Sao Tome and Principe,0,0,727,14
2020-07-12,Sao Tome and Principe,2,0,729,14
2020-07-13,Sao Tome and Principe,3,0,732,14
2020-07-14,Sao Tome and Principe,0,0,732,14
2020-07-15,Sao Tome and Principe,5,0,737,14
2020-07-16,Sao Tome and Principe,3,0,740,14
2020-07-17,Sao Tome and Principe,1,0,741,14
2020-07-18,Sao Tome and Principe,2,0,743,14
2020-07-19,Sao Tome and Principe,3,0,746,14
2020-07-20,Sao Tome and Principe,0,0,746,14
2020-07-21,Sao Tome and Principe,0,0,746,14
2020-07-22,Sao Tome and Principe,1,0,747,14
2020-07-23,Sao Tome and Principe,2,0,749,14
2020-07-24,Sao Tome and Principe,111,0,860,14
2020-07-25,Sao Tome and Principe,2,0,862,14
2020-07-26,Sao Tome and Principe,1,0,863,14
2020-07-27,Sao Tome and Principe,2,0,865,14
2020-07-28,Sao Tome and Principe,2,0,867,14
2020-07-29,Sao Tome and Principe,1,1,868,15
2020-07-30,Sao Tome and Principe,2,0,870,15
2020-07-31,Sao Tome and Principe,1,0,871,15
2020-08-01,Sao Tome and Principe,3,0,874,15
2020-08-02,Sao Tome and Principe,0,0,874,15
2020-08-03,Sao Tome and Principe,0,0,874,15
2020-08-04,Sao Tome and Principe,1,0,875,15
2020-08-05,Sao Tome and Principe,3,0,878,15
2020-08-06,Sao Tome and Principe,0,0,878,15
2020-08-07,Sao Tome and Principe,0,0,878,15
2020-08-08,Sao Tome and Principe,0,0,878,15
2020-08-09,Sao Tome and Principe,0,0,878,15
2020-08-10,Sao Tome and Principe,0,0,878,15
2020-08-11,Sao Tome and Principe,3,0,881,15
2020-08-12,Sao Tome and Principe,1,0,882,15
2020-08-13,Sao Tome and Principe,1,0,883,15
2020-08-14,Sao Tome and Principe,2,0,885,15
2020-08-15,Sao Tome and Principe,0,0,885,15
2020-08-16,Sao Tome and Principe,0,0,885,15
2020-08-17,Sao Tome and Principe,0,0,885,15
2020-08-18,Sao Tome and Principe,0,0,885,15
2020-08-19,Sao Tome and Principe,0,0,885,15
2020-08-20,Sao Tome and Principe,3,0,888,15
2020-08-21,Sao Tome and Principe,3,0,891,15
2020-08-22,Sao Tome and Principe,1,0,892,15
2020-08-23,Sao Tome and Principe,0,0,892,15
2020-08-24,Sao Tome and Principe,0,0,892,15
2020-08-25,Sao Tome and Principe,0,0,892,15
2020-08-26,Sao Tome and Principe,0,0,892,15
2020-08-27,Sao Tome and Principe,2,0,894,15
2020-08-28,Sao Tome and Principe,1,0,895,15
2020-08-29,Sao Tome and Principe,0,0,895,15
2020-08-30,Sao Tome and Principe,1,0,896,15
2020-08-31,Sao Tome and Principe,0,0,896,15
2020-09-01,Sao Tome and Principe,0,0,896,15
2020-09-02,Sao Tome and Principe,0,0,896,15
2020-09-03,Sao Tome and Principe,1,0,897,15
2020-09-04,Sao Tome and Principe,0,0,897,15
2020-09-05,Sao Tome and Principe,1,0,898,15
2020-09-06,Sao Tome and Principe,0,0,898,15
2020-09-07,Sao Tome and Principe,0,0,898,15
2020-09-08,Sao Tome and Principe,0,0,898,15
2020-09-09,Sao Tome and Principe,0,0,898,15
2020-09-10,Sao Tome and Principe,3,0,901,15
2020-09-11,Sao Tome and Principe,5,0,906,15
2020-09-12,Sao Tome and Principe,0,0,906,15
2020-09-13,Sao Tome and Principe,0,0,906,15
2020-09-14,Sao Tome and Principe,0,0,906,15
2020-09-15,Sao Tome and Principe,1,0,907,15
2020-09-16,Sao Tome and Principe,0,0,907,15
2020-09-17,Sao Tome and Principe,0,0,907,15
2020-09-18,Sao Tome and Principe,1,0,908,15
2020-09-19,Sao Tome and Principe,0,0,908,15
2020-09-20,Sao Tome and Principe,0,0,908,15
2020-09-21,Sao Tome and Principe,0,0,908,15
2020-09-22,Sao Tome and Principe,0,0,908,15
2020-09-23,Sao Tome and Principe,0,0,908,15
2020-09-24,Sao Tome and Principe,2,0,910,15
2020-09-25,Sao Tome and Principe,1,0,911,15
2020-09-26,Sao Tome and Principe,0,0,911,15
2020-09-27,Sao Tome and Principe,0,0,911,15
2020-09-28,Sao Tome and Principe,0,0,911,15
2020-09-29,Sao Tome and Principe,0,0,911,15
2020-09-30,Sao Tome and Principe,0,0,911,15
2020-10-01,Sao Tome and Principe,0,0,911,15
2020-10-02,Sao Tome and Principe,0,0,911,15
2020-10-03,Sao Tome and Principe,2,0,913,15
2020-10-04,Sao Tome and Principe,0,0,913,15
2020-10-05,Sao Tome and Principe,0,0,913,15
2020-10-06,Sao Tome and Principe,1,0,914,15
2020-10-07,Sao Tome and Principe,0,0,914,15
2020-10-08,Sao Tome and Principe,7,0,921,15
2020-10-09,Sao Tome and Principe,1,0,922,15
2020-10-10,Sao Tome and Principe,0,0,922,15
2020-10-11,Sao Tome and Principe,7,0,929,15
2020-10-12,Sao Tome and Principe,0,0,929,15
2020-10-13,Sao Tome and Principe,0,0,929,15
2020-10-14,Sao Tome and Principe,0,0,929,15
2020-10-15,Sao Tome and Principe,0,0,929,15
2020-10-16,Sao Tome and Principe,3,0,932,15
2020-10-17,Sao Tome and Principe,0,0,932,15
2020-10-18,Sao Tome and Principe,1,0,933,15
2020-10-19,Sao Tome and Principe,0,0,933,15
2020-10-20,Sao Tome and Principe,0,0,933,15
2020-10-21,Sao Tome and Principe,2,0,935,15
2020-10-22,Sao Tome and Principe,0,0,935,15
2020-10-23,Sao Tome and Principe,3,0,938,15
2020-10-24,Sao Tome and Principe,2,0,940,15
2020-10-25,Sao Tome and Principe,0,0,940,15
2020-10-26,Sao Tome and Principe,1,0,941,15
2020-10-27,Sao Tome and Principe,0,0,941,15
2020-10-28,Sao Tome and Principe,2,0,943,15
2020-10-29,Sao Tome and Principe,1,1,944,16
2020-10-30,Sao Tome and Principe,1,0,945,16
2020-10-31,Sao Tome and Principe,0,0,945,16
2020-11-01,Sao Tome and Principe,4,0,949,16
2020-11-02,Sao Tome and Principe,0,0,949,16
2020-11-03,Sao Tome and Principe,5,0,954,16
2020-11-04,Sao Tome and Principe,4,0,958,16
2020-11-05,Sao Tome and Principe,0,0,958,16
2020-11-06,Sao Tome and Principe,2,0,960,16
2020-11-07,Sao Tome and Principe,2,0,962,16
2020-11-08,Sao Tome and Principe,0,0,962,16
2020-11-09,Sao Tome and Principe,0,0,962,16
2020-11-10,Sao Tome and Principe,0,0,962,16
2020-11-11,Sao Tome and Principe,0,0,962,16
2020-11-12,Sao Tome and Principe,1,0,963,16
2020-11-13,Sao Tome and Principe,0,0,963,16
2020-11-14,Sao Tome and Principe,1,0,964,16
2020-11-15,Sao Tome and Principe,1,0,965,16
2020-11-16,Sao Tome and Principe,0,0,965,16
2020-11-17,Sao Tome and Principe,2,0,967,16
2020-11-18,Sao Tome and Principe,0,0,967,16
2020-11-19,Sao Tome and Principe,7,0,974,16
2020-11-20,Sao Tome and Principe,0,1,974,17
2020-11-21,Sao Tome and Principe,5,0,979,17
2020-11-22,Sao Tome and Principe,0,0,979,17
2020-11-23,Sao Tome and Principe,2,0,981,17
2020-11-24,Sao Tome and Principe,0,0,981,17
2020-11-25,Sao Tome and Principe,1,0,982,17
2020-11-26,Sao Tome and Principe,3,0,985,17
2020-11-27,Sao Tome and Principe,0,0,985,17
2020-11-28,Sao Tome and Principe,4,0,989,17
2020-11-29,Sao Tome and Principe,0,0,989,17
2020-11-30,Sao Tome and Principe,2,0,991,17
2020-12-01,Sao Tome and Principe,5,0,996,17
2020-12-02,Sao Tome and Principe,1,0,997,17
2020-12-03,Sao Tome and Principe,0,0,997,17
2020-12-04,Sao Tome and Principe,2,0,999,17
2020-12-05,Sao Tome and Principe,0,0,999,17
2020-12-06,Sao Tome and Principe,0,0,999,17
2020-12-07,Sao Tome and Principe,3,0,1002,17
2020-12-08,Sao Tome and Principe,3,0,1005,17
2020-12-09,Sao Tome and Principe,0,0,1005,17
2020-12-10,Sao Tome and Principe,4,0,1009,17
2020-12-11,Sao Tome and Principe,0,0,1009,17
2020-12-12,Sao Tome and Principe,0,0,1009,17
2020-12-13,Sao Tome and Principe,0,0,1009,17
2020-12-14,Sao Tome and Principe,1,0,1010,17
2020-12-15,Sao Tome and Principe,0,0,1010,17
2020-12-16,Sao Tome and Principe,0,0,1010,17
2020-12-17,Sao Tome and Principe,1,0,1011,17
2020-12-18,Sao Tome and Principe,0,0,1011,17
2020-12-19,Sao Tome and Principe,1,0,1012,17
2020-12-20,Sao Tome and Principe,0,0,1012,17
2020-12-21,Sao Tome and Principe,0,0,1012,17
2020-12-22,Sao Tome and Principe,0,0,1012,17
2020-12-23,Sao Tome and Principe,0,0,1012,17
2020-12-24,Sao Tome and Principe,0,0,1012,17
2020-12-25,Sao Tome and Principe,2,0,1014,17
2020-12-26,Sao Tome and Principe,0,0,1014,17
2020-12-27,Sao Tome and Principe,0,0,1014,17
2020-12-28,Sao Tome and Principe,0,0,1014,17
2020-12-29,Sao Tome and Principe,0,0,1014,17
2020-12-30,Sao Tome and Principe,0,0,1014,17
2020-12-31,Sao Tome and Principe,0,0,1014,17
2021-01-01,Sao Tome and Principe,8,0,1022,17
2021-01-02,Sao Tome and Principe,2,0,1024,17
2021-01-03,Sao Tome and Principe,0,0,1024,17
2021-01-04,Sao Tome and Principe,0,0,1024,17
2021-01-05,Sao Tome and Principe,0,0,1024,17
2021-01-06,Sao Tome and Principe,1,0,1025,17
2021-01-07,Sao Tome and Principe,10,0,1035,17
2021-01-08,Sao Tome and Principe,19,0,1054,17
2021-01-09,Sao Tome and Principe,12,0,1066,17
2021-01-10,Sao Tome and Principe,0,0,1066,17
2021-01-11,Sao Tome and Principe,0,0,1066,17
2021-01-12,Sao Tome and Principe,24,0,1090,17
2021-01-13,Sao Tome and Principe,15,0,1105,17
2021-01-14,Sao Tome and Principe,14,0,1119,17
2021-01-15,Sao Tome and Principe,6,0,1125,17
2021-01-16,Sao Tome and Principe,5,0,1130,17
2021-01-17,Sao Tome and Principe,12,0,1142,17
2021-01-18,Sao Tome and Principe,0,0,1142,17
2021-01-19,Sao Tome and Principe,9,0,1151,17
2021-01-20,Sao Tome and Principe,19,0,1170,17
2021-01-21,Sao Tome and Principe,1,0,1171,17
2021-01-22,Sao Tome and Principe,11,0,1182,17
2021-01-23,Sao Tome and Principe,6,0,1188,17
2021-01-24,Sao Tome and Principe,0,0,1188,17
2021-01-25,Sao Tome and Principe,1,0,1189,17
2021-01-26,Sao Tome and Principe,21,0,1210,17
2021-01-27,Sao Tome and Principe,11,0,1221,17
2021-01-28,Sao Tome and Principe,11,0,1232,17
2021-01-29,Sao Tome and Principe,13,0,1245,17
2021-01-30,Sao Tome and Principe,11,0,1256,17
2021-01-31,Sao Tome and Principe,1,0,1257,17
2021-02-01,Sao Tome and Principe,2,0,1259,17
2021-02-02,Sao Tome and Principe,24,0,1283,17
2021-02-03,Sao Tome and Principe,4,0,1287,17
2021-02-04,Sao Tome and Principe,11,0,1298,17
2021-02-05,Sao Tome and Principe,48,1,1346,18
2021-02-06,Sao Tome and Principe,5,0,1351,18
2021-02-07,Sao Tome and Principe,0,0,1351,18
2021-02-08,Sao Tome and Principe,4,0,1355,18
2021-02-09,Sao Tome and Principe,30,0,1385,18
2021-02-10,Sao Tome and Principe,45,0,1430,18
2021-02-11,Sao Tome and Principe,1,1,1431,19
2021-02-12,Sao Tome and Principe,47,0,1478,19
2021-02-13,Sao Tome and Principe,4,0,1482,19
2021-02-14,Sao Tome and Principe,0,0,1482,19
2021-02-15,Sao Tome and Principe,0,0,1482,19
2021-02-16,Sao Tome and Principe,38,0,1520,19
2021-02-17,Sao Tome and Principe,15,1,1535,20
2021-02-18,Sao Tome and Principe,13,0,1548,20
2021-02-19,Sao Tome and Principe,30,0,1578,20
2021-02-20,Sao Tome and Principe,0,1,1578,21
2021-02-21,Sao Tome and Principe,32,0,1610,21
2021-02-22,Sao Tome and Principe,18,1,1628,22
2021-02-23,Sao Tome and Principe,27,4,1655,26
2021-02-24,Sao Tome and Principe,17,1,1672,27
2021-02-25,Sao Tome and Principe,47,0,1719,27
2021-02-26,Sao Tome and Principe,26,1,1745,28
2021-02-27,Sao Tome and Principe,41,0,1786,28
2021-02-28,Sao Tome and Principe,0,1,1786,29
2021-03-01,Sao Tome and Principe,42,1,1828,30
2021-03-02,Sao Tome and Principe,12,0,1840,30
2021-03-03,Sao Tome and Principe,41,0,1881,30
2021-03-04,Sao Tome and Principe,17,0,1898,30
2021-03-05,Sao Tome and Principe,25,1,1923,31
2021-03-06,Sao Tome and Principe,21,0,1944,31
2021-03-07,Sao Tome and Principe,6,1,1950,32
2021-03-08,Sao Tome and Principe,11,0,1961,32
2021-03-09,Sao Tome and Principe,16,0,1977,32
2021-03-10,Sao Tome and Principe,33,0,2010,32
2021-03-11,Sao Tome and Principe,25,0,2035,32
2021-03-12,Sao Tome and Principe,22,0,2057,32
2021-03-13,Sao Tome and Principe,21,0,2078,32
2021-03-14,Sao Tome and Principe,0,0,2078,32
2021-03-15,Sao Tome and Principe,6,0,2084,32
2021-03-16,Sao Tome and Principe,1,0,2085,32
2021-03-17,Sao Tome and Principe,22,1,2107,33
2021-03-18,Sao Tome and Principe,7,1,2114,34
2021-03-19,Sao Tome and Principe,9,0,2123,34
2021-03-20,Sao Tome and Principe,19,0,2142,34
2021-03-21,Sao Tome and Principe,3,0,2145,34
2021-03-22,Sao Tome and Principe,12,0,2157,34
2021-03-23,Sao Tome and Principe,2,0,2159,34
2021-03-24,Sao Tome and Principe,15,0,2174,34
2021-03-25,Sao Tome and Principe,3,0,2177,34
2021-03-26,Sao Tome and Principe,19,0,2196,34
2021-03-27,Sao Tome and Principe,14,0,2210,34
2021-03-28,Sao Tome and Principe,2,0,2212,34
2021-03-29,Sao Tome and Principe,3,0,2215,34
2021-03-30,Sao Tome and Principe,6,0,2221,34
2021-03-31,Sao Tome and Principe,2,0,2223,34
2021-04-01,Sao Tome and Principe,9,0,2232,34
2021-04-02,Sao Tome and Principe,4,0,2236,34
2021-04-03,Sao Tome and Principe,4,1,2240,35
2021-04-04,Sao Tome and Principe,0,0,2240,35
2021-04-05,Sao Tome and Principe,4,0,2244,35
2021-04-06,Sao Tome and Principe,4,0,2248,35
2021-04-07,Sao Tome and Principe,7,0,2255,35
2021-04-08,Sao Tome and Principe,0,0,2255,35
2020-03-02,Saudi Arabia,1,0,1,0
2020-03-03,Saudi Arabia,0,0,1,0
2020-03-04,Saudi Arabia,0,0,1,0
2020-03-05,Saudi Arabia,4,0,5,0
2020-03-06,Saudi Arabia,0,0,5,0
2020-03-07,Saudi Arabia,0,0,5,0
2020-03-08,Saudi Arabia,6,0,11,0
2020-03-09,Saudi Arabia,4,0,15,0
2020-03-10,Saudi Arabia,5,0,20,0
2020-03-11,Saudi Arabia,1,0,21,0
2020-03-12,Saudi Arabia,24,0,45,0
2020-03-13,Saudi Arabia,41,0,86,0
2020-03-14,Saudi Arabia,17,0,103,0
2020-03-15,Saudi Arabia,0,0,103,0
2020-03-16,Saudi Arabia,15,0,118,0
2020-03-17,Saudi Arabia,53,0,171,0
2020-03-18,Saudi Arabia,0,0,171,0
2020-03-19,Saudi Arabia,103,0,274,0
2020-03-20,Saudi Arabia,70,0,344,0
2020-03-21,Saudi Arabia,48,0,392,0
2020-03-22,Saudi Arabia,119,0,511,0
2020-03-23,Saudi Arabia,51,0,562,0
2020-03-24,Saudi Arabia,205,1,767,1
2020-03-25,Saudi Arabia,133,1,900,2
2020-03-26,Saudi Arabia,112,1,1012,3
2020-03-27,Saudi Arabia,92,0,1104,3
2020-03-28,Saudi Arabia,99,1,1203,4
2020-03-29,Saudi Arabia,96,4,1299,8
2020-03-30,Saudi Arabia,154,0,1453,8
2020-03-31,Saudi Arabia,110,2,1563,10
2020-04-01,Saudi Arabia,157,6,1720,16
2020-04-02,Saudi Arabia,165,5,1885,21
2020-04-03,Saudi Arabia,154,4,2039,25
2020-04-04,Saudi Arabia,140,4,2179,29
2020-04-05,Saudi Arabia,223,5,2402,34
2020-04-06,Saudi Arabia,203,4,2605,38
2020-04-07,Saudi Arabia,190,3,2795,41
2020-04-08,Saudi Arabia,137,0,2932,41
2020-04-09,Saudi Arabia,355,3,3287,44
2020-04-10,Saudi Arabia,364,3,3651,47
2020-04-11,Saudi Arabia,382,5,4033,52
2020-04-12,Saudi Arabia,429,7,4462,59
2020-04-13,Saudi Arabia,472,6,4934,65
2020-04-14,Saudi Arabia,435,8,5369,73
2020-04-15,Saudi Arabia,493,6,5862,79
2020-04-16,Saudi Arabia,518,4,6380,83
2020-04-17,Saudi Arabia,762,4,7142,87
2020-04-18,Saudi Arabia,1132,5,8274,92
2020-04-19,Saudi Arabia,1088,5,9362,97
2020-04-20,Saudi Arabia,1122,6,10484,103
2020-04-21,Saudi Arabia,1147,6,11631,109
2020-04-22,Saudi Arabia,1141,5,12772,114
2020-04-23,Saudi Arabia,1158,7,13930,121
2020-04-24,Saudi Arabia,1172,6,15102,127
2020-04-25,Saudi Arabia,1197,9,16299,136
2020-04-26,Saudi Arabia,1223,3,17522,139
2020-04-27,Saudi Arabia,1289,5,18811,144
2020-04-28,Saudi Arabia,1266,8,20077,152
2020-04-29,Saudi Arabia,1325,5,21402,157
2020-04-30,Saudi Arabia,1351,5,22753,162
2020-05-01,Saudi Arabia,1344,7,24097,169
2020-05-02,Saudi Arabia,1362,7,25459,176
2020-05-03,Saudi Arabia,1552,8,27011,184
2020-05-04,Saudi Arabia,1645,7,28656,191
2020-05-05,Saudi Arabia,1595,9,30251,200
2020-05-06,Saudi Arabia,1687,9,31938,209
2020-05-07,Saudi Arabia,1793,10,33731,219
2020-05-08,Saudi Arabia,1701,10,35432,229
2020-05-09,Saudi Arabia,1704,10,37136,239
2020-05-10,Saudi Arabia,1912,7,39048,246
2020-05-11,Saudi Arabia,1966,9,41014,255
2020-05-12,Saudi Arabia,1911,9,42925,264
2020-05-13,Saudi Arabia,1905,9,44830,273
2020-05-14,Saudi Arabia,2039,10,46869,283
2020-05-15,Saudi Arabia,2307,9,49176,292
2020-05-16,Saudi Arabia,2840,10,52016,302
2020-05-17,Saudi Arabia,2736,10,54752,312
2020-05-18,Saudi Arabia,2593,8,57345,320
2020-05-19,Saudi Arabia,2509,9,59854,329
2020-05-20,Saudi Arabia,2691,10,62545,339
2020-05-21,Saudi Arabia,2532,12,65077,351
2020-05-22,Saudi Arabia,2642,13,67719,364
2020-05-23,Saudi Arabia,2442,15,70161,379
2020-05-24,Saudi Arabia,2399,11,72560,390
2020-05-25,Saudi Arabia,2235,9,74795,399
2020-05-26,Saudi Arabia,1931,12,76726,411
2020-05-27,Saudi Arabia,1815,14,78541,425
2020-05-28,Saudi Arabia,1644,16,80185,441
2020-05-29,Saudi Arabia,1581,17,81766,458
2020-05-30,Saudi Arabia,1618,22,83384,480
2020-05-31,Saudi Arabia,1877,23,85261,503
2020-06-01,Saudi Arabia,1881,22,87142,525
2020-06-02,Saudi Arabia,1869,24,89011,549
2020-06-03,Saudi Arabia,2171,30,91182,579
2020-06-04,Saudi Arabia,1975,32,93157,611
2020-06-05,Saudi Arabia,2591,31,95748,642
2020-06-06,Saudi Arabia,3121,34,98869,676
2020-06-07,Saudi Arabia,3045,36,101914,712
2020-06-08,Saudi Arabia,3369,34,105283,746
2020-06-09,Saudi Arabia,3288,37,108571,783
2020-06-10,Saudi Arabia,3717,36,112288,819
2020-06-11,Saudi Arabia,3733,38,116021,857
2020-06-12,Saudi Arabia,3921,36,119942,893
2020-06-13,Saudi Arabia,3366,39,123308,932
2020-06-14,Saudi Arabia,4233,40,127541,972
2020-06-15,Saudi Arabia,4507,39,132048,1011
2020-06-16,Saudi Arabia,4267,41,136315,1052
2020-06-17,Saudi Arabia,4919,39,141234,1091
2020-06-18,Saudi Arabia,4757,48,145991,1139
2020-06-19,Saudi Arabia,4301,45,150292,1184
2020-06-20,Saudi Arabia,3941,46,154233,1230
2020-06-21,Saudi Arabia,3379,37,157612,1267
2020-06-22,Saudi Arabia,3393,40,161005,1307
2020-06-23,Saudi Arabia,3139,39,164144,1346
2020-06-24,Saudi Arabia,3123,41,167267,1387
2020-06-25,Saudi Arabia,3372,41,170639,1428
2020-06-26,Saudi Arabia,3938,46,174577,1474
2020-06-27,Saudi Arabia,3927,37,178504,1511
2020-06-28,Saudi Arabia,3989,40,182493,1551
2020-06-29,Saudi Arabia,3943,48,186436,1599
2020-06-30,Saudi Arabia,4387,50,190823,1649
2020-07-01,Saudi Arabia,3402,49,194225,1698
2020-07-02,Saudi Arabia,3383,54,197608,1752
2020-07-03,Saudi Arabia,4193,50,201801,1802
2020-07-04,Saudi Arabia,4128,56,205929,1858
2020-07-05,Saudi Arabia,3580,58,209509,1916
2020-07-06,Saudi Arabia,4207,52,213716,1968
2020-07-07,Saudi Arabia,3392,49,217108,2017
2020-07-08,Saudi Arabia,3036,42,220144,2059
2020-07-09,Saudi Arabia,3183,41,223327,2100
2020-07-10,Saudi Arabia,3159,51,226486,2151
2020-07-11,Saudi Arabia,2994,30,229480,2181
2020-07-12,Saudi Arabia,2779,42,232259,2223
2020-07-13,Saudi Arabia,2852,20,235111,2243
2020-07-14,Saudi Arabia,2692,40,237803,2283
2020-07-15,Saudi Arabia,2671,42,240474,2325
2020-07-16,Saudi Arabia,2764,45,243238,2370
2020-07-17,Saudi Arabia,2613,37,245851,2407
2020-07-18,Saudi Arabia,2565,40,248416,2447
2020-07-19,Saudi Arabia,2504,39,250920,2486
2020-07-20,Saudi Arabia,2429,37,253349,2523
2020-07-21,Saudi Arabia,2476,34,255825,2557
2020-07-22,Saudi Arabia,2331,44,258156,2601
2020-07-23,Saudi Arabia,2238,34,260394,2635
2020-07-24,Saudi Arabia,2378,37,262772,2672
2020-07-25,Saudi Arabia,2201,31,264973,2703
2020-07-26,Saudi Arabia,1968,30,266941,2733
2020-07-27,Saudi Arabia,1993,27,268934,2760
2020-07-28,Saudi Arabia,1897,29,270831,2789
2020-07-29,Saudi Arabia,1759,27,272590,2816
2020-07-30,Saudi Arabia,1629,26,274219,2842
2020-07-31,Saudi Arabia,1686,24,275905,2866
2020-08-01,Saudi Arabia,1573,21,277478,2887
2020-08-02,Saudi Arabia,1357,30,278835,2917
2020-08-03,Saudi Arabia,1258,32,280093,2949
2020-08-04,Saudi Arabia,1363,35,281456,2984
2020-08-05,Saudi Arabia,1368,36,282824,3020
2020-08-06,Saudi Arabia,1402,35,284226,3055
2020-08-07,Saudi Arabia,1567,38,285793,3093
2020-08-08,Saudi Arabia,1469,37,287262,3130
2020-08-09,Saudi Arabia,1428,37,288690,3167
2020-08-10,Saudi Arabia,1257,32,289947,3199
2020-08-11,Saudi Arabia,1521,34,291468,3233
2020-08-12,Saudi Arabia,1569,36,293037,3269
2020-08-13,Saudi Arabia,1482,34,294519,3303
2020-08-14,Saudi Arabia,1383,35,295902,3338
2020-08-15,Saudi Arabia,1413,31,297315,3369
2020-08-16,Saudi Arabia,1227,39,298542,3408
2020-08-17,Saudi Arabia,1372,28,299914,3436
2020-08-18,Saudi Arabia,1409,34,301323,3470
2020-08-19,Saudi Arabia,1363,36,302686,3506
2020-08-20,Saudi Arabia,1287,42,303973,3548
2020-08-21,Saudi Arabia,1213,32,305186,3580
2020-08-22,Saudi Arabia,1184,39,306370,3619
2020-08-23,Saudi Arabia,1109,30,307479,3649
2020-08-24,Saudi Arabia,1175,42,308654,3691
2020-08-25,Saudi Arabia,1114,31,309768,3722
2020-08-26,Saudi Arabia,1068,33,310836,3755
2020-08-27,Saudi Arabia,1019,30,311855,3785
2020-08-28,Saudi Arabia,1069,28,312924,3813
2020-08-29,Saudi Arabia,987,27,313911,3840
2020-08-30,Saudi Arabia,910,30,314821,3870
2020-08-31,Saudi Arabia,951,27,315772,3897
2020-09-01,Saudi Arabia,898,32,316670,3929
2020-09-02,Saudi Arabia,816,27,317486,3956
2020-09-03,Saudi Arabia,833,26,318319,3982
2020-09-04,Saudi Arabia,822,33,319141,4015
2020-09-05,Saudi Arabia,791,34,319932,4049
2020-09-06,Saudi Arabia,756,32,320688,4081
2020-09-07,Saudi Arabia,768,26,321456,4107
2020-09-08,Saudi Arabia,781,30,322237,4137
2020-09-09,Saudi Arabia,775,28,323012,4165
2020-09-10,Saudi Arabia,708,24,323720,4189
2020-09-11,Saudi Arabia,687,24,324407,4213
2020-09-12,Saudi Arabia,643,27,325050,4240
2020-09-13,Saudi Arabia,601,28,325651,4268
2020-09-14,Saudi Arabia,607,37,326258,4305
2020-09-15,Saudi Arabia,672,33,326930,4338
2020-09-16,Saudi Arabia,621,31,327551,4369
2020-09-17,Saudi Arabia,593,30,328144,4399
2020-09-18,Saudi Arabia,576,31,328720,4430
2020-09-19,Saudi Arabia,551,28,329271,4458
2020-09-20,Saudi Arabia,483,27,329754,4485
2020-09-21,Saudi Arabia,492,27,330246,4512
2020-09-22,Saudi Arabia,552,30,330798,4542
2020-09-23,Saudi Arabia,561,27,331359,4569
2020-09-24,Saudi Arabia,498,30,331857,4599
2020-09-25,Saudi Arabia,472,26,332329,4625
2020-09-26,Saudi Arabia,461,30,332790,4655
2020-09-27,Saudi Arabia,403,28,333193,4683
2020-09-28,Saudi Arabia,455,29,333648,4712
2020-09-29,Saudi Arabia,539,27,334187,4739
2020-09-30,Saudi Arabia,418,29,334605,4768
2020-10-01,Saudi Arabia,492,26,335097,4794
2020-10-02,Saudi Arabia,481,29,335578,4823
2020-10-03,Saudi Arabia,419,27,335997,4850
2020-10-04,Saudi Arabia,390,25,336387,4875
2020-10-05,Saudi Arabia,379,23,336766,4898
2020-10-06,Saudi Arabia,477,25,337243,4923
2020-10-07,Saudi Arabia,468,24,337711,4947
2020-10-08,Saudi Arabia,421,25,338132,4972
2020-10-09,Saudi Arabia,407,24,338539,4996
2020-10-10,Saudi Arabia,405,22,338944,5018
2020-10-11,Saudi Arabia,323,25,339267,5043
2020-10-12,Saudi Arabia,348,25,339615,5068
2020-10-13,Saudi Arabia,474,19,340089,5087
2020-10-14,Saudi Arabia,501,21,340590,5108
2020-10-15,Saudi Arabia,472,19,341062,5127
2020-10-16,Saudi Arabia,433,17,341495,5144
2020-10-17,Saudi Arabia,359,21,341854,5165
2020-10-18,Saudi Arabia,348,20,342202,5185
2020-10-19,Saudi Arabia,381,16,342583,5201
2020-10-20,Saudi Arabia,385,16,342968,5217
2020-10-21,Saudi Arabia,405,18,343373,5235
2020-10-22,Saudi Arabia,401,15,343774,5250
2020-10-23,Saudi Arabia,383,14,344157,5264
2020-10-24,Saudi Arabia,395,17,344552,5281
2020-10-25,Saudi Arabia,323,15,344875,5296
2020-10-26,Saudi Arabia,357,17,345232,5313
2020-10-27,Saudi Arabia,399,16,345631,5329
2020-10-28,Saudi Arabia,416,19,346047,5348
2020-10-29,Saudi Arabia,435,15,346482,5363
2020-10-30,Saudi Arabia,398,20,346880,5383
2020-10-31,Saudi Arabia,402,19,347282,5402
2020-11-01,Saudi Arabia,374,18,347656,5420
2020-11-02,Saudi Arabia,381,17,348037,5437
2020-11-03,Saudi Arabia,473,19,348510,5456
2020-11-04,Saudi Arabia,426,15,348936,5471
2020-11-05,Saudi Arabia,450,18,349386,5489
2020-11-06,Saudi Arabia,436,17,349822,5506
2020-11-07,Saudi Arabia,407,19,350229,5525
2020-11-08,Saudi Arabia,363,15,350592,5540
2020-11-09,Saudi Arabia,392,19,350984,5559
2020-11-10,Saudi Arabia,471,17,351455,5576
2020-11-11,Saudi Arabia,394,14,351849,5590
2020-11-12,Saudi Arabia,311,15,352160,5605
2020-11-13,Saudi Arabia,441,20,352601,5625
2020-11-14,Saudi Arabia,349,16,352950,5641
2020-11-15,Saudi Arabia,305,16,353255,5657
2020-11-16,Saudi Arabia,301,19,353556,5676
2020-11-17,Saudi Arabia,362,16,353918,5692
2020-11-18,Saudi Arabia,290,18,354208,5710
2020-11-19,Saudi Arabia,319,19,354527,5729
2020-11-20,Saudi Arabia,286,16,354813,5745
2020-11-21,Saudi Arabia,221,16,355034,5761
2020-11-22,Saudi Arabia,224,19,355258,5780
2020-11-23,Saudi Arabia,231,16,355489,5796
2020-11-24,Saudi Arabia,252,15,355741,5811
2020-11-25,Saudi Arabia,326,14,356067,5825
2020-11-26,Saudi Arabia,322,15,356389,5840
2020-11-27,Saudi Arabia,302,17,356691,5857
2020-11-28,Saudi Arabia,220,13,356911,5870
2020-11-29,Saudi Arabia,217,14,357128,5884
2020-11-30,Saudi Arabia,232,12,357360,5896
2020-12-01,Saudi Arabia,263,11,357623,5907
2020-12-02,Saudi Arabia,249,12,357872,5919
2020-12-03,Saudi Arabia,230,11,358102,5930
2020-12-04,Saudi Arabia,234,10,358336,5940
2020-12-05,Saudi Arabia,190,14,358526,5954
2020-12-06,Saudi Arabia,187,11,358713,5965
2020-12-07,Saudi Arabia,209,12,358922,5977
2020-12-08,Saudi Arabia,193,12,359115,5989
2020-12-09,Saudi Arabia,159,13,359274,6002
2020-12-10,Saudi Arabia,141,10,359415,6012
2020-12-11,Saudi Arabia,168,11,359583,6023
2020-12-12,Saudi Arabia,166,13,359749,6036
2020-12-13,Saudi Arabia,139,12,359888,6048
2020-12-14,Saudi Arabia,125,11,360013,6059
2020-12-15,Saudi Arabia,142,10,360155,6069
2020-12-16,Saudi Arabia,180,11,360335,6080
2020-12-17,Saudi Arabia,181,11,360516,6091
2020-12-18,Saudi Arabia,174,10,360690,6101
2020-12-19,Saudi Arabia,158,11,360848,6112
2020-12-20,Saudi Arabia,162,10,361010,6122
2020-12-21,Saudi Arabia,168,9,361178,6131
2020-12-22,Saudi Arabia,181,8,361359,6139
2020-12-23,Saudi Arabia,177,9,361536,6148
2020-12-24,Saudi Arabia,189,11,361725,6159
2020-12-25,Saudi Arabia,178,9,361903,6168
2020-12-26,Saudi Arabia,163,8,362066,6176
2020-12-27,Saudi Arabia,154,9,362220,6185
2020-12-28,Saudi Arabia,119,11,362339,6196
2020-12-29,Saudi Arabia,149,8,362488,6204
2020-12-30,Saudi Arabia,113,10,362601,6214
2020-12-31,Saudi Arabia,140,9,362741,6223
2021-01-01,Saudi Arabia,137,7,362878,6230
2021-01-02,Saudi Arabia,101,9,362979,6239
2021-01-03,Saudi Arabia,82,7,363061,6246
2021-01-04,Saudi Arabia,94,10,363155,6256
2021-01-05,Saudi Arabia,104,9,363259,6265
2021-01-06,Saudi Arabia,118,7,363377,6272
2021-01-07,Saudi Arabia,108,6,363485,6278
2021-01-08,Saudi Arabia,97,4,363582,6282
2021-01-09,Saudi Arabia,110,4,363692,6286
2021-01-10,Saudi Arabia,117,5,363809,6291
2021-01-11,Saudi Arabia,140,4,363949,6295
2021-01-12,Saudi Arabia,147,5,364096,6300
2021-01-13,Saudi Arabia,175,4,364271,6304
2021-01-14,Saudi Arabia,169,6,364440,6310
2021-01-15,Saudi Arabia,173,3,364613,6313
2021-01-16,Saudi Arabia,140,5,364753,6318
2021-01-17,Saudi Arabia,176,5,364929,6323
2021-01-18,Saudi Arabia,170,6,365099,6329
2021-01-19,Saudi Arabia,226,6,365325,6335
2021-01-20,Saudi Arabia,238,3,365563,6338
2021-01-21,Saudi Arabia,212,4,365775,6342
2021-01-22,Saudi Arabia,213,4,365988,6346
2021-01-23,Saudi Arabia,197,4,366185,6350
2021-01-24,Saudi Arabia,186,2,366371,6352
2021-01-25,Saudi Arabia,213,3,366584,6355
2021-01-26,Saudi Arabia,223,4,366807,6359
2021-01-27,Saudi Arabia,216,4,367023,6363
2021-01-28,Saudi Arabia,253,3,367276,6366
2021-01-29,Saudi Arabia,267,2,367543,6368
2021-01-30,Saudi Arabia,270,4,367813,6372
2021-01-31,Saudi Arabia,261,3,368074,6375
2021-02-01,Saudi Arabia,255,4,368329,6379
2021-02-02,Saudi Arabia,310,4,368639,6383
2021-02-03,Saudi Arabia,306,3,368945,6386
2021-02-04,Saudi Arabia,303,3,369248,6389
2021-02-05,Saudi Arabia,327,4,369575,6393
2021-02-06,Saudi Arabia,386,4,369961,6397
2021-02-07,Saudi Arabia,317,5,370278,6402
2021-02-08,Saudi Arabia,356,4,370634,6406
2021-02-09,Saudi Arabia,353,4,370987,6410
2021-02-10,Saudi Arabia,369,5,371356,6415
2021-02-11,Saudi Arabia,364,5,371720,6420
2021-02-12,Saudi Arabia,353,4,372073,6424
2021-02-13,Saudi Arabia,337,5,372410,6429
2021-02-14,Saudi Arabia,322,4,372732,6433
2021-02-15,Saudi Arabia,314,5,373046,6438
2021-02-16,Saudi Arabia,322,3,373368,6441
2021-02-17,Saudi Arabia,334,4,373702,6445
2021-02-18,Saudi Arabia,327,5,374029,6450
2021-02-19,Saudi Arabia,337,4,374366,6454
2021-02-20,Saudi Arabia,325,3,374691,6457
2021-02-21,Saudi Arabia,315,4,375006,6461
2021-02-22,Saudi Arabia,327,5,375333,6466
2021-02-23,Saudi Arabia,335,4,375668,6470
2021-02-24,Saudi Arabia,353,5,376021,6475
2021-02-25,Saudi Arabia,356,5,376377,6480
2021-02-26,Saudi Arabia,346,3,376723,6483
2021-02-27,Saudi Arabia,338,5,377061,6488
2021-02-28,Saudi Arabia,322,6,377383,6494
2021-03-01,Saudi Arabia,317,6,377700,6500
2021-03-02,Saudi Arabia,302,5,378002,6505
2021-03-03,Saudi Arabia,331,5,378333,6510
2021-03-04,Saudi Arabia,375,4,378708,6514
2021-03-05,Saudi Arabia,384,5,379092,6519
2021-03-06,Saudi Arabia,382,5,379474,6524
2021-03-07,Saudi Arabia,357,4,379831,6528
2021-03-08,Saudi Arabia,351,6,380182,6534
2021-03-09,Saudi Arabia,390,5,380572,6539
2021-03-10,Saudi Arabia,386,6,380958,6545
2021-03-11,Saudi Arabia,390,6,381348,6551
2021-03-12,Saudi Arabia,360,5,381708,6556
2021-03-13,Saudi Arabia,351,7,382059,6563
2021-03-14,Saudi Arabia,348,4,382407,6567
2021-03-15,Saudi Arabia,345,6,382752,6573
2021-03-16,Saudi Arabia,354,5,383106,6578
2021-03-17,Saudi Arabia,393,7,383499,6585
2021-03-18,Saudi Arabia,381,6,383880,6591
2021-03-19,Saudi Arabia,391,5,384271,6596
2021-03-20,Saudi Arabia,382,6,384653,6602
2021-03-21,Saudi Arabia,367,7,385020,6609
2021-03-22,Saudi Arabia,404,4,385424,6613
2021-03-23,Saudi Arabia,410,5,385834,6618
2021-03-24,Saudi Arabia,466,6,386300,6624
2021-03-25,Saudi Arabia,482,6,386782,6630
2021-03-26,Saudi Arabia,510,7,387292,6637
2021-03-27,Saudi Arabia,502,6,387794,6643
2021-03-28,Saudi Arabia,531,7,388325,6650
2021-03-29,Saudi Arabia,541,6,388866,6656
2021-03-30,Saudi Arabia,556,7,389422,6663
2021-03-31,Saudi Arabia,585,6,390007,6669
2021-04-01,Saudi Arabia,590,7,390597,6676
2021-04-02,Saudi Arabia,728,8,391325,6684
2021-04-03,Saudi Arabia,684,6,392009,6690
2021-04-04,Saudi Arabia,673,7,392682,6697
2021-04-05,Saudi Arabia,695,7,393377,6704
2021-04-06,Saudi Arabia,792,7,394169,6711
2021-04-07,Saudi Arabia,783,8,394952,6719
2021-04-08,Saudi Arabia,902,9,395854,6728
2020-03-02,Senegal,1,0,1,0
2020-03-03,Senegal,1,0,2,0
2020-03-04,Senegal,2,0,4,0
2020-03-05,Senegal,0,0,4,0
2020-03-06,Senegal,0,0,4,0
2020-03-07,Senegal,0,0,4,0
2020-03-08,Senegal,0,0,4,0
2020-03-09,Senegal,0,0,4,0
2020-03-10,Senegal,0,0,4,0
2020-03-11,Senegal,0,0,4,0
2020-03-12,Senegal,0,0,4,0
2020-03-13,Senegal,6,0,10,0
2020-03-14,Senegal,0,0,10,0
2020-03-15,Senegal,14,0,24,0
2020-03-16,Senegal,0,0,24,0
2020-03-17,Senegal,2,0,26,0
2020-03-18,Senegal,5,0,31,0
2020-03-19,Senegal,0,0,31,0
2020-03-20,Senegal,7,0,38,0
2020-03-21,Senegal,9,0,47,0
2020-03-22,Senegal,20,0,67,0
2020-03-23,Senegal,12,0,79,0
2020-03-24,Senegal,7,0,86,0
2020-03-25,Senegal,13,0,99,0
2020-03-26,Senegal,6,0,105,0
2020-03-27,Senegal,14,0,119,0
2020-03-28,Senegal,11,0,130,0
2020-03-29,Senegal,12,0,142,0
2020-03-30,Senegal,20,0,162,0
2020-03-31,Senegal,13,0,175,0
2020-04-01,Senegal,15,1,190,1
2020-04-02,Senegal,5,0,195,1
2020-04-03,Senegal,12,0,207,1
2020-04-04,Senegal,12,1,219,2
2020-04-05,Senegal,3,0,222,2
2020-04-06,Senegal,4,0,226,2
2020-04-07,Senegal,11,0,237,2
2020-04-08,Senegal,7,0,244,2
2020-04-09,Senegal,6,0,250,2
2020-04-10,Senegal,15,0,265,2
2020-04-11,Senegal,13,0,278,2
2020-04-12,Senegal,2,0,280,2
2020-04-13,Senegal,11,0,291,2
2020-04-14,Senegal,8,0,299,2
2020-04-15,Senegal,15,0,314,2
2020-04-16,Senegal,21,0,335,2
2020-04-17,Senegal,7,0,342,2
2020-04-18,Senegal,8,1,350,3
2020-04-19,Senegal,17,0,367,3
2020-04-20,Senegal,10,2,377,5
2020-04-21,Senegal,35,0,412,5
2020-04-22,Senegal,30,1,442,6
2020-04-23,Senegal,37,0,479,6
2020-04-24,Senegal,66,1,545,7
2020-04-25,Senegal,69,0,614,7
2020-04-26,Senegal,57,2,671,9
2020-04-27,Senegal,65,0,736,9
2020-04-28,Senegal,87,0,823,9
2020-04-29,Senegal,59,0,882,9
2020-04-30,Senegal,51,0,933,9
2020-05-01,Senegal,91,0,1024,9
2020-05-02,Senegal,91,0,1115,9
2020-05-03,Senegal,67,0,1182,9
2020-05-04,Senegal,89,1,1271,10
2020-05-05,Senegal,58,1,1329,11
2020-05-06,Senegal,104,1,1433,12
2020-05-07,Senegal,59,1,1492,13
2020-05-08,Senegal,59,0,1551,13
2020-05-09,Senegal,83,4,1634,17
2020-05-10,Senegal,75,2,1709,19
2020-05-11,Senegal,177,0,1886,19
2020-05-12,Senegal,109,0,1995,19
2020-05-13,Senegal,110,2,2105,21
2020-05-14,Senegal,84,2,2189,23
2020-05-15,Senegal,121,2,2310,25
2020-05-16,Senegal,119,0,2429,25
2020-05-17,Senegal,51,0,2480,25
2020-05-18,Senegal,64,1,2544,26
2020-05-19,Senegal,73,4,2617,30
2020-05-20,Senegal,97,0,2714,30
2020-05-21,Senegal,98,3,2812,33
2020-05-22,Senegal,97,0,2909,33
2020-05-23,Senegal,67,1,2976,34
2020-05-24,Senegal,71,1,3047,35
2020-05-25,Senegal,83,0,3130,35
2020-05-26,Senegal,31,1,3161,36
2020-05-27,Senegal,92,2,3253,38
2020-05-28,Senegal,95,1,3348,39
2020-05-29,Senegal,81,2,3429,41
2020-05-30,Senegal,106,1,3535,42
2020-05-31,Senegal,110,0,3645,42
2020-06-01,Senegal,94,0,3739,42
2020-06-02,Senegal,97,1,3836,43
2020-06-03,Senegal,96,2,3932,45
2020-06-04,Senegal,89,0,4021,45
2020-06-05,Senegal,134,0,4155,45
2020-06-06,Senegal,94,2,4249,47
2020-06-07,Senegal,79,2,4328,49
2020-06-08,Senegal,99,0,4427,49
2020-06-09,Senegal,89,3,4516,52
2020-06-10,Senegal,124,0,4640,52
2020-06-11,Senegal,119,3,4759,55
2020-06-12,Senegal,92,1,4851,56
2020-06-13,Senegal,145,4,4996,60
2020-06-14,Senegal,94,0,5090,60
2020-06-15,Senegal,83,4,5173,64
2020-06-16,Senegal,74,6,5247,70
2020-06-17,Senegal,122,3,5369,73
2020-06-18,Senegal,106,3,5475,76
2020-06-19,Senegal,164,3,5639,79
2020-06-20,Senegal,144,3,5783,82
2020-06-21,Senegal,105,2,5888,84
2020-06-22,Senegal,82,2,5970,86
2020-06-23,Senegal,64,3,6034,89
2020-06-24,Senegal,95,4,6129,93
2020-06-25,Senegal,104,1,6233,94
2020-06-26,Senegal,121,4,6354,98
2020-06-27,Senegal,105,4,6459,102
2020-06-28,Senegal,127,3,6586,105
2020-06-29,Senegal,112,3,6698,108
2020-06-30,Senegal,95,4,6793,112
2020-07-01,Senegal,132,4,6925,116
2020-07-02,Senegal,129,5,7054,121
2020-07-03,Senegal,110,4,7164,125
2020-07-04,Senegal,108,4,7272,129
2020-07-05,Senegal,128,4,7400,133
2020-07-06,Senegal,78,3,7478,136
2020-07-07,Senegal,69,1,7547,137
2020-07-08,Senegal,110,4,7657,141
2020-07-09,Senegal,127,2,7784,143
2020-07-10,Senegal,98,2,7882,145
2020-07-11,Senegal,132,0,8014,145
2020-07-12,Senegal,121,3,8135,148
2020-07-13,Senegal,63,2,8198,150
2020-07-14,Senegal,45,0,8243,150
2020-07-15,Senegal,126,3,8369,153
2020-07-16,Senegal,112,3,8481,156
2020-07-17,Senegal,63,4,8544,160
2020-07-18,Senegal,125,3,8669,163
2020-07-19,Senegal,141,4,8810,167
2020-07-20,Senegal,138,3,8948,170
2020-07-21,Senegal,37,4,8985,174
2020-07-22,Senegal,136,3,9121,177
2020-07-23,Senegal,145,1,9266,178
2020-07-24,Senegal,156,4,9422,182
2020-07-25,Senegal,130,5,9552,187
2020-07-26,Senegal,129,4,9681,191
2020-07-27,Senegal,83,3,9764,194
2020-07-28,Senegal,41,4,9805,198
2020-07-29,Senegal,156,2,9961,200
2020-07-30,Senegal,145,4,10106,204
2020-07-31,Senegal,126,1,10232,205
2020-08-01,Senegal,52,4,10284,209
2020-08-02,Senegal,60,0,10344,209
2020-08-03,Senegal,42,2,10386,211
2020-08-04,Senegal,46,3,10432,214
2020-08-05,Senegal,106,4,10538,218
2020-08-06,Senegal,177,5,10715,223
2020-08-07,Senegal,172,2,10887,225
2020-08-08,Senegal,116,4,11003,229
2020-08-09,Senegal,172,3,11175,232
2020-08-10,Senegal,137,4,11312,236
2020-08-11,Senegal,68,2,11380,238
2020-08-12,Senegal,207,4,11587,242
2020-08-13,Senegal,153,2,11740,244
2020-08-14,Senegal,132,5,11872,249
2020-08-15,Senegal,160,2,12032,251
2020-08-16,Senegal,130,2,12162,253
2020-08-17,Senegal,75,3,12237,256
2020-08-18,Senegal,68,0,12305,256
2020-08-19,Senegal,141,2,12446,258
2020-08-20,Senegal,113,3,12559,261
2020-08-21,Senegal,130,1,12689,262
2020-08-22,Senegal,161,4,12850,266
2020-08-23,Senegal,99,3,12949,269
2020-08-24,Senegal,64,3,13013,272
2020-08-25,Senegal,43,2,13056,274
2020-08-26,Senegal,130,1,13186,275
2020-08-27,Senegal,108,2,13294,277
2020-08-28,Senegal,90,2,13384,279
2020-08-29,Senegal,72,3,13456,282
2020-08-30,Senegal,100,2,13556,284
2020-08-31,Senegal,55,0,13611,284
2020-09-01,Senegal,44,0,13655,284
2020-09-02,Senegal,88,3,13743,287
2020-09-03,Senegal,83,0,13826,287
2020-09-04,Senegal,55,2,13881,289
2020-09-05,Senegal,67,1,13948,290
2020-09-06,Senegal,39,0,13987,290
2020-09-07,Senegal,27,1,14014,291
2020-09-08,Senegal,30,1,14044,292
2020-09-09,Senegal,58,1,14102,293
2020-09-10,Senegal,48,0,14150,293
2020-09-11,Senegal,43,0,14193,293
2020-09-12,Senegal,44,2,14237,295
2020-09-13,Senegal,43,2,14280,297
2020-09-14,Senegal,26,0,14306,297
2020-09-15,Senegal,223,1,14529,298
2020-09-16,Senegal,39,1,14568,299
2020-09-17,Senegal,50,1,14618,300
2020-09-18,Senegal,27,1,14645,301
2020-09-19,Senegal,43,1,14688,302
2020-09-20,Senegal,26,0,14714,302
2020-09-21,Senegal,24,0,14738,302
2020-09-22,Senegal,21,0,14759,302
2020-09-23,Senegal,36,1,14795,303
2020-09-24,Senegal,21,1,14816,304
2020-09-25,Senegal,23,0,14839,304
2020-09-26,Senegal,30,2,14869,306
2020-09-27,Senegal,40,2,14909,308
2020-09-28,Senegal,10,1,14919,309
2020-09-29,Senegal,26,1,14945,310
2020-09-30,Senegal,37,1,14982,311
2020-10-01,Senegal,37,0,15019,311
2020-10-02,Senegal,32,1,15051,312
2020-10-03,Senegal,17,0,15068,312
2020-10-04,Senegal,26,0,15094,312
2020-10-05,Senegal,28,0,15122,312
2020-10-06,Senegal,19,0,15141,312
2020-10-07,Senegal,33,1,15174,313
2020-10-08,Senegal,16,0,15190,313
2020-10-09,Senegal,23,0,15213,313
2020-10-10,Senegal,31,1,15244,314
2020-10-11,Senegal,24,0,15268,314
2020-10-12,Senegal,24,1,15292,315
2020-10-13,Senegal,15,0,15307,315
2020-10-14,Senegal,24,1,15331,316
2020-10-15,Senegal,17,0,15348,316
2020-10-16,Senegal,20,1,15368,317
2020-10-17,Senegal,24,0,15392,317
2020-10-18,Senegal,26,0,15418,317
2020-10-19,Senegal,14,2,15432,319
2020-10-20,Senegal,27,1,15459,320
2020-10-21,Senegal,25,1,15484,321
2020-10-22,Senegal,24,0,15508,321
2020-10-23,Senegal,17,0,15525,321
2020-10-24,Senegal,18,0,15543,321
2020-10-25,Senegal,8,0,15551,321
2020-10-26,Senegal,14,1,15565,322
2020-10-27,Senegal,6,0,15571,322
2020-10-28,Senegal,11,0,15582,322
2020-10-29,Senegal,11,1,15593,323
2020-10-30,Senegal,12,0,15605,323
2020-10-31,Senegal,11,1,15616,324
2020-11-01,Senegal,14,1,15630,325
2020-11-02,Senegal,7,0,15637,325
2020-11-03,Senegal,3,1,15640,326
2020-11-04,Senegal,10,0,15650,326
2020-11-05,Senegal,18,0,15668,326
2020-11-06,Senegal,8,0,15676,326
2020-11-07,Senegal,17,0,15693,326
2020-11-08,Senegal,15,0,15708,326
2020-11-09,Senegal,3,0,15711,326
2020-11-10,Senegal,9,0,15720,326
2020-11-11,Senegal,15,0,15735,326
2020-11-12,Senegal,9,0,15744,326
2020-11-13,Senegal,11,0,15755,326
2020-11-14,Senegal,24,1,15779,327
2020-11-15,Senegal,14,1,15793,328
2020-11-16,Senegal,8,1,15801,329
2020-11-17,Senegal,5,0,15806,329
2020-11-18,Senegal,17,0,15823,329
2020-11-19,Senegal,12,0,15835,329
2020-11-20,Senegal,13,1,15848,330
2020-11-21,Senegal,17,0,15865,330
2020-11-22,Senegal,17,0,15882,330
2020-11-23,Senegal,15,0,15897,330
2020-11-24,Senegal,11,1,15908,331
2020-11-25,Senegal,19,0,15927,331
2020-11-26,Senegal,33,0,15960,331
2020-11-27,Senegal,21,1,15981,332
2020-11-28,Senegal,46,0,16027,332
2020-11-29,Senegal,48,1,16075,333
2020-11-30,Senegal,14,0,16089,333
2020-12-01,Senegal,18,0,16107,333
2020-12-02,Senegal,66,1,16173,334
2020-12-03,Senegal,44,1,16217,335
2020-12-04,Senegal,80,1,16297,336
2020-12-05,Senegal,100,1,16397,337
2020-12-06,Senegal,80,1,16477,338
2020-12-07,Senegal,76,2,16553,340
2020-12-08,Senegal,43,0,16596,340
2020-12-09,Senegal,69,1,16665,341
2020-12-10,Senegal,101,2,16766,343
2020-12-11,Senegal,127,2,16893,345
2020-12-12,Senegal,168,4,17061,349
2020-12-13,Senegal,14,0,17075,349
2020-12-14,Senegal,71,1,17146,350
2020-12-15,Senegal,70,0,17216,350
2020-12-16,Senegal,120,2,17336,352
2020-12-17,Senegal,115,3,17451,355
2020-12-18,Senegal,108,2,17559,357
2020-12-19,Senegal,111,4,17670,361
2020-12-20,Senegal,88,4,17758,365
2020-12-21,Senegal,121,6,17879,371
2020-12-22,Senegal,66,1,17945,372
2020-12-23,Senegal,98,6,18043,378
2020-12-24,Senegal,157,3,18200,381
2020-12-25,Senegal,169,5,18369,386
2020-12-26,Senegal,154,1,18523,387
2020-12-27,Senegal,86,1,18609,388
2020-12-28,Senegal,119,2,18728,390
2020-12-29,Senegal,78,5,18806,395
2020-12-30,Senegal,139,7,18945,402
2020-12-31,Senegal,195,8,19140,410
2021-01-01,Senegal,224,0,19364,410
2021-01-02,Senegal,147,6,19511,416
2021-01-03,Senegal,186,5,19697,421
2021-01-04,Senegal,106,3,19803,424
2021-01-05,Senegal,161,4,19964,428
2021-01-06,Senegal,192,5,20156,433
2021-01-07,Senegal,220,5,20376,438
2021-01-08,Senegal,296,8,20672,446
2021-01-09,Senegal,328,13,21000,459
2021-01-10,Senegal,245,6,21245,465
2021-01-11,Senegal,288,4,21533,469
2021-01-12,Senegal,152,11,21685,480
2021-01-13,Senegal,198,9,21883,489
2021-01-14,Senegal,295,7,22178,496
2021-01-15,Senegal,218,10,22396,506
2021-01-16,Senegal,342,3,22738,509
2021-01-17,Senegal,290,6,23028,515
2021-01-18,Senegal,196,11,23224,526
2021-01-19,Senegal,168,10,23392,536
2021-01-20,Senegal,250,10,23642,546
2021-01-21,Senegal,267,6,23909,552
2021-01-22,Senegal,300,9,24209,561
2021-01-23,Senegal,250,8,24459,569
2021-01-24,Senegal,268,6,24727,575
2021-01-25,Senegal,266,7,24993,582
2021-01-26,Senegal,134,10,25127,592
2021-01-27,Senegal,280,9,25407,601
2021-01-28,Senegal,304,13,25711,614
2021-01-29,Senegal,184,3,25895,617
2021-01-30,Senegal,318,4,26213,621
2021-01-31,Senegal,310,7,26523,628
2021-02-01,Senegal,404,10,26927,638
2021-02-02,Senegal,153,3,27080,641
2021-02-03,Senegal,285,7,27365,648
2021-02-04,Senegal,368,11,27733,659
2021-02-05,Senegal,373,7,28106,666
2021-02-06,Senegal,383,9,28489,675
2021-02-07,Senegal,271,7,28760,682
2021-02-08,Senegal,297,7,29057,689
2021-02-09,Senegal,188,11,29245,700
2021-02-10,Senegal,276,12,29521,712
2021-02-11,Senegal,393,12,29914,724
2021-02-12,Senegal,462,11,30376,735
2021-02-13,Senegal,265,6,30641,741
2021-02-14,Senegal,366,7,31007,748
2021-02-15,Senegal,268,6,31275,754
2021-02-16,Senegal,201,6,31476,760
2021-02-17,Senegal,295,9,31771,769
2021-02-18,Senegal,328,12,32099,781
2021-02-19,Senegal,279,6,32378,787
2021-02-20,Senegal,252,8,32630,795
2021-02-21,Senegal,297,13,32927,808
2021-02-22,Senegal,172,6,33099,814
2021-02-23,Senegal,143,18,33242,832
2021-02-24,Senegal,211,8,33453,840
2021-02-25,Senegal,288,12,33741,852
2021-02-26,Senegal,290,5,34031,857
2021-02-27,Senegal,224,9,34255,866
2021-02-28,Senegal,265,6,34520,872
2021-03-01,Senegal,212,8,34732,880
2021-03-02,Senegal,100,8,34832,888
2021-03-03,Senegal,205,8,35037,896
2021-03-04,Senegal,210,2,35247,898
2021-03-05,Senegal,221,5,35468,903
2021-03-06,Senegal,164,4,35632,907
2021-03-07,Senegal,225,12,35857,919
2021-03-08,Senegal,102,6,35959,925
2021-03-09,Senegal,80,5,36039,930
2021-03-10,Senegal,156,5,36195,935
2021-03-11,Senegal,176,6,36371,941
2021-03-12,Senegal,198,10,36569,951
2021-03-13,Senegal,157,4,36726,955
2021-03-14,Senegal,166,8,36892,963
2021-03-15,Senegal,104,15,36996,978
2021-03-16,Senegal,66,3,37062,981
2021-03-17,Senegal,192,9,37254,990
2021-03-18,Senegal,174,5,37428,995
2021-03-19,Senegal,113,8,37541,1003
2021-03-20,Senegal,152,4,37693,1007
2021-03-21,Senegal,140,6,37833,1013
2021-03-22,Senegal,87,3,37920,1016
2021-03-23,Senegal,38,4,37958,1020
2021-03-24,Senegal,176,3,38134,1023
2021-03-25,Senegal,121,5,38255,1028
2021-03-26,Senegal,99,3,38354,1031
2021-03-27,Senegal,102,3,38456,1034
2021-03-28,Senegal,64,3,38520,1037
2021-03-29,Senegal,46,7,38566,1044
2021-03-30,Senegal,52,5,38618,1049
2021-03-31,Senegal,87,2,38705,1051
2021-04-01,Senegal,77,3,38782,1054
2021-04-02,Senegal,107,2,38889,1056
2021-04-03,Senegal,64,7,38953,1063
2021-04-04,Senegal,71,0,39024,1063
2021-04-05,Senegal,69,0,39093,1063
2021-04-06,Senegal,34,2,39127,1065
2021-04-07,Senegal,37,5,39164,1070
2021-04-08,Senegal,73,3,39237,1073
2020-03-06,Serbia,1,0,1,0
2020-03-07,Serbia,0,0,1,0
2020-03-08,Serbia,0,0,1,0
2020-03-09,Serbia,0,0,1,0
2020-03-10,Serbia,4,0,5,0
2020-03-11,Serbia,7,0,12,0
2020-03-12,Serbia,7,0,19,0
2020-03-13,Serbia,16,0,35,0
2020-03-14,Serbia,11,0,46,0
2020-03-15,Serbia,2,0,48,0
2020-03-16,Serbia,7,0,55,0
2020-03-17,Serbia,10,0,65,0
2020-03-18,Serbia,18,0,83,0
2020-03-19,Serbia,20,0,103,0
2020-03-20,Serbia,32,1,135,1
2020-03-21,Serbia,36,0,171,1
2020-03-22,Serbia,51,1,222,2
2020-03-23,Serbia,27,1,249,3
2020-03-24,Serbia,54,0,303,3
2020-03-25,Serbia,81,1,384,4
2020-03-26,Serbia,0,-3,384,1
2020-03-27,Serbia,73,0,457,1
2020-03-28,Serbia,202,9,659,10
2020-03-29,Serbia,82,3,741,13
2020-03-30,Serbia,44,3,785,16
2020-03-31,Serbia,115,0,900,16
2020-04-01,Serbia,160,12,1060,28
2020-04-02,Serbia,111,3,1171,31
2020-04-03,Serbia,305,8,1476,39
2020-04-04,Serbia,148,5,1624,44
2020-04-05,Serbia,284,7,1908,51
2020-04-06,Serbia,292,7,2200,58
2020-04-07,Serbia,247,3,2447,61
2020-04-08,Serbia,219,4,2666,65
2020-04-09,Serbia,201,1,2867,66
2020-04-10,Serbia,238,5,3105,71
2020-04-11,Serbia,275,3,3380,74
2020-04-12,Serbia,250,6,3630,80
2020-04-13,Serbia,424,5,4054,85
2020-04-14,Serbia,411,9,4465,94
2020-04-15,Serbia,408,5,4873,99
2020-04-16,Serbia,445,4,5318,103
2020-04-17,Serbia,372,7,5690,110
2020-04-18,Serbia,304,7,5994,117
2020-04-19,Serbia,324,5,6318,122
2020-04-20,Serbia,312,3,6630,125
2020-04-21,Serbia,260,5,6890,130
2020-04-22,Serbia,254,4,7144,134
2020-04-23,Serbia,132,5,7276,139
2020-04-24,Serbia,207,5,7483,144
2020-04-25,Serbia,296,7,7779,151
2020-04-26,Serbia,263,5,8042,156
2020-04-27,Serbia,233,6,8275,162
2020-04-28,Serbia,222,6,8497,168
2020-04-29,Serbia,227,5,8724,173
2020-04-30,Serbia,285,6,9009,179
2020-05-01,Serbia,0,0,9009,179
2020-05-02,Serbia,353,10,9362,189
2020-05-03,Serbia,102,4,9464,193
2020-05-04,Serbia,93,4,9557,197
2020-05-05,Serbia,120,3,9677,200
2020-05-06,Serbia,114,3,9791,203
2020-05-07,Serbia,57,3,9848,206
2020-05-08,Serbia,95,3,9943,209
2020-05-09,Serbia,89,6,10032,215
2020-05-10,Serbia,0,0,10032,215
2020-05-11,Serbia,144,3,10176,218
2020-05-12,Serbia,67,2,10243,220
2020-05-13,Serbia,52,2,10295,222
2020-05-14,Serbia,79,2,10374,224
2020-05-15,Serbia,64,1,10438,225
2020-05-16,Serbia,58,3,10496,228
2020-05-17,Serbia,114,2,10610,230
2020-05-18,Serbia,89,1,10699,231
2020-05-19,Serbia,34,3,10733,234
2020-05-20,Serbia,100,1,10833,235
2020-05-21,Serbia,86,2,10919,237
2020-05-22,Serbia,105,0,11024,237
2020-05-23,Serbia,68,1,11092,238
2020-05-24,Serbia,67,0,11159,238
2020-05-25,Serbia,34,1,11193,239
2020-05-26,Serbia,34,0,11227,239
2020-05-27,Serbia,48,1,11275,240
2020-05-28,Serbia,25,1,11300,241
2020-05-29,Serbia,54,1,11354,242
2020-05-30,Serbia,27,0,11381,242
2020-05-31,Serbia,31,1,11412,243
2020-06-01,Serbia,18,1,11430,244
2020-06-02,Serbia,24,1,11454,245
2020-06-03,Serbia,69,0,11523,245
2020-06-04,Serbia,48,1,11571,246
2020-06-05,Serbia,96,1,11667,247
2020-06-06,Serbia,74,1,11741,248
2020-06-07,Serbia,82,1,11823,249
2020-06-08,Serbia,73,1,11896,250
2020-06-09,Serbia,69,0,11965,250
2020-06-10,Serbia,66,1,12031,251
2020-06-11,Serbia,71,1,12102,252
2020-06-12,Serbia,73,0,12175,252
2020-06-13,Serbia,76,1,12251,253
2020-06-14,Serbia,59,1,12310,254
2020-06-15,Serbia,57,1,12367,255
2020-06-16,Serbia,59,1,12426,256
2020-06-17,Serbia,96,1,12522,257
2020-06-18,Serbia,94,1,12616,258
2020-06-19,Serbia,93,1,12709,259
2020-06-20,Serbia,94,1,12803,260
2020-06-21,Serbia,91,1,12894,261
2020-06-22,Serbia,96,1,12990,262
2020-06-23,Serbia,102,1,13092,263
2020-06-24,Serbia,143,0,13235,263
2020-06-25,Serbia,137,1,13372,264
2020-06-26,Serbia,193,1,13565,265
2020-06-27,Serbia,227,2,13792,267
2020-06-28,Serbia,254,3,14046,270
2020-06-29,Serbia,242,4,14288,274
2020-06-30,Serbia,276,3,14564,277
2020-07-01,Serbia,272,4,14836,281
2020-07-02,Serbia,359,6,15195,287
2020-07-03,Serbia,309,11,15504,298
2020-07-04,Serbia,325,8,15829,306
2020-07-05,Serbia,302,5,16131,311
2020-07-06,Serbia,289,6,16420,317
2020-07-07,Serbia,299,13,16719,330
2020-07-08,Serbia,357,11,17076,341
2020-07-09,Serbia,266,11,17342,352
2020-07-10,Serbia,386,18,17728,370
2020-07-11,Serbia,345,12,18073,382
2020-07-12,Serbia,287,11,18360,393
2020-07-13,Serbia,279,12,18639,405
2020-07-14,Serbia,344,13,18983,418
2020-07-15,Serbia,351,11,19334,429
2020-07-16,Serbia,383,13,19717,442
2020-07-17,Serbia,392,10,20109,452
2020-07-18,Serbia,389,9,20498,461
2020-07-19,Serbia,396,11,20894,472
2020-07-20,Serbia,359,10,21253,482
2020-07-21,Serbia,352,9,21605,491
2020-07-22,Serbia,426,8,22031,499
2020-07-23,Serbia,412,9,22443,508
2020-07-24,Serbia,409,10,22852,518
2020-07-25,Serbia,0,0,22852,518
2020-07-26,Serbia,878,16,23730,534
2020-07-27,Serbia,411,9,24141,543
2020-07-28,Serbia,379,8,24520,551
2020-07-29,Serbia,372,7,24892,558
2020-07-30,Serbia,321,7,25213,565
2020-07-31,Serbia,339,8,25552,573
2020-08-01,Serbia,330,9,25882,582
2020-08-02,Serbia,311,8,26193,590
2020-08-03,Serbia,258,8,26451,598
2020-08-04,Serbia,287,7,26738,605
2020-08-05,Serbia,295,9,27033,614
2020-08-06,Serbia,299,7,27332,621
2020-08-07,Serbia,276,5,27608,626
2020-08-08,Serbia,255,6,27863,632
2020-08-09,Serbia,236,9,28099,641
2020-08-10,Serbia,163,5,28262,646
2020-08-11,Serbia,235,6,28497,652
2020-08-12,Serbia,254,6,28751,658
2020-08-13,Serbia,247,3,28998,661
2020-08-14,Serbia,235,4,29233,665
2020-08-15,Serbia,238,5,29471,670
2020-08-16,Serbia,211,4,29682,674
2020-08-17,Serbia,100,3,29782,677
2020-08-18,Serbia,108,4,29890,681
2020-08-19,Serbia,158,3,30048,684
2020-08-20,Serbia,161,5,30209,689
2020-08-21,Serbia,169,3,30378,692
2020-08-22,Serbia,170,3,30548,695
2020-08-23,Serbia,109,3,30657,698
2020-08-24,Serbia,57,3,30714,701
2020-08-25,Serbia,106,4,30820,705
2020-08-26,Serbia,154,2,30974,707
2020-08-27,Serbia,125,0,31099,707
2020-08-28,Serbia,108,2,31207,709
2020-08-29,Serbia,75,1,31282,710
2020-08-30,Serbia,83,1,31365,711
2020-08-31,Serbia,41,2,31406,713
2020-09-01,Serbia,76,2,31482,715
2020-09-02,Serbia,99,1,31581,716
2020-09-03,Serbia,95,2,31676,718
2020-09-04,Serbia,96,3,31772,721
2020-09-05,Serbia,77,2,31849,723
2020-09-06,Serbia,56,1,31905,724
2020-09-07,Serbia,36,1,31941,725
2020-09-08,Serbia,53,2,31994,727
2020-09-09,Serbia,84,1,32078,728
2020-09-10,Serbia,58,1,32136,729
2020-09-11,Serbia,92,1,32228,730
2020-09-12,Serbia,72,1,32300,731
2020-09-13,Serbia,108,2,32408,733
2020-09-14,Serbia,29,0,32437,733
2020-09-15,Serbia,74,2,32511,735
2020-09-16,Serbia,102,1,32613,736
2020-09-17,Serbia,82,2,32695,738
2020-09-18,Serbia,62,1,32757,739
2020-09-19,Serbia,83,1,32840,740
2020-09-20,Serbia,68,1,32908,741
2020-09-21,Serbia,30,2,32938,743
2020-09-22,Serbia,61,0,32999,743
2020-09-23,Serbia,81,1,33080,744
2020-09-24,Serbia,83,1,33163,745
2020-09-25,Serbia,75,1,33238,746
2020-09-26,Serbia,74,0,33312,746
2020-09-27,Serbia,72,1,33384,747
2020-09-28,Serbia,30,1,33414,748
2020-09-29,Serbia,65,1,33479,749
2020-09-30,Serbia,72,0,33551,749
2020-10-01,Serbia,111,1,33662,750
2020-10-02,Serbia,73,1,33735,751
2020-10-03,Serbia,107,2,33842,753
2020-10-04,Serbia,59,1,33901,754
2020-10-05,Serbia,51,2,33952,756
2020-10-06,Serbia,120,1,34072,757
2020-10-07,Serbia,121,1,34193,758
2020-10-08,Serbia,151,2,34344,760
2020-10-09,Serbia,173,1,34517,761
2020-10-10,Serbia,168,1,34685,762
2020-10-11,Serbia,102,1,34787,763
2020-10-12,Serbia,67,2,34854,765
2020-10-13,Serbia,152,2,35006,767
2020-10-14,Serbia,245,1,35251,768
2020-10-15,Serbia,203,2,35454,770
2020-10-16,Serbia,265,2,35719,772
2020-10-17,Serbia,227,2,35946,774
2020-10-18,Serbia,214,2,36160,776
2020-10-19,Serbia,122,2,36282,778
2020-10-20,Serbia,326,2,36608,780
2020-10-21,Serbia,512,0,37120,780
2020-10-22,Serbia,416,3,37536,783
2020-10-23,Serbia,579,3,38115,786
2020-10-24,Serbia,757,3,38872,789
2020-10-25,Serbia,614,3,39486,792
2020-10-26,Serbia,341,1,39827,793
2020-10-27,Serbia,1053,5,40880,798
2020-10-28,Serbia,1328,5,42208,803
2020-10-29,Serbia,1384,6,43592,809
2020-10-30,Serbia,1545,5,45137,814
2020-10-31,Serbia,1817,6,46954,820
2020-11-01,Serbia,1449,6,48403,826
2020-11-02,Serbia,802,7,49205,833
2020-11-03,Serbia,1878,11,51083,844
2020-11-04,Serbia,2412,6,53495,850
2020-11-05,Serbia,2181,11,55676,861
2020-11-06,Serbia,2282,10,57958,871
2020-11-07,Serbia,2677,9,60635,880
2020-11-08,Serbia,2112,10,62747,890
2020-11-09,Serbia,1318,11,64065,901
2020-11-10,Serbia,2823,14,66888,915
2020-11-11,Serbia,3536,21,70424,936
2020-11-12,Serbia,3341,19,73765,955
2020-11-13,Serbia,3499,17,77264,972
2020-11-14,Serbia,3822,17,81086,989
2020-11-15,Serbia,3482,20,84568,1009
2020-11-16,Serbia,2813,21,87381,1030
2020-11-17,Serbia,4994,24,92375,1054
2020-11-18,Serbia,5613,27,97988,1081
2020-11-19,Serbia,6109,29,104097,1110
2020-11-20,Serbia,6254,30,110351,1140
2020-11-21,Serbia,5774,28,116125,1168
2020-11-22,Serbia,4995,31,121120,1199
2020-11-23,Serbia,5067,38,126187,1237
2020-11-24,Serbia,6842,37,133029,1274
2020-11-25,Serbia,7579,41,140608,1315
2020-11-26,Serbia,7606,51,148214,1366
2020-11-27,Serbia,7780,57,155994,1423
2020-11-28,Serbia,7041,61,163035,1484
2020-11-29,Serbia,6179,65,169214,1549
2020-11-30,Serbia,6224,55,175438,1604
2020-12-01,Serbia,7999,48,183437,1652
2020-12-02,Serbia,7919,52,191356,1704
2020-12-03,Serbia,7802,61,199158,1765
2020-12-04,Serbia,7782,69,206940,1834
2020-12-05,Serbia,6903,57,213843,1891
2020-12-06,Serbia,5809,58,219652,1949
2020-12-07,Serbia,6557,56,226209,2005
2020-12-08,Serbia,7818,57,234027,2062
2020-12-09,Serbia,7804,54,241831,2116
2020-12-10,Serbia,7393,56,249224,2172
2020-12-11,Serbia,6534,55,255758,2227
2020-12-12,Serbia,5679,48,261437,2275
2020-12-13,Serbia,4995,56,266432,2331
2020-12-14,Serbia,4932,49,271364,2380
2020-12-15,Serbia,5884,53,277248,2433
2020-12-16,Serbia,5353,49,282601,2482
2020-12-17,Serbia,5129,47,287730,2529
2020-12-18,Serbia,4910,51,292640,2580
2020-12-19,Serbia,3888,52,296528,2632
2020-12-20,Serbia,3534,54,300062,2686
2020-12-21,Serbia,3685,47,303747,2733
2020-12-22,Serbia,4080,49,307827,2782
2020-12-23,Serbia,4426,51,312253,2833
2020-12-24,Serbia,4091,49,316344,2882
2020-12-25,Serbia,3823,49,320167,2931
2020-12-26,Serbia,3200,52,323367,2983
2020-12-27,Serbia,2693,47,326060,3030
2020-12-28,Serbia,2559,43,328619,3073
2020-12-29,Serbia,3136,46,331755,3119
2020-12-30,Serbia,3236,44,334991,3163
2020-12-31,Serbia,2932,48,337923,3211
2021-01-01,Serbia,2074,39,339997,3250
2021-01-02,Serbia,1907,38,341904,3288
2021-01-03,Serbia,1966,37,343870,3325
2021-01-04,Serbia,2715,39,346585,3364
2021-01-05,Serbia,2653,41,349238,3405
2021-01-06,Serbia,2882,39,352120,3444
2021-01-07,Serbia,1787,35,353907,3479
2021-01-08,Serbia,2218,34,356125,3513
2021-01-09,Serbia,0,0,356125,3513
2021-01-10,Serbia,3564,69,359689,3582
2021-01-11,Serbia,2093,28,361782,3610
2021-01-12,Serbia,2142,29,363924,3639
2021-01-13,Serbia,2267,25,366191,3664
2021-01-14,Serbia,1881,23,368072,3687
2021-01-15,Serbia,1751,21,369823,3708
2021-01-16,Serbia,1393,22,371216,3730
2021-01-17,Serbia,1317,20,372533,3750
2021-01-18,Serbia,1578,21,374111,3771
2021-01-19,Serbia,1688,20,375799,3791
2021-01-20,Serbia,1646,19,377445,3810
2021-01-21,Serbia,1648,20,379093,3830
2021-01-22,Serbia,1709,19,380802,3849
2021-01-23,Serbia,1483,19,382285,3868
2021-01-24,Serbia,1318,18,383603,3886
2021-01-25,Serbia,1523,19,385126,3905
2021-01-26,Serbia,2080,19,387206,3924
2021-01-27,Serbia,1839,20,389045,3944
2021-01-28,Serbia,1592,21,390637,3965
2021-01-29,Serbia,1717,18,392354,3983
2021-01-30,Serbia,1543,17,393897,4000
2021-01-31,Serbia,1366,20,395263,4020
2021-02-01,Serbia,1739,18,397002,4038
2021-02-02,Serbia,1903,18,398905,4056
2021-02-03,Serbia,1932,15,400837,4071
2021-02-04,Serbia,1863,14,402700,4085
2021-02-05,Serbia,1968,14,404668,4099
2021-02-06,Serbia,1684,13,406352,4112
2021-02-07,Serbia,1529,14,407881,4126
2021-02-08,Serbia,1960,13,409841,4139
2021-02-09,Serbia,2014,15,411855,4154
2021-02-10,Serbia,2088,14,413943,4168
2021-02-11,Serbia,2000,15,415943,4183
2021-02-12,Serbia,1928,16,417871,4199
2021-02-13,Serbia,1622,15,419493,4214
2021-02-14,Serbia,1386,16,420879,4230
2021-02-15,Serbia,1331,15,422210,4245
2021-02-16,Serbia,1810,16,424020,4261
2021-02-17,Serbia,2467,16,426487,4277
2021-02-18,Serbia,2561,15,429048,4292
2021-02-19,Serbia,2632,14,431680,4306
2021-02-20,Serbia,2442,15,434122,4321
2021-02-21,Serbia,2518,16,436640,4337
2021-02-22,Serbia,2956,14,439596,4351
2021-02-23,Serbia,3257,15,442853,4366
2021-02-24,Serbia,3460,17,446313,4383
2021-02-25,Serbia,3588,15,449901,4398
2021-02-26,Serbia,3339,16,453240,4414
2021-02-27,Serbia,3210,15,456450,4429
2021-02-28,Serbia,2809,14,459259,4443
2021-03-01,Serbia,3469,16,462728,4459
2021-03-02,Serbia,4157,16,466885,4475
2021-03-03,Serbia,4056,16,470941,4491
2021-03-04,Serbia,3866,17,474807,4508
2021-03-05,Serbia,4071,17,478878,4525
2021-03-06,Serbia,3519,17,482397,4542
2021-03-07,Serbia,3042,20,485439,4562
2021-03-08,Serbia,4091,17,489530,4579
2021-03-09,Serbia,4576,20,494106,4599
2021-03-10,Serbia,4590,21,498696,4620
2021-03-11,Serbia,4595,24,503291,4644
2021-03-12,Serbia,4668,26,507959,4670
2021-03-13,Serbia,4092,24,512051,4694
2021-03-14,Serbia,4226,25,516277,4719
2021-03-15,Serbia,4634,28,520911,4747
2021-03-16,Serbia,5201,31,526112,4778
2021-03-17,Serbia,5446,32,531558,4810
2021-03-18,Serbia,5346,30,536904,4840
2021-03-19,Serbia,5305,29,542209,4869
2021-03-20,Serbia,4687,31,546896,4900
2021-03-21,Serbia,4232,34,551128,4934
2021-03-22,Serbia,4769,32,555897,4966
2021-03-23,Serbia,5475,36,561372,5002
2021-03-24,Serbia,5297,37,566669,5039
2021-03-25,Serbia,5226,36,571895,5075
2021-03-26,Serbia,0,0,571895,5075
2021-03-27,Serbia,9722,76,581617,5151
2021-03-28,Serbia,3889,39,585506,5190
2021-03-29,Serbia,0,0,585506,5190
2021-03-30,Serbia,9983,80,595489,5270
2021-03-31,Serbia,5107,38,600596,5308
2021-04-01,Serbia,4810,37,605406,5345
2021-04-02,Serbia,4826,39,610232,5384
2021-04-03,Serbia,4133,38,614365,5422
2021-04-04,Serbia,3304,36,617669,5458
2021-04-05,Serbia,3706,39,621375,5497
2021-04-06,Serbia,4398,40,625773,5537
2021-04-07,Serbia,3615,42,629388,5579
2021-04-08,Serbia,3625,41,633013,5620
2020-03-14,Seychelles,2,0,2,0
2020-03-15,Seychelles,0,0,2,0
2020-03-16,Seychelles,1,0,3,0
2020-03-17,Seychelles,1,0,4,0
2020-03-18,Seychelles,0,0,4,0
2020-03-19,Seychelles,2,0,6,0
2020-03-20,Seychelles,1,0,7,0
2020-03-21,Seychelles,0,0,7,0
2020-03-22,Seychelles,0,0,7,0
2020-03-23,Seychelles,0,0,7,0
2020-03-24,Seychelles,0,0,7,0
2020-03-25,Seychelles,0,0,7,0
2020-03-26,Seychelles,0,0,7,0
2020-03-27,Seychelles,0,0,7,0
2020-03-28,Seychelles,1,0,8,0
2020-03-29,Seychelles,0,0,8,0
2020-03-30,Seychelles,0,0,8,0
2020-03-31,Seychelles,2,0,10,0
2020-04-01,Seychelles,0,0,10,0
2020-04-02,Seychelles,0,0,10,0
2020-04-03,Seychelles,0,0,10,0
2020-04-04,Seychelles,0,0,10,0
2020-04-05,Seychelles,0,0,10,0
2020-04-06,Seychelles,1,0,11,0
2020-04-07,Seychelles,0,0,11,0
2020-04-08,Seychelles,0,0,11,0
2020-04-09,Seychelles,0,0,11,0
2020-04-10,Seychelles,0,0,11,0
2020-04-11,Seychelles,0,0,11,0
2020-04-12,Seychelles,0,0,11,0
2020-04-13,Seychelles,0,0,11,0
2020-04-14,Seychelles,0,0,11,0
2020-04-15,Seychelles,0,0,11,0
2020-04-16,Seychelles,0,0,11,0
2020-04-17,Seychelles,0,0,11,0
2020-04-18,Seychelles,0,0,11,0
2020-04-19,Seychelles,0,0,11,0
2020-04-20,Seychelles,0,0,11,0
2020-04-21,Seychelles,0,0,11,0
2020-04-22,Seychelles,0,0,11,0
2020-04-23,Seychelles,0,0,11,0
2020-04-24,Seychelles,0,0,11,0
2020-04-25,Seychelles,0,0,11,0
2020-04-26,Seychelles,0,0,11,0
2020-04-27,Seychelles,0,0,11,0
2020-04-28,Seychelles,0,0,11,0
2020-04-29,Seychelles,0,0,11,0
2020-04-30,Seychelles,0,0,11,0
2020-05-01,Seychelles,0,0,11,0
2020-05-02,Seychelles,0,0,11,0
2020-05-03,Seychelles,0,0,11,0
2020-05-04,Seychelles,0,0,11,0
2020-05-05,Seychelles,0,0,11,0
2020-05-06,Seychelles,0,0,11,0
2020-05-07,Seychelles,0,0,11,0
2020-05-08,Seychelles,0,0,11,0
2020-05-09,Seychelles,0,0,11,0
2020-05-10,Seychelles,0,0,11,0
2020-05-11,Seychelles,0,0,11,0
2020-05-12,Seychelles,0,0,11,0
2020-05-13,Seychelles,0,0,11,0
2020-05-14,Seychelles,0,0,11,0
2020-05-15,Seychelles,0,0,11,0
2020-05-16,Seychelles,0,0,11,0
2020-05-17,Seychelles,0,0,11,0
2020-05-18,Seychelles,0,0,11,0
2020-05-19,Seychelles,0,0,11,0
2020-05-20,Seychelles,0,0,11,0
2020-05-21,Seychelles,0,0,11,0
2020-05-22,Seychelles,0,0,11,0
2020-05-23,Seychelles,0,0,11,0
2020-05-24,Seychelles,0,0,11,0
2020-05-25,Seychelles,0,0,11,0
2020-05-26,Seychelles,0,0,11,0
2020-05-27,Seychelles,0,0,11,0
2020-05-28,Seychelles,0,0,11,0
2020-05-29,Seychelles,0,0,11,0
2020-05-30,Seychelles,0,0,11,0
2020-05-31,Seychelles,0,0,11,0
2020-06-01,Seychelles,0,0,11,0
2020-06-02,Seychelles,0,0,11,0
2020-06-03,Seychelles,0,0,11,0
2020-06-04,Seychelles,0,0,11,0
2020-06-05,Seychelles,0,0,11,0
2020-06-06,Seychelles,0,0,11,0
2020-06-07,Seychelles,0,0,11,0
2020-06-08,Seychelles,0,0,11,0
2020-06-09,Seychelles,0,0,11,0
2020-06-10,Seychelles,0,0,11,0
2020-06-11,Seychelles,0,0,11,0
2020-06-12,Seychelles,0,0,11,0
2020-06-13,Seychelles,0,0,11,0
2020-06-14,Seychelles,0,0,11,0
2020-06-15,Seychelles,0,0,11,0
2020-06-16,Seychelles,0,0,11,0
2020-06-17,Seychelles,0,0,11,0
2020-06-18,Seychelles,0,0,11,0
2020-06-19,Seychelles,0,0,11,0
2020-06-20,Seychelles,0,0,11,0
2020-06-21,Seychelles,0,0,11,0
2020-06-22,Seychelles,0,0,11,0
2020-06-23,Seychelles,0,0,11,0
2020-06-24,Seychelles,0,0,11,0
2020-06-25,Seychelles,0,0,11,0
2020-06-26,Seychelles,0,0,11,0
2020-06-27,Seychelles,9,0,20,0
2020-06-28,Seychelles,50,0,70,0
2020-06-29,Seychelles,7,0,77,0
2020-06-30,Seychelles,4,0,81,0
2020-07-01,Seychelles,0,0,81,0
2020-07-02,Seychelles,0,0,81,0
2020-07-03,Seychelles,0,0,81,0
2020-07-04,Seychelles,0,0,81,0
2020-07-05,Seychelles,0,0,81,0
2020-07-06,Seychelles,0,0,81,0
2020-07-07,Seychelles,0,0,81,0
2020-07-08,Seychelles,10,0,91,0
2020-07-09,Seychelles,3,0,94,0
2020-07-10,Seychelles,6,0,100,0
2020-07-11,Seychelles,0,0,100,0
2020-07-12,Seychelles,0,0,100,0
2020-07-13,Seychelles,0,0,100,0
2020-07-14,Seychelles,0,0,100,0
2020-07-15,Seychelles,0,0,100,0
2020-07-16,Seychelles,8,0,108,0
2020-07-17,Seychelles,0,0,108,0
2020-07-18,Seychelles,0,0,108,0
2020-07-19,Seychelles,0,0,108,0
2020-07-20,Seychelles,0,0,108,0
2020-07-21,Seychelles,0,0,108,0
2020-07-22,Seychelles,0,0,108,0
2020-07-23,Seychelles,0,0,108,0
2020-07-24,Seychelles,0,0,108,0
2020-07-25,Seychelles,6,0,114,0
2020-07-26,Seychelles,0,0,114,0
2020-07-27,Seychelles,0,0,114,0
2020-07-28,Seychelles,0,0,114,0
2020-07-29,Seychelles,0,0,114,0
2020-07-30,Seychelles,0,0,114,0
2020-07-31,Seychelles,0,0,114,0
2020-08-01,Seychelles,0,0,114,0
2020-08-02,Seychelles,0,0,114,0
2020-08-03,Seychelles,0,0,114,0
2020-08-04,Seychelles,0,0,114,0
2020-08-05,Seychelles,12,0,126,0
2020-08-06,Seychelles,0,0,126,0
2020-08-07,Seychelles,0,0,126,0
2020-08-08,Seychelles,0,0,126,0
2020-08-09,Seychelles,0,0,126,0
2020-08-10,Seychelles,0,0,126,0
2020-08-11,Seychelles,1,0,127,0
2020-08-12,Seychelles,0,0,127,0
2020-08-13,Seychelles,0,0,127,0
2020-08-14,Seychelles,0,0,127,0
2020-08-15,Seychelles,0,0,127,0
2020-08-16,Seychelles,0,0,127,0
2020-08-17,Seychelles,0,0,127,0
2020-08-18,Seychelles,0,0,127,0
2020-08-19,Seychelles,5,0,132,0
2020-08-20,Seychelles,0,0,132,0
2020-08-21,Seychelles,0,0,132,0
2020-08-22,Seychelles,0,0,132,0
2020-08-23,Seychelles,0,0,132,0
2020-08-24,Seychelles,0,0,132,0
2020-08-25,Seychelles,4,0,136,0
2020-08-26,Seychelles,0,0,136,0
2020-08-27,Seychelles,0,0,136,0
2020-08-28,Seychelles,0,0,136,0
2020-08-29,Seychelles,0,0,136,0
2020-08-30,Seychelles,0,0,136,0
2020-08-31,Seychelles,0,0,136,0
2020-09-01,Seychelles,0,0,136,0
2020-09-02,Seychelles,0,0,136,0
2020-09-03,Seychelles,0,0,136,0
2020-09-04,Seychelles,0,0,136,0
2020-09-05,Seychelles,0,0,136,0
2020-09-06,Seychelles,0,0,136,0
2020-09-07,Seychelles,1,0,137,0
2020-09-08,Seychelles,0,0,137,0
2020-09-09,Seychelles,0,0,137,0
2020-09-10,Seychelles,0,0,137,0
2020-09-11,Seychelles,1,0,138,0
2020-09-12,Seychelles,1,0,139,0
2020-09-13,Seychelles,0,0,139,0
2020-09-14,Seychelles,1,0,140,0
2020-09-15,Seychelles,0,0,140,0
2020-09-16,Seychelles,0,0,140,0
2020-09-17,Seychelles,1,0,141,0
2020-09-18,Seychelles,0,0,141,0
2020-09-19,Seychelles,0,0,141,0
2020-09-20,Seychelles,0,0,141,0
2020-09-21,Seychelles,2,0,143,0
2020-09-22,Seychelles,0,0,143,0
2020-09-23,Seychelles,0,0,143,0
2020-09-24,Seychelles,0,0,143,0
2020-09-25,Seychelles,0,0,143,0
2020-09-26,Seychelles,0,0,143,0
2020-09-27,Seychelles,0,0,143,0
2020-09-28,Seychelles,0,0,143,0
2020-09-29,Seychelles,0,0,143,0
2020-09-30,Seychelles,1,0,144,0
2020-10-01,Seychelles,0,0,144,0
2020-10-02,Seychelles,1,0,145,0
2020-10-03,Seychelles,1,0,146,0
2020-10-04,Seychelles,0,0,146,0
2020-10-05,Seychelles,0,0,146,0
2020-10-06,Seychelles,2,0,148,0
2020-10-07,Seychelles,0,0,148,0
2020-10-08,Seychelles,0,0,148,0
2020-10-09,Seychelles,0,0,148,0
2020-10-10,Seychelles,0,0,148,0
2020-10-11,Seychelles,0,0,148,0
2020-10-12,Seychelles,0,0,148,0
2020-10-13,Seychelles,0,0,148,0
2020-10-14,Seychelles,0,0,148,0
2020-10-15,Seychelles,0,0,148,0
2020-10-16,Seychelles,1,0,149,0
2020-10-17,Seychelles,0,0,149,0
2020-10-18,Seychelles,0,0,149,0
2020-10-19,Seychelles,0,0,149,0
2020-10-20,Seychelles,0,0,149,0
2020-10-21,Seychelles,2,0,151,0
2020-10-22,Seychelles,0,0,151,0
2020-10-23,Seychelles,2,0,153,0
2020-10-24,Seychelles,0,0,153,0
2020-10-25,Seychelles,0,0,153,0
2020-10-26,Seychelles,0,0,153,0
2020-10-27,Seychelles,0,0,153,0
2020-10-28,Seychelles,0,0,153,0
2020-10-29,Seychelles,0,0,153,0
2020-10-30,Seychelles,0,0,153,0
2020-10-31,Seychelles,0,0,153,0
2020-11-01,Seychelles,0,0,153,0
2020-11-02,Seychelles,0,0,153,0
2020-11-03,Seychelles,4,0,157,0
2020-11-04,Seychelles,0,0,157,0
2020-11-05,Seychelles,0,0,157,0
2020-11-06,Seychelles,1,0,158,0
2020-11-07,Seychelles,0,0,158,0
2020-11-08,Seychelles,0,0,158,0
2020-11-09,Seychelles,0,0,158,0
2020-11-10,Seychelles,0,0,158,0
2020-11-11,Seychelles,0,0,158,0
2020-11-12,Seychelles,2,0,160,0
2020-11-13,Seychelles,0,0,160,0
2020-11-14,Seychelles,0,0,160,0
2020-11-15,Seychelles,0,0,160,0
2020-11-16,Seychelles,0,0,160,0
2020-11-17,Seychelles,0,0,160,0
2020-11-18,Seychelles,0,0,160,0
2020-11-19,Seychelles,3,0,163,0
2020-11-20,Seychelles,0,0,163,0
2020-11-21,Seychelles,0,0,163,0
2020-11-22,Seychelles,0,0,163,0
2020-11-23,Seychelles,3,0,166,0
2020-11-24,Seychelles,0,0,166,0
2020-11-25,Seychelles,0,0,166,0
2020-11-26,Seychelles,0,0,166,0
2020-11-27,Seychelles,7,0,173,0
2020-11-28,Seychelles,0,0,173,0
2020-11-29,Seychelles,0,0,173,0
2020-11-30,Seychelles,10,0,183,0
2020-12-01,Seychelles,0,0,183,0
2020-12-02,Seychelles,0,0,183,0
2020-12-03,Seychelles,0,0,183,0
2020-12-04,Seychelles,1,0,184,0
2020-12-05,Seychelles,0,0,184,0
2020-12-06,Seychelles,0,0,184,0
2020-12-07,Seychelles,0,0,184,0
2020-12-08,Seychelles,0,0,184,0
2020-12-09,Seychelles,0,0,184,0
2020-12-10,Seychelles,0,0,184,0
2020-12-11,Seychelles,3,0,187,0
2020-12-12,Seychelles,0,0,187,0
2020-12-13,Seychelles,0,0,187,0
2020-12-14,Seychelles,0,0,187,0
2020-12-15,Seychelles,15,0,202,0
2020-12-16,Seychelles,0,0,202,0
2020-12-17,Seychelles,0,0,202,0
2020-12-18,Seychelles,0,0,202,0
2020-12-19,Seychelles,0,0,202,0
2020-12-20,Seychelles,0,0,202,0
2020-12-21,Seychelles,3,0,205,0
2020-12-22,Seychelles,0,0,205,0
2020-12-23,Seychelles,0,0,205,0
2020-12-24,Seychelles,0,0,205,0
2020-12-25,Seychelles,0,0,205,0
2020-12-26,Seychelles,0,0,205,0
2020-12-27,Seychelles,0,0,205,0
2020-12-28,Seychelles,12,0,217,0
2020-12-29,Seychelles,0,0,217,0
2020-12-30,Seychelles,39,0,256,0
2020-12-31,Seychelles,0,0,256,0
2021-01-01,Seychelles,0,0,256,0
2021-01-02,Seychelles,29,0,285,0
2021-01-03,Seychelles,12,0,297,0
2021-01-04,Seychelles,25,1,322,1
2021-01-05,Seychelles,32,0,354,1
2021-01-06,Seychelles,19,0,373,1
2021-01-07,Seychelles,0,0,373,1
2021-01-08,Seychelles,78,0,451,1
2021-01-09,Seychelles,57,0,508,1
2021-01-10,Seychelles,23,0,531,1
2021-01-11,Seychelles,52,0,583,1
2021-01-12,Seychelles,18,0,601,1
2021-01-13,Seychelles,11,0,612,1
2021-01-14,Seychelles,15,0,627,1
2021-01-15,Seychelles,29,0,656,1
2021-01-16,Seychelles,40,1,696,2
2021-01-17,Seychelles,9,0,705,2
2021-01-18,Seychelles,41,0,746,2
2021-01-19,Seychelles,0,0,746,2
2021-01-20,Seychelles,16,0,762,2
2021-01-21,Seychelles,0,0,762,2
2021-01-22,Seychelles,210,1,972,3
2021-01-23,Seychelles,61,0,1033,3
2021-01-24,Seychelles,0,0,1033,3
2021-01-25,Seychelles,36,0,1069,3
2021-01-26,Seychelles,47,0,1116,3
2021-01-27,Seychelles,13,0,1129,3
2021-01-28,Seychelles,20,0,1149,3
2021-01-29,Seychelles,13,0,1162,3
2021-01-30,Seychelles,24,1,1186,4
2021-01-31,Seychelles,19,0,1205,4
2021-02-01,Seychelles,18,1,1223,5
2021-02-02,Seychelles,20,0,1243,5
2021-02-03,Seychelles,36,0,1279,5
2021-02-04,Seychelles,10,0,1289,5
2021-02-05,Seychelles,0,0,1289,5
2021-02-06,Seychelles,215,1,1504,6
2021-02-07,Seychelles,9,1,1513,7
2021-02-08,Seychelles,62,0,1575,7
2021-02-09,Seychelles,120,0,1695,7
2021-02-10,Seychelles,0,0,1695,7
2021-02-11,Seychelles,73,0,1768,7
2021-02-12,Seychelles,34,0,1802,7
2021-02-13,Seychelles,90,1,1892,8
2021-02-14,Seychelles,0,0,1892,8
2021-02-15,Seychelles,18,0,1910,8
2021-02-16,Seychelles,148,2,2058,10
2021-02-17,Seychelles,153,0,2211,10
2021-02-18,Seychelles,69,0,2280,10
2021-02-19,Seychelles,25,0,2305,10
2021-02-20,Seychelles,23,0,2328,10
2021-02-21,Seychelles,73,0,2401,10
2021-02-22,Seychelles,63,1,2464,11
2021-02-23,Seychelles,50,0,2514,11
2021-02-24,Seychelles,48,0,2562,11
2021-02-25,Seychelles,0,0,2562,11
2021-02-26,Seychelles,30,0,2592,11
2021-02-27,Seychelles,0,0,2592,11
2021-02-28,Seychelles,26,0,2618,11
2021-03-01,Seychelles,70,0,2688,11
2021-03-02,Seychelles,161,0,2849,11
2021-03-03,Seychelles,41,2,2890,13
2021-03-04,Seychelles,38,0,2928,13
2021-03-05,Seychelles,22,2,2950,15
2021-03-06,Seychelles,29,0,2979,15
2021-03-07,Seychelles,0,0,2979,15
2021-03-08,Seychelles,21,0,3000,15
2021-03-09,Seychelles,32,0,3032,15
2021-03-10,Seychelles,0,0,3032,15
2021-03-11,Seychelles,100,1,3132,16
2021-03-12,Seychelles,41,0,3173,16
2021-03-13,Seychelles,0,0,3173,16
2021-03-14,Seychelles,142,0,3315,16
2021-03-15,Seychelles,27,0,3342,16
2021-03-16,Seychelles,12,0,3354,16
2021-03-17,Seychelles,132,0,3486,16
2021-03-18,Seychelles,80,0,3566,16
2021-03-19,Seychelles,50,0,3616,16
2021-03-20,Seychelles,154,0,3770,16
2021-03-21,Seychelles,0,0,3770,16
2021-03-22,Seychelles,28,0,3798,16
2021-03-23,Seychelles,0,0,3798,16
2021-03-24,Seychelles,84,2,3882,18
2021-03-25,Seychelles,0,0,3882,18
2021-03-26,Seychelles,114,2,3996,20
2021-03-27,Seychelles,0,0,3996,20
2021-03-28,Seychelles,88,0,4084,20
2021-03-29,Seychelles,30,0,4114,20
2021-03-30,Seychelles,0,0,4114,20
2021-03-31,Seychelles,21,2,4135,22
2021-04-01,Seychelles,0,0,4135,22
2021-04-02,Seychelles,124,2,4259,24
2021-04-03,Seychelles,31,0,4290,24
2021-04-04,Seychelles,0,0,4290,24
2021-04-05,Seychelles,30,0,4320,24
2021-04-06,Seychelles,0,0,4320,24
2021-04-07,Seychelles,12,0,4332,24
2021-04-08,Seychelles,63,0,4395,24
2020-03-31,Sierra Leone,1,0,1,0
2020-04-01,Sierra Leone,1,0,2,0
2020-04-02,Sierra Leone,0,0,2,0
2020-04-03,Sierra Leone,0,0,2,0
2020-04-04,Sierra Leone,2,0,4,0
2020-04-05,Sierra Leone,2,0,6,0
2020-04-06,Sierra Leone,0,0,6,0
2020-04-07,Sierra Leone,0,0,6,0
2020-04-08,Sierra Leone,1,0,7,0
2020-04-09,Sierra Leone,0,0,7,0
2020-04-10,Sierra Leone,1,0,8,0
2020-04-11,Sierra Leone,0,0,8,0
2020-04-12,Sierra Leone,2,0,10,0
2020-04-13,Sierra Leone,0,0,10,0
2020-04-14,Sierra Leone,1,0,11,0
2020-04-15,Sierra Leone,2,0,13,0
2020-04-16,Sierra Leone,2,0,15,0
2020-04-17,Sierra Leone,11,0,26,0
2020-04-18,Sierra Leone,4,0,30,0
2020-04-19,Sierra Leone,5,0,35,0
2020-04-20,Sierra Leone,8,0,43,0
2020-04-21,Sierra Leone,7,0,50,0
2020-04-22,Sierra Leone,11,0,61,0
2020-04-23,Sierra Leone,3,1,64,1
2020-04-24,Sierra Leone,18,1,82,2
2020-04-25,Sierra Leone,0,0,82,2
2020-04-26,Sierra Leone,11,2,93,4
2020-04-27,Sierra Leone,0,0,93,4
2020-04-28,Sierra Leone,11,0,104,4
2020-04-29,Sierra Leone,0,0,104,4
2020-04-30,Sierra Leone,20,3,124,7
2020-05-01,Sierra Leone,12,0,136,7
2020-05-02,Sierra Leone,19,1,155,8
2020-05-03,Sierra Leone,11,0,166,8
2020-05-04,Sierra Leone,12,1,178,9
2020-05-05,Sierra Leone,21,2,199,11
2020-05-06,Sierra Leone,26,3,225,14
2020-05-07,Sierra Leone,6,2,231,16
2020-05-08,Sierra Leone,26,1,257,17
2020-05-09,Sierra Leone,34,1,291,18
2020-05-10,Sierra Leone,16,0,307,18
2020-05-11,Sierra Leone,31,1,338,19
2020-05-12,Sierra Leone,0,0,338,19
2020-05-13,Sierra Leone,49,7,387,26
2020-05-14,Sierra Leone,21,0,408,26
2020-05-15,Sierra Leone,39,1,447,27
2020-05-16,Sierra Leone,15,2,462,29
2020-05-17,Sierra Leone,43,3,505,32
2020-05-18,Sierra Leone,14,1,519,33
2020-05-19,Sierra Leone,15,0,534,33
2020-05-20,Sierra Leone,36,1,570,34
2020-05-21,Sierra Leone,15,1,585,35
2020-05-22,Sierra Leone,21,3,606,38
2020-05-23,Sierra Leone,15,1,621,39
2020-05-24,Sierra Leone,86,1,707,40
2020-05-25,Sierra Leone,28,2,735,42
2020-05-26,Sierra Leone,19,2,754,44
2020-05-27,Sierra Leone,28,1,782,45
2020-05-28,Sierra Leone,30,0,812,45
2020-05-29,Sierra Leone,17,0,829,45
2020-05-30,Sierra Leone,23,1,852,46
2020-05-31,Sierra Leone,9,0,861,46
2020-06-01,Sierra Leone,4,0,865,46
2020-06-02,Sierra Leone,31,0,896,46
2020-06-03,Sierra Leone,13,1,909,47
2020-06-04,Sierra Leone,5,0,914,47
2020-06-05,Sierra Leone,15,0,929,47
2020-06-06,Sierra Leone,17,1,946,48
2020-06-07,Sierra Leone,23,0,969,48
2020-06-08,Sierra Leone,32,1,1001,49
2020-06-09,Sierra Leone,24,1,1025,50
2020-06-10,Sierra Leone,37,0,1062,50
2020-06-11,Sierra Leone,23,0,1085,50
2020-06-12,Sierra Leone,18,1,1103,51
2020-06-13,Sierra Leone,29,0,1132,51
2020-06-14,Sierra Leone,37,0,1169,51
2020-06-15,Sierra Leone,7,0,1176,51
2020-06-16,Sierra Leone,49,0,1225,51
2020-06-17,Sierra Leone,24,0,1249,51
2020-06-18,Sierra Leone,23,0,1272,51
2020-06-19,Sierra Leone,26,2,1298,53
2020-06-20,Sierra Leone,11,0,1309,53
2020-06-21,Sierra Leone,18,2,1327,55
2020-06-22,Sierra Leone,13,0,1340,55
2020-06-23,Sierra Leone,7,0,1347,55
2020-06-24,Sierra Leone,7,0,1354,55
2020-06-25,Sierra Leone,0,1,1354,56
2020-06-26,Sierra Leone,40,3,1394,59
2020-06-27,Sierra Leone,16,0,1410,59
2020-06-28,Sierra Leone,17,1,1427,60
2020-06-29,Sierra Leone,23,0,1450,60
2020-06-30,Sierra Leone,12,0,1462,60
2020-07-01,Sierra Leone,36,0,1498,60
2020-07-02,Sierra Leone,20,0,1518,60
2020-07-03,Sierra Leone,6,2,1524,62
2020-07-04,Sierra Leone,9,0,1533,62
2020-07-05,Sierra Leone,9,0,1542,62
2020-07-06,Sierra Leone,5,0,1547,62
2020-07-07,Sierra Leone,25,1,1572,63
2020-07-08,Sierra Leone,12,0,1584,63
2020-07-09,Sierra Leone,14,0,1598,63
2020-07-10,Sierra Leone,15,0,1613,63
2020-07-11,Sierra Leone,5,0,1618,63
2020-07-12,Sierra Leone,17,0,1635,63
2020-07-13,Sierra Leone,7,0,1642,63
2020-07-14,Sierra Leone,9,1,1651,64
2020-07-15,Sierra Leone,17,0,1668,64
2020-07-16,Sierra Leone,10,0,1678,64
2020-07-17,Sierra Leone,10,1,1688,65
2020-07-18,Sierra Leone,13,0,1701,65
2020-07-19,Sierra Leone,10,0,1711,65
2020-07-20,Sierra Leone,0,1,1711,66
2020-07-21,Sierra Leone,16,0,1727,66
2020-07-22,Sierra Leone,4,0,1731,66
2020-07-23,Sierra Leone,21,0,1752,66
2020-07-24,Sierra Leone,13,0,1765,66
2020-07-25,Sierra Leone,3,0,1768,66
2020-07-26,Sierra Leone,15,0,1783,66
2020-07-27,Sierra Leone,0,0,1783,66
2020-07-28,Sierra Leone,3,0,1786,66
2020-07-29,Sierra Leone,17,1,1803,67
2020-07-30,Sierra Leone,15,0,1818,67
2020-07-31,Sierra Leone,5,0,1823,67
2020-08-01,Sierra Leone,0,0,1823,67
2020-08-02,Sierra Leone,20,0,1843,67
2020-08-03,Sierra Leone,5,0,1848,67
2020-08-04,Sierra Leone,7,0,1855,67
2020-08-05,Sierra Leone,5,0,1860,67
2020-08-06,Sierra Leone,17,0,1877,67
2020-08-07,Sierra Leone,10,1,1887,68
2020-08-08,Sierra Leone,8,0,1895,68
2020-08-09,Sierra Leone,21,0,1916,68
2020-08-10,Sierra Leone,1,1,1917,69
2020-08-11,Sierra Leone,15,0,1932,69
2020-08-12,Sierra Leone,5,0,1937,69
2020-08-13,Sierra Leone,3,0,1940,69
2020-08-14,Sierra Leone,7,0,1947,69
2020-08-15,Sierra Leone,7,0,1954,69
2020-08-16,Sierra Leone,2,0,1956,69
2020-08-17,Sierra Leone,0,0,1956,69
2020-08-18,Sierra Leone,3,0,1959,69
2020-08-19,Sierra Leone,2,0,1961,69
2020-08-20,Sierra Leone,8,0,1969,69
2020-08-21,Sierra Leone,3,0,1972,69
2020-08-22,Sierra Leone,8,0,1980,69
2020-08-23,Sierra Leone,12,0,1992,69
2020-08-24,Sierra Leone,5,0,1997,69
2020-08-25,Sierra Leone,4,0,2001,69
2020-08-26,Sierra Leone,2,0,2003,69
2020-08-27,Sierra Leone,10,1,2013,70
2020-08-28,Sierra Leone,0,0,2013,70
2020-08-29,Sierra Leone,6,0,2019,70
2020-08-30,Sierra Leone,3,0,2022,70
2020-08-31,Sierra Leone,0,0,2022,70
2020-09-01,Sierra Leone,6,1,2028,71
2020-09-02,Sierra Leone,1,0,2029,71
2020-09-03,Sierra Leone,6,0,2035,71
2020-09-04,Sierra Leone,6,0,2041,71
2020-09-05,Sierra Leone,0,0,2041,71
2020-09-06,Sierra Leone,13,0,2054,71
2020-09-07,Sierra Leone,1,0,2055,71
2020-09-08,Sierra Leone,9,1,2064,72
2020-09-09,Sierra Leone,3,0,2067,72
2020-09-10,Sierra Leone,2,0,2069,72
2020-09-11,Sierra Leone,18,0,2087,72
2020-09-12,Sierra Leone,9,0,2096,72
2020-09-13,Sierra Leone,13,0,2109,72
2020-09-14,Sierra Leone,2,0,2111,72
2020-09-15,Sierra Leone,15,0,2126,72
2020-09-16,Sierra Leone,7,0,2133,72
2020-09-17,Sierra Leone,0,0,2133,72
2020-09-18,Sierra Leone,20,0,2153,72
2020-09-19,Sierra Leone,6,0,2159,72
2020-09-20,Sierra Leone,9,0,2168,72
2020-09-21,Sierra Leone,0,0,2168,72
2020-09-22,Sierra Leone,6,0,2174,72
2020-09-23,Sierra Leone,9,0,2183,72
2020-09-24,Sierra Leone,5,0,2188,72
2020-09-25,Sierra Leone,11,0,2199,72
2020-09-26,Sierra Leone,9,0,2208,72
2020-09-27,Sierra Leone,7,0,2215,72
2020-09-28,Sierra Leone,0,0,2215,72
2020-09-29,Sierra Leone,7,0,2222,72
2020-09-30,Sierra Leone,9,0,2231,72
2020-10-01,Sierra Leone,7,0,2238,72
2020-10-02,Sierra Leone,14,0,2252,72
2020-10-03,Sierra Leone,7,0,2259,72
2020-10-04,Sierra Leone,10,0,2269,72
2020-10-05,Sierra Leone,0,0,2269,72
2020-10-06,Sierra Leone,8,0,2277,72
2020-10-07,Sierra Leone,10,0,2287,72
2020-10-08,Sierra Leone,6,0,2293,72
2020-10-09,Sierra Leone,2,0,2295,72
2020-10-10,Sierra Leone,5,0,2300,72
2020-10-11,Sierra Leone,6,0,2306,72
2020-10-12,Sierra Leone,0,0,2306,72
2020-10-13,Sierra Leone,3,0,2309,72
2020-10-14,Sierra Leone,6,1,2315,73
2020-10-15,Sierra Leone,8,0,2323,73
2020-10-16,Sierra Leone,2,0,2325,73
2020-10-17,Sierra Leone,2,0,2327,73
2020-10-18,Sierra Leone,3,0,2330,73
2020-10-19,Sierra Leone,1,0,2331,73
2020-10-20,Sierra Leone,5,0,2336,73
2020-10-21,Sierra Leone,1,0,2337,73
2020-10-22,Sierra Leone,3,0,2340,73
2020-10-23,Sierra Leone,3,1,2343,74
2020-10-24,Sierra Leone,2,0,2345,74
2020-10-25,Sierra Leone,1,0,2346,74
2020-10-26,Sierra Leone,0,0,2346,74
2020-10-27,Sierra Leone,4,0,2350,74
2020-10-28,Sierra Leone,4,0,2354,74
2020-10-29,Sierra Leone,8,0,2362,74
2020-10-30,Sierra Leone,3,0,2365,74
2020-10-31,Sierra Leone,1,0,2366,74
2020-11-01,Sierra Leone,0,0,2366,74
2020-11-02,Sierra Leone,0,0,2366,74
2020-11-03,Sierra Leone,2,0,2368,74
2020-11-04,Sierra Leone,1,0,2369,74
2020-11-05,Sierra Leone,2,0,2371,74
2020-11-06,Sierra Leone,2,0,2373,74
2020-11-07,Sierra Leone,8,0,2381,74
2020-11-08,Sierra Leone,0,0,2381,74
2020-11-09,Sierra Leone,4,0,2385,74
2020-11-10,Sierra Leone,1,0,2386,74
2020-11-11,Sierra Leone,0,0,2386,74
2020-11-12,Sierra Leone,1,0,2387,74
2020-11-13,Sierra Leone,2,0,2389,74
2020-11-14,Sierra Leone,2,0,2391,74
2020-11-15,Sierra Leone,0,0,2391,74
2020-11-16,Sierra Leone,0,0,2391,74
2020-11-17,Sierra Leone,1,0,2392,74
2020-11-18,Sierra Leone,5,0,2397,74
2020-11-19,Sierra Leone,0,0,2397,74
2020-11-20,Sierra Leone,2,0,2399,74
2020-11-21,Sierra Leone,6,0,2405,74
2020-11-22,Sierra Leone,0,0,2405,74
2020-11-23,Sierra Leone,1,0,2406,74
2020-11-24,Sierra Leone,0,0,2406,74
2020-11-25,Sierra Leone,2,0,2408,74
2020-11-26,Sierra Leone,1,0,2409,74
2020-11-27,Sierra Leone,1,0,2410,74
2020-11-28,Sierra Leone,0,0,2410,74
2020-11-29,Sierra Leone,1,0,2411,74
2020-11-30,Sierra Leone,1,0,2412,74
2020-12-01,Sierra Leone,1,0,2413,74
2020-12-02,Sierra Leone,3,0,2416,74
2020-12-03,Sierra Leone,0,0,2416,74
2020-12-04,Sierra Leone,4,0,2420,74
2020-12-05,Sierra Leone,0,0,2420,74
2020-12-06,Sierra Leone,6,0,2426,74
2020-12-07,Sierra Leone,2,0,2428,74
2020-12-08,Sierra Leone,0,0,2428,74
2020-12-09,Sierra Leone,6,0,2434,74
2020-12-10,Sierra Leone,1,0,2435,74
2020-12-11,Sierra Leone,3,1,2438,75
2020-12-12,Sierra Leone,2,0,2440,75
2020-12-13,Sierra Leone,0,0,2440,75
2020-12-14,Sierra Leone,5,0,2445,75
2020-12-15,Sierra Leone,6,0,2451,75
2020-12-16,Sierra Leone,9,0,2460,75
2020-12-17,Sierra Leone,4,0,2464,75
2020-12-18,Sierra Leone,22,0,2486,75
2020-12-19,Sierra Leone,11,0,2497,75
2020-12-20,Sierra Leone,12,0,2509,75
2020-12-21,Sierra Leone,0,0,2509,75
2020-12-22,Sierra Leone,9,0,2518,75
2020-12-23,Sierra Leone,6,1,2524,76
2020-12-24,Sierra Leone,7,0,2531,76
2020-12-25,Sierra Leone,18,0,2549,76
2020-12-26,Sierra Leone,0,0,2549,76
2020-12-27,Sierra Leone,11,0,2560,76
2020-12-28,Sierra Leone,0,0,2560,76
2020-12-29,Sierra Leone,9,0,2569,76
2020-12-30,Sierra Leone,14,0,2583,76
2020-12-31,Sierra Leone,28,0,2611,76
2021-01-01,Sierra Leone,24,0,2635,76
2021-01-02,Sierra Leone,11,0,2646,76
2021-01-03,Sierra Leone,27,0,2673,76
2021-01-04,Sierra Leone,0,0,2673,76
2021-01-05,Sierra Leone,51,0,2724,76
2021-01-06,Sierra Leone,15,0,2739,76
2021-01-07,Sierra Leone,18,1,2757,77
2021-01-08,Sierra Leone,25,0,2782,77
2021-01-09,Sierra Leone,21,0,2803,77
2021-01-10,Sierra Leone,31,0,2834,77
2021-01-11,Sierra Leone,12,0,2846,77
2021-01-12,Sierra Leone,18,0,2864,77
2021-01-13,Sierra Leone,23,0,2887,77
2021-01-14,Sierra Leone,46,0,2933,77
2021-01-15,Sierra Leone,26,0,2959,77
2021-01-16,Sierra Leone,11,0,2970,77
2021-01-17,Sierra Leone,36,0,3006,77
2021-01-18,Sierra Leone,8,0,3014,77
2021-01-19,Sierra Leone,16,0,3030,77
2021-01-20,Sierra Leone,0,0,3030,77
2021-01-21,Sierra Leone,51,0,3081,77
2021-01-22,Sierra Leone,12,0,3093,77
2021-01-23,Sierra Leone,27,0,3120,77
2021-01-24,Sierra Leone,19,0,3139,77
2021-01-25,Sierra Leone,34,0,3173,77
2021-01-26,Sierra Leone,21,0,3194,77
2021-01-27,Sierra Leone,42,0,3236,77
2021-01-28,Sierra Leone,46,0,3282,77
2021-01-29,Sierra Leone,100,2,3382,79
2021-01-30,Sierra Leone,146,0,3528,79
2021-01-31,Sierra Leone,65,0,3593,79
2021-02-01,Sierra Leone,41,0,3634,79
2021-02-02,Sierra Leone,26,0,3660,79
2021-02-03,Sierra Leone,39,0,3699,79
2021-02-04,Sierra Leone,29,0,3728,79
2021-02-05,Sierra Leone,31,0,3759,79
2021-02-06,Sierra Leone,13,0,3772,79
2021-02-07,Sierra Leone,13,0,3785,79
2021-02-08,Sierra Leone,4,0,3789,79
2021-02-09,Sierra Leone,12,0,3801,79
2021-02-10,Sierra Leone,2,0,3803,79
2021-02-11,Sierra Leone,10,0,3813,79
2021-02-12,Sierra Leone,4,0,3817,79
2021-02-13,Sierra Leone,4,0,3821,79
2021-02-14,Sierra Leone,0,0,3821,79
2021-02-15,Sierra Leone,2,0,3823,79
2021-02-16,Sierra Leone,2,0,3825,79
2021-02-17,Sierra Leone,0,0,3825,79
2021-02-18,Sierra Leone,4,0,3829,79
2021-02-19,Sierra Leone,12,0,3841,79
2021-02-20,Sierra Leone,8,0,3849,79
2021-02-21,Sierra Leone,6,0,3855,79
2021-02-22,Sierra Leone,2,0,3857,79
2021-02-23,Sierra Leone,5,0,3862,79
2021-02-24,Sierra Leone,18,0,3880,79
2021-02-25,Sierra Leone,4,0,3884,79
2021-02-26,Sierra Leone,0,0,3884,79
2021-02-27,Sierra Leone,3,0,3887,79
2021-02-28,Sierra Leone,0,0,3887,79
2021-03-01,Sierra Leone,0,0,3887,79
2021-03-02,Sierra Leone,2,0,3889,79
2021-03-03,Sierra Leone,11,0,3900,79
2021-03-04,Sierra Leone,0,0,3900,79
2021-03-05,Sierra Leone,9,0,3909,79
2021-03-06,Sierra Leone,9,0,3918,79
2021-03-07,Sierra Leone,2,0,3920,79
2021-03-08,Sierra Leone,1,0,3921,79
2021-03-09,Sierra Leone,1,0,3922,79
2021-03-10,Sierra Leone,6,0,3928,79
2021-03-11,Sierra Leone,4,0,3932,79
2021-03-12,Sierra Leone,2,0,3934,79
2021-03-13,Sierra Leone,3,0,3937,79
2021-03-14,Sierra Leone,0,0,3937,79
2021-03-15,Sierra Leone,1,0,3938,79
2021-03-16,Sierra Leone,1,0,3939,79
2021-03-17,Sierra Leone,3,0,3942,79
2021-03-18,Sierra Leone,5,0,3947,79
2021-03-19,Sierra Leone,0,0,3947,79
2021-03-20,Sierra Leone,1,0,3948,79
2021-03-21,Sierra Leone,0,0,3948,79
2021-03-22,Sierra Leone,0,0,3948,79
2021-03-23,Sierra Leone,1,0,3949,79
2021-03-24,Sierra Leone,4,0,3953,79
2021-03-25,Sierra Leone,0,0,3953,79
2021-03-26,Sierra Leone,9,0,3962,79
2021-03-27,Sierra Leone,0,0,3962,79
2021-03-28,Sierra Leone,8,0,3970,79
2021-03-29,Sierra Leone,0,0,3970,79
2021-03-30,Sierra Leone,0,0,3970,79
2021-03-31,Sierra Leone,10,0,3980,79
2021-04-01,Sierra Leone,1,0,3981,79
2021-04-02,Sierra Leone,6,0,3987,79
2021-04-03,Sierra Leone,0,0,3987,79
2021-04-04,Sierra Leone,1,0,3988,79
2021-04-05,Sierra Leone,1,0,3989,79
2021-04-06,Sierra Leone,1,0,3990,79
2021-04-07,Sierra Leone,3,0,3993,79
2021-04-08,Sierra Leone,0,0,3993,79
2020-01-23,Singapore,1,0,1,0
2020-01-24,Singapore,2,0,3,0
2020-01-25,Singapore,0,0,3,0
2020-01-26,Singapore,1,0,4,0
2020-01-27,Singapore,1,0,5,0
2020-01-28,Singapore,2,0,7,0
2020-01-29,Singapore,0,0,7,0
2020-01-30,Singapore,3,0,10,0
2020-01-31,Singapore,3,0,13,0
2020-02-01,Singapore,3,0,16,0
2020-02-02,Singapore,2,0,18,0
2020-02-03,Singapore,0,0,18,0
2020-02-04,Singapore,6,0,24,0
2020-02-05,Singapore,4,0,28,0
2020-02-06,Singapore,0,0,28,0
2020-02-07,Singapore,2,0,30,0
2020-02-08,Singapore,3,0,33,0
2020-02-09,Singapore,7,0,40,0
2020-02-10,Singapore,5,0,45,0
2020-02-11,Singapore,2,0,47,0
2020-02-12,Singapore,3,0,50,0
2020-02-13,Singapore,8,0,58,0
2020-02-14,Singapore,9,0,67,0
2020-02-15,Singapore,5,0,72,0
2020-02-16,Singapore,3,0,75,0
2020-02-17,Singapore,2,0,77,0
2020-02-18,Singapore,4,0,81,0
2020-02-19,Singapore,3,0,84,0
2020-02-20,Singapore,0,0,84,0
2020-02-21,Singapore,1,0,85,0
2020-02-22,Singapore,0,0,85,0
2020-02-23,Singapore,4,0,89,0
2020-02-24,Singapore,0,0,89,0
2020-02-25,Singapore,2,0,91,0
2020-02-26,Singapore,2,0,93,0
2020-02-27,Singapore,0,0,93,0
2020-02-28,Singapore,0,0,93,0
2020-02-29,Singapore,9,0,102,0
2020-03-01,Singapore,4,0,106,0
2020-03-02,Singapore,2,0,108,0
2020-03-03,Singapore,2,0,110,0
2020-03-04,Singapore,0,0,110,0
2020-03-05,Singapore,7,0,117,0
2020-03-06,Singapore,13,0,130,0
2020-03-07,Singapore,8,0,138,0
2020-03-08,Singapore,12,0,150,0
2020-03-09,Singapore,0,0,150,0
2020-03-10,Singapore,10,0,160,0
2020-03-11,Singapore,18,0,178,0
2020-03-12,Singapore,0,0,178,0
2020-03-13,Singapore,22,0,200,0
2020-03-14,Singapore,12,0,212,0
2020-03-15,Singapore,14,0,226,0
2020-03-16,Singapore,17,0,243,0
2020-03-17,Singapore,23,0,266,0
2020-03-18,Singapore,47,0,313,0
2020-03-19,Singapore,32,0,345,0
2020-03-20,Singapore,40,0,385,0
2020-03-21,Singapore,47,2,432,2
2020-03-22,Singapore,23,0,455,2
2020-03-23,Singapore,54,0,509,2
2020-03-24,Singapore,49,0,558,2
2020-03-25,Singapore,73,0,631,2
2020-03-26,Singapore,52,0,683,2
2020-03-27,Singapore,49,0,732,2
2020-03-28,Singapore,70,0,802,2
2020-03-29,Singapore,42,1,844,3
2020-03-30,Singapore,35,0,879,3
2020-03-31,Singapore,47,0,926,3
2020-04-01,Singapore,74,0,1000,3
2020-04-02,Singapore,49,1,1049,4
2020-04-03,Singapore,65,1,1114,5
2020-04-04,Singapore,75,1,1189,6
2020-04-05,Singapore,120,0,1309,6
2020-04-06,Singapore,66,0,1375,6
2020-04-07,Singapore,106,0,1481,6
2020-04-08,Singapore,142,0,1623,6
2020-04-09,Singapore,287,0,1910,6
2020-04-10,Singapore,198,1,2108,7
2020-04-11,Singapore,191,1,2299,8
2020-04-12,Singapore,233,0,2532,8
2020-04-13,Singapore,386,1,2918,9
2020-04-14,Singapore,334,1,3252,10
2020-04-15,Singapore,447,0,3699,10
2020-04-16,Singapore,728,0,4427,10
2020-04-17,Singapore,623,1,5050,11
2020-04-18,Singapore,942,0,5992,11
2020-04-19,Singapore,596,0,6588,11
2020-04-20,Singapore,1426,0,8014,11
2020-04-21,Singapore,1111,0,9125,11
2020-04-22,Singapore,1016,1,10141,12
2020-04-23,Singapore,1037,0,11178,12
2020-04-24,Singapore,897,0,12075,12
2020-04-25,Singapore,618,0,12693,12
2020-04-26,Singapore,931,0,13624,12
2020-04-27,Singapore,799,2,14423,14
2020-04-28,Singapore,528,0,14951,14
2020-04-29,Singapore,690,0,15641,14
2020-04-30,Singapore,528,1,16169,15
2020-05-01,Singapore,932,1,17101,16
2020-05-02,Singapore,447,1,17548,17
2020-05-03,Singapore,657,1,18205,18
2020-05-04,Singapore,573,0,18778,18
2020-05-05,Singapore,632,0,19410,18
2020-05-06,Singapore,788,2,20198,20
2020-05-07,Singapore,741,0,20939,20
2020-05-08,Singapore,768,0,21707,20
2020-05-09,Singapore,753,0,22460,20
2020-05-10,Singapore,876,0,23336,20
2020-05-11,Singapore,486,1,23822,21
2020-05-12,Singapore,849,0,24671,21
2020-05-13,Singapore,675,0,25346,21
2020-05-14,Singapore,752,0,26098,21
2020-05-15,Singapore,793,0,26891,21
2020-05-16,Singapore,465,1,27356,22
2020-05-17,Singapore,682,0,28038,22
2020-05-18,Singapore,305,0,28343,22
2020-05-19,Singapore,451,0,28794,22
2020-05-20,Singapore,570,0,29364,22
2020-05-21,Singapore,448,1,29812,23
2020-05-22,Singapore,614,0,30426,23
2020-05-23,Singapore,642,0,31068,23
2020-05-24,Singapore,548,0,31616,23
2020-05-25,Singapore,344,0,31960,23
2020-05-26,Singapore,383,0,32343,23
2020-05-27,Singapore,533,0,32876,23
2020-05-28,Singapore,373,0,33249,23
2020-05-29,Singapore,611,0,33860,23
2020-05-30,Singapore,506,0,34366,23
2020-05-31,Singapore,518,0,34884,23
2020-06-01,Singapore,408,1,35292,24
2020-06-02,Singapore,544,0,35836,24
2020-06-03,Singapore,569,0,36405,24
2020-06-04,Singapore,517,0,36922,24
2020-06-05,Singapore,261,0,37183,24
2020-06-06,Singapore,344,1,37527,25
2020-06-07,Singapore,383,0,37910,25
2020-06-08,Singapore,386,0,38296,25
2020-06-09,Singapore,218,0,38514,25
2020-06-10,Singapore,451,0,38965,25
2020-06-11,Singapore,422,0,39387,25
2020-06-12,Singapore,463,0,39850,25
2020-06-13,Singapore,347,1,40197,26
2020-06-14,Singapore,407,0,40604,26
2020-06-15,Singapore,214,0,40818,26
2020-06-16,Singapore,151,0,40969,26
2020-06-17,Singapore,247,0,41216,26
2020-06-18,Singapore,257,0,41473,26
2020-06-19,Singapore,142,0,41615,26
2020-06-20,Singapore,218,0,41833,26
2020-06-21,Singapore,262,0,42095,26
2020-06-22,Singapore,218,0,42313,26
2020-06-23,Singapore,119,0,42432,26
2020-06-24,Singapore,191,0,42623,26
2020-06-25,Singapore,113,0,42736,26
2020-06-26,Singapore,219,0,42955,26
2020-06-27,Singapore,291,0,43246,26
2020-06-28,Singapore,213,0,43459,26
2020-06-29,Singapore,202,0,43661,26
2020-06-30,Singapore,246,0,43907,26
2020-07-01,Singapore,215,0,44122,26
2020-07-02,Singapore,188,0,44310,26
2020-07-03,Singapore,169,0,44479,26
2020-07-04,Singapore,185,0,44664,26
2020-07-05,Singapore,136,0,44800,26
2020-07-06,Singapore,183,0,44983,26
2020-07-07,Singapore,157,0,45140,26
2020-07-08,Singapore,158,0,45298,26
2020-07-09,Singapore,125,0,45423,26
2020-07-10,Singapore,191,0,45614,26
2020-07-11,Singapore,169,0,45783,26
2020-07-12,Singapore,178,0,45961,26
2020-07-13,Singapore,322,0,46283,26
2020-07-14,Singapore,347,1,46630,27
2020-07-15,Singapore,248,0,46878,27
2020-07-16,Singapore,248,0,47126,27
2020-07-17,Singapore,327,0,47453,27
2020-07-18,Singapore,202,0,47655,27
2020-07-19,Singapore,257,0,47912,27
2020-07-20,Singapore,123,0,48035,27
2020-07-21,Singapore,399,0,48434,27
2020-07-22,Singapore,310,0,48744,27
2020-07-23,Singapore,354,0,49098,27
2020-07-24,Singapore,277,0,49375,27
2020-07-25,Singapore,513,0,49888,27
2020-07-26,Singapore,481,0,50369,27
2020-07-27,Singapore,469,0,50838,27
2020-07-28,Singapore,359,0,51197,27
2020-07-29,Singapore,334,0,51531,27
2020-07-30,Singapore,278,0,51809,27
2020-07-31,Singapore,396,0,52205,27
2020-08-01,Singapore,307,0,52512,27
2020-08-02,Singapore,313,0,52825,27
2020-08-03,Singapore,226,0,53051,27
2020-08-04,Singapore,295,0,53346,27
2020-08-05,Singapore,908,0,54254,27
2020-08-06,Singapore,301,0,54555,27
2020-08-07,Singapore,242,0,54797,27
2020-08-08,Singapore,132,0,54929,27
2020-08-09,Singapore,175,0,55104,27
2020-08-10,Singapore,188,0,55292,27
2020-08-11,Singapore,61,0,55353,27
2020-08-12,Singapore,42,0,55395,27
2020-08-13,Singapore,102,0,55497,27
2020-08-14,Singapore,83,0,55580,27
2020-08-15,Singapore,81,0,55661,27
2020-08-16,Singapore,86,0,55747,27
2020-08-17,Singapore,91,0,55838,27
2020-08-18,Singapore,100,0,55938,27
2020-08-19,Singapore,93,0,56031,27
2020-08-20,Singapore,68,0,56099,27
2020-08-21,Singapore,117,0,56216,27
2020-08-22,Singapore,50,0,56266,27
2020-08-23,Singapore,87,0,56353,27
2020-08-24,Singapore,51,0,56404,27
2020-08-25,Singapore,31,0,56435,27
2020-08-26,Singapore,60,0,56495,27
2020-08-27,Singapore,77,0,56572,27
2020-08-28,Singapore,94,0,56666,27
2020-08-29,Singapore,51,0,56717,27
2020-08-30,Singapore,54,0,56771,27
2020-08-31,Singapore,41,0,56812,27
2020-09-01,Singapore,40,0,56852,27
2020-09-02,Singapore,8,0,56860,27
2020-09-03,Singapore,48,0,56908,27
2020-09-04,Singapore,40,0,56948,27
2020-09-05,Singapore,34,0,56982,27
2020-09-06,Singapore,40,0,57022,27
2020-09-07,Singapore,22,0,57044,27
2020-09-08,Singapore,47,0,57091,27
2020-09-09,Singapore,75,0,57166,27
2020-09-10,Singapore,63,0,57229,27
2020-09-11,Singapore,86,0,57315,27
2020-09-12,Singapore,42,0,57357,27
2020-09-13,Singapore,49,0,57406,27
2020-09-14,Singapore,48,0,57454,27
2020-09-15,Singapore,34,0,57488,27
2020-09-16,Singapore,26,0,57514,27
2020-09-17,Singapore,18,0,57532,27
2020-09-18,Singapore,11,0,57543,27
2020-09-19,Singapore,15,0,57558,27
2020-09-20,Singapore,18,0,57576,27
2020-09-21,Singapore,30,0,57606,27
2020-09-22,Singapore,21,0,57627,27
2020-09-23,Singapore,12,0,57639,27
2020-09-24,Singapore,15,0,57654,27
2020-09-25,Singapore,11,0,57665,27
2020-09-26,Singapore,20,0,57685,27
2020-09-27,Singapore,15,0,57700,27
2020-09-28,Singapore,15,0,57715,27
2020-09-29,Singapore,27,0,57742,27
2020-09-30,Singapore,23,0,57765,27
2020-10-01,Singapore,19,0,57784,27
2020-10-02,Singapore,10,0,57794,27
2020-10-03,Singapore,6,0,57800,27
2020-10-04,Singapore,12,0,57812,27
2020-10-05,Singapore,7,0,57819,27
2020-10-06,Singapore,11,0,57830,27
2020-10-07,Singapore,10,0,57840,27
2020-10-08,Singapore,9,0,57849,27
2020-10-09,Singapore,10,0,57859,27
2020-10-10,Singapore,7,0,57866,27
2020-10-11,Singapore,10,0,57876,27
2020-10-12,Singapore,4,1,57880,28
2020-10-13,Singapore,4,0,57884,28
2020-10-14,Singapore,5,0,57889,28
2020-10-15,Singapore,3,0,57892,28
2020-10-16,Singapore,9,0,57901,28
2020-10-17,Singapore,3,0,57904,28
2020-10-18,Singapore,7,0,57911,28
2020-10-19,Singapore,4,0,57915,28
2020-10-20,Singapore,6,0,57921,28
2020-10-21,Singapore,12,0,57933,28
2020-10-22,Singapore,8,0,57941,28
2020-10-23,Singapore,10,0,57951,28
2020-10-24,Singapore,14,0,57965,28
2020-10-25,Singapore,5,0,57970,28
2020-10-26,Singapore,3,0,57973,28
2020-10-27,Singapore,7,0,57980,28
2020-10-28,Singapore,7,0,57987,28
2020-10-29,Singapore,7,0,57994,28
2020-10-30,Singapore,9,0,58003,28
2020-10-31,Singapore,12,0,58015,28
2020-11-01,Singapore,4,0,58019,28
2020-11-02,Singapore,1,0,58020,28
2020-11-03,Singapore,9,0,58029,28
2020-11-04,Singapore,7,0,58036,28
2020-11-05,Singapore,7,0,58043,28
2020-11-06,Singapore,4,0,58047,28
2020-11-07,Singapore,7,0,58054,28
2020-11-08,Singapore,2,0,58056,28
2020-11-09,Singapore,8,0,58064,28
2020-11-10,Singapore,9,0,58073,28
2020-11-11,Singapore,18,0,58091,28
2020-11-12,Singapore,11,0,58102,28
2020-11-13,Singapore,12,0,58114,28
2020-11-14,Singapore,2,0,58116,28
2020-11-15,Singapore,3,0,58119,28
2020-11-16,Singapore,5,0,58124,28
2020-11-17,Singapore,6,0,58130,28
2020-11-18,Singapore,5,0,58135,28
2020-11-19,Singapore,4,0,58139,28
2020-11-20,Singapore,4,0,58143,28
2020-11-21,Singapore,5,0,58148,28
2020-11-22,Singapore,12,0,58160,28
2020-11-23,Singapore,5,0,58165,28
2020-11-24,Singapore,18,0,58183,28
2020-11-25,Singapore,7,0,58190,28
2020-11-26,Singapore,5,0,58195,28
2020-11-27,Singapore,4,0,58199,28
2020-11-28,Singapore,6,1,58205,29
2020-11-29,Singapore,8,0,58213,29
2020-11-30,Singapore,5,0,58218,29
2020-12-01,Singapore,10,0,58228,29
2020-12-02,Singapore,2,0,58230,29
2020-12-03,Singapore,9,0,58239,29
2020-12-04,Singapore,3,0,58242,29
2020-12-05,Singapore,13,0,58255,29
2020-12-06,Singapore,5,0,58260,29
2020-12-07,Singapore,13,0,58273,29
2020-12-08,Singapore,12,0,58285,29
2020-12-09,Singapore,6,0,58291,29
2020-12-10,Singapore,6,0,58297,29
2020-12-11,Singapore,8,0,58305,29
2020-12-12,Singapore,8,0,58313,29
2020-12-13,Singapore,7,0,58320,29
2020-12-14,Singapore,5,0,58325,29
2020-12-15,Singapore,16,0,58341,29
2020-12-16,Singapore,12,0,58353,29
2020-12-17,Singapore,24,0,58377,29
2020-12-18,Singapore,9,0,58386,29
2020-12-19,Singapore,17,0,58403,29
2020-12-20,Singapore,19,0,58422,29
2020-12-21,Singapore,10,0,58432,29
2020-12-22,Singapore,29,0,58461,29
2020-12-23,Singapore,21,0,58482,29
2020-12-24,Singapore,13,0,58495,29
2020-12-25,Singapore,14,0,58509,29
2020-12-26,Singapore,10,0,58519,29
2020-12-27,Singapore,5,0,58524,29
2020-12-28,Singapore,5,0,58529,29
2020-12-29,Singapore,13,0,58542,29
2020-12-30,Singapore,27,0,58569,29
2020-12-31,Singapore,30,0,58599,29
2021-01-01,Singapore,30,0,58629,29
2021-01-02,Singapore,33,0,58662,29
2021-01-03,Singapore,35,0,58697,29
2021-01-04,Singapore,24,0,58721,29
2021-01-05,Singapore,28,0,58749,29
2021-01-06,Singapore,31,0,58780,29
2021-01-07,Singapore,33,0,58813,29
2021-01-08,Singapore,23,0,58836,29
2021-01-09,Singapore,29,0,58865,29
2021-01-10,Singapore,42,0,58907,29
2021-01-11,Singapore,22,0,58929,29
2021-01-12,Singapore,17,0,58946,29
2021-01-13,Singapore,38,0,58984,29
2021-01-14,Singapore,45,0,59029,29
2021-01-15,Singapore,30,0,59059,29
2021-01-16,Singapore,24,0,59083,29
2021-01-17,Singapore,30,0,59113,29
2021-01-18,Singapore,14,0,59127,29
2021-01-19,Singapore,30,0,59157,29
2021-01-20,Singapore,40,0,59197,29
2021-01-21,Singapore,38,0,59235,29
2021-01-22,Singapore,15,0,59250,29
2021-01-23,Singapore,10,0,59260,29
2021-01-24,Singapore,48,0,59308,29
2021-01-25,Singapore,44,0,59352,29
2021-01-26,Singapore,14,0,59366,29
2021-01-27,Singapore,25,0,59391,29
2021-01-28,Singapore,34,0,59425,29
2021-01-29,Singapore,24,0,59449,29
2021-01-30,Singapore,58,0,59507,29
2021-01-31,Singapore,29,0,59536,29
2021-02-01,Singapore,29,0,59565,29
2021-02-02,Singapore,19,0,59584,29
2021-02-03,Singapore,18,0,59602,29
2021-02-04,Singapore,22,0,59624,29
2021-02-05,Singapore,25,0,59649,29
2021-02-06,Singapore,26,0,59675,29
2021-02-07,Singapore,24,0,59699,29
2021-02-08,Singapore,22,0,59721,29
2021-02-09,Singapore,11,0,59732,29
2021-02-10,Singapore,15,0,59747,29
2021-02-11,Singapore,12,0,59759,29
2021-02-12,Singapore,18,0,59777,29
2021-02-13,Singapore,9,0,59786,29
2021-02-14,Singapore,14,0,59800,29
2021-02-15,Singapore,9,0,59809,29
2021-02-16,Singapore,1,0,59810,29
2021-02-17,Singapore,11,0,59821,29
2021-02-18,Singapore,11,0,59832,29
2021-02-19,Singapore,14,0,59846,29
2021-02-20,Singapore,12,0,59858,29
2021-02-21,Singapore,11,0,59869,29
2021-02-22,Singapore,10,0,59879,29
2021-02-23,Singapore,4,0,59883,29
2021-02-24,Singapore,7,0,59890,29
2021-02-25,Singapore,10,0,59900,29
2021-02-26,Singapore,13,0,59913,29
2021-02-27,Singapore,12,0,59925,29
2021-02-28,Singapore,11,0,59936,29
2021-03-01,Singapore,12,0,59948,29
2021-03-02,Singapore,8,0,59956,29
2021-03-03,Singapore,23,0,59979,29
2021-03-04,Singapore,19,0,59998,29
2021-03-05,Singapore,9,0,60007,29
2021-03-06,Singapore,13,0,60020,29
2021-03-07,Singapore,13,0,60033,29
2021-03-08,Singapore,13,0,60046,29
2021-03-09,Singapore,6,0,60052,29
2021-03-10,Singapore,10,0,60062,29
2021-03-11,Singapore,8,0,60070,29
2021-03-12,Singapore,10,0,60080,29
2021-03-13,Singapore,8,1,60088,30
2021-03-14,Singapore,17,0,60105,30
2021-03-15,Singapore,12,0,60117,30
2021-03-16,Singapore,11,0,60128,30
2021-03-17,Singapore,9,0,60137,30
2021-03-18,Singapore,15,0,60152,30
2021-03-19,Singapore,15,0,60167,30
2021-03-20,Singapore,17,0,60184,30
2021-03-21,Singapore,12,0,60196,30
2021-03-22,Singapore,12,0,60208,30
2021-03-23,Singapore,13,0,60221,30
2021-03-24,Singapore,15,0,60236,30
2021-03-25,Singapore,17,0,60253,30
2021-03-26,Singapore,12,0,60265,30
2021-03-27,Singapore,23,0,60288,30
2021-03-28,Singapore,12,0,60300,30
2021-03-29,Singapore,21,0,60321,30
2021-03-30,Singapore,26,0,60347,30
2021-03-31,Singapore,34,0,60381,30
2021-04-01,Singapore,26,0,60407,30
2021-04-02,Singapore,43,0,60450,30
2021-04-03,Singapore,18,0,60468,30
2021-04-04,Singapore,10,0,60478,30
2021-04-05,Singapore,17,0,60495,30
2021-04-06,Singapore,24,0,60519,30
2021-04-07,Singapore,35,0,60554,30
2021-04-08,Singapore,21,0,60575,30
2020-03-06,Slovakia,1,0,1,0
2020-03-07,Slovakia,0,0,1,0
2020-03-08,Slovakia,2,0,3,0
2020-03-09,Slovakia,0,0,3,0
2020-03-10,Slovakia,4,0,7,0
2020-03-11,Slovakia,3,0,10,0
2020-03-12,Slovakia,6,0,16,0
2020-03-13,Slovakia,16,0,32,0
2020-03-14,Slovakia,12,0,44,0
2020-03-15,Slovakia,10,0,54,0
2020-03-16,Slovakia,9,0,63,0
2020-03-17,Slovakia,9,0,72,0
2020-03-18,Slovakia,33,0,105,0
2020-03-19,Slovakia,18,0,123,0
2020-03-20,Slovakia,14,0,137,0
2020-03-21,Slovakia,41,0,178,0
2020-03-22,Slovakia,7,0,185,0
2020-03-23,Slovakia,1,0,186,0
2020-03-24,Slovakia,18,0,204,0
2020-03-25,Slovakia,12,0,216,0
2020-03-26,Slovakia,10,0,226,0
2020-03-27,Slovakia,43,0,269,0
2020-03-28,Slovakia,23,0,292,0
2020-03-29,Slovakia,22,0,314,0
2020-03-30,Slovakia,22,0,336,0
2020-03-31,Slovakia,27,0,363,0
2020-04-01,Slovakia,37,1,400,1
2020-04-02,Slovakia,26,0,426,1
2020-04-03,Slovakia,24,0,450,1
2020-04-04,Slovakia,21,0,471,1
2020-04-05,Slovakia,14,0,485,1
2020-04-06,Slovakia,49,1,534,2
2020-04-07,Slovakia,47,0,581,2
2020-04-08,Slovakia,101,0,682,2
2020-04-09,Slovakia,19,0,701,2
2020-04-10,Slovakia,14,0,715,2
2020-04-11,Slovakia,13,0,728,2
2020-04-12,Slovakia,14,0,742,2
2020-04-13,Slovakia,27,0,769,2
2020-04-14,Slovakia,66,0,835,2
2020-04-15,Slovakia,28,4,863,6
2020-04-16,Slovakia,114,2,977,8
2020-04-17,Slovakia,72,1,1049,9
2020-04-18,Slovakia,40,2,1089,11
2020-04-19,Slovakia,72,1,1161,12
2020-04-20,Slovakia,12,1,1173,13
2020-04-21,Slovakia,26,1,1199,14
2020-04-22,Slovakia,45,0,1244,14
2020-04-23,Slovakia,81,1,1325,15
2020-04-24,Slovakia,35,2,1360,17
2020-04-25,Slovakia,13,0,1373,17
2020-04-26,Slovakia,6,1,1379,18
2020-04-27,Slovakia,2,0,1381,18
2020-04-28,Slovakia,3,2,1384,20
2020-04-29,Slovakia,7,2,1391,22
2020-04-30,Slovakia,5,1,1396,23
2020-05-01,Slovakia,7,0,1403,23
2020-05-02,Slovakia,4,1,1407,24
2020-05-03,Slovakia,1,0,1408,24
2020-05-04,Slovakia,5,1,1413,25
2020-05-05,Slovakia,8,0,1421,25
2020-05-06,Slovakia,8,0,1429,25
2020-05-07,Slovakia,16,1,1445,26
2020-05-08,Slovakia,10,0,1455,26
2020-05-09,Slovakia,0,0,1455,26
2020-05-10,Slovakia,2,0,1457,26
2020-05-11,Slovakia,0,0,1457,26
2020-05-12,Slovakia,8,1,1465,27
2020-05-13,Slovakia,4,0,1469,27
2020-05-14,Slovakia,8,0,1477,27
2020-05-15,Slovakia,3,0,1480,27
2020-05-16,Slovakia,13,1,1493,28
2020-05-17,Slovakia,1,0,1494,28
2020-05-18,Slovakia,1,0,1495,28
2020-05-19,Slovakia,0,0,1495,28
2020-05-20,Slovakia,1,0,1496,28
2020-05-21,Slovakia,6,0,1502,28
2020-05-22,Slovakia,1,0,1503,28
2020-05-23,Slovakia,1,0,1504,28
2020-05-24,Slovakia,5,0,1509,28
2020-05-25,Slovakia,2,0,1511,28
2020-05-26,Slovakia,2,0,1513,28
2020-05-27,Slovakia,2,0,1515,28
2020-05-28,Slovakia,5,0,1520,28
2020-05-29,Slovakia,0,0,1520,28
2020-05-30,Slovakia,1,0,1521,28
2020-05-31,Slovakia,0,0,1521,28
2020-06-01,Slovakia,1,0,1522,28
2020-06-02,Slovakia,0,0,1522,28
2020-06-03,Slovakia,3,0,1525,28
2020-06-04,Slovakia,1,0,1526,28
2020-06-05,Slovakia,0,0,1526,28
2020-06-06,Slovakia,2,0,1528,28
2020-06-07,Slovakia,0,0,1528,28
2020-06-08,Slovakia,2,0,1530,28
2020-06-09,Slovakia,1,0,1531,28
2020-06-10,Slovakia,2,0,1533,28
2020-06-11,Slovakia,8,0,1541,28
2020-06-12,Slovakia,1,0,1542,28
2020-06-13,Slovakia,3,0,1545,28
2020-06-14,Slovakia,3,0,1548,28
2020-06-15,Slovakia,4,0,1552,28
2020-06-16,Slovakia,0,0,1552,28
2020-06-17,Slovakia,9,0,1561,28
2020-06-18,Slovakia,1,0,1562,28
2020-06-19,Slovakia,14,0,1576,28
2020-06-20,Slovakia,10,0,1586,28
2020-06-21,Slovakia,1,0,1587,28
2020-06-22,Slovakia,1,0,1588,28
2020-06-23,Slovakia,1,0,1589,28
2020-06-24,Slovakia,18,0,1607,28
2020-06-25,Slovakia,23,0,1630,28
2020-06-26,Slovakia,13,0,1643,28
2020-06-27,Slovakia,14,0,1657,28
2020-06-28,Slovakia,7,0,1664,28
2020-06-29,Slovakia,1,0,1665,28
2020-06-30,Slovakia,2,0,1667,28
2020-07-01,Slovakia,20,0,1687,28
2020-07-02,Slovakia,13,0,1700,28
2020-07-03,Slovakia,20,0,1720,28
2020-07-04,Slovakia,29,0,1749,28
2020-07-05,Slovakia,15,0,1764,28
2020-07-06,Slovakia,1,0,1765,28
2020-07-07,Slovakia,2,0,1767,28
2020-07-08,Slovakia,31,0,1798,28
2020-07-09,Slovakia,53,0,1851,28
2020-07-10,Slovakia,19,0,1870,28
2020-07-11,Slovakia,23,0,1893,28
2020-07-12,Slovakia,8,0,1901,28
2020-07-13,Slovakia,1,0,1902,28
2020-07-14,Slovakia,6,0,1908,28
2020-07-15,Slovakia,19,0,1927,28
2020-07-16,Slovakia,24,0,1951,28
2020-07-17,Slovakia,14,0,1965,28
2020-07-18,Slovakia,11,0,1976,28
2020-07-19,Slovakia,3,0,1979,28
2020-07-20,Slovakia,1,0,1980,28
2020-07-21,Slovakia,41,0,2021,28
2020-07-22,Slovakia,37,0,2058,28
2020-07-23,Slovakia,31,0,2089,28
2020-07-24,Slovakia,29,0,2118,28
2020-07-25,Slovakia,23,0,2141,28
2020-07-26,Slovakia,38,0,2179,28
2020-07-27,Slovakia,2,0,2181,28
2020-07-28,Slovakia,23,0,2204,28
2020-07-29,Slovakia,41,0,2245,28
2020-07-30,Slovakia,20,0,2265,28
2020-07-31,Slovakia,27,1,2292,29
2020-08-01,Slovakia,45,0,2337,29
2020-08-02,Slovakia,7,0,2344,29
2020-08-03,Slovakia,10,0,2354,29
2020-08-04,Slovakia,14,0,2368,29
2020-08-05,Slovakia,49,0,2417,29
2020-08-06,Slovakia,63,0,2480,29
2020-08-07,Slovakia,43,2,2523,31
2020-08-08,Slovakia,43,0,2566,31
2020-08-09,Slovakia,30,0,2596,31
2020-08-10,Slovakia,3,0,2599,31
2020-08-11,Slovakia,16,0,2615,31
2020-08-12,Slovakia,75,0,2690,31
2020-08-13,Slovakia,49,0,2739,31
2020-08-14,Slovakia,62,0,2801,31
2020-08-15,Slovakia,54,0,2855,31
2020-08-16,Slovakia,47,0,2902,31
2020-08-17,Slovakia,5,0,2907,31
2020-08-18,Slovakia,15,0,2922,31
2020-08-19,Slovakia,100,2,3022,33
2020-08-20,Slovakia,80,0,3102,33
2020-08-21,Slovakia,123,0,3225,33
2020-08-22,Slovakia,91,0,3316,33
2020-08-23,Slovakia,40,0,3356,33
2020-08-24,Slovakia,68,0,3424,33
2020-08-25,Slovakia,28,0,3452,33
2020-08-26,Slovakia,84,0,3536,33
2020-08-27,Slovakia,90,0,3626,33
2020-08-28,Slovakia,102,0,3728,33
2020-08-29,Slovakia,114,0,3842,33
2020-08-30,Slovakia,34,0,3876,33
2020-08-31,Slovakia,41,0,3917,33
2020-09-01,Slovakia,72,0,3989,33
2020-09-02,Slovakia,53,0,4042,33
2020-09-03,Slovakia,121,4,4163,37
2020-09-04,Slovakia,137,0,4300,37
2020-09-05,Slovakia,226,0,4526,37
2020-09-06,Slovakia,88,0,4614,37
2020-09-07,Slovakia,22,0,4636,37
2020-09-08,Slovakia,91,0,4727,37
2020-09-09,Slovakia,161,0,4888,37
2020-09-10,Slovakia,178,0,5066,37
2020-09-11,Slovakia,186,0,5252,37
2020-09-12,Slovakia,201,1,5453,38
2020-09-13,Slovakia,79,0,5532,38
2020-09-14,Slovakia,48,0,5580,38
2020-09-15,Slovakia,188,0,5768,38
2020-09-16,Slovakia,92,0,5860,38
2020-09-17,Slovakia,161,1,6021,39
2020-09-18,Slovakia,235,0,6256,39
2020-09-19,Slovakia,290,0,6546,39
2020-09-20,Slovakia,131,0,6677,39
2020-09-21,Slovakia,79,0,6756,39
2020-09-22,Slovakia,175,1,6931,40
2020-09-23,Slovakia,338,1,7269,41
2020-09-24,Slovakia,360,0,7629,41
2020-09-25,Slovakia,419,0,8048,41
2020-09-26,Slovakia,552,3,8600,44
2020-09-27,Slovakia,478,0,9078,44
2020-09-28,Slovakia,265,0,9343,44
2020-09-29,Slovakia,231,1,9574,45
2020-09-30,Slovakia,567,3,10141,48
2020-10-01,Slovakia,797,0,10938,48
2020-10-02,Slovakia,679,6,11617,54
2020-10-03,Slovakia,704,0,12321,54
2020-10-04,Slovakia,818,1,13139,55
2020-10-05,Slovakia,353,0,13492,55
2020-10-06,Slovakia,320,0,13812,55
2020-10-07,Slovakia,877,0,14689,55
2020-10-08,Slovakia,1037,2,15726,57
2020-10-09,Slovakia,1184,0,16910,57
2020-10-10,Slovakia,1887,4,18797,61
2020-10-11,Slovakia,1054,0,19851,61
2020-10-12,Slovakia,504,0,20355,61
2020-10-13,Slovakia,531,0,20886,61
2020-10-14,Slovakia,1410,5,22296,66
2020-10-15,Slovakia,1929,5,24225,71
2020-10-16,Slovakia,2075,0,26300,71
2020-10-17,Slovakia,1968,11,28268,82
2020-10-18,Slovakia,1567,6,29835,88
2020-10-19,Slovakia,860,4,30695,92
2020-10-20,Slovakia,705,6,31400,98
2020-10-21,Slovakia,2202,0,33602,98
2020-10-22,Slovakia,1728,17,35330,115
2020-10-23,Slovakia,2581,19,37911,134
2020-10-24,Slovakia,2890,25,40801,159
2020-10-25,Slovakia,3042,0,43843,159
2020-10-26,Slovakia,1312,6,45155,165
2020-10-27,Slovakia,901,11,46056,176
2020-10-28,Slovakia,2887,8,48943,184
2020-10-29,Slovakia,2785,16,51728,200
2020-10-30,Slovakia,3363,12,55091,212
2020-10-31,Slovakia,2573,7,57664,219
2020-11-01,Slovakia,2282,0,59946,219
2020-11-02,Slovakia,1883,0,61829,219
2020-11-03,Slovakia,1727,16,63556,235
2020-11-04,Slovakia,3216,26,66772,261
2020-11-05,Slovakia,1962,25,68734,286
2020-11-06,Slovakia,2354,31,71088,317
2020-11-07,Slovakia,2579,34,73667,351
2020-11-08,Slovakia,1828,0,75495,351
2020-11-09,Slovakia,577,15,76072,366
2020-11-10,Slovakia,1051,24,77123,390
2020-11-11,Slovakia,2058,24,79181,414
2020-11-12,Slovakia,2591,50,81772,464
2020-11-13,Slovakia,2024,27,83796,491
2020-11-14,Slovakia,1771,19,85567,510
2020-11-15,Slovakia,1200,0,86767,510
2020-11-16,Slovakia,509,16,87276,526
2020-11-17,Slovakia,1326,31,88602,557
2020-11-18,Slovakia,1311,22,89913,579
2020-11-19,Slovakia,1665,0,91578,579
2020-11-20,Slovakia,1818,35,93396,614
2020-11-21,Slovakia,1861,30,95257,644
2020-11-22,Slovakia,984,27,96241,671
2020-11-23,Slovakia,231,22,96472,693
2020-11-24,Slovakia,1021,16,97493,709
2020-11-25,Slovakia,1811,23,99304,732
2020-11-26,Slovakia,1953,17,101257,749
2020-11-27,Slovakia,1849,22,103106,771
2020-11-28,Slovakia,1526,27,104632,798
2020-11-29,Slovakia,1101,18,105733,816
2020-11-30,Slovakia,196,23,105929,839
2020-12-01,Slovakia,1254,29,107183,868
2020-12-02,Slovakia,2043,30,109226,898
2020-12-03,Slovakia,1982,32,111208,930
2020-12-04,Slovakia,2184,27,113392,957
2020-12-05,Slovakia,2070,24,115462,981
2020-12-06,Slovakia,1269,15,116731,996
2020-12-07,Slovakia,552,22,117283,1018
2020-12-08,Slovakia,1949,28,119232,1046
2020-12-09,Slovakia,2564,38,121796,1084
2020-12-10,Slovakia,3125,20,124921,1104
2020-12-11,Slovakia,2166,18,127087,1122
2020-12-12,Slovakia,3707,26,130794,1148
2020-12-13,Slovakia,2190,27,132984,1175
2020-12-14,Slovakia,505,30,133489,1205
2020-12-15,Slovakia,2034,46,135523,1251
2020-12-16,Slovakia,3565,58,139088,1309
2020-12-17,Slovakia,3045,69,142133,1378
2020-12-18,Slovakia,3991,62,146124,1440
2020-12-19,Slovakia,3151,70,149275,1510
2020-12-20,Slovakia,2061,45,151336,1555
2020-12-21,Slovakia,1219,63,152555,1618
2020-12-22,Slovakia,2663,0,155218,1618
2020-12-23,Slovakia,3687,68,158905,1686
2020-12-24,Slovakia,2657,46,161562,1732
2020-12-25,Slovakia,4046,0,165608,1732
2020-12-26,Slovakia,1041,0,166649,1732
2020-12-27,Slovakia,874,41,167523,1773
2020-12-28,Slovakia,569,106,168092,1879
2020-12-29,Slovakia,2095,104,170187,1983
2020-12-30,Slovakia,3041,82,173228,2065
2020-12-31,Slovakia,6315,73,179543,2138
2021-01-01,Slovakia,4965,112,184508,2250
2021-01-02,Slovakia,1736,0,186244,2250
2021-01-03,Slovakia,1219,67,187463,2317
2021-01-04,Slovakia,636,204,188099,2521
2021-01-05,Slovakia,2989,82,191088,2603
2021-01-06,Slovakia,4959,54,196047,2657
2021-01-07,Slovakia,2137,60,198184,2717
2021-01-08,Slovakia,2980,71,201164,2788
2021-01-09,Slovakia,4072,48,205236,2836
2021-01-10,Slovakia,2973,82,208209,2918
2021-01-11,Slovakia,860,89,209069,3007
2021-01-12,Slovakia,2410,95,211479,3102
2021-01-13,Slovakia,3576,61,215055,3163
2021-01-14,Slovakia,2923,97,217978,3260
2021-01-15,Slovakia,2729,102,220707,3362
2021-01-16,Slovakia,2045,55,222752,3417
2021-01-17,Slovakia,573,57,223325,3474
2021-01-18,Slovakia,1060,52,224385,3526
2021-01-19,Slovakia,1909,111,226294,3637
2021-01-20,Slovakia,2484,100,228778,3737
2021-01-21,Slovakia,2464,64,231242,3801
2021-01-22,Slovakia,1785,93,233027,3894
2021-01-23,Slovakia,1544,71,234571,3965
2021-01-24,Slovakia,1905,103,236476,4068
2021-01-25,Slovakia,551,0,237027,4068
2021-01-26,Slovakia,1590,192,238617,4260
2021-01-27,Slovakia,2775,101,241392,4361
2021-01-28,Slovakia,2035,50,243427,4411
2021-01-29,Slovakia,2581,84,246008,4495
2021-01-30,Slovakia,2182,70,248190,4565
2021-01-31,Slovakia,1723,77,249913,4642
2021-02-01,Slovakia,444,69,250357,4711
2021-02-02,Slovakia,1737,73,252094,4784
2021-02-03,Slovakia,2732,105,254826,4889
2021-02-04,Slovakia,2077,87,256903,4976
2021-02-05,Slovakia,2630,74,259533,5050
2021-02-06,Slovakia,2241,85,261774,5135
2021-02-07,Slovakia,1552,64,263326,5199
2021-02-08,Slovakia,757,72,264083,5271
2021-02-09,Slovakia,1724,111,265807,5382
2021-02-10,Slovakia,3179,120,268986,5502
2021-02-11,Slovakia,2487,127,271473,5629
2021-02-12,Slovakia,2431,104,273904,5733
2021-02-13,Slovakia,2330,79,276234,5812
2021-02-14,Slovakia,1448,73,277682,5885
2021-02-15,Slovakia,572,67,278254,5952
2021-02-16,Slovakia,1442,111,279696,6063
2021-02-17,Slovakia,3168,105,282864,6168
2021-02-18,Slovakia,2555,103,285419,6271
2021-02-19,Slovakia,2333,79,287752,6350
2021-02-20,Slovakia,2705,74,290457,6424
2021-02-21,Slovakia,1686,81,292143,6505
2021-02-22,Slovakia,649,72,292792,6577
2021-02-23,Slovakia,1998,94,294790,6671
2021-02-24,Slovakia,3547,104,298337,6775
2021-02-25,Slovakia,2438,84,300775,6859
2021-02-26,Slovakia,2645,107,303420,6966
2021-02-27,Slovakia,2848,109,306268,7075
2021-02-28,Slovakia,1815,114,308083,7189
2021-03-01,Slovakia,842,81,308925,7270
2021-03-02,Slovakia,2077,118,311002,7388
2021-03-03,Slovakia,3357,101,314359,7489
2021-03-04,Slovakia,2800,71,317159,7560
2021-03-05,Slovakia,2423,105,319582,7665
2021-03-06,Slovakia,2522,74,322104,7739
2021-03-07,Slovakia,1286,97,323390,7836
2021-03-08,Slovakia,396,85,323786,7921
2021-03-09,Slovakia,2207,116,325993,8037
2021-03-10,Slovakia,3600,109,329593,8146
2021-03-11,Slovakia,1978,98,331571,8244
2021-03-12,Slovakia,2301,102,333872,8346
2021-03-13,Slovakia,2363,94,336235,8440
2021-03-14,Slovakia,1268,88,337503,8528
2021-03-15,Slovakia,457,77,337960,8605
2021-03-16,Slovakia,1578,64,339538,8669
2021-03-17,Slovakia,2892,69,342430,8738
2021-03-18,Slovakia,2040,76,344470,8814
2021-03-19,Slovakia,1679,80,346149,8894
2021-03-20,Slovakia,1795,84,347944,8978
2021-03-21,Slovakia,925,66,348869,9044
2021-03-22,Slovakia,401,60,349270,9104
2021-03-23,Slovakia,1281,86,350551,9190
2021-03-24,Slovakia,1977,71,352528,9261
2021-03-25,Slovakia,1654,52,354182,9313
2021-03-26,Slovakia,1272,60,355454,9373
2021-03-27,Slovakia,1531,53,356985,9426
2021-03-28,Slovakia,925,70,357910,9496
2021-03-29,Slovakia,205,46,358115,9542
2021-03-30,Slovakia,1215,82,359330,9624
2021-03-31,Slovakia,1855,95,361185,9719
2021-04-01,Slovakia,1304,71,362489,9790
2021-04-02,Slovakia,1385,87,363874,9877
2021-04-03,Slovakia,748,71,364622,9948
2021-04-04,Slovakia,620,77,365242,10025
2021-04-05,Slovakia,158,69,365400,10094
2021-04-06,Slovakia,333,0,365733,10094
2021-04-07,Slovakia,1161,149,366894,10243
2021-04-08,Slovakia,1576,79,368470,10322
2020-03-05,Slovenia,2,0,2,0
2020-03-06,Slovenia,5,0,7,0
2020-03-07,Slovenia,0,0,7,0
2020-03-08,Slovenia,9,0,16,0
2020-03-09,Slovenia,0,0,16,0
2020-03-10,Slovenia,15,0,31,0
2020-03-11,Slovenia,26,0,57,0
2020-03-12,Slovenia,32,0,89,0
2020-03-13,Slovenia,52,0,141,0
2020-03-14,Slovenia,40,1,181,1
2020-03-15,Slovenia,38,0,219,1
2020-03-16,Slovenia,34,0,253,1
2020-03-17,Slovenia,22,0,275,1
2020-03-18,Slovenia,0,0,275,1
2020-03-19,Slovenia,11,0,286,1
2020-03-20,Slovenia,55,0,341,1
2020-03-21,Slovenia,42,0,383,1
2020-03-22,Slovenia,31,1,414,2
2020-03-23,Slovenia,28,1,442,3
2020-03-24,Slovenia,38,1,480,4
2020-03-25,Slovenia,48,1,528,5
2020-03-26,Slovenia,34,1,562,6
2020-03-27,Slovenia,70,3,632,9
2020-03-28,Slovenia,52,0,684,9
2020-03-29,Slovenia,46,2,730,11
2020-03-30,Slovenia,26,0,756,11
2020-03-31,Slovenia,46,4,802,15
2020-04-01,Slovenia,39,0,841,15
2020-04-02,Slovenia,56,2,897,17
2020-04-03,Slovenia,37,3,934,20
2020-04-04,Slovenia,43,2,977,22
2020-04-05,Slovenia,20,6,997,28
2020-04-06,Slovenia,24,2,1021,30
2020-04-07,Slovenia,38,6,1059,36
2020-04-08,Slovenia,32,4,1091,40
2020-04-09,Slovenia,33,3,1124,43
2020-04-10,Slovenia,36,2,1160,45
2020-04-11,Slovenia,28,5,1188,50
2020-04-12,Slovenia,17,3,1205,53
2020-04-13,Slovenia,7,2,1212,55
2020-04-14,Slovenia,8,1,1220,56
2020-04-15,Slovenia,28,5,1248,61
2020-04-16,Slovenia,20,0,1268,61
2020-04-17,Slovenia,36,5,1304,66
2020-04-18,Slovenia,13,4,1317,70
2020-04-19,Slovenia,13,4,1330,74
2020-04-20,Slovenia,5,3,1335,77
2020-04-21,Slovenia,9,0,1344,77
2020-04-22,Slovenia,9,2,1353,79
2020-04-23,Slovenia,13,0,1366,79
2020-04-24,Slovenia,7,1,1373,80
2020-04-25,Slovenia,15,1,1388,81
2020-04-26,Slovenia,8,1,1396,82
2020-04-27,Slovenia,6,1,1402,83
2020-04-28,Slovenia,6,3,1408,86
2020-04-29,Slovenia,10,3,1418,89
2020-04-30,Slovenia,11,2,1429,91
2020-05-01,Slovenia,5,1,1434,92
2020-05-02,Slovenia,5,2,1439,94
2020-05-03,Slovenia,0,2,1439,96
2020-05-04,Slovenia,0,1,1439,97
2020-05-05,Slovenia,6,1,1445,98
2020-05-06,Slovenia,3,1,1448,99
2020-05-07,Slovenia,1,0,1449,99
2020-05-08,Slovenia,1,1,1450,100
2020-05-09,Slovenia,4,1,1454,101
2020-05-10,Slovenia,3,1,1457,102
2020-05-11,Slovenia,3,0,1460,102
2020-05-12,Slovenia,1,0,1461,102
2020-05-13,Slovenia,2,1,1463,103
2020-05-14,Slovenia,1,0,1464,103
2020-05-15,Slovenia,1,0,1465,103
2020-05-16,Slovenia,0,0,1465,103
2020-05-17,Slovenia,1,1,1466,104
2020-05-18,Slovenia,0,0,1466,104
2020-05-19,Slovenia,1,0,1467,104
2020-05-20,Slovenia,1,1,1468,105
2020-05-21,Slovenia,0,1,1468,106
2020-05-22,Slovenia,0,0,1468,106
2020-05-23,Slovenia,0,0,1468,106
2020-05-24,Slovenia,0,1,1468,107
2020-05-25,Slovenia,1,0,1469,107
2020-05-26,Slovenia,0,1,1469,108
2020-05-27,Slovenia,2,0,1471,108
2020-05-28,Slovenia,2,0,1473,108
2020-05-29,Slovenia,0,0,1473,108
2020-05-30,Slovenia,0,0,1473,108
2020-05-31,Slovenia,0,0,1473,108
2020-06-01,Slovenia,0,1,1473,109
2020-06-02,Slovenia,2,0,1475,109
2020-06-03,Slovenia,2,0,1477,109
2020-06-04,Slovenia,0,0,1477,109
2020-06-05,Slovenia,2,0,1479,109
2020-06-06,Slovenia,5,0,1484,109
2020-06-07,Slovenia,1,0,1485,109
2020-06-08,Slovenia,0,0,1485,109
2020-06-09,Slovenia,1,0,1486,109
2020-06-10,Slovenia,2,0,1488,109
2020-06-11,Slovenia,0,0,1488,109
2020-06-12,Slovenia,2,0,1490,109
2020-06-13,Slovenia,2,0,1492,109
2020-06-14,Slovenia,3,0,1495,109
2020-06-15,Slovenia,1,0,1496,109
2020-06-16,Slovenia,3,0,1499,109
2020-06-17,Slovenia,4,0,1503,109
2020-06-18,Slovenia,8,0,1511,109
2020-06-19,Slovenia,2,0,1513,109
2020-06-20,Slovenia,6,0,1519,109
2020-06-21,Slovenia,1,0,1520,109
2020-06-22,Slovenia,1,0,1521,109
2020-06-23,Slovenia,13,0,1534,109
2020-06-24,Slovenia,7,0,1541,109
2020-06-25,Slovenia,6,0,1547,109
2020-06-26,Slovenia,11,0,1558,109
2020-06-27,Slovenia,14,0,1572,109
2020-06-28,Slovenia,9,2,1581,111
2020-06-29,Slovenia,4,0,1585,111
2020-06-30,Slovenia,15,0,1600,111
2020-07-01,Slovenia,13,0,1613,111
2020-07-02,Slovenia,21,0,1634,111
2020-07-03,Slovenia,16,0,1650,111
2020-07-04,Slovenia,29,0,1679,111
2020-07-05,Slovenia,21,0,1700,111
2020-07-06,Slovenia,16,0,1716,111
2020-07-07,Slovenia,23,0,1739,111
2020-07-08,Slovenia,24,0,1763,111
2020-07-09,Slovenia,13,0,1776,111
2020-07-10,Slovenia,17,0,1793,111
2020-07-11,Slovenia,34,0,1827,111
2020-07-12,Slovenia,14,0,1841,111
2020-07-13,Slovenia,8,0,1849,111
2020-07-14,Slovenia,10,0,1859,111
2020-07-15,Slovenia,19,0,1878,111
2020-07-16,Slovenia,19,0,1897,111
2020-07-17,Slovenia,19,0,1916,111
2020-07-18,Slovenia,24,0,1940,111
2020-07-19,Slovenia,6,1,1946,112
2020-07-20,Slovenia,7,1,1953,113
2020-07-21,Slovenia,24,1,1977,114
2020-07-22,Slovenia,29,1,2006,115
2020-07-23,Slovenia,27,0,2033,115
2020-07-24,Slovenia,19,0,2052,115
2020-07-25,Slovenia,14,1,2066,116
2020-07-26,Slovenia,16,0,2082,116
2020-07-27,Slovenia,5,0,2087,116
2020-07-28,Slovenia,14,1,2101,117
2020-07-29,Slovenia,14,0,2115,117
2020-07-30,Slovenia,24,0,2139,117
2020-07-31,Slovenia,17,2,2156,119
2020-08-01,Slovenia,15,0,2171,119
2020-08-02,Slovenia,9,1,2180,120
2020-08-03,Slovenia,1,2,2181,122
2020-08-04,Slovenia,9,1,2190,123
2020-08-05,Slovenia,18,1,2208,124
2020-08-06,Slovenia,15,1,2223,125
2020-08-07,Slovenia,10,0,2233,125
2020-08-08,Slovenia,14,1,2247,126
2020-08-09,Slovenia,2,1,2249,127
2020-08-10,Slovenia,6,1,2255,128
2020-08-11,Slovenia,17,1,2272,129
2020-08-12,Slovenia,31,0,2303,129
2020-08-13,Slovenia,29,0,2332,129
2020-08-14,Slovenia,37,0,2369,129
2020-08-15,Slovenia,32,0,2401,129
2020-08-16,Slovenia,15,0,2416,129
2020-08-17,Slovenia,13,0,2429,129
2020-08-18,Slovenia,27,0,2456,129
2020-08-19,Slovenia,37,0,2493,129
2020-08-20,Slovenia,43,0,2536,129
2020-08-21,Slovenia,38,1,2574,130
2020-08-22,Slovenia,43,1,2617,131
2020-08-23,Slovenia,34,0,2651,131
2020-08-24,Slovenia,14,2,2665,133
2020-08-25,Slovenia,21,0,2686,133
2020-08-26,Slovenia,36,0,2722,133
2020-08-27,Slovenia,33,0,2755,133
2020-08-28,Slovenia,42,0,2797,133
2020-08-29,Slovenia,37,0,2834,133
2020-08-30,Slovenia,31,0,2865,133
2020-08-31,Slovenia,18,0,2883,133
2020-09-01,Slovenia,41,0,2924,133
2020-09-02,Slovenia,55,1,2979,134
2020-09-03,Slovenia,53,0,3032,134
2020-09-04,Slovenia,47,0,3079,134
2020-09-05,Slovenia,43,1,3122,135
2020-09-06,Slovenia,43,0,3165,135
2020-09-07,Slovenia,25,0,3190,135
2020-09-08,Slovenia,42,0,3232,135
2020-09-09,Slovenia,80,0,3312,135
2020-09-10,Slovenia,77,0,3389,135
2020-09-11,Slovenia,108,0,3497,135
2020-09-12,Slovenia,106,0,3603,135
2020-09-13,Slovenia,99,0,3702,135
2020-09-14,Slovenia,47,0,3749,135
2020-09-15,Slovenia,82,0,3831,135
2020-09-16,Slovenia,123,0,3954,135
2020-09-17,Slovenia,104,1,4058,136
2020-09-18,Slovenia,137,4,4195,140
2020-09-19,Slovenia,114,1,4309,141
2020-09-20,Slovenia,111,1,4420,142
2020-09-21,Slovenia,50,0,4470,142
2020-09-22,Slovenia,88,0,4558,142
2020-09-23,Slovenia,136,1,4694,143
2020-09-24,Slovenia,122,2,4816,145
2020-09-25,Slovenia,191,0,5007,145
2020-09-26,Slovenia,184,1,5191,146
2020-09-27,Slovenia,159,1,5350,147
2020-09-28,Slovenia,38,2,5388,149
2020-09-29,Slovenia,99,0,5487,149
2020-09-30,Slovenia,203,1,5690,150
2020-10-01,Slovenia,175,2,5865,152
2020-10-02,Slovenia,238,2,6103,154
2020-10-03,Slovenia,227,1,6330,155
2020-10-04,Slovenia,168,0,6498,155
2020-10-05,Slovenia,175,1,6673,156
2020-10-06,Slovenia,91,3,6764,159
2020-10-07,Slovenia,356,0,7120,159
2020-10-08,Slovenia,387,1,7507,160
2020-10-09,Slovenia,365,5,7872,165
2020-10-10,Slovenia,380,2,8252,167
2020-10-11,Slovenia,411,0,8663,167
2020-10-12,Slovenia,169,2,8832,169
2020-10-13,Slovenia,399,4,9231,173
2020-10-14,Slovenia,707,2,9938,175
2020-10-15,Slovenia,745,1,10683,176
2020-10-16,Slovenia,834,4,11517,180
2020-10-17,Slovenia,899,4,12416,184
2020-10-18,Slovenia,726,4,13142,188
2020-10-19,Slovenia,537,2,13679,190
2020-10-20,Slovenia,794,2,14473,192
2020-10-21,Slovenia,1509,8,15982,200
2020-10-22,Slovenia,1664,11,17646,211
2020-10-23,Slovenia,1661,3,19307,214
2020-10-24,Slovenia,1967,21,21274,235
2020-10-25,Slovenia,1676,5,22950,240
2020-10-26,Slovenia,1130,11,24080,251
2020-10-27,Slovenia,1523,13,25603,264
2020-10-28,Slovenia,2612,14,28215,278
2020-10-29,Slovenia,2490,14,30705,292
2020-10-30,Slovenia,1798,23,32503,315
2020-10-31,Slovenia,1804,23,34307,338
2020-11-01,Slovenia,1342,25,35649,363
2020-11-02,Slovenia,557,25,36206,388
2020-11-03,Slovenia,1176,24,37382,412
2020-11-04,Slovenia,2026,29,39408,441
2020-11-05,Slovenia,1686,30,41094,471
2020-11-06,Slovenia,1564,26,42658,497
2020-11-07,Slovenia,1612,34,44270,531
2020-11-08,Slovenia,891,23,45161,554
2020-11-09,Slovenia,464,24,45625,578
2020-11-10,Slovenia,1092,27,46717,605
2020-11-11,Slovenia,2222,40,48939,645
2020-11-12,Slovenia,1931,41,50870,686
2020-11-13,Slovenia,1515,38,52385,724
2020-11-14,Slovenia,1737,41,54122,765
2020-11-15,Slovenia,920,32,55042,797
2020-11-16,Slovenia,502,34,55544,831
2020-11-17,Slovenia,1393,45,56937,876
2020-11-18,Slovenia,2027,43,58964,919
2020-11-19,Slovenia,2070,45,61034,964
2020-11-20,Slovenia,1546,31,62580,995
2020-11-21,Slovenia,1704,31,64284,1026
2020-11-22,Slovenia,1024,26,65308,1052
2020-11-23,Slovenia,470,45,65778,1097
2020-11-24,Slovenia,1302,59,67080,1156
2020-11-25,Slovenia,2226,43,69306,1199
2020-11-26,Slovenia,1767,46,71073,1245
2020-11-27,Slovenia,1601,48,72674,1293
2020-11-28,Slovenia,1583,43,74257,1336
2020-11-29,Slovenia,1124,48,75381,1384
2020-11-30,Slovenia,433,51,75814,1435
2020-12-01,Slovenia,1321,55,77135,1490
2020-12-02,Slovenia,2431,57,79566,1547
2020-12-03,Slovenia,1783,45,81349,1592
2020-12-04,Slovenia,1784,61,83133,1653
2020-12-05,Slovenia,1642,47,84775,1700
2020-12-06,Slovenia,1030,44,85805,1744
2020-12-07,Slovenia,483,52,86288,1796
2020-12-08,Slovenia,1648,66,87936,1862
2020-12-09,Slovenia,2139,38,90075,1900
2020-12-10,Slovenia,1847,49,91922,1949
2020-12-11,Slovenia,1815,49,93737,1998
2020-12-12,Slovenia,1744,43,95481,2041
2020-12-13,Slovenia,833,22,96314,2063
2020-12-14,Slovenia,431,44,96745,2107
2020-12-15,Slovenia,1536,42,98281,2149
2020-12-16,Slovenia,2120,41,100401,2190
2020-12-17,Slovenia,1642,43,102043,2233
2020-12-18,Slovenia,1512,41,103555,2274
2020-12-19,Slovenia,1458,40,105013,2314
2020-12-20,Slovenia,886,39,105899,2353
2020-12-21,Slovenia,395,26,106294,2379
2020-12-22,Slovenia,1511,39,107805,2418
2020-12-23,Slovenia,2129,36,109934,2454
2020-12-24,Slovenia,2087,25,112021,2479
2020-12-25,Slovenia,1794,28,113815,2507
2020-12-26,Slovenia,369,25,114184,2532
2020-12-27,Slovenia,622,33,114806,2565
2020-12-28,Slovenia,521,30,115327,2595
2020-12-29,Slovenia,1978,36,117305,2631
2020-12-30,Slovenia,2435,34,119740,2665
2020-12-31,Slovenia,2412,32,122152,2697
2021-01-01,Slovenia,1798,31,123950,2728
2021-01-02,Slovenia,393,46,124343,2774
2021-01-03,Slovenia,743,29,125086,2803
2021-01-04,Slovenia,772,35,125858,2838
2021-01-05,Slovenia,2512,30,128370,2868
2021-01-06,Slovenia,3354,31,131724,2899
2021-01-07,Slovenia,2821,23,134545,2922
2021-01-08,Slovenia,2084,25,136629,2947
2021-01-09,Slovenia,1889,26,138518,2973
2021-01-10,Slovenia,763,25,139281,2998
2021-01-11,Slovenia,432,24,139713,3022
2021-01-12,Slovenia,1874,31,141587,3053
2021-01-13,Slovenia,2092,17,143679,3070
2021-01-14,Slovenia,1793,23,145472,3093
2021-01-15,Slovenia,1544,28,147016,3121
2021-01-16,Slovenia,1540,19,148556,3140
2021-01-17,Slovenia,569,40,149125,3180
2021-01-18,Slovenia,299,26,149424,3206
2021-01-19,Slovenia,1713,25,151137,3231
2021-01-20,Slovenia,1714,26,152851,3257
2021-01-21,Slovenia,1455,27,154306,3284
2021-01-22,Slovenia,1446,25,155752,3309
2021-01-23,Slovenia,1541,20,157293,3329
2021-01-24,Slovenia,537,31,157830,3360
2021-01-25,Slovenia,301,19,158131,3379
2021-01-26,Slovenia,1681,27,159812,3406
2021-01-27,Slovenia,1850,19,161662,3425
2021-01-28,Slovenia,1573,23,163235,3448
2021-01-29,Slovenia,1294,20,164529,3468
2021-01-30,Slovenia,1358,22,165887,3490
2021-01-31,Slovenia,586,13,166473,3503
2021-02-01,Slovenia,363,19,166836,3522
2021-02-02,Slovenia,1650,19,168486,3541
2021-02-03,Slovenia,1615,23,170101,3564
2021-02-04,Slovenia,1239,16,171340,3580
2021-02-05,Slovenia,959,15,172299,3595
2021-02-06,Slovenia,902,17,173201,3612
2021-02-07,Slovenia,501,11,173702,3623
2021-02-08,Slovenia,298,12,174000,3635
2021-02-09,Slovenia,364,19,174364,3654
2021-02-10,Slovenia,1431,13,175795,3667
2021-02-11,Slovenia,1345,10,177140,3677
2021-02-12,Slovenia,993,15,178133,3692
2021-02-13,Slovenia,1015,13,179148,3705
2021-02-14,Slovenia,329,12,179477,3717
2021-02-15,Slovenia,303,11,179780,3728
2021-02-16,Slovenia,740,5,180520,3733
2021-02-17,Slovenia,1086,12,181606,3745
2021-02-18,Slovenia,878,10,182484,3755
2021-02-19,Slovenia,912,7,183396,3762
2021-02-20,Slovenia,956,7,184352,3769
2021-02-21,Slovenia,415,7,184767,3776
2021-02-22,Slovenia,247,8,185014,3784
2021-02-23,Slovenia,902,8,185916,3792
2021-02-24,Slovenia,1089,10,187005,3802
2021-02-25,Slovenia,757,7,187762,3809
2021-02-26,Slovenia,914,14,188676,3823
2021-02-27,Slovenia,951,13,189627,3836
2021-02-28,Slovenia,454,0,190081,3836
2021-03-01,Slovenia,243,18,190324,3854
2021-03-02,Slovenia,732,9,191056,3863
2021-03-03,Slovenia,1210,11,192266,3874
2021-03-04,Slovenia,1019,4,193285,3878
2021-03-05,Slovenia,880,4,194165,3882
2021-03-06,Slovenia,921,6,195086,3888
2021-03-07,Slovenia,382,3,195468,3891
2021-03-08,Slovenia,210,6,195678,3897
2021-03-09,Slovenia,743,7,196421,3904
2021-03-10,Slovenia,953,4,197374,3908
2021-03-11,Slovenia,860,10,198234,3918
2021-03-12,Slovenia,770,8,199004,3926
2021-03-13,Slovenia,850,3,199854,3929
2021-03-14,Slovenia,520,5,200374,3934
2021-03-15,Slovenia,205,4,200579,3938
2021-03-16,Slovenia,918,3,201497,3941
2021-03-17,Slovenia,1076,7,202573,3948
2021-03-18,Slovenia,971,3,203544,3951
2021-03-19,Slovenia,938,10,204482,3961
2021-03-20,Slovenia,1027,6,205509,3967
2021-03-21,Slovenia,517,5,206026,3972
2021-03-22,Slovenia,291,4,206317,3976
2021-03-23,Slovenia,981,9,207298,3985
2021-03-24,Slovenia,1290,9,208588,3994
2021-03-25,Slovenia,1165,4,209753,3998
2021-03-26,Slovenia,1032,10,210785,4008
2021-03-27,Slovenia,1255,3,212040,4011
2021-03-28,Slovenia,638,7,212678,4018
2021-03-29,Slovenia,288,6,212966,4024
2021-03-30,Slovenia,1079,16,214045,4040
2021-03-31,Slovenia,1557,7,215602,4047
2021-04-01,Slovenia,1337,7,216939,4054
2021-04-02,Slovenia,1175,9,218114,4063
2021-04-03,Slovenia,1306,5,219420,4068
2021-04-04,Slovenia,721,7,220141,4075
2021-04-05,Slovenia,284,7,220425,4082
2021-04-06,Slovenia,273,7,220698,4089
2021-04-07,Slovenia,1192,3,221890,4092
2021-04-08,Slovenia,1526,5,223416,4097
2020-10-12,Solomon Islands,2,0,2,0
2020-10-13,Solomon Islands,0,0,2,0
2020-10-14,Solomon Islands,0,0,2,0
2020-10-15,Solomon Islands,1,0,3,0
2020-10-16,Solomon Islands,0,0,3,0
2020-10-17,Solomon Islands,0,0,3,0
2020-10-18,Solomon Islands,0,0,3,0
2020-10-19,Solomon Islands,0,0,3,0
2020-10-20,Solomon Islands,0,0,3,0
2020-10-21,Solomon Islands,0,0,3,0
2020-10-22,Solomon Islands,1,0,4,0
2020-10-23,Solomon Islands,0,0,4,0
2020-10-24,Solomon Islands,0,0,4,0
2020-10-25,Solomon Islands,0,0,4,0
2020-10-26,Solomon Islands,0,0,4,0
2020-10-27,Solomon Islands,4,0,8,0
2020-10-28,Solomon Islands,0,0,8,0
2020-10-29,Solomon Islands,0,0,8,0
2020-10-30,Solomon Islands,0,0,8,0
2020-10-31,Solomon Islands,0,0,8,0
2020-11-01,Solomon Islands,0,0,8,0
2020-11-02,Solomon Islands,5,0,13,0
2020-11-03,Solomon Islands,0,0,13,0
2020-11-04,Solomon Islands,0,0,13,0
2020-11-05,Solomon Islands,0,0,13,0
2020-11-06,Solomon Islands,0,0,13,0
2020-11-07,Solomon Islands,0,0,13,0
2020-11-08,Solomon Islands,0,0,13,0
2020-11-09,Solomon Islands,3,0,16,0
2020-11-10,Solomon Islands,0,0,16,0
2020-11-11,Solomon Islands,0,0,16,0
2020-11-12,Solomon Islands,0,0,16,0
2020-11-13,Solomon Islands,0,0,16,0
2020-11-14,Solomon Islands,0,0,16,0
2020-11-15,Solomon Islands,0,0,16,0
2020-11-16,Solomon Islands,0,0,16,0
2020-11-17,Solomon Islands,0,0,16,0
2020-11-18,Solomon Islands,0,0,16,0
2020-11-19,Solomon Islands,0,0,16,0
2020-11-20,Solomon Islands,0,0,16,0
2020-11-21,Solomon Islands,0,0,16,0
2020-11-22,Solomon Islands,0,0,16,0
2020-11-23,Solomon Islands,0,0,16,0
2020-11-24,Solomon Islands,1,0,17,0
2020-11-25,Solomon Islands,0,0,17,0
2020-11-26,Solomon Islands,0,0,17,0
2020-11-27,Solomon Islands,0,0,17,0
2020-11-28,Solomon Islands,0,0,17,0
2020-11-29,Solomon Islands,0,0,17,0
2020-11-30,Solomon Islands,0,0,17,0
2020-12-01,Solomon Islands,0,0,17,0
2020-12-02,Solomon Islands,0,0,17,0
2020-12-03,Solomon Islands,0,0,17,0
2020-12-04,Solomon Islands,0,0,17,0
2020-12-05,Solomon Islands,0,0,17,0
2020-12-06,Solomon Islands,0,0,17,0
2020-12-07,Solomon Islands,0,0,17,0
2020-12-08,Solomon Islands,0,0,17,0
2020-12-09,Solomon Islands,0,0,17,0
2020-12-10,Solomon Islands,0,0,17,0
2020-12-11,Solomon Islands,0,0,17,0
2020-12-12,Solomon Islands,0,0,17,0
2020-12-13,Solomon Islands,0,0,17,0
2020-12-14,Solomon Islands,0,0,17,0
2020-12-15,Solomon Islands,0,0,17,0
2020-12-16,Solomon Islands,0,0,17,0
2020-12-17,Solomon Islands,0,0,17,0
2020-12-18,Solomon Islands,0,0,17,0
2020-12-19,Solomon Islands,0,0,17,0
2020-12-20,Solomon Islands,0,0,17,0
2020-12-21,Solomon Islands,0,0,17,0
2020-12-22,Solomon Islands,0,0,17,0
2020-12-23,Solomon Islands,0,0,17,0
2020-12-24,Solomon Islands,0,0,17,0
2020-12-25,Solomon Islands,0,0,17,0
2020-12-26,Solomon Islands,0,0,17,0
2020-12-27,Solomon Islands,0,0,17,0
2020-12-28,Solomon Islands,0,0,17,0
2020-12-29,Solomon Islands,0,0,17,0
2020-12-30,Solomon Islands,0,0,17,0
2020-12-31,Solomon Islands,0,0,17,0
2021-01-01,Solomon Islands,0,0,17,0
2021-01-02,Solomon Islands,0,0,17,0
2021-01-03,Solomon Islands,0,0,17,0
2021-01-04,Solomon Islands,0,0,17,0
2021-01-05,Solomon Islands,0,0,17,0
2021-01-06,Solomon Islands,0,0,17,0
2021-01-07,Solomon Islands,0,0,17,0
2021-01-08,Solomon Islands,0,0,17,0
2021-01-09,Solomon Islands,0,0,17,0
2021-01-10,Solomon Islands,0,0,17,0
2021-01-11,Solomon Islands,0,0,17,0
2021-01-12,Solomon Islands,0,0,17,0
2021-01-13,Solomon Islands,0,0,17,0
2021-01-14,Solomon Islands,0,0,17,0
2021-01-15,Solomon Islands,0,0,17,0
2021-01-16,Solomon Islands,0,0,17,0
2021-01-17,Solomon Islands,0,0,17,0
2021-01-18,Solomon Islands,0,0,17,0
2021-01-19,Solomon Islands,0,0,17,0
2021-01-20,Solomon Islands,0,0,17,0
2021-01-21,Solomon Islands,0,0,17,0
2021-01-22,Solomon Islands,0,0,17,0
2021-01-23,Solomon Islands,0,0,17,0
2021-01-24,Solomon Islands,0,0,17,0
2021-01-25,Solomon Islands,0,0,17,0
2021-01-26,Solomon Islands,0,0,17,0
2021-01-27,Solomon Islands,0,0,17,0
2021-01-28,Solomon Islands,0,0,17,0
2021-01-29,Solomon Islands,0,0,17,0
2021-01-30,Solomon Islands,0,0,17,0
2021-01-31,Solomon Islands,0,0,17,0
2021-02-01,Solomon Islands,0,0,17,0
2021-02-02,Solomon Islands,0,0,17,0
2021-02-03,Solomon Islands,0,0,17,0
2021-02-04,Solomon Islands,0,0,17,0
2021-02-05,Solomon Islands,0,0,17,0
2021-02-06,Solomon Islands,0,0,17,0
2021-02-07,Solomon Islands,0,0,17,0
2021-02-08,Solomon Islands,0,0,17,0
2021-02-09,Solomon Islands,0,0,17,0
2021-02-10,Solomon Islands,1,0,18,0
2021-02-11,Solomon Islands,0,0,18,0
2021-02-12,Solomon Islands,0,0,18,0
2021-02-13,Solomon Islands,0,0,18,0
2021-02-14,Solomon Islands,0,0,18,0
2021-02-15,Solomon Islands,0,0,18,0
2021-02-16,Solomon Islands,0,0,18,0
2021-02-17,Solomon Islands,0,0,18,0
2021-02-18,Solomon Islands,0,0,18,0
2021-02-19,Solomon Islands,0,0,18,0
2021-02-20,Solomon Islands,0,0,18,0
2021-02-21,Solomon Islands,0,0,18,0
2021-02-22,Solomon Islands,0,0,18,0
2021-02-23,Solomon Islands,0,0,18,0
2021-02-24,Solomon Islands,0,0,18,0
2021-02-25,Solomon Islands,0,0,18,0
2021-02-26,Solomon Islands,0,0,18,0
2021-02-27,Solomon Islands,0,0,18,0
2021-02-28,Solomon Islands,0,0,18,0
2021-03-01,Solomon Islands,0,0,18,0
2021-03-02,Solomon Islands,0,0,18,0
2021-03-03,Solomon Islands,0,0,18,0
2021-03-04,Solomon Islands,0,0,18,0
2021-03-05,Solomon Islands,0,0,18,0
2021-03-06,Solomon Islands,0,0,18,0
2021-03-07,Solomon Islands,0,0,18,0
2021-03-08,Solomon Islands,0,0,18,0
2021-03-09,Solomon Islands,0,0,18,0
2021-03-10,Solomon Islands,0,0,18,0
2021-03-11,Solomon Islands,0,0,18,0
2021-03-12,Solomon Islands,0,0,18,0
2021-03-13,Solomon Islands,0,0,18,0
2021-03-14,Solomon Islands,0,0,18,0
2021-03-15,Solomon Islands,0,0,18,0
2021-03-16,Solomon Islands,0,0,18,0
2021-03-17,Solomon Islands,0,0,18,0
2021-03-18,Solomon Islands,0,0,18,0
2021-03-19,Solomon Islands,0,0,18,0
2021-03-20,Solomon Islands,0,0,18,0
2021-03-21,Solomon Islands,0,0,18,0
2021-03-22,Solomon Islands,0,0,18,0
2021-03-23,Solomon Islands,0,0,18,0
2021-03-24,Solomon Islands,0,0,18,0
2021-03-25,Solomon Islands,0,0,18,0
2021-03-26,Solomon Islands,0,0,18,0
2021-03-27,Solomon Islands,0,0,18,0
2021-03-28,Solomon Islands,0,0,18,0
2021-03-29,Solomon Islands,0,0,18,0
2021-03-30,Solomon Islands,0,0,18,0
2021-03-31,Solomon Islands,1,0,19,0
2021-04-01,Solomon Islands,0,0,19,0
2021-04-02,Solomon Islands,0,0,19,0
2021-04-03,Solomon Islands,0,0,19,0
2021-04-04,Solomon Islands,0,0,19,0
2021-04-05,Solomon Islands,0,0,19,0
2021-04-06,Solomon Islands,0,0,19,0
2021-04-07,Solomon Islands,0,0,19,0
2021-04-08,Solomon Islands,0,0,19,0
2020-03-16,Somalia,1,0,1,0
2020-03-17,Somalia,0,0,1,0
2020-03-18,Somalia,0,0,1,0
2020-03-19,Somalia,0,0,1,0
2020-03-20,Somalia,0,0,1,0
2020-03-21,Somalia,0,0,1,0
2020-03-22,Somalia,0,0,1,0
2020-03-23,Somalia,0,0,1,0
2020-03-24,Somalia,0,0,1,0
2020-03-25,Somalia,0,0,1,0
2020-03-26,Somalia,1,0,2,0
2020-03-27,Somalia,1,0,3,0
2020-03-28,Somalia,0,0,3,0
2020-03-29,Somalia,0,0,3,0
2020-03-30,Somalia,0,0,3,0
2020-03-31,Somalia,2,0,5,0
2020-04-01,Somalia,0,0,5,0
2020-04-02,Somalia,0,0,5,0
2020-04-03,Somalia,2,0,7,0
2020-04-04,Somalia,0,0,7,0
2020-04-05,Somalia,0,0,7,0
2020-04-06,Somalia,0,0,7,0
2020-04-07,Somalia,1,0,8,0
2020-04-08,Somalia,4,1,12,1
2020-04-09,Somalia,0,0,12,1
2020-04-10,Somalia,9,0,21,1
2020-04-11,Somalia,0,0,21,1
2020-04-12,Somalia,4,0,25,1
2020-04-13,Somalia,35,1,60,2
2020-04-14,Somalia,0,0,60,2
2020-04-15,Somalia,20,3,80,5
2020-04-16,Somalia,0,0,80,5
2020-04-17,Somalia,36,1,116,6
2020-04-18,Somalia,19,1,135,7
2020-04-19,Somalia,29,0,164,7
2020-04-20,Somalia,73,1,237,8
2020-04-21,Somalia,49,0,286,8
2020-04-22,Somalia,0,0,286,8
2020-04-23,Somalia,42,8,328,16
2020-04-24,Somalia,0,0,328,16
2020-04-25,Somalia,62,2,390,18
2020-04-26,Somalia,46,5,436,23
2020-04-27,Somalia,44,3,480,26
2020-04-28,Somalia,48,2,528,28
2020-04-29,Somalia,54,0,582,28
2020-04-30,Somalia,19,0,601,28
2020-05-01,Somalia,0,0,601,28
2020-05-02,Somalia,70,3,671,31
2020-05-03,Somalia,51,1,722,32
2020-05-04,Somalia,34,3,756,35
2020-05-05,Somalia,79,3,835,38
2020-05-06,Somalia,38,1,873,39
2020-05-07,Somalia,55,5,928,44
2020-05-08,Somalia,0,0,928,44
2020-05-09,Somalia,69,4,997,48
2020-05-10,Somalia,57,3,1054,51
2020-05-11,Somalia,35,1,1089,52
2020-05-12,Somalia,81,0,1170,52
2020-05-13,Somalia,49,0,1219,52
2020-05-14,Somalia,65,1,1284,53
2020-05-15,Somalia,0,0,1284,53
2020-05-16,Somalia,73,2,1357,55
2020-05-17,Somalia,64,1,1421,56
2020-05-18,Somalia,34,1,1455,57
2020-05-19,Somalia,47,2,1502,59
2020-05-20,Somalia,71,2,1573,61
2020-05-21,Somalia,21,0,1594,61
2020-05-22,Somalia,0,0,1594,61
2020-05-23,Somalia,0,0,1594,61
2020-05-24,Somalia,0,0,1594,61
2020-05-25,Somalia,95,5,1689,66
2020-05-26,Somalia,22,1,1711,67
2020-05-27,Somalia,20,0,1731,67
2020-05-28,Somalia,97,5,1828,72
2020-05-29,Somalia,0,0,1828,72
2020-05-30,Somalia,88,1,1916,73
2020-05-31,Somalia,60,5,1976,78
2020-06-01,Somalia,47,1,2023,79
2020-06-02,Somalia,66,0,2089,79
2020-06-03,Somalia,57,0,2146,79
2020-06-04,Somalia,58,0,2204,79
2020-06-05,Somalia,0,0,2204,79
2020-06-06,Somalia,85,3,2289,82
2020-06-07,Somalia,45,1,2334,83
2020-06-08,Somalia,34,1,2368,84
2020-06-09,Somalia,48,1,2416,85
2020-06-10,Somalia,36,0,2452,85
2020-06-11,Somalia,61,0,2513,85
2020-06-12,Somalia,0,0,2513,85
2020-06-13,Somalia,66,2,2579,87
2020-06-14,Somalia,39,1,2618,88
2020-06-15,Somalia,24,0,2642,88
2020-06-16,Somalia,16,0,2658,88
2020-06-17,Somalia,38,0,2696,88
2020-06-18,Somalia,23,0,2719,88
2020-06-19,Somalia,0,0,2719,88
2020-06-20,Somalia,36,0,2755,88
2020-06-21,Somalia,24,2,2779,90
2020-06-22,Somalia,33,0,2812,90
2020-06-23,Somalia,0,0,2812,90
2020-06-24,Somalia,23,0,2835,90
2020-06-25,Somalia,43,0,2878,90
2020-06-26,Somalia,0,0,2878,90
2020-06-27,Somalia,0,0,2878,90
2020-06-28,Somalia,16,0,2894,90
2020-06-29,Somalia,10,0,2904,90
2020-06-30,Somalia,20,0,2924,90
2020-07-01,Somalia,0,0,2924,90
2020-07-02,Somalia,20,0,2944,90
2020-07-03,Somalia,0,0,2944,90
2020-07-04,Somalia,17,2,2961,92
2020-07-05,Somalia,36,0,2997,92
2020-07-06,Somalia,9,0,3006,92
2020-07-07,Somalia,9,0,3015,92
2020-07-08,Somalia,13,0,3028,92
2020-07-09,Somalia,10,0,3038,92
2020-07-10,Somalia,0,0,3038,92
2020-07-11,Somalia,13,0,3051,92
2020-07-12,Somalia,8,1,3059,93
2020-07-13,Somalia,13,0,3072,93
2020-07-14,Somalia,4,0,3076,93
2020-07-15,Somalia,7,0,3083,93
2020-07-16,Somalia,23,0,3106,93
2020-07-17,Somalia,0,0,3106,93
2020-07-18,Somalia,5,0,3111,93
2020-07-19,Somalia,8,0,3119,93
2020-07-20,Somalia,11,0,3130,93
2020-07-21,Somalia,5,0,3135,93
2020-07-22,Somalia,26,0,3161,93
2020-07-23,Somalia,10,0,3171,93
2020-07-24,Somalia,0,0,3171,93
2020-07-25,Somalia,7,0,3178,93
2020-07-26,Somalia,0,0,3178,93
2020-07-27,Somalia,18,0,3196,93
2020-07-28,Somalia,16,0,3212,93
2020-07-29,Somalia,0,0,3212,93
2020-07-30,Somalia,0,0,3212,93
2020-07-31,Somalia,0,0,3212,93
2020-08-01,Somalia,0,0,3212,93
2020-08-02,Somalia,8,0,3220,93
2020-08-03,Somalia,0,0,3220,93
2020-08-04,Somalia,0,0,3220,93
2020-08-05,Somalia,7,0,3227,93
2020-08-06,Somalia,0,0,3227,93
2020-08-07,Somalia,0,0,3227,93
2020-08-08,Somalia,0,0,3227,93
2020-08-09,Somalia,0,0,3227,93
2020-08-10,Somalia,0,0,3227,93
2020-08-11,Somalia,0,0,3227,93
2020-08-12,Somalia,0,0,3227,93
2020-08-13,Somalia,0,0,3227,93
2020-08-14,Somalia,23,0,3250,93
2020-08-15,Somalia,0,0,3250,93
2020-08-16,Somalia,6,0,3256,93
2020-08-17,Somalia,1,0,3257,93
2020-08-18,Somalia,0,0,3257,93
2020-08-19,Somalia,8,0,3265,93
2020-08-20,Somalia,0,0,3265,93
2020-08-21,Somalia,0,0,3265,93
2020-08-22,Somalia,4,0,3269,93
2020-08-23,Somalia,0,0,3269,93
2020-08-24,Somalia,0,0,3269,93
2020-08-25,Somalia,6,2,3275,95
2020-08-26,Somalia,0,0,3275,95
2020-08-27,Somalia,0,0,3275,95
2020-08-28,Somalia,0,0,3275,95
2020-08-29,Somalia,35,2,3310,97
2020-08-30,Somalia,0,1,3310,98
2020-08-31,Somalia,0,0,3310,98
2020-09-01,Somalia,0,0,3310,98
2020-09-02,Somalia,0,0,3310,98
2020-09-03,Somalia,0,0,3310,98
2020-09-04,Somalia,22,-1,3332,97
2020-09-05,Somalia,0,0,3332,97
2020-09-06,Somalia,30,0,3362,97
2020-09-07,Somalia,0,0,3362,97
2020-09-08,Somalia,9,0,3371,97
2020-09-09,Somalia,0,0,3371,97
2020-09-10,Somalia,0,0,3371,97
2020-09-11,Somalia,5,1,3376,98
2020-09-12,Somalia,0,0,3376,98
2020-09-13,Somalia,13,0,3389,98
2020-09-14,Somalia,0,0,3389,98
2020-09-15,Somalia,1,0,3390,98
2020-09-16,Somalia,0,0,3390,98
2020-09-17,Somalia,0,0,3390,98
2020-09-18,Somalia,0,0,3390,98
2020-09-19,Somalia,11,0,3401,98
2020-09-20,Somalia,41,0,3442,98
2020-09-21,Somalia,23,0,3465,98
2020-09-22,Somalia,0,0,3465,98
2020-09-23,Somalia,0,0,3465,98
2020-09-24,Somalia,0,0,3465,98
2020-09-25,Somalia,0,0,3465,98
2020-09-26,Somalia,123,1,3588,99
2020-09-27,Somalia,0,0,3588,99
2020-09-28,Somalia,0,0,3588,99
2020-09-29,Somalia,0,0,3588,99
2020-09-30,Somalia,0,0,3588,99
2020-10-01,Somalia,5,0,3593,99
2020-10-02,Somalia,0,0,3593,99
2020-10-03,Somalia,0,0,3593,99
2020-10-04,Somalia,152,0,3745,99
2020-10-05,Somalia,0,0,3745,99
2020-10-06,Somalia,0,0,3745,99
2020-10-07,Somalia,0,0,3745,99
2020-10-08,Somalia,0,0,3745,99
2020-10-09,Somalia,0,0,3745,99
2020-10-10,Somalia,102,0,3847,99
2020-10-11,Somalia,17,0,3864,99
2020-10-12,Somalia,0,0,3864,99
2020-10-13,Somalia,0,0,3864,99
2020-10-14,Somalia,0,0,3864,99
2020-10-15,Somalia,0,0,3864,99
2020-10-16,Somalia,0,0,3864,99
2020-10-17,Somalia,0,0,3864,99
2020-10-18,Somalia,0,0,3864,99
2020-10-19,Somalia,26,0,3890,99
2020-10-20,Somalia,0,2,3890,101
2020-10-21,Somalia,0,0,3890,101
2020-10-22,Somalia,7,1,3897,102
2020-10-23,Somalia,0,0,3897,102
2020-10-24,Somalia,0,0,3897,102
2020-10-25,Somalia,44,2,3941,104
2020-10-26,Somalia,0,0,3941,104
2020-10-27,Somalia,0,0,3941,104
2020-10-28,Somalia,0,0,3941,104
2020-10-29,Somalia,0,0,3941,104
2020-10-30,Somalia,0,0,3941,104
2020-10-31,Somalia,0,0,3941,104
2020-11-01,Somalia,0,0,3941,104
2020-11-02,Somalia,0,0,3941,104
2020-11-03,Somalia,288,3,4229,107
2020-11-04,Somalia,0,0,4229,107
2020-11-05,Somalia,0,0,4229,107
2020-11-06,Somalia,0,0,4229,107
2020-11-07,Somalia,0,0,4229,107
2020-11-08,Somalia,0,0,4229,107
2020-11-09,Somalia,72,0,4301,107
2020-11-10,Somalia,0,0,4301,107
2020-11-11,Somalia,0,0,4301,107
2020-11-12,Somalia,0,0,4301,107
2020-11-13,Somalia,0,0,4301,107
2020-11-14,Somalia,0,0,4301,107
2020-11-15,Somalia,0,0,4301,107
2020-11-16,Somalia,0,0,4301,107
2020-11-17,Somalia,81,1,4382,108
2020-11-18,Somalia,0,0,4382,108
2020-11-19,Somalia,0,0,4382,108
2020-11-20,Somalia,0,0,4382,108
2020-11-21,Somalia,0,0,4382,108
2020-11-22,Somalia,63,5,4445,113
2020-11-23,Somalia,0,0,4445,113
2020-11-24,Somalia,0,0,4445,113
2020-11-25,Somalia,0,0,4445,113
2020-11-26,Somalia,6,0,4451,113
2020-11-27,Somalia,0,0,4451,113
2020-11-28,Somalia,0,0,4451,113
2020-11-29,Somalia,0,0,4451,113
2020-11-30,Somalia,0,0,4451,113
2020-12-01,Somalia,0,0,4451,113
2020-12-02,Somalia,74,8,4525,121
2020-12-03,Somalia,0,0,4525,121
2020-12-04,Somalia,0,0,4525,121
2020-12-05,Somalia,0,0,4525,121
2020-12-06,Somalia,0,0,4525,121
2020-12-07,Somalia,54,0,4579,121
2020-12-08,Somalia,0,0,4579,121
2020-12-09,Somalia,0,0,4579,121
2020-12-10,Somalia,0,0,4579,121
2020-12-11,Somalia,0,0,4579,121
2020-12-12,Somalia,0,0,4579,121
2020-12-13,Somalia,0,0,4579,121
2020-12-14,Somalia,0,0,4579,121
2020-12-15,Somalia,0,0,4579,121
2020-12-16,Somalia,0,0,4579,121
2020-12-17,Somalia,83,3,4662,124
2020-12-18,Somalia,0,0,4662,124
2020-12-19,Somalia,0,0,4662,124
2020-12-20,Somalia,0,0,4662,124
2020-12-21,Somalia,0,0,4662,124
2020-12-22,Somalia,28,3,4690,127
2020-12-23,Somalia,0,0,4690,127
2020-12-24,Somalia,0,0,4690,127
2020-12-25,Somalia,0,0,4690,127
2020-12-26,Somalia,0,0,4690,127
2020-12-27,Somalia,0,0,4690,127
2020-12-28,Somalia,0,0,4690,127
2020-12-29,Somalia,0,0,4690,127
2020-12-30,Somalia,24,3,4714,130
2020-12-31,Somalia,0,0,4714,130
2021-01-01,Somalia,0,0,4714,130
2021-01-02,Somalia,0,0,4714,130
2021-01-03,Somalia,0,0,4714,130
2021-01-04,Somalia,0,0,4714,130
2021-01-05,Somalia,0,0,4714,130
2021-01-06,Somalia,12,0,4726,130
2021-01-07,Somalia,0,0,4726,130
2021-01-08,Somalia,0,0,4726,130
2021-01-09,Somalia,0,0,4726,130
2021-01-10,Somalia,0,0,4726,130
2021-01-11,Somalia,0,0,4726,130
2021-01-12,Somalia,0,0,4726,130
2021-01-13,Somalia,0,0,4726,130
2021-01-14,Somalia,18,0,4744,130
2021-01-15,Somalia,0,0,4744,130
2021-01-16,Somalia,0,0,4744,130
2021-01-17,Somalia,0,0,4744,130
2021-01-18,Somalia,0,0,4744,130
2021-01-19,Somalia,0,0,4744,130
2021-01-20,Somalia,0,0,4744,130
2021-01-21,Somalia,0,0,4744,130
2021-01-22,Somalia,0,0,4744,130
2021-01-23,Somalia,10,0,4754,130
2021-01-24,Somalia,0,0,4754,130
2021-01-25,Somalia,0,0,4754,130
2021-01-26,Somalia,0,0,4754,130
2021-01-27,Somalia,0,0,4754,130
2021-01-28,Somalia,30,0,4784,130
2021-01-29,Somalia,0,0,4784,130
2021-01-30,Somalia,0,0,4784,130
2021-01-31,Somalia,0,0,4784,130
2021-02-01,Somalia,0,0,4784,130
2021-02-02,Somalia,0,0,4784,130
2021-02-03,Somalia,30,2,4814,132
2021-02-04,Somalia,0,0,4814,132
2021-02-05,Somalia,0,0,4814,132
2021-02-06,Somalia,40,2,4854,134
2021-02-07,Somalia,8,0,4862,134
2021-02-08,Somalia,0,0,4862,134
2021-02-09,Somalia,0,0,4862,134
2021-02-10,Somalia,73,5,4935,139
2021-02-11,Somalia,78,5,5013,144
2021-02-12,Somalia,62,2,5075,146
2021-02-13,Somalia,17,2,5092,148
2021-02-14,Somalia,91,4,5183,152
2021-02-15,Somalia,90,2,5273,154
2021-02-16,Somalia,100,9,5373,163
2021-02-17,Somalia,127,9,5500,172
2021-02-18,Somalia,132,7,5632,179
2021-02-19,Somalia,0,0,5632,179
2021-02-20,Somalia,257,15,5889,194
2021-02-21,Somalia,128,8,6017,202
2021-02-22,Somalia,229,6,6246,208
2021-02-23,Somalia,0,0,6246,208
2021-02-24,Somalia,303,10,6549,218
2021-02-25,Somalia,138,5,6687,223
2021-02-26,Somalia,0,0,6687,223
2021-02-27,Somalia,304,8,6991,231
2021-02-28,Somalia,266,8,7257,239
2021-03-01,Somalia,135,4,7392,243
2021-03-02,Somalia,126,6,7518,249
2021-03-03,Somalia,209,11,7727,260
2021-03-04,Somalia,123,14,7850,274
2021-03-05,Somalia,0,0,7850,274
2021-03-06,Somalia,191,20,8041,294
2021-03-07,Somalia,280,8,8321,302
2021-03-08,Somalia,117,5,8438,307
2021-03-09,Somalia,139,12,8577,319
2021-03-10,Somalia,136,8,8713,327
2021-03-11,Somalia,107,11,8820,338
2021-03-12,Somalia,0,0,8820,338
2021-03-13,Somalia,126,11,8946,349
2021-03-14,Somalia,244,18,9190,367
2021-03-15,Somalia,138,12,9328,379
2021-03-16,Somalia,109,6,9437,385
2021-03-17,Somalia,163,7,9600,392
2021-03-18,Somalia,0,0,9600,392
2021-03-19,Somalia,325,22,9925,414
2021-03-20,Somalia,43,5,9968,419
2021-03-21,Somalia,117,10,10085,429
2021-03-22,Somalia,129,12,10214,441
2021-03-23,Somalia,155,12,10369,453
2021-03-24,Somalia,0,0,10369,453
2021-03-25,Somalia,295,18,10664,471
2021-03-26,Somalia,0,0,10664,471
2021-03-27,Somalia,174,17,10838,488
2021-03-28,Somalia,139,8,10977,496
2021-03-29,Somalia,187,14,11164,510
2021-03-30,Somalia,128,11,11292,521
2021-03-31,Somalia,106,8,11398,529
2021-04-01,Somalia,101,8,11499,537
2021-04-02,Somalia,0,0,11499,537
2021-04-03,Somalia,5,0,11504,537
2021-04-04,Somalia,279,20,11783,557
2021-04-05,Somalia,125,11,11908,568
2021-04-06,Somalia,70,8,11978,576
2021-04-07,Somalia,0,0,11978,576
2021-04-08,Somalia,293,29,12271,605
2020-03-05,South Africa,1,0,1,0
2020-03-06,South Africa,0,0,1,0
2020-03-07,South Africa,0,0,1,0
2020-03-08,South Africa,2,0,3,0
2020-03-09,South Africa,0,0,3,0
2020-03-10,South Africa,4,0,7,0
2020-03-11,South Africa,6,0,13,0
2020-03-12,South Africa,4,0,17,0
2020-03-13,South Africa,7,0,24,0
2020-03-14,South Africa,14,0,38,0
2020-03-15,South Africa,13,0,51,0
2020-03-16,South Africa,11,0,62,0
2020-03-17,South Africa,0,0,62,0
2020-03-18,South Africa,54,0,116,0
2020-03-19,South Africa,34,0,150,0
2020-03-20,South Africa,52,0,202,0
2020-03-21,South Africa,38,0,240,0
2020-03-22,South Africa,34,0,274,0
2020-03-23,South Africa,128,0,402,0
2020-03-24,South Africa,152,0,554,0
2020-03-25,South Africa,155,0,709,0
2020-03-26,South Africa,218,0,927,0
2020-03-27,South Africa,243,1,1170,1
2020-03-28,South Africa,17,0,1187,1
2020-03-29,South Africa,93,1,1280,2
2020-03-30,South Africa,46,1,1326,3
2020-03-31,South Africa,27,2,1353,5
2020-04-01,South Africa,27,0,1380,5
2020-04-02,South Africa,82,0,1462,5
2020-04-03,South Africa,43,4,1505,9
2020-04-04,South Africa,80,0,1585,9
2020-04-05,South Africa,70,2,1655,11
2020-04-06,South Africa,31,1,1686,12
2020-04-07,South Africa,63,1,1749,13
2020-04-08,South Africa,96,5,1845,18
2020-04-09,South Africa,89,0,1934,18
2020-04-10,South Africa,69,6,2003,24
2020-04-11,South Africa,25,1,2028,25
2020-04-12,South Africa,145,0,2173,25
2020-04-13,South Africa,99,2,2272,27
2020-04-14,South Africa,143,0,2415,27
2020-04-15,South Africa,91,7,2506,34
2020-04-16,South Africa,99,14,2605,48
2020-04-17,South Africa,178,2,2783,50
2020-04-18,South Africa,251,2,3034,52
2020-04-19,South Africa,124,2,3158,54
2020-04-20,South Africa,142,4,3300,58
2020-04-21,South Africa,165,0,3465,58
2020-04-22,South Africa,170,7,3635,65
2020-04-23,South Africa,318,10,3953,75
2020-04-24,South Africa,267,4,4220,79
2020-04-25,South Africa,141,7,4361,86
2020-04-26,South Africa,185,1,4546,87
2020-04-27,South Africa,247,3,4793,90
2020-04-28,South Africa,203,3,4996,93
2020-04-29,South Africa,354,10,5350,103
2020-04-30,South Africa,297,0,5647,103
2020-05-01,South Africa,304,13,5951,116
2020-05-02,South Africa,385,7,6336,123
2020-05-03,South Africa,447,8,6783,131
2020-05-04,South Africa,437,7,7220,138
2020-05-05,South Africa,352,10,7572,148
2020-05-06,South Africa,236,5,7808,153
2020-05-07,South Africa,424,8,8232,161
2020-05-08,South Africa,663,17,8895,178
2020-05-09,South Africa,525,8,9420,186
2020-05-10,South Africa,595,8,10015,194
2020-05-11,South Africa,637,12,10652,206
2020-05-12,South Africa,698,0,11350,206
2020-05-13,South Africa,724,13,12074,219
2020-05-14,South Africa,665,19,12739,238
2020-05-15,South Africa,785,9,13524,247
2020-05-16,South Africa,831,14,14355,261
2020-05-17,South Africa,1160,3,15515,264
2020-05-18,South Africa,918,22,16433,286
2020-05-19,South Africa,767,26,17200,312
2020-05-20,South Africa,803,27,18003,339
2020-05-21,South Africa,1134,30,19137,369
2020-05-22,South Africa,988,28,20125,397
2020-05-23,South Africa,1218,10,21343,407
2020-05-24,South Africa,1240,22,22583,429
2020-05-25,South Africa,1032,52,23615,481
2020-05-26,South Africa,649,43,24264,524
2020-05-27,South Africa,1673,28,25937,552
2020-05-28,South Africa,1466,25,27403,577
2020-05-29,South Africa,1837,34,29240,611
2020-05-30,South Africa,1727,32,30967,643
2020-05-31,South Africa,1716,40,32683,683
2020-06-01,South Africa,1674,22,34357,705
2020-06-02,South Africa,1455,50,35812,755
2020-06-03,South Africa,1713,37,37525,792
2020-06-04,South Africa,3267,56,40792,848
2020-06-05,South Africa,2642,60,43434,908
2020-06-06,South Africa,2539,44,45973,952
2020-06-07,South Africa,2312,46,48285,998
2020-06-08,South Africa,2594,82,50879,1080
2020-06-09,South Africa,2112,82,52991,1162
2020-06-10,South Africa,2430,48,55421,1210
2020-06-11,South Africa,3147,74,58568,1284
2020-06-12,South Africa,3359,70,61927,1354
2020-06-13,South Africa,3809,69,65736,1423
2020-06-14,South Africa,4302,57,70038,1480
2020-06-15,South Africa,3495,88,73533,1568
2020-06-16,South Africa,2801,57,76334,1625
2020-06-17,South Africa,4078,49,80412,1674
2020-06-18,South Africa,3478,63,83890,1737
2020-06-19,South Africa,3825,94,87715,1831
2020-06-20,South Africa,4966,46,92681,1877
2020-06-21,South Africa,4621,53,97302,1930
2020-06-22,South Africa,4288,61,101590,1991
2020-06-23,South Africa,4518,111,106108,2102
2020-06-24,South Africa,5688,103,111796,2205
2020-06-25,South Africa,6579,87,118375,2292
2020-06-26,South Africa,6215,48,124590,2340
2020-06-27,South Africa,7210,73,131800,2413
2020-06-28,South Africa,6334,43,138134,2456
2020-06-29,South Africa,6130,73,144264,2529
2020-06-30,South Africa,6945,128,151209,2657
2020-07-01,South Africa,8124,92,159333,2749
2020-07-02,South Africa,8728,95,168061,2844
2020-07-03,South Africa,9063,108,177124,2952
2020-07-04,South Africa,10853,74,187977,3026
2020-07-05,South Africa,8773,173,196750,3199
2020-07-06,South Africa,8971,111,205721,3310
2020-07-07,South Africa,10134,192,215855,3502
2020-07-08,South Africa,8810,100,224665,3602
2020-07-09,South Africa,13674,118,238339,3720
2020-07-10,South Africa,12348,140,250687,3860
2020-07-11,South Africa,13497,111,264184,3971
2020-07-12,South Africa,12058,108,276242,4079
2020-07-13,South Africa,11554,93,287796,4172
2020-07-14,South Africa,10496,174,298292,4346
2020-07-15,South Africa,12757,107,311049,4453
2020-07-16,South Africa,13172,216,324221,4669
2020-07-17,South Africa,13373,135,337594,4804
2020-07-18,South Africa,13285,144,350879,4948
2020-07-19,South Africa,13449,85,364328,5033
2020-07-20,South Africa,9300,140,373628,5173
2020-07-21,South Africa,8170,195,381798,5368
2020-07-22,South Africa,13150,572,394948,5940
2020-07-23,South Africa,13104,153,408052,6093
2020-07-24,South Africa,13944,250,421996,6343
2020-07-25,South Africa,12204,312,434200,6655
2020-07-26,South Africa,11233,114,445433,6769
2020-07-27,South Africa,7096,298,452529,7067
2020-07-28,South Africa,7232,190,459761,7257
2020-07-29,South Africa,11362,240,471123,7497
2020-07-30,South Africa,11046,315,482169,7812
2020-07-31,South Africa,11014,193,493183,8005
2020-08-01,South Africa,10107,148,503290,8153
2020-08-02,South Africa,8195,213,511485,8366
2020-08-03,South Africa,5377,173,516862,8539
2020-08-04,South Africa,4456,345,521318,8884
2020-08-05,South Africa,8559,414,529877,9298
2020-08-06,South Africa,8307,306,538184,9604
2020-08-07,South Africa,7292,305,545476,9909
2020-08-08,South Africa,7712,301,553188,10210
2020-08-09,South Africa,6671,198,559859,10408
2020-08-10,South Africa,3739,213,563598,10621
2020-08-11,South Africa,2511,130,566109,10751
2020-08-12,South Africa,2810,259,568919,11010
2020-08-13,South Africa,3946,260,572865,11270
2020-08-14,South Africa,6275,286,579140,11556
2020-08-15,South Africa,4513,121,583653,11677
2020-08-16,South Africa,3692,162,587345,11839
2020-08-17,South Africa,2541,143,589886,11982
2020-08-18,South Africa,2258,282,592144,12264
2020-08-19,South Africa,3916,159,596060,12423
2020-08-20,South Africa,3880,195,599940,12618
2020-08-21,South Africa,3398,225,603338,12843
2020-08-22,South Africa,3707,144,607045,12987
2020-08-23,South Africa,2728,72,609773,13059
2020-08-24,South Africa,1677,100,611450,13159
2020-08-25,South Africa,1567,149,613017,13308
2020-08-26,South Africa,2684,194,615701,13502
2020-08-27,South Africa,2585,126,618286,13628
2020-08-28,South Africa,1846,115,620132,13743
2020-08-29,South Africa,2419,238,622551,13981
2020-08-30,South Africa,2505,47,625056,14028
2020-08-31,South Africa,1985,121,627041,14149
2020-09-01,South Africa,1218,114,628259,14263
2020-09-02,South Africa,2336,126,630595,14389
2020-09-03,South Africa,2420,174,633015,14563
2020-09-04,South Africa,2063,115,635078,14678
2020-09-05,South Africa,1806,101,636884,14779
2020-09-06,South Africa,1633,110,638517,14889
2020-09-07,South Africa,845,115,639362,15004
2020-09-08,South Africa,1079,82,640441,15086
2020-09-09,South Africa,1990,82,642431,15168
2020-09-10,South Africa,2007,97,644438,15265
2020-09-11,South Africa,1960,113,646398,15378
2020-09-12,South Africa,1816,49,648214,15427
2020-09-13,South Africa,1579,20,649793,15447
2020-09-14,South Africa,956,52,650749,15499
2020-09-15,South Africa,772,142,651521,15641
2020-09-16,South Africa,1923,64,653444,15705
2020-09-17,South Africa,2128,67,655572,15772
2020-09-18,South Africa,2055,85,657627,15857
2020-09-19,South Africa,2029,83,659656,15940
2020-09-20,South Africa,1555,13,661211,15953
2020-09-21,South Africa,725,39,661936,15992
2020-09-22,South Africa,1346,126,663282,16118
2020-09-23,South Africa,1906,88,665188,16206
2020-09-24,South Africa,1861,77,667049,16283
2020-09-25,South Africa,1480,29,668529,16312
2020-09-26,South Africa,969,64,669498,16376
2020-09-27,South Africa,1268,22,670766,16398
2020-09-28,South Africa,903,188,671669,16586
2020-09-29,South Africa,903,81,672572,16667
2020-09-30,South Africa,1767,67,674339,16734
2020-10-01,South Africa,1745,132,676084,16866
2020-10-02,South Africa,1749,43,677833,16909
2020-10-03,South Africa,1883,29,679716,16938
2020-10-04,South Africa,1573,38,681289,16976
2020-10-05,South Africa,926,40,682215,17016
2020-10-06,South Africa,1027,87,683242,17103
2020-10-07,South Africa,1913,145,685155,17248
2020-10-08,South Africa,1736,160,686891,17408
2020-10-09,South Africa,1461,139,688352,17547
2020-10-10,South Africa,2544,126,690896,17673
2020-10-11,South Africa,1575,107,692471,17780
2020-10-12,South Africa,888,83,693359,17863
2020-10-13,South Africa,1178,165,694537,18028
2020-10-14,South Africa,1877,123,696414,18151
2020-10-15,South Africa,1770,158,698184,18309
2020-10-16,South Africa,2019,61,700203,18370
2020-10-17,South Africa,1928,38,702131,18408
2020-10-18,South Africa,1662,63,703793,18471
2020-10-19,South Africa,1461,21,705254,18492
2020-10-20,South Africa,1050,164,706304,18656
2020-10-21,South Africa,2055,85,708359,18741
2020-10-22,South Africa,2156,102,710515,18843
2020-10-23,South Africa,1897,48,712412,18891
2020-10-24,South Africa,1834,53,714246,18944
2020-10-25,South Africa,1622,24,715868,18968
2020-10-26,South Africa,891,40,716759,19008
2020-10-27,South Africa,1092,45,717851,19053
2020-10-28,South Africa,1863,58,719714,19111
2020-10-29,South Africa,2056,53,721770,19164
2020-10-30,South Africa,1912,66,723682,19230
2020-10-31,South Africa,1770,46,725452,19276
2020-11-01,South Africa,1371,135,726823,19411
2020-11-02,South Africa,772,54,727595,19465
2020-11-03,South Africa,1241,74,728836,19539
2020-11-04,South Africa,1712,46,730548,19585
2020-11-05,South Africa,1866,92,732414,19677
2020-11-06,South Africa,1761,72,734175,19749
2020-11-07,South Africa,1731,40,735906,19789
2020-11-08,South Africa,1372,20,737278,19809
2020-11-09,South Africa,1247,36,738525,19845
2020-11-10,South Africa,1729,106,740254,19951
2020-11-11,South Africa,2140,60,742394,20011
2020-11-12,South Africa,2338,65,744732,20076
2020-11-13,South Africa,2213,77,746945,20153
2020-11-14,South Africa,2237,53,749182,20206
2020-11-15,South Africa,1842,35,751024,20241
2020-11-16,South Africa,1245,73,752269,20314
2020-11-17,South Africa,1987,118,754256,20432
2020-11-18,South Africa,2888,124,757144,20556
2020-11-19,South Africa,2514,115,759658,20671
2020-11-20,South Africa,3105,88,762763,20759
2020-11-21,South Africa,2646,86,765409,20845
2020-11-22,South Africa,2270,58,767679,20903
2020-11-23,South Africa,2080,65,769759,20968
2020-11-24,South Africa,2493,115,772252,21083
2020-11-25,South Africa,3250,118,775502,21201
2020-11-26,South Africa,3069,88,778571,21289
2020-11-27,South Africa,3370,89,781941,21378
2020-11-28,South Africa,3198,61,785139,21439
2020-11-29,South Africa,2563,38,787702,21477
2020-11-30,South Africa,2302,58,790004,21535
2020-12-01,South Africa,2295,109,792299,21644
2020-12-02,South Africa,4173,65,796472,21709
2020-12-03,South Africa,4400,94,800872,21803
2020-12-04,South Africa,4932,160,805804,21963
2020-12-05,South Africa,4645,104,810449,22067
2020-12-06,South Africa,4116,139,814565,22206
2020-12-07,South Africa,3313,43,817878,22249
2020-12-08,South Africa,4011,183,821889,22432
2020-12-09,South Africa,6709,142,828598,22574
2020-12-10,South Africa,8166,173,836764,22747
2020-12-11,South Africa,8319,205,845083,22952
2020-12-12,South Africa,7882,154,852965,23106
2020-12-13,South Africa,7999,170,860964,23276
2020-12-14,South Africa,5163,175,866127,23451
2020-12-15,South Africa,7552,210,873679,23661
2020-12-16,South Africa,10008,166,883687,23827
2020-12-17,South Africa,9126,184,892813,24011
2020-12-18,South Africa,8725,274,901538,24285
2020-12-19,South Africa,10939,254,912477,24539
2020-12-20,South Africa,9445,152,921922,24691
2020-12-21,South Africa,8789,216,930711,24907
2020-12-22,South Africa,9501,339,940212,25246
2020-12-23,South Africa,14046,411,954258,25657
2020-12-24,South Africa,14305,326,968563,25983
2020-12-25,South Africa,14796,293,983359,26276
2020-12-26,South Africa,11552,245,994911,26521
2020-12-27,South Africa,9502,214,1004413,26735
2020-12-28,South Africa,7458,336,1011871,27071
2020-12-29,South Africa,9580,497,1021451,27568
2020-12-30,South Africa,17710,465,1039161,28033
2020-12-31,South Africa,18000,436,1057161,28469
2021-01-01,South Africa,16726,418,1073887,28887
2021-01-02,South Africa,15002,288,1088889,29175
2021-01-03,South Africa,11859,402,1100748,29577
2021-01-04,South Africa,12601,434,1113349,30011
2021-01-05,South Africa,14410,513,1127759,30524
2021-01-06,South Africa,21832,844,1149591,31368
2021-01-07,South Africa,20999,441,1170590,31809
2021-01-08,South Africa,21980,616,1192570,32425
2021-01-09,South Africa,21606,399,1214176,32824
2021-01-10,South Africa,17421,339,1231597,33163
2021-01-11,South Africa,15046,416,1246643,33579
2021-01-12,South Africa,13105,755,1259748,34334
2021-01-13,South Africa,18555,806,1278303,35140
2021-01-14,South Africa,18503,712,1296806,35852
2021-01-15,South Africa,14880,615,1311686,36467
2021-01-16,South Africa,13973,384,1325659,36851
2021-01-17,South Africa,12267,254,1337926,37105
2021-01-18,South Africa,9010,344,1346936,37449
2021-01-19,South Africa,9780,839,1356716,38288
2021-01-20,South Africa,12710,566,1369426,38854
2021-01-21,South Africa,11381,647,1380807,39501
2021-01-22,South Africa,11761,575,1392568,40076
2021-01-23,South Africa,12271,498,1404839,40574
2021-01-24,South Africa,8147,300,1412986,40874
2021-01-25,South Africa,4551,243,1417537,41117
2021-01-26,South Africa,6041,680,1423578,41797
2021-01-27,South Africa,7070,753,1430648,42550
2021-01-28,South Africa,7150,555,1437798,43105
2021-01-29,South Africa,6141,528,1443939,43633
2021-01-30,South Africa,5297,318,1449236,43951
2021-01-31,South Africa,4525,213,1453761,44164
2021-02-01,South Africa,2548,235,1456309,44399
2021-02-02,South Africa,2649,547,1458958,44946
2021-02-03,South Africa,4058,398,1463016,45344
2021-02-04,South Africa,3751,261,1466767,45605
2021-02-05,South Africa,3749,297,1470516,45902
2021-02-06,South Africa,3184,278,1473700,46180
2021-02-07,South Africa,2435,110,1476135,46290
2021-02-08,South Africa,1376,183,1477511,46473
2021-02-09,South Africa,1742,396,1479253,46869
2021-02-10,South Africa,3159,276,1482412,47145
2021-02-11,South Africa,2488,237,1484900,47382
2021-02-12,South Africa,2781,288,1487681,47670
2021-02-13,South Africa,2382,151,1490063,47821
2021-02-14,South Africa,1744,78,1491807,47899
2021-02-15,South Africa,1102,195,1492909,48094
2021-02-16,South Africa,1210,219,1494119,48313
2021-02-17,South Africa,2320,165,1496439,48478
2021-02-18,South Africa,2327,230,1498766,48708
2021-02-19,South Africa,1911,151,1500677,48859
2021-02-20,South Africa,1690,81,1502367,48940
2021-02-21,South Africa,1429,113,1503796,49053
2021-02-22,South Africa,792,97,1504588,49150
2021-02-23,South Africa,998,263,1505586,49413
2021-02-24,South Africa,1862,110,1507448,49523
2021-02-25,South Africa,1676,144,1509124,49667
2021-02-26,South Africa,1654,117,1510778,49784
2021-02-27,South Africa,1447,157,1512225,49941
2021-02-28,South Africa,1168,52,1513393,49993
2021-03-01,South Africa,566,84,1513959,50077
2021-03-02,South Africa,856,194,1514815,50271
2021-03-03,South Africa,1447,95,1516262,50366
2021-03-04,South Africa,1404,96,1517666,50462
2021-03-05,South Africa,1313,104,1518979,50566
2021-03-06,South Africa,1227,81,1520206,50647
2021-03-07,South Africa,862,31,1521068,50678
2021-03-08,South Africa,638,125,1521706,50803
2021-03-09,South Africa,991,103,1522697,50906
2021-03-10,South Africa,1477,109,1524174,51015
2021-03-11,South Africa,1474,95,1525648,51110
2021-03-12,South Africa,1225,69,1526873,51179
2021-03-13,South Africa,1541,82,1528414,51261
2021-03-14,South Africa,1006,65,1529420,51326
2021-03-15,South Africa,613,95,1530033,51421
2021-03-16,South Africa,933,139,1530966,51560
2021-03-17,South Africa,1531,74,1532497,51634
2021-03-18,South Africa,1464,90,1533961,51724
2021-03-19,South Africa,1462,311,1535423,52035
2021-03-20,South Africa,1378,47,1536801,52082
2021-03-21,South Africa,1051,29,1537852,52111
2021-03-22,South Africa,599,85,1538451,52196
2021-03-23,South Africa,510,55,1538961,52251
2021-03-24,South Africa,1048,121,1540009,52372
2021-03-25,South Africa,1554,163,1541563,52535
2021-03-26,South Africa,1516,67,1543079,52602
2021-03-27,South Africa,1387,46,1544466,52648
2021-03-28,South Africa,965,15,1545431,52663
2021-03-29,South Africa,548,47,1545979,52710
2021-03-30,South Africa,756,78,1546735,52788
2021-03-31,South Africa,1422,58,1548157,52846
2021-04-01,South Africa,1294,51,1549451,52897
2021-04-02,South Africa,1273,49,1550724,52946
2021-04-03,South Africa,777,8,1551501,52954
2021-04-04,South Africa,463,33,1551964,52987
2021-04-05,South Africa,452,8,1552416,52995
2021-04-06,South Africa,437,37,1552853,53032
2021-04-07,South Africa,756,79,1553609,53111
2021-04-08,South Africa,1366,62,1554975,53173
2020-02-22,South America,0,0,0,0
2020-02-23,South America,2,0,2,0
2020-02-24,South America,0,0,2,0
2020-02-25,South America,0,0,2,0
2020-02-26,South America,1,0,3,0
2020-02-27,South America,0,0,3,0
2020-02-28,South America,0,0,3,0
2020-02-29,South America,1,0,4,0
2020-03-01,South America,13,0,17,0
2020-03-02,South America,0,0,17,0
2020-03-03,South America,3,0,20,0
2020-03-04,South America,5,0,25,0
2020-03-05,South America,6,0,31,0
2020-03-06,South America,12,0,43,0
2020-03-07,South America,6,0,49,0
2020-03-08,South America,25,1,74,1
2020-03-09,South America,7,0,81,1
2020-03-10,South America,22,0,103,1
2020-03-11,South America,33,0,136,1
2020-03-12,South America,19,1,155,2
2020-03-13,South America,154,1,309,3
2020-03-14,South America,78,2,387,5
2020-03-15,South America,65,0,452,5
2020-03-16,South America,236,0,688,5
2020-03-17,South America,290,1,978,6
2020-03-18,South America,242,2,1220,8
2020-03-19,South America,471,5,1691,13
2020-03-20,South America,641,10,2332,23
2020-03-21,South America,712,10,3044,33
2020-03-22,South America,1136,20,4180,53
2020-03-23,South America,812,15,4992,68
2020-03-24,South America,836,26,5828,94
2020-03-25,South America,823,21,6651,115
2020-03-26,South America,1113,28,7764,143
2020-03-27,South America,1183,25,8947,168
2020-03-28,South America,1332,44,10279,212
2020-03-29,South America,1029,44,11308,256
2020-03-30,South America,988,42,12296,298
2020-03-31,South America,2196,78,14492,376
2020-04-01,South America,2377,73,16869,449
2020-04-02,South America,2300,147,19169,596
2020-04-03,South America,2021,83,21190,679
2020-04-04,South America,2416,143,23606,822
2020-04-05,South America,1912,71,25518,893
2020-04-06,South America,2010,119,27528,1012
2020-04-07,South America,2866,160,30394,1172
2020-04-08,South America,5076,218,35470,1390
2020-04-09,South America,4106,214,39576,1604
2020-04-10,South America,5372,194,44948,1798
2020-04-11,South America,3073,127,48021,1925
2020-04-12,South America,2876,156,50897,2081
2020-04-13,South America,4074,166,54971,2247
2020-04-14,South America,3060,264,58031,2511
2020-04-15,South America,5195,264,63226,2775
2020-04-16,South America,4351,252,67577,3027
2020-04-17,South America,5292,291,72869,3318
2020-04-18,South America,5720,325,78589,3643
2020-04-19,South America,4333,204,82922,3847
2020-04-20,South America,4205,224,87127,4071
2020-04-21,South America,4777,236,91904,4307
2020-04-22,South America,5353,260,97257,4567
2020-04-23,South America,7416,526,104673,5093
2020-04-24,South America,17393,479,122066,5572
2020-04-25,South America,10863,447,132929,6019
2020-04-26,South America,6881,289,139810,6308
2020-04-27,South America,6942,484,146752,6792
2020-04-28,South America,10381,797,157133,7589
2020-04-29,South America,10612,560,167745,8149
2020-04-30,South America,12490,661,180235,8810
2020-05-01,South America,11624,675,191859,9485
2020-05-02,South America,11347,773,203206,10258
2020-05-03,South America,12072,612,215278,10870
2020-05-04,South America,12088,427,227366,11297
2020-05-05,South America,12953,705,240319,12002
2020-05-06,South America,16464,827,256783,12829
2020-05-07,South America,13711,766,270494,13595
2020-05-08,South America,15492,1010,285986,14605
2020-05-09,South America,16974,794,302960,15399
2020-05-10,South America,12061,988,315021,16387
2020-05-11,South America,10654,660,325675,17047
2020-05-12,South America,15526,1123,341201,18170
2020-05-13,South America,20060,950,361261,19120
2020-05-14,South America,21211,933,382472,20053
2020-05-15,South America,25660,1406,408132,21459
2020-05-16,South America,25411,976,433543,22435
2020-05-17,South America,15279,685,448822,23120
2020-05-18,South America,20915,999,469737,24119
2020-05-19,South America,26626,1373,496363,25492
2020-05-20,South America,30723,1107,527086,26599
2020-05-21,South America,29298,1459,556384,28058
2020-05-22,South America,30509,1317,586893,29375
2020-05-23,South America,33011,1224,619904,30599
2020-05-24,South America,26430,832,646334,31431
2020-05-25,South America,23035,1168,669369,32599
2020-05-26,South America,28208,1300,697577,33899
2020-05-27,South America,34323,1437,731900,35336
2020-05-28,South America,40078,1399,771978,36735
2020-05-29,South America,39679,1383,811657,38118
2020-05-30,South America,57197,1206,868854,39324
2020-05-31,South America,32830,759,901684,40083
2020-06-01,South America,25038,891,926722,40974
2020-06-02,South America,44796,1637,971518,42611
2020-06-03,South America,38205,1687,1009723,44298
2020-06-04,South America,43338,1773,1053061,46071
2020-06-05,South America,42755,1370,1095816,47441
2020-06-06,South America,49777,1315,1145593,48756
2020-06-07,South America,32862,879,1178455,49635
2020-06-08,South America,26516,1522,1204971,51157
2020-06-09,South America,43991,1607,1248962,52764
2020-06-10,South America,47816,1765,1296778,54529
2020-06-11,South America,45943,1703,1342721,56232
2020-06-12,South America,37984,1343,1380705,57575
2020-06-13,South America,40798,1493,1421503,59068
2020-06-14,South America,37637,1356,1459140,60424
2020-06-15,South America,33675,976,1492815,61400
2020-06-16,South America,48883,1670,1541698,63070
2020-06-17,South America,42963,1858,1584661,64928
2020-06-18,South America,37418,1888,1622079,66816
2020-06-19,South America,71461,1873,1693540,68689
2020-06-20,South America,48701,1548,1742241,70237
2020-06-21,South America,31526,1213,1773767,71450
2020-06-22,South America,36206,1035,1809973,72485
2020-06-23,South America,53336,1765,1863309,74250
2020-06-24,South America,57883,1753,1921192,76003
2020-06-25,South America,56930,1792,1978122,77795
2020-06-26,South America,63653,1610,2041775,79405
2020-06-27,South America,55925,1793,2097700,81198
2020-06-28,South America,45398,1212,2143098,82410
2020-06-29,South America,37951,1226,2181049,83636
2020-06-30,South America,47374,1734,2228423,85370
2020-07-01,South America,62588,1600,2291011,86970
2020-07-02,South America,63759,1946,2354770,88916
2020-07-03,South America,58420,1902,2413190,90818
2020-07-04,South America,54039,1759,2467229,92577
2020-07-05,South America,41675,1115,2508904,93692
2020-07-06,South America,33971,1186,2542875,94878
2020-07-07,South America,60799,1806,2603674,96684
2020-07-08,South America,59862,1814,2663536,98498
2020-07-09,South America,60874,1816,2724410,100314
2020-07-10,South America,64296,1871,2788706,102185
2020-07-11,South America,57449,1732,2846155,103917
2020-07-12,South America,40999,1215,2887154,105132
2020-07-13,South America,35600,1250,2922754,106382
2020-07-14,South America,59865,1857,2982619,108239
2020-07-15,South America,57732,1886,3040351,110125
2020-07-16,South America,67035,2000,3107386,112125
2020-07-17,South America,57853,2842,3165239,114967
2020-07-18,South America,50195,1583,3215434,116550
2020-07-19,South America,43134,1304,3258568,117854
2020-07-20,South America,39740,1343,3298308,119197
2020-07-21,South America,63003,2069,3361311,121266
2020-07-22,South America,90682,1935,3451993,123201
2020-07-23,South America,83589,5850,3535582,129051
2020-07-24,South America,78925,1916,3614507,130967
2020-07-25,South America,69177,1804,3683684,132771
2020-07-26,South America,41691,1010,3725375,133781
2020-07-27,South America,55109,1725,3780484,135506
2020-07-28,South America,67227,1717,3847711,137223
2020-07-29,South America,93856,2461,3941567,139684
2020-07-30,South America,80068,1860,4021635,141544
2020-07-31,South America,80202,2030,4101837,143574
2020-08-01,South America,67335,1571,4169172,145145
2020-08-02,South America,68500,1678,4237672,146823
2020-08-03,South America,40855,1504,4278527,148327
2020-08-04,South America,77152,1998,4355679,150325
2020-08-05,South America,88371,2255,4444050,152580
2020-08-06,South America,86714,2114,4530764,154694
2020-08-07,South America,81859,1932,4612623,156626
2020-08-08,South America,71856,1452,4684479,158078
2020-08-09,South America,57485,1516,4741964,159594
2020-08-10,South America,49965,1535,4791929,161129
2020-08-11,South America,84255,2189,4876184,163318
2020-08-12,South America,81498,1888,4957682,165206
2020-08-13,South America,94021,2125,5051703,167331
2020-08-14,South America,92442,5851,5144145,173182
2020-08-15,South America,65829,1321,5209974,174503
2020-08-16,South America,55470,1331,5265444,175834
2020-08-17,South America,46514,1432,5311958,177266
2020-08-18,South America,78533,2170,5390491,179436
2020-08-19,South America,83446,2177,5473937,181613
2020-08-20,South America,79585,2007,5553522,183620
2020-08-21,South America,61345,2034,5614867,185654
2020-08-22,South America,82637,1813,5697504,187467
2020-08-23,South America,50277,1367,5747781,188834
2020-08-24,South America,50100,1621,5797881,190455
2020-08-25,South America,76997,2089,5874878,192544
2020-08-26,South America,80296,2005,5955174,194549
2020-08-27,South America,75004,1839,6030178,196388
2020-08-28,South America,77981,1702,6108159,198090
2020-08-29,South America,73475,1530,6181634,199620
2020-08-30,South America,45833,1236,6227467,200856
2020-08-31,South America,74216,1373,6301683,202229
2020-09-01,South America,71438,2169,6373121,204398
2020-09-02,South America,77668,1992,6450789,206390
2020-09-03,South America,69480,1565,6520269,207955
2020-09-04,South America,87779,1948,6608048,209903
2020-09-05,South America,62266,1421,6670314,211324
2020-09-06,South America,40814,1037,6711128,212361
2020-09-07,South America,27784,6531,6738912,218892
2020-09-08,South America,40410,1267,6779322,220159
2020-09-09,South America,66107,1874,6845429,222033
2020-09-10,South America,72175,1762,6917604,223795
2020-09-11,South America,76099,1701,6993703,225496
2020-09-12,South America,64323,1420,7058026,226916
2020-09-13,South America,43850,911,7101876,227827
2020-09-14,South America,41897,1237,7143773,229064
2020-09-15,South America,64463,1709,7208236,230773
2020-09-16,South America,66234,1661,7274470,232434
2020-09-17,South America,67771,1664,7342241,234098
2020-09-18,South America,70160,1300,7412401,235398
2020-09-19,South America,62092,1561,7474493,236959
2020-09-20,South America,41896,972,7516389,237931
2020-09-21,South America,37065,1075,7553454,239006
2020-09-22,South America,56546,1439,7610000,240445
2020-09-23,South America,33032,1115,7643032,241560
2020-09-24,South America,97989,2621,7741021,244181
2020-09-25,South America,70285,1841,7811306,246022
2020-09-26,South America,52759,1557,7864065,247579
2020-09-27,South America,40306,953,7904371,248532
2020-09-28,South America,39182,1079,7943553,249611
2020-09-29,South America,59230,1641,8002783,251252
2020-09-30,South America,61646,1809,8064429,253061
2020-10-01,South America,64592,4561,8129021,257622
2020-10-02,South America,29400,767,8158421,258389
2020-10-03,South America,85444,1948,8243865,260337
2020-10-04,South America,27402,904,8271267,261241
2020-10-05,South America,40344,1184,8311611,262425
2020-10-06,South America,70408,1553,8382019,263978
2020-10-07,South America,63196,1505,8445215,265483
2020-10-08,South America,59363,1852,8504578,267335
2020-10-09,South America,58133,1763,8562711,269098
2020-10-10,South America,59668,1331,8622379,270429
2020-10-11,South America,38097,917,8660476,271346
2020-10-12,South America,30751,853,8691227,272199
2020-10-13,South America,35443,995,8726670,273194
2020-10-14,South America,51799,1365,8778469,274559
2020-10-15,South America,62073,1561,8840542,276120
2020-10-16,South America,60347,1492,8900889,277612
2020-10-17,South America,51153,1226,8952042,278838
2020-10-18,South America,24696,472,8976738,279310
2020-10-19,South America,51373,1230,9028111,280540
2020-10-20,South America,53767,1374,9081878,281914
2020-10-21,South America,58044,1358,9139922,283272
2020-10-22,South America,59308,1382,9199230,284654
2020-10-23,South America,59251,1242,9258481,285896
2020-10-24,South America,55404,1056,9313885,286952
2020-10-25,South America,41186,886,9355071,287838
2020-10-26,South America,39813,984,9394884,288822
2020-10-27,South America,57120,1313,9452004,290135
2020-10-28,South America,57403,1168,9509407,291303
2020-10-29,South America,57324,1247,9566731,292550
2020-10-30,South America,51811,1194,9618542,293744
2020-10-31,South America,46243,964,9664785,294708
2020-11-01,South America,31791,674,9696576,295382
2020-11-02,South America,30565,892,9727141,296274
2020-11-03,South America,32714,916,9759855,297190
2020-11-04,South America,56035,1493,9815890,298683
2020-11-05,South America,27054,614,9842944,299297
2020-11-06,South America,66587,1580,9909531,300877
2020-11-07,South America,45519,833,9955050,301710
2020-11-08,South America,29823,652,9984873,302362
2020-11-09,South America,29186,897,10014059,303259
2020-11-10,South America,45924,725,10059983,303984
2020-11-11,South America,74428,1273,10134411,305257
2020-11-12,South America,60059,1497,10194470,306754
2020-11-13,South America,55975,1030,10250445,307784
2020-11-14,South America,62151,1464,10312596,309248
2020-11-15,South America,32500,626,10345096,309874
2020-11-16,South America,32722,837,10377818,310711
2020-11-17,South America,55811,1315,10433629,312026
2020-11-18,South America,56349,1290,10489978,313316
2020-11-19,South America,57455,1099,10547433,314415
2020-11-20,South America,63259,1202,10610692,315617
2020-11-21,South America,55035,849,10665727,316466
2020-11-22,South America,34238,590,10699965,317056
2020-11-23,South America,31410,743,10731375,317799
2020-11-24,South America,49597,1278,10780972,319077
2020-11-25,South America,70274,1218,10851246,320295
2020-11-26,South America,59953,1228,10911199,321523
2020-11-27,South America,60440,1193,10971639,322716
2020-11-28,South America,75483,1053,11047122,323769
2020-11-29,South America,44850,755,11091972,324524
2020-11-30,South America,38304,841,11130276,325365
2020-12-01,South America,71691,1192,11201967,326557
2020-12-02,South America,70791,1205,11272758,327762
2020-12-03,South America,75261,1360,11348019,329122
2020-12-04,South America,67234,1212,11415253,330334
2020-12-05,South America,65732,1192,11480985,331526
2020-12-06,South America,44050,749,11525035,332275
2020-12-07,South America,34394,789,11559429,333064
2020-12-08,South America,65780,1184,11625209,334248
2020-12-09,South America,72452,1378,11697661,335626
2020-12-10,South America,75453,1398,11773114,337024
2020-12-11,South America,74752,1072,11847866,338096
2020-12-12,South America,63702,1087,11911568,339183
2020-12-13,South America,38789,632,11950357,339815
2020-12-14,South America,46533,1062,11996890,340877
2020-12-15,South America,65129,1434,12062019,342311
2020-12-16,South America,94006,1367,12156025,343678
2020-12-17,South America,97694,1685,12253719,345363
2020-12-18,South America,78625,1276,12332344,346639
2020-12-19,South America,75655,1137,12407999,347776
2020-12-20,South America,51422,920,12459421,348696
2020-12-21,South America,47983,1056,12507404,349752
2020-12-22,South America,80634,1598,12588038,351350
2020-12-23,South America,76482,1379,12664520,352729
2020-12-24,South America,80599,1170,12745119,353899
2020-12-25,South America,58441,1031,12803560,354930
2020-12-26,South America,37537,779,12841097,355709
2020-12-27,South America,36568,795,12877665,356504
2020-12-28,South America,44152,989,12921817,357493
2020-12-29,South America,88184,1668,13010001,359161
2020-12-30,South America,87977,1757,13097978,360918
2020-12-31,South America,96181,1733,13194159,362651
2021-01-01,South America,47568,912,13241727,363563
2021-01-02,South America,39297,750,13281024,364313
2021-01-03,South America,39702,769,13320726,365082
2021-01-04,South America,45506,1029,13366232,366111
2021-01-05,South America,94346,1667,13460578,367778
2021-01-06,South America,103776,1966,13564354,369744
2021-01-07,South America,128346,2175,13692700,371919
2021-01-08,South America,97114,1727,13789814,373646
2021-01-09,South America,98686,1795,13888500,375441
2021-01-10,South America,61587,990,13950087,376431
2021-01-11,South America,66290,1358,14016377,377789
2021-01-12,South America,102425,1790,14118802,379579
2021-01-13,South America,101853,1936,14220655,381515
2021-01-14,South America,109505,1810,14330160,383325
2021-01-15,South America,129021,2057,14459181,385382
2021-01-16,South America,103838,1671,14563019,387053
2021-01-17,South America,70576,1267,14633595,388320
2021-01-18,South America,53879,1398,14687474,389718
2021-01-19,South America,98987,1985,14786461,391703
2021-01-20,South America,117692,2305,14904153,394008
2021-01-21,South America,97257,2133,15001410,396141
2021-01-22,South America,102569,2159,15103979,398300
2021-01-23,South America,95726,1949,15199705,400249
2021-01-24,South America,67306,1600,15267011,401849
2021-01-25,South America,54378,1390,15321389,403239
2021-01-26,South America,107741,2456,15429130,405695
2021-01-27,South America,97912,2008,15527042,407703
2021-01-28,South America,101514,2392,15628556,410095
2021-01-29,South America,95548,2076,15724104,412171
2021-01-30,South America,99075,2380,15823179,414551
2021-01-31,South America,54657,1299,15877836,415850
2021-02-01,South America,47615,1368,15925451,417218
2021-02-02,South America,85644,1999,16011095,419217
2021-02-03,South America,99539,2167,16110634,421384
2021-02-04,South America,83830,1918,16194464,423302
2021-02-05,South America,82693,2179,16277157,425481
2021-02-06,South America,31921,797,16309078,426278
2021-02-07,South America,108156,2400,16417234,428678
2021-02-08,South America,16115,711,16433349,429389
2021-02-09,South America,105715,2888,16539064,432277
2021-02-10,South America,80298,1814,16619362,434091
2021-02-11,South America,84166,2517,16703528,436608
2021-02-12,South America,81631,1873,16785159,438481
2021-02-13,South America,72617,1864,16857776,440345
2021-02-14,South America,56239,1610,16914015,441955
2021-02-15,South America,48263,1156,16962278,443111
2021-02-16,South America,68630,1564,17030908,444675
2021-02-17,South America,79346,1775,17110254,446450
2021-02-18,South America,80686,2327,17190940,448777
2021-02-19,South America,84031,1975,17274971,450752
2021-02-20,South America,82808,1909,17357779,452661
2021-02-21,South America,58614,1303,17416393,453964
2021-02-22,South America,42452,1093,17458845,455057
2021-02-23,South America,84162,1963,17543007,457020
2021-02-24,South America,94848,2091,17637855,459111
2021-02-25,South America,95751,2246,17733606,461357
2021-02-26,South America,99192,2155,17832798,463512
2021-02-27,South America,87048,1973,17919846,465485
2021-02-28,South America,48219,1019,17968065,466504
2021-03-01,South America,58038,1338,18026103,467842
2021-03-02,South America,85389,2372,18111492,470214
2021-03-03,South America,91956,2438,18203448,472652
2021-03-04,South America,101514,2423,18304962,475075
2021-03-05,South America,102156,2460,18407118,477535
2021-03-06,South America,96954,2090,18504072,479625
2021-03-07,South America,103091,1518,18607163,481143
2021-03-08,South America,54248,1649,18661411,482792
2021-03-09,South America,98878,2582,18760289,485374
2021-03-10,South America,100681,2616,18860970,487990
2021-03-11,South America,107161,2857,18968131,490847
2021-03-12,South America,116743,2773,19084874,493620
2021-03-13,South America,106177,2537,19191051,496157
2021-03-14,South America,67136,1595,19258187,497752
2021-03-15,South America,59365,1663,19317552,499415
2021-03-16,South America,111720,3452,19429272,502867
2021-03-17,South America,131576,3463,19560848,506330
2021-03-18,South America,115463,3287,19676311,509617
2021-03-19,South America,134153,3666,19810464,513283
2021-03-20,South America,106408,2800,19916872,516083
2021-03-21,South America,85356,1926,20002228,518009
2021-03-22,South America,73197,1819,20075425,519828
2021-03-23,South America,122724,3951,20198149,523779
2021-03-24,South America,118704,2399,20316853,526178
2021-03-25,South America,148476,3661,20465329,529839
2021-03-26,South America,133387,4325,20598716,534164
2021-03-27,South America,128218,4140,20726934,538304
2021-03-28,South America,82297,2400,20809231,540704
2021-03-29,South America,77088,2538,20886319,543242
2021-03-30,South America,117245,4267,21003564,547509
2021-03-31,South America,145976,4723,21149540,552232
2021-04-01,South America,145939,4537,21295479,556769
2021-04-02,South America,113379,3580,21408858,560349
2021-04-03,South America,83881,2752,21492739,563101
2021-04-04,South America,76525,2008,21569264,565109
2021-04-05,South America,72844,2263,21642108,567372
2021-04-06,South America,134012,4806,21776120,572178
2021-04-07,South America,150165,4794,21926285,576972
2021-04-08,South America,161096,5742,22087381,582714
2020-01-22,South Korea,0,0,1,0
2020-01-23,South Korea,0,0,1,0
2020-01-24,South Korea,1,0,2,0
2020-01-25,South Korea,0,0,2,0
2020-01-26,South Korea,1,0,3,0
2020-01-27,South Korea,1,0,4,0
2020-01-28,South Korea,0,0,4,0
2020-01-29,South Korea,0,0,4,0
2020-01-30,South Korea,0,0,4,0
2020-01-31,South Korea,7,0,11,0
2020-02-01,South Korea,1,0,12,0
2020-02-02,South Korea,3,0,15,0
2020-02-03,South Korea,0,0,15,0
2020-02-04,South Korea,1,0,16,0
2020-02-05,South Korea,3,0,19,0
2020-02-06,South Korea,4,0,23,0
2020-02-07,South Korea,1,0,24,0
2020-02-08,South Korea,0,0,24,0
2020-02-09,South Korea,1,0,25,0
2020-02-10,South Korea,2,0,27,0
2020-02-11,South Korea,1,0,28,0
2020-02-12,South Korea,0,0,28,0
2020-02-13,South Korea,0,0,28,0
2020-02-14,South Korea,0,0,28,0
2020-02-15,South Korea,0,0,28,0
2020-02-16,South Korea,1,0,29,0
2020-02-17,South Korea,1,0,30,0
2020-02-18,South Korea,1,0,31,0
2020-02-19,South Korea,0,0,31,0
2020-02-20,South Korea,73,1,104,1
2020-02-21,South Korea,100,1,204,2
2020-02-22,South Korea,229,0,433,2
2020-02-23,South Korea,169,4,602,6
2020-02-24,South Korea,231,2,833,8
2020-02-25,South Korea,144,2,977,10
2020-02-26,South Korea,284,2,1261,12
2020-02-27,South Korea,505,1,1766,13
2020-02-28,South Korea,571,0,2337,13
2020-02-29,South Korea,813,3,3150,16
2020-03-01,South Korea,586,1,3736,17
2020-03-02,South Korea,599,11,4335,28
2020-03-03,South Korea,851,0,5186,28
2020-03-04,South Korea,435,7,5621,35
2020-03-05,South Korea,467,0,6088,35
2020-03-06,South Korea,505,7,6593,42
2020-03-07,South Korea,448,2,7041,44
2020-03-08,South Korea,273,6,7314,50
2020-03-09,South Korea,164,3,7478,53
2020-03-10,South Korea,35,1,7513,54
2020-03-11,South Korea,242,6,7755,60
2020-03-12,South Korea,114,6,7869,66
2020-03-13,South Korea,110,0,7979,66
2020-03-14,South Korea,107,6,8086,72
2020-03-15,South Korea,76,3,8162,75
2020-03-16,South Korea,74,0,8236,75
2020-03-17,South Korea,84,6,8320,81
2020-03-18,South Korea,93,3,8413,84
2020-03-19,South Korea,152,7,8565,91
2020-03-20,South Korea,87,3,8652,94
2020-03-21,South Korea,147,8,8799,102
2020-03-22,South Korea,162,9,8961,111
2020-03-23,South Korea,0,0,8961,111
2020-03-24,South Korea,76,9,9037,120
2020-03-25,South Korea,100,6,9137,126
2020-03-26,South Korea,104,5,9241,131
2020-03-27,South Korea,91,8,9332,139
2020-03-28,South Korea,146,5,9478,144
2020-03-29,South Korea,105,8,9583,152
2020-03-30,South Korea,78,6,9661,158
2020-03-31,South Korea,125,4,9786,162
2020-04-01,South Korea,101,3,9887,165
2020-04-02,South Korea,89,4,9976,169
2020-04-03,South Korea,86,5,10062,174
2020-04-04,South Korea,94,3,10156,177
2020-04-05,South Korea,81,6,10237,183
2020-04-06,South Korea,47,3,10284,186
2020-04-07,South Korea,47,6,10331,192
2020-04-08,South Korea,53,8,10384,200
2020-04-09,South Korea,39,4,10423,204
2020-04-10,South Korea,27,4,10450,208
2020-04-11,South Korea,30,3,10480,211
2020-04-12,South Korea,32,3,10512,214
2020-04-13,South Korea,25,3,10537,217
2020-04-14,South Korea,27,5,10564,222
2020-04-15,South Korea,27,3,10591,225
2020-04-16,South Korea,22,4,10613,229
2020-04-17,South Korea,22,1,10635,230
2020-04-18,South Korea,18,2,10653,232
2020-04-19,South Korea,8,2,10661,234
2020-04-20,South Korea,13,2,10674,236
2020-04-21,South Korea,9,1,10683,237
2020-04-22,South Korea,11,1,10694,238
2020-04-23,South Korea,14,2,10708,240
2020-04-24,South Korea,10,0,10718,240
2020-04-25,South Korea,10,2,10728,242
2020-04-26,South Korea,10,1,10738,243
2020-04-27,South Korea,14,1,10752,244
2020-04-28,South Korea,9,2,10761,246
2020-04-29,South Korea,4,1,10765,247
2020-04-30,South Korea,9,1,10774,248
2020-05-01,South Korea,6,2,10780,250
2020-05-02,South Korea,13,0,10793,250
2020-05-03,South Korea,8,2,10801,252
2020-05-04,South Korea,3,2,10804,254
2020-05-05,South Korea,2,1,10806,255
2020-05-06,South Korea,4,1,10810,256
2020-05-07,South Korea,12,0,10822,256
2020-05-08,South Korea,18,0,10840,256
2020-05-09,South Korea,34,0,10874,256
2020-05-10,South Korea,35,0,10909,256
2020-05-11,South Korea,27,2,10936,258
2020-05-12,South Korea,26,1,10962,259
2020-05-13,South Korea,29,1,10991,260
2020-05-14,South Korea,27,0,11018,260
2020-05-15,South Korea,19,2,11037,262
2020-05-16,South Korea,13,0,11050,262
2020-05-17,South Korea,15,1,11065,263
2020-05-18,South Korea,13,0,11078,263
2020-05-19,South Korea,32,0,11110,263
2020-05-20,South Korea,12,1,11122,264
2020-05-21,South Korea,20,0,11142,264
2020-05-22,South Korea,23,2,11165,266
2020-05-23,South Korea,25,0,11190,266
2020-05-24,South Korea,16,1,11206,267
2020-05-25,South Korea,19,2,11225,269
2020-05-26,South Korea,40,0,11265,269
2020-05-27,South Korea,79,0,11344,269
2020-05-28,South Korea,58,0,11402,269
2020-05-29,South Korea,39,0,11441,269
2020-05-30,South Korea,27,1,11468,270
2020-05-31,South Korea,35,1,11503,271
2020-06-01,South Korea,38,1,11541,272
2020-06-02,South Korea,49,1,11590,273
2020-06-03,South Korea,39,0,11629,273
2020-06-04,South Korea,39,0,11668,273
2020-06-05,South Korea,51,0,11719,273
2020-06-06,South Korea,57,0,11776,273
2020-06-07,South Korea,38,0,11814,273
2020-06-08,South Korea,38,1,11852,274
2020-06-09,South Korea,50,2,11902,276
2020-06-10,South Korea,45,0,11947,276
2020-06-11,South Korea,56,1,12003,277
2020-06-12,South Korea,48,0,12051,277
2020-06-13,South Korea,34,0,12085,277
2020-06-14,South Korea,36,0,12121,277
2020-06-15,South Korea,34,1,12155,278
2020-06-16,South Korea,43,1,12198,279
2020-06-17,South Korea,59,1,12257,280
2020-06-18,South Korea,49,0,12306,280
2020-06-19,South Korea,67,0,12373,280
2020-06-20,South Korea,48,0,12421,280
2020-06-21,South Korea,17,0,12438,280
2020-06-22,South Korea,46,1,12484,281
2020-06-23,South Korea,51,0,12535,281
2020-06-24,South Korea,28,1,12563,282
2020-06-25,South Korea,39,0,12602,282
2020-06-26,South Korea,51,0,12653,282
2020-06-27,South Korea,62,0,12715,282
2020-06-28,South Korea,42,0,12757,282
2020-06-29,South Korea,43,0,12800,282
2020-06-30,South Korea,50,0,12850,282
2020-07-01,South Korea,54,0,12904,282
2020-07-02,South Korea,63,0,12967,282
2020-07-03,South Korea,63,1,13030,283
2020-07-04,South Korea,61,0,13091,283
2020-07-05,South Korea,46,1,13137,284
2020-07-06,South Korea,44,1,13181,285
2020-07-07,South Korea,63,0,13244,285
2020-07-08,South Korea,49,2,13293,287
2020-07-09,South Korea,45,1,13338,288
2020-07-10,South Korea,35,0,13373,288
2020-07-11,South Korea,44,1,13417,289
2020-07-12,South Korea,62,0,13479,289
2020-07-13,South Korea,33,0,13512,289
2020-07-14,South Korea,39,0,13551,289
2020-07-15,South Korea,61,2,13612,291
2020-07-16,South Korea,60,2,13672,293
2020-07-17,South Korea,39,1,13711,294
2020-07-18,South Korea,34,1,13745,295
2020-07-19,South Korea,26,1,13771,296
2020-07-20,South Korea,45,0,13816,296
2020-07-21,South Korea,63,1,13879,297
2020-07-22,South Korea,59,0,13938,297
2020-07-23,South Korea,41,1,13979,298
2020-07-24,South Korea,113,0,14092,298
2020-07-25,South Korea,58,0,14150,298
2020-07-26,South Korea,25,1,14175,299
2020-07-27,South Korea,28,1,14203,300
2020-07-28,South Korea,48,0,14251,300
2020-07-29,South Korea,18,0,14269,300
2020-07-30,South Korea,36,1,14305,301
2020-07-31,South Korea,31,0,14336,301
2020-08-01,South Korea,30,0,14366,301
2020-08-02,South Korea,23,0,14389,301
2020-08-03,South Korea,34,0,14423,301
2020-08-04,South Korea,33,1,14456,302
2020-08-05,South Korea,43,0,14499,302
2020-08-06,South Korea,20,1,14519,303
2020-08-07,South Korea,43,1,14562,304
2020-08-08,South Korea,36,1,14598,305
2020-08-09,South Korea,28,0,14626,305
2020-08-10,South Korea,34,0,14660,305
2020-08-11,South Korea,54,0,14714,305
2020-08-12,South Korea,56,0,14770,305
2020-08-13,South Korea,103,0,14873,305
2020-08-14,South Korea,166,0,15039,305
2020-08-15,South Korea,279,0,15318,305
2020-08-16,South Korea,197,0,15515,305
2020-08-17,South Korea,246,1,15761,306
2020-08-18,South Korea,297,0,16058,306
2020-08-19,South Korea,288,1,16346,307
2020-08-20,South Korea,324,2,16670,309
2020-08-21,South Korea,332,0,17002,309
2020-08-22,South Korea,397,0,17399,309
2020-08-23,South Korea,266,0,17665,309
2020-08-24,South Korea,280,1,17945,310
2020-08-25,South Korea,320,2,18265,312
2020-08-26,South Korea,441,1,18706,313
2020-08-27,South Korea,371,3,19077,316
2020-08-28,South Korea,323,5,19400,321
2020-08-29,South Korea,299,2,19699,323
2020-08-30,South Korea,248,1,19947,324
2020-08-31,South Korea,235,0,20182,324
2020-09-01,South Korea,267,2,20449,326
2020-09-02,South Korea,195,3,20644,329
2020-09-03,South Korea,198,2,20842,331
2020-09-04,South Korea,168,2,21010,333
2020-09-05,South Korea,167,1,21177,334
2020-09-06,South Korea,119,2,21296,336
2020-09-07,South Korea,136,5,21432,341
2020-09-08,South Korea,156,3,21588,344
2020-09-09,South Korea,155,2,21743,346
2020-09-10,South Korea,176,4,21919,350
2020-09-11,South Korea,136,5,22055,355
2020-09-12,South Korea,121,3,22176,358
2020-09-13,South Korea,109,5,22285,363
2020-09-14,South Korea,106,4,22391,367
2020-09-15,South Korea,113,0,22504,367
2020-09-16,South Korea,153,5,22657,372
2020-09-17,South Korea,126,5,22783,377
2020-09-18,South Korea,110,1,22893,378
2020-09-19,South Korea,82,5,22975,383
2020-09-20,South Korea,70,2,23045,385
2020-09-21,South Korea,61,3,23106,388
2020-09-22,South Korea,110,0,23216,388
2020-09-23,South Korea,125,5,23341,393
2020-09-24,South Korea,114,2,23455,395
2020-09-25,South Korea,61,4,23516,399
2020-09-26,South Korea,95,2,23611,401
2020-09-27,South Korea,50,5,23661,406
2020-09-28,South Korea,38,1,23699,407
2020-09-29,South Korea,113,6,23812,413
2020-09-30,South Korea,77,2,23889,415
2020-10-01,South Korea,63,1,23952,416
2020-10-02,South Korea,75,4,24027,420
2020-10-03,South Korea,64,1,24091,421
2020-10-04,South Korea,73,1,24164,422
2020-10-05,South Korea,75,0,24239,422
2020-10-06,South Korea,114,3,24353,425
2020-10-07,South Korea,69,2,24422,427
2020-10-08,South Korea,54,1,24476,428
2020-10-09,South Korea,72,2,24548,430
2020-10-10,South Korea,58,2,24606,432
2020-10-11,South Korea,97,1,24703,433
2020-10-12,South Korea,102,1,24805,434
2020-10-13,South Korea,84,4,24889,438
2020-10-14,South Korea,99,1,24988,439
2020-10-15,South Korea,47,2,25035,441
2020-10-16,South Korea,73,2,25108,443
2020-10-17,South Korea,91,1,25199,444
2020-10-18,South Korea,76,0,25275,444
2020-10-19,South Korea,58,3,25333,447
2020-10-20,South Korea,91,3,25424,450
2020-10-21,South Korea,119,3,25543,453
2020-10-22,South Korea,155,2,25698,455
2020-10-23,South Korea,77,2,25775,457
2020-10-24,South Korea,61,0,25836,457
2020-10-25,South Korea,119,0,25955,457
2020-10-26,South Korea,88,3,26043,460
2020-10-27,South Korea,103,1,26146,461
2020-10-28,South Korea,125,1,26271,462
2020-10-29,South Korea,114,1,26385,463
2020-10-30,South Korea,126,1,26511,464
2020-10-31,South Korea,124,2,26635,466
2020-11-01,South Korea,97,2,26732,468
2020-11-02,South Korea,75,4,26807,472
2020-11-03,South Korea,118,2,26925,474
2020-11-04,South Korea,125,1,27050,475
2020-11-05,South Korea,145,1,27195,476
2020-11-06,South Korea,89,1,27284,477
2020-11-07,South Korea,143,1,27427,478
2020-11-08,South Korea,126,2,27553,480
2020-11-09,South Korea,100,5,27653,485
2020-11-10,South Korea,146,2,27799,487
2020-11-11,South Korea,143,0,27942,487
2020-11-12,South Korea,191,1,28133,488
2020-11-13,South Korea,205,4,28338,492
2020-11-14,South Korea,208,1,28546,493
2020-11-15,South Korea,223,1,28769,494
2020-11-16,South Korea,229,0,28998,494
2020-11-17,South Korea,313,2,29311,496
2020-11-18,South Korea,343,2,29654,498
2020-11-19,South Korea,363,3,30017,501
2020-11-20,South Korea,386,2,30403,503
2020-11-21,South Korea,330,2,30733,505
2020-11-22,South Korea,271,4,31004,509
2020-11-23,South Korea,349,1,31353,510
2020-11-24,South Korea,382,3,31735,513
2020-11-25,South Korea,583,2,32318,515
2020-11-26,South Korea,569,1,32887,516
2020-11-27,South Korea,488,6,33375,522
2020-11-28,South Korea,449,1,33824,523
2020-11-29,South Korea,377,3,34201,526
2020-11-30,South Korea,451,0,34652,526
2020-12-01,South Korea,511,0,35163,526
2020-12-02,South Korea,540,3,35703,529
2020-12-03,South Korea,629,7,36332,536
2020-12-04,South Korea,583,4,36915,540
2020-12-05,South Korea,631,5,37546,545
2020-12-06,South Korea,615,4,38161,549
2020-12-07,South Korea,594,3,38755,552
2020-12-08,South Korea,677,4,39432,556
2020-12-09,South Korea,666,8,40098,564
2020-12-10,South Korea,688,8,40786,572
2020-12-11,South Korea,950,6,41736,578
2020-12-12,South Korea,1030,2,42766,580
2020-12-13,South Korea,718,7,43484,587
2020-12-14,South Korea,880,13,44364,600
2020-12-15,South Korea,1078,12,45442,612
2020-12-16,South Korea,1011,22,46453,634
2020-12-17,South Korea,1062,11,47515,645
2020-12-18,South Korea,1055,14,48570,659
2020-12-19,South Korea,1095,15,49665,674
2020-12-20,South Korea,926,24,50591,698
2020-12-21,South Korea,869,24,51460,722
2020-12-22,South Korea,1090,17,52550,739
2020-12-23,South Korea,983,17,53533,756
2020-12-24,South Korea,1237,17,54770,773
2020-12-25,South Korea,1132,20,55902,793
2020-12-26,South Korea,970,15,56872,808
2020-12-27,South Korea,808,11,57680,819
2020-12-28,South Korea,1045,40,58725,859
2020-12-29,South Korea,1048,20,59773,879
2020-12-30,South Korea,967,21,60740,900
2020-12-31,South Korea,1029,17,61769,917
2021-01-01,South Korea,824,25,62593,942
2021-01-02,South Korea,651,20,63244,962
2021-01-03,South Korea,1020,19,64264,981
2021-01-04,South Korea,715,26,64979,1007
2021-01-05,South Korea,839,20,65818,1027
2021-01-06,South Korea,868,19,66686,1046
2021-01-07,South Korea,672,35,67358,1081
2021-01-08,South Korea,641,19,67999,1100
2021-01-09,South Korea,665,25,68664,1125
2021-01-10,South Korea,450,15,69114,1140
2021-01-11,South Korea,537,25,69651,1165
2021-01-12,South Korea,561,20,70212,1185
2021-01-13,South Korea,516,10,70728,1195
2021-01-14,South Korea,513,22,71241,1217
2021-01-15,South Korea,579,19,71820,1236
2021-01-16,South Korea,520,13,72340,1249
2021-01-17,South Korea,389,15,72729,1264
2021-01-18,South Korea,386,19,73115,1283
2021-01-19,South Korea,403,17,73518,1300
2021-01-20,South Korea,400,16,73918,1316
2021-01-21,South Korea,344,12,74262,1328
2021-01-22,South Korea,430,9,74692,1337
2021-01-23,South Korea,392,12,75084,1349
2021-01-24,South Korea,437,11,75521,1360
2021-01-25,South Korea,354,11,75875,1371
2021-01-26,South Korea,554,7,76429,1378
2021-01-27,South Korea,497,8,76926,1386
2021-01-28,South Korea,469,13,77395,1399
2021-01-29,South Korea,455,15,77850,1414
2021-01-30,South Korea,355,6,78205,1420
2021-01-31,South Korea,303,5,78508,1425
2021-02-01,South Korea,336,10,78844,1435
2021-02-02,South Korea,467,6,79311,1441
2021-02-03,South Korea,451,7,79762,1448
2021-02-04,South Korea,369,11,80131,1459
2021-02-05,South Korea,393,5,80524,1464
2021-02-06,South Korea,372,7,80896,1471
2021-02-07,South Korea,289,3,81185,1474
2021-02-08,South Korea,302,8,81487,1482
2021-02-09,South Korea,443,4,81930,1486
2021-02-10,South Korea,504,10,82434,1496
2021-02-11,South Korea,403,11,82837,1507
2021-02-12,South Korea,362,7,83199,1514
2021-02-13,South Korea,326,8,83525,1522
2021-02-14,South Korea,344,5,83869,1527
2021-02-15,South Korea,456,7,84325,1534
2021-02-16,South Korea,621,4,84946,1538
2021-02-17,South Korea,621,6,85567,1544
2021-02-18,South Korea,561,6,86128,1550
2021-02-19,South Korea,446,3,86574,1553
2021-02-20,South Korea,418,4,86992,1557
2021-02-21,South Korea,332,5,87324,1562
2021-02-22,South Korea,357,11,87681,1573
2021-02-23,South Korea,439,3,88120,1576
2021-02-24,South Korea,396,5,88516,1581
2021-02-25,South Korea,406,4,88922,1585
2021-02-26,South Korea,399,10,89321,1595
2021-02-27,South Korea,355,8,89676,1603
2021-02-28,South Korea,355,2,90031,1605
2021-03-01,South Korea,341,1,90372,1606
2021-03-02,South Korea,444,6,90816,1612
2021-03-03,South Korea,424,7,91240,1619
2021-03-04,South Korea,398,8,91638,1627
2021-03-05,South Korea,417,5,92055,1632
2021-03-06,South Korea,416,2,92471,1634
2021-03-07,South Korea,346,8,92817,1642
2021-03-08,South Korea,446,3,93263,1645
2021-03-09,South Korea,470,3,93733,1648
2021-03-10,South Korea,465,4,94198,1652
2021-03-11,South Korea,488,10,94686,1662
2021-03-12,South Korea,490,5,95176,1667
2021-03-13,South Korea,459,2,95635,1669
2021-03-14,South Korea,382,6,96017,1675
2021-03-15,South Korea,363,3,96380,1678
2021-03-16,South Korea,469,8,96849,1686
2021-03-17,South Korea,445,2,97294,1688
2021-03-18,South Korea,463,2,97757,1690
2021-03-19,South Korea,452,3,98209,1693
2021-03-20,South Korea,456,3,98665,1696
2021-03-21,South Korea,410,1,99075,1697
2021-03-22,South Korea,346,7,99421,1704
2021-03-23,South Korea,425,3,99846,1707
2021-03-24,South Korea,430,2,100276,1709
2021-03-25,South Korea,494,7,100770,1716
2021-03-26,South Korea,505,5,101275,1721
2021-03-27,South Korea,482,1,101757,1722
2021-03-28,South Korea,384,4,102141,1726
2021-03-29,South Korea,441,3,102582,1729
2021-03-30,South Korea,506,2,103088,1731
2021-03-31,South Korea,551,4,103639,1735
2021-04-01,South Korea,555,2,104194,1737
2021-04-02,South Korea,542,3,104736,1740
2021-04-03,South Korea,543,4,105279,1744
2021-04-04,South Korea,473,4,105752,1748
2021-04-05,South Korea,478,4,106230,1752
2021-04-06,South Korea,668,4,106898,1756
2021-04-07,South Korea,700,2,107598,1758
2021-04-08,South Korea,671,6,108269,1764
2020-04-05,South Sudan,1,0,1,0
2020-04-06,South Sudan,0,0,1,0
2020-04-07,South Sudan,1,0,2,0
2020-04-08,South Sudan,0,0,2,0
2020-04-09,South Sudan,1,0,3,0
2020-04-10,South Sudan,1,0,4,0
2020-04-11,South Sudan,0,0,4,0
2020-04-12,South Sudan,0,0,4,0
2020-04-13,South Sudan,0,0,4,0
2020-04-14,South Sudan,0,0,4,0
2020-04-15,South Sudan,0,0,4,0
2020-04-16,South Sudan,0,0,4,0
2020-04-17,South Sudan,0,0,4,0
2020-04-18,South Sudan,0,0,4,0
2020-04-19,South Sudan,0,0,4,0
2020-04-20,South Sudan,0,0,4,0
2020-04-21,South Sudan,0,0,4,0
2020-04-22,South Sudan,0,0,4,0
2020-04-23,South Sudan,1,0,5,0
2020-04-24,South Sudan,0,0,5,0
2020-04-25,South Sudan,0,0,5,0
2020-04-26,South Sudan,1,0,6,0
2020-04-27,South Sudan,0,0,6,0
2020-04-28,South Sudan,28,0,34,0
2020-04-29,South Sudan,0,0,34,0
2020-04-30,South Sudan,1,0,35,0
2020-05-01,South Sudan,10,0,45,0
2020-05-02,South Sudan,0,0,45,0
2020-05-03,South Sudan,1,0,46,0
2020-05-04,South Sudan,0,0,46,0
2020-05-05,South Sudan,6,0,52,0
2020-05-06,South Sudan,6,0,58,0
2020-05-07,South Sudan,16,0,74,0
2020-05-08,South Sudan,46,0,120,0
2020-05-09,South Sudan,0,0,120,0
2020-05-10,South Sudan,0,0,120,0
2020-05-11,South Sudan,36,0,156,0
2020-05-12,South Sudan,38,0,194,0
2020-05-13,South Sudan,9,0,203,0
2020-05-14,South Sudan,0,0,203,0
2020-05-15,South Sudan,33,4,236,4
2020-05-16,South Sudan,0,0,236,4
2020-05-17,South Sudan,54,0,290,4
2020-05-18,South Sudan,0,0,290,4
2020-05-19,South Sudan,0,0,290,4
2020-05-20,South Sudan,0,0,290,4
2020-05-21,South Sudan,191,0,481,4
2020-05-22,South Sudan,82,2,563,6
2020-05-23,South Sudan,92,2,655,8
2020-05-24,South Sudan,0,0,655,8
2020-05-25,South Sudan,151,0,806,8
2020-05-26,South Sudan,0,0,806,8
2020-05-27,South Sudan,188,2,994,10
2020-05-28,South Sudan,0,0,994,10
2020-05-29,South Sudan,0,0,994,10
2020-05-30,South Sudan,0,0,994,10
2020-05-31,South Sudan,0,0,994,10
2020-06-01,South Sudan,0,0,994,10
2020-06-02,South Sudan,0,0,994,10
2020-06-03,South Sudan,0,0,994,10
2020-06-04,South Sudan,0,0,994,10
2020-06-05,South Sudan,0,0,994,10
2020-06-06,South Sudan,0,0,994,10
2020-06-07,South Sudan,323,4,1317,14
2020-06-08,South Sudan,287,5,1604,19
2020-06-09,South Sudan,0,0,1604,19
2020-06-10,South Sudan,0,0,1604,19
2020-06-11,South Sudan,66,5,1670,24
2020-06-12,South Sudan,0,0,1670,24
2020-06-13,South Sudan,23,3,1693,27
2020-06-14,South Sudan,0,0,1693,27
2020-06-15,South Sudan,0,0,1693,27
2020-06-16,South Sudan,83,3,1776,30
2020-06-17,South Sudan,37,1,1813,31
2020-06-18,South Sudan,17,1,1830,32
2020-06-19,South Sudan,34,2,1864,34
2020-06-20,South Sudan,18,0,1882,34
2020-06-21,South Sudan,10,0,1892,34
2020-06-22,South Sudan,24,1,1916,35
2020-06-23,South Sudan,14,1,1930,36
2020-06-24,South Sudan,12,0,1942,36
2020-06-25,South Sudan,0,0,1942,36
2020-06-26,South Sudan,0,0,1942,36
2020-06-27,South Sudan,0,0,1942,36
2020-06-28,South Sudan,47,0,1989,36
2020-06-29,South Sudan,0,0,1989,36
2020-06-30,South Sudan,18,2,2007,38
2020-07-01,South Sudan,14,0,2021,38
2020-07-02,South Sudan,0,0,2021,38
2020-07-03,South Sudan,0,0,2021,38
2020-07-04,South Sudan,0,0,2021,38
2020-07-05,South Sudan,0,0,2021,38
2020-07-06,South Sudan,0,0,2021,38
2020-07-07,South Sudan,0,0,2021,38
2020-07-08,South Sudan,0,0,2021,38
2020-07-09,South Sudan,0,0,2021,38
2020-07-10,South Sudan,0,0,2021,38
2020-07-11,South Sudan,0,0,2021,38
2020-07-12,South Sudan,0,0,2021,38
2020-07-13,South Sudan,127,3,2148,41
2020-07-14,South Sudan,0,0,2148,41
2020-07-15,South Sudan,5,0,2153,41
2020-07-16,South Sudan,18,0,2171,41
2020-07-17,South Sudan,20,2,2191,43
2020-07-18,South Sudan,0,0,2191,43
2020-07-19,South Sudan,9,0,2200,43
2020-07-20,South Sudan,11,2,2211,45
2020-07-21,South Sudan,0,0,2211,45
2020-07-22,South Sudan,0,0,2211,45
2020-07-23,South Sudan,28,0,2239,45
2020-07-24,South Sudan,19,0,2258,45
2020-07-25,South Sudan,0,0,2258,45
2020-07-26,South Sudan,4,0,2262,45
2020-07-27,South Sudan,43,1,2305,46
2020-07-28,South Sudan,0,0,2305,46
2020-07-29,South Sudan,17,0,2322,46
2020-07-30,South Sudan,0,0,2322,46
2020-07-31,South Sudan,0,0,2322,46
2020-08-01,South Sudan,30,0,2352,46
2020-08-02,South Sudan,77,0,2429,46
2020-08-03,South Sudan,0,0,2429,46
2020-08-04,South Sudan,8,1,2437,47
2020-08-05,South Sudan,0,0,2437,47
2020-08-06,South Sudan,13,0,2450,47
2020-08-07,South Sudan,0,0,2450,47
2020-08-08,South Sudan,13,0,2463,47
2020-08-09,South Sudan,7,0,2470,47
2020-08-10,South Sudan,0,0,2470,47
2020-08-11,South Sudan,2,0,2472,47
2020-08-12,South Sudan,5,0,2477,47
2020-08-13,South Sudan,1,0,2478,47
2020-08-14,South Sudan,4,0,2482,47
2020-08-15,South Sudan,6,0,2488,47
2020-08-16,South Sudan,1,0,2489,47
2020-08-17,South Sudan,1,0,2490,47
2020-08-18,South Sudan,0,0,2490,47
2020-08-19,South Sudan,4,0,2494,47
2020-08-20,South Sudan,0,0,2494,47
2020-08-21,South Sudan,3,0,2497,47
2020-08-22,South Sudan,0,0,2497,47
2020-08-23,South Sudan,2,0,2499,47
2020-08-24,South Sudan,5,0,2504,47
2020-08-25,South Sudan,3,0,2507,47
2020-08-26,South Sudan,3,0,2510,47
2020-08-27,South Sudan,4,0,2514,47
2020-08-28,South Sudan,4,0,2518,47
2020-08-29,South Sudan,1,0,2519,47
2020-08-30,South Sudan,0,0,2519,47
2020-08-31,South Sudan,8,0,2527,47
2020-09-01,South Sudan,0,0,2527,47
2020-09-02,South Sudan,5,0,2532,47
2020-09-03,South Sudan,1,0,2533,47
2020-09-04,South Sudan,3,0,2536,47
2020-09-05,South Sudan,8,1,2544,48
2020-09-06,South Sudan,0,0,2544,48
2020-09-07,South Sudan,1,0,2545,48
2020-09-08,South Sudan,7,1,2552,49
2020-09-09,South Sudan,3,0,2555,49
2020-09-10,South Sudan,0,0,2555,49
2020-09-11,South Sudan,13,0,2568,49
2020-09-12,South Sudan,10,0,2578,49
2020-09-13,South Sudan,0,0,2578,49
2020-09-14,South Sudan,9,0,2587,49
2020-09-15,South Sudan,5,0,2592,49
2020-09-16,South Sudan,2,0,2594,49
2020-09-17,South Sudan,5,0,2599,49
2020-09-18,South Sudan,10,0,2609,49
2020-09-19,South Sudan,33,0,2642,49
2020-09-20,South Sudan,0,0,2642,49
2020-09-21,South Sudan,7,0,2649,49
2020-09-22,South Sudan,11,0,2660,49
2020-09-23,South Sudan,4,0,2664,49
2020-09-24,South Sudan,5,0,2669,49
2020-09-25,South Sudan,7,0,2676,49
2020-09-26,South Sudan,0,0,2676,49
2020-09-27,South Sudan,10,0,2686,49
2020-09-28,South Sudan,6,0,2692,49
2020-09-29,South Sudan,8,0,2700,49
2020-09-30,South Sudan,4,0,2704,49
2020-10-01,South Sudan,0,0,2704,49
2020-10-02,South Sudan,11,1,2715,50
2020-10-03,South Sudan,0,0,2715,50
2020-10-04,South Sudan,11,0,2726,50
2020-10-05,South Sudan,0,0,2726,50
2020-10-06,South Sudan,8,0,2734,50
2020-10-07,South Sudan,14,0,2748,50
2020-10-08,South Sudan,1,3,2749,53
2020-10-09,South Sudan,12,1,2761,54
2020-10-10,South Sudan,0,0,2761,54
2020-10-11,South Sudan,16,1,2777,55
2020-10-12,South Sudan,10,0,2787,55
2020-10-13,South Sudan,11,0,2798,55
2020-10-14,South Sudan,0,0,2798,55
2020-10-15,South Sudan,9,0,2807,55
2020-10-16,South Sudan,10,0,2817,55
2020-10-17,South Sudan,0,0,2817,55
2020-10-18,South Sudan,25,0,2842,55
2020-10-19,South Sudan,5,0,2847,55
2020-10-20,South Sudan,0,0,2847,55
2020-10-21,South Sudan,23,0,2870,55
2020-10-22,South Sudan,2,0,2872,55
2020-10-23,South Sudan,4,1,2876,56
2020-10-24,South Sudan,2,0,2878,56
2020-10-25,South Sudan,5,0,2883,56
2020-10-26,South Sudan,0,0,2883,56
2020-10-27,South Sudan,7,0,2890,56
2020-10-28,South Sudan,0,0,2890,56
2020-10-29,South Sudan,13,2,2903,58
2020-10-30,South Sudan,0,0,2903,58
2020-10-31,South Sudan,2,0,2905,58
2020-11-01,South Sudan,21,1,2926,59
2020-11-02,South Sudan,0,0,2926,59
2020-11-03,South Sudan,14,0,2940,59
2020-11-04,South Sudan,3,0,2943,59
2020-11-05,South Sudan,0,0,2943,59
2020-11-06,South Sudan,0,0,2943,59
2020-11-07,South Sudan,0,0,2943,59
2020-11-08,South Sudan,0,0,2943,59
2020-11-09,South Sudan,17,0,2960,59
2020-11-10,South Sudan,0,0,2960,59
2020-11-11,South Sudan,0,0,2960,59
2020-11-12,South Sudan,0,0,2960,59
2020-11-13,South Sudan,20,0,2980,59
2020-11-14,South Sudan,23,0,3003,59
2020-11-15,South Sudan,0,0,3003,59
2020-11-16,South Sudan,9,0,3012,59
2020-11-17,South Sudan,4,0,3016,59
2020-11-18,South Sudan,0,0,3016,59
2020-11-19,South Sudan,0,0,3016,59
2020-11-20,South Sudan,0,0,3016,59
2020-11-21,South Sudan,31,1,3047,60
2020-11-22,South Sudan,0,0,3047,60
2020-11-23,South Sudan,0,0,3047,60
2020-11-24,South Sudan,0,0,3047,60
2020-11-25,South Sudan,26,1,3073,61
2020-11-26,South Sudan,19,0,3092,61
2020-11-27,South Sudan,12,0,3104,61
2020-11-28,South Sudan,0,0,3104,61
2020-11-29,South Sudan,5,0,3109,61
2020-11-30,South Sudan,0,0,3109,61
2020-12-01,South Sudan,2,0,3111,61
2020-12-02,South Sudan,7,0,3118,61
2020-12-03,South Sudan,36,1,3154,62
2020-12-04,South Sudan,0,0,3154,62
2020-12-05,South Sudan,12,0,3166,62
2020-12-06,South Sudan,15,0,3181,62
2020-12-07,South Sudan,0,0,3181,62
2020-12-08,South Sudan,0,0,3181,62
2020-12-09,South Sudan,0,0,3181,62
2020-12-10,South Sudan,0,0,3181,62
2020-12-11,South Sudan,0,0,3181,62
2020-12-12,South Sudan,25,0,3206,62
2020-12-13,South Sudan,0,0,3206,62
2020-12-14,South Sudan,0,0,3206,62
2020-12-15,South Sudan,16,0,3222,62
2020-12-16,South Sudan,0,0,3222,62
2020-12-17,South Sudan,0,0,3222,62
2020-12-18,South Sudan,6,0,3228,62
2020-12-19,South Sudan,0,0,3228,62
2020-12-20,South Sudan,0,0,3228,62
2020-12-21,South Sudan,6,0,3234,62
2020-12-22,South Sudan,0,0,3234,62
2020-12-23,South Sudan,221,0,3455,62
2020-12-24,South Sudan,0,0,3455,62
2020-12-25,South Sudan,0,0,3455,62
2020-12-26,South Sudan,0,0,3455,62
2020-12-27,South Sudan,35,0,3490,62
2020-12-28,South Sudan,1,0,3491,62
2020-12-29,South Sudan,20,1,3511,63
2020-12-30,South Sudan,29,0,3540,63
2020-12-31,South Sudan,18,0,3558,63
2021-01-01,South Sudan,0,0,3558,63
2021-01-02,South Sudan,0,0,3558,63
2021-01-03,South Sudan,0,0,3558,63
2021-01-04,South Sudan,31,0,3589,63
2021-01-05,South Sudan,0,0,3589,63
2021-01-06,South Sudan,0,0,3589,63
2021-01-07,South Sudan,0,0,3589,63
2021-01-08,South Sudan,0,0,3589,63
2021-01-09,South Sudan,0,0,3589,63
2021-01-10,South Sudan,60,0,3649,63
2021-01-11,South Sudan,13,0,3662,63
2021-01-12,South Sudan,8,0,3670,63
2021-01-13,South Sudan,0,0,3670,63
2021-01-14,South Sudan,0,0,3670,63
2021-01-15,South Sudan,0,0,3670,63
2021-01-16,South Sudan,0,0,3670,63
2021-01-17,South Sudan,23,0,3693,63
2021-01-18,South Sudan,10,0,3703,63
2021-01-19,South Sudan,59,1,3762,64
2021-01-20,South Sudan,11,0,3773,64
2021-01-21,South Sudan,15,0,3788,64
2021-01-22,South Sudan,0,0,3788,64
2021-01-23,South Sudan,0,0,3788,64
2021-01-24,South Sudan,0,0,3788,64
2021-01-25,South Sudan,0,0,3788,64
2021-01-26,South Sudan,0,0,3788,64
2021-01-27,South Sudan,0,0,3788,64
2021-01-28,South Sudan,141,0,3929,64
2021-01-29,South Sudan,0,0,3929,64
2021-01-30,South Sudan,0,0,3929,64
2021-01-31,South Sudan,0,0,3929,64
2021-02-01,South Sudan,0,0,3929,64
2021-02-02,South Sudan,0,0,3929,64
2021-02-03,South Sudan,0,0,3929,64
2021-02-04,South Sudan,338,2,4267,66
2021-02-05,South Sudan,88,0,4355,66
2021-02-06,South Sudan,0,0,4355,66
2021-02-07,South Sudan,0,0,4355,66
2021-02-08,South Sudan,254,0,4609,66
2021-02-09,South Sudan,195,3,4804,69
2021-02-10,South Sudan,156,2,4960,71
2021-02-11,South Sudan,0,0,4960,71
2021-02-12,South Sudan,174,1,5134,72
2021-02-13,South Sudan,176,2,5310,74
2021-02-14,South Sudan,103,0,5413,74
2021-02-15,South Sudan,149,3,5562,77
2021-02-16,South Sudan,148,2,5710,79
2021-02-17,South Sudan,212,0,5922,79
2021-02-18,South Sudan,162,4,6084,83
2021-02-19,South Sudan,193,0,6277,83
2021-02-20,South Sudan,140,2,6417,85
2021-02-21,South Sudan,166,1,6583,86
2021-02-22,South Sudan,348,1,6931,87
2021-02-23,South Sudan,167,0,7098,87
2021-02-24,South Sudan,126,0,7224,87
2021-02-25,South Sudan,125,0,7349,87
2021-02-26,South Sudan,248,3,7597,90
2021-02-27,South Sudan,174,3,7771,93
2021-02-28,South Sudan,155,0,7926,93
2021-03-01,South Sudan,84,1,8010,94
2021-03-02,South Sudan,134,1,8144,95
2021-03-03,South Sudan,161,2,8305,97
2021-03-04,South Sudan,109,3,8414,100
2021-03-05,South Sudan,113,0,8527,100
2021-03-06,South Sudan,150,2,8677,102
2021-03-07,South Sudan,89,0,8766,102
2021-03-08,South Sudan,104,0,8870,102
2021-03-09,South Sudan,0,0,8870,102
2021-03-10,South Sudan,0,0,8870,102
2021-03-11,South Sudan,335,1,9205,103
2021-03-12,South Sudan,129,1,9334,104
2021-03-13,South Sudan,95,0,9429,104
2021-03-14,South Sudan,61,0,9490,104
2021-03-15,South Sudan,64,0,9554,104
2021-03-16,South Sudan,59,2,9613,106
2021-03-17,South Sudan,81,0,9694,106
2021-03-18,South Sudan,74,0,9768,106
2021-03-19,South Sudan,41,0,9809,106
2021-03-20,South Sudan,40,0,9849,106
2021-03-21,South Sudan,30,0,9879,106
2021-03-22,South Sudan,11,0,9890,106
2021-03-23,South Sudan,29,0,9919,106
2021-03-24,South Sudan,50,1,9969,107
2021-03-25,South Sudan,79,1,10048,108
2021-03-26,South Sudan,0,0,10048,108
2021-03-27,South Sudan,31,0,10079,108
2021-03-28,South Sudan,19,0,10098,108
2021-03-29,South Sudan,21,0,10119,108
2021-03-30,South Sudan,0,0,10119,108
2021-03-31,South Sudan,46,1,10165,109
2021-04-01,South Sudan,32,3,10197,112
2021-04-02,South Sudan,22,0,10219,112
2021-04-03,South Sudan,36,0,10255,112
2021-04-04,South Sudan,12,1,10267,113
2021-04-05,South Sudan,14,0,10281,113
2021-04-06,South Sudan,5,0,10286,113
2021-04-07,South Sudan,11,0,10297,113
2021-04-08,South Sudan,27,1,10324,114
2020-02-01,Spain,1,0,1,0
2020-02-02,Spain,0,0,1,0
2020-02-03,Spain,0,0,1,0
2020-02-04,Spain,0,0,1,0
2020-02-05,Spain,0,0,1,0
2020-02-06,Spain,0,0,1,0
2020-02-07,Spain,0,0,1,0
2020-02-08,Spain,0,0,1,0
2020-02-09,Spain,1,0,2,0
2020-02-10,Spain,0,0,2,0
2020-02-11,Spain,0,0,2,0
2020-02-12,Spain,0,0,2,0
2020-02-13,Spain,0,0,2,0
2020-02-14,Spain,0,0,2,0
2020-02-15,Spain,0,0,2,0
2020-02-16,Spain,0,0,2,0
2020-02-17,Spain,0,0,2,0
2020-02-18,Spain,0,0,2,0
2020-02-19,Spain,0,0,2,0
2020-02-20,Spain,0,0,2,0
2020-02-21,Spain,0,0,2,0
2020-02-22,Spain,0,0,2,0
2020-02-23,Spain,0,0,2,0
2020-02-24,Spain,0,0,2,0
2020-02-25,Spain,4,0,6,0
2020-02-26,Spain,7,0,13,0
2020-02-27,Spain,2,0,15,0
2020-02-28,Spain,17,0,32,0
2020-02-29,Spain,13,0,45,0
2020-03-01,Spain,39,0,84,0
2020-03-02,Spain,36,0,120,0
2020-03-03,Spain,45,1,165,1
2020-03-04,Spain,57,1,222,2
2020-03-05,Spain,37,1,259,3
2020-03-06,Spain,141,2,400,5
2020-03-07,Spain,100,5,500,10
2020-03-08,Spain,173,7,673,17
2020-03-09,Spain,400,11,1073,28
2020-03-10,Spain,622,7,1695,35
2020-03-11,Spain,582,19,2277,54
2020-03-12,Spain,0,1,2277,55
2020-03-13,Spain,2955,78,5232,133
2020-03-14,Spain,1159,62,6391,195
2020-03-15,Spain,1407,94,7798,289
2020-03-16,Spain,2144,53,9942,342
2020-03-17,Spain,1806,191,11748,533
2020-03-18,Spain,2162,90,13910,623
2020-03-19,Spain,4053,207,17963,830
2020-03-20,Spain,2447,213,20410,1043
2020-03-21,Spain,4964,332,25374,1375
2020-03-22,Spain,3394,397,28768,1772
2020-03-23,Spain,6368,539,35136,2311
2020-03-24,Spain,4749,497,39885,2808
2020-03-25,Spain,9630,839,49515,3647
2020-03-26,Spain,8271,718,57786,4365
2020-03-27,Spain,7933,773,65719,5138
2020-03-28,Spain,7516,844,73235,5982
2020-03-29,Spain,6875,821,80110,6803
2020-03-30,Spain,7846,913,87956,7716
2020-03-31,Spain,7967,748,95923,8464
2020-04-01,Spain,8195,923,104118,9387
2020-04-02,Spain,7947,961,112065,10348
2020-04-03,Spain,7134,850,119199,11198
2020-04-04,Spain,6969,749,126168,11947
2020-04-05,Spain,5478,694,131646,12641
2020-04-06,Spain,5029,700,136675,13341
2020-04-07,Spain,5267,704,141942,14045
2020-04-08,Spain,6278,747,148220,14792
2020-04-09,Spain,5002,655,153222,15447
2020-04-10,Spain,5051,634,158273,16081
2020-04-11,Spain,4754,525,163027,16606
2020-04-12,Spain,3804,603,166831,17209
2020-04-13,Spain,3268,547,170099,17756
2020-04-14,Spain,2442,300,172541,18056
2020-04-15,Spain,5103,652,177644,18708
2020-04-16,Spain,7304,607,184948,19315
2020-04-17,Spain,5891,687,190839,20002
2020-04-18,Spain,887,41,191726,20043
2020-04-19,Spain,6948,410,198674,20453
2020-04-20,Spain,1536,399,200210,20852
2020-04-21,Spain,3968,430,204178,21282
2020-04-22,Spain,4211,435,208389,21717
2020-04-23,Spain,4635,440,213024,22157
2020-04-24,Spain,-10034,367,202990,22524
2020-04-25,Spain,2915,378,205905,22902
2020-04-26,Spain,1729,288,207634,23190
2020-04-27,Spain,1831,331,209465,23521
2020-04-28,Spain,1308,301,210773,23822
2020-04-29,Spain,2144,453,212917,24275
2020-04-30,Spain,518,268,213435,24543
2020-05-01,Spain,1781,0,215216,24543
2020-05-02,Spain,1366,557,216582,25100
2020-05-03,Spain,884,164,217466,25264
2020-05-04,Spain,545,164,218011,25428
2020-05-05,Spain,1318,185,219329,25613
2020-05-06,Spain,996,244,220325,25857
2020-05-07,Spain,1122,213,221447,26070
2020-05-08,Spain,1410,229,222857,26299
2020-05-09,Spain,721,179,223578,26478
2020-05-10,Spain,772,143,224350,26621
2020-05-11,Spain,3086,123,227436,26744
2020-05-12,Spain,594,176,228030,26920
2020-05-13,Spain,661,184,228691,27104
2020-05-14,Spain,849,217,229540,27321
2020-05-15,Spain,643,138,230183,27459
2020-05-16,Spain,515,104,230698,27563
2020-05-17,Spain,0,0,230698,27563
2020-05-18,Spain,908,146,231606,27709
2020-05-19,Spain,431,69,232037,27778
2020-05-20,Spain,518,110,232555,27888
2020-05-21,Spain,482,52,233037,27940
2020-05-22,Spain,1787,688,234824,28628
2020-05-23,Spain,466,50,235290,28678
2020-05-24,Spain,482,74,235772,28752
2020-05-25,Spain,-372,-1918,235400,26834
2020-05-26,Spain,859,283,236259,27117
2020-05-27,Spain,0,0,236259,27117
2020-05-28,Spain,1647,2,237906,27119
2020-05-29,Spain,658,2,238564,27121
2020-05-30,Spain,664,4,239228,27125
2020-05-31,Spain,251,2,239479,27127
2020-06-01,Spain,159,0,239638,27127
2020-06-02,Spain,294,0,239932,27127
2020-06-03,Spain,394,1,240326,27128
2020-06-04,Spain,334,5,240660,27133
2020-06-05,Spain,318,1,240978,27134
2020-06-06,Spain,332,1,241310,27135
2020-06-07,Spain,240,1,241550,27136
2020-06-08,Spain,167,0,241717,27136
2020-06-09,Spain,249,0,241966,27136
2020-06-10,Spain,314,0,242280,27136
2020-06-11,Spain,427,0,242707,27136
2020-06-12,Spain,502,0,243209,27136
2020-06-13,Spain,396,0,243605,27136
2020-06-14,Spain,323,0,243928,27136
2020-06-15,Spain,181,0,244109,27136
2020-06-16,Spain,219,0,244328,27136
2020-06-17,Spain,355,0,244683,27136
2020-06-18,Spain,585,0,245268,27136
2020-06-19,Spain,307,1179,245575,28315
2020-06-20,Spain,363,7,245938,28322
2020-06-21,Spain,334,1,246272,28323
2020-06-22,Spain,232,1,246504,28324
2020-06-23,Spain,248,1,246752,28325
2020-06-24,Spain,334,2,247086,28327
2020-06-25,Spain,400,3,247486,28330
2020-06-26,Spain,419,8,247905,28338
2020-06-27,Spain,564,3,248469,28341
2020-06-28,Spain,301,2,248770,28343
2020-06-29,Spain,200,3,248970,28346
2020-06-30,Spain,301,9,249271,28355
2020-07-01,Spain,388,9,249659,28364
2020-07-02,Spain,444,4,250103,28368
2020-07-03,Spain,442,17,250545,28385
2020-07-04,Spain,0,0,250545,28385
2020-07-05,Spain,0,0,250545,28385
2020-07-06,Spain,1244,3,251789,28388
2020-07-07,Spain,341,4,252130,28392
2020-07-08,Spain,383,4,252513,28396
2020-07-09,Spain,543,5,253056,28401
2020-07-10,Spain,852,2,253908,28403
2020-07-11,Spain,0,0,253908,28403
2020-07-12,Spain,0,0,253908,28403
2020-07-13,Spain,2045,3,255953,28406
2020-07-14,Spain,666,3,256619,28409
2020-07-15,Spain,875,4,257494,28413
2020-07-16,Spain,1361,3,258855,28416
2020-07-17,Spain,1400,4,260255,28420
2020-07-18,Spain,0,0,260255,28420
2020-07-19,Spain,0,0,260255,28420
2020-07-20,Spain,4581,2,264836,28422
2020-07-21,Spain,1358,2,266194,28424
2020-07-22,Spain,1357,2,267551,28426
2020-07-23,Spain,2615,3,270166,28429
2020-07-24,Spain,2255,3,272421,28432
2020-07-25,Spain,0,0,272421,28432
2020-07-26,Spain,0,0,272421,28432
2020-07-27,Spain,6361,2,278782,28434
2020-07-28,Spain,1828,2,280610,28436
2020-07-29,Spain,2031,5,282641,28441
2020-07-30,Spain,2789,2,285430,28443
2020-07-31,Spain,3092,2,288522,28445
2020-08-01,Spain,0,0,288522,28445
2020-08-02,Spain,0,0,288522,28445
2020-08-03,Spain,8532,27,297054,28472
2020-08-04,Spain,5760,26,302814,28498
2020-08-05,Spain,2953,1,305767,28499
2020-08-06,Spain,4088,1,309855,28500
2020-08-07,Spain,4507,3,314362,28503
2020-08-08,Spain,0,0,314362,28503
2020-08-09,Spain,0,0,314362,28503
2020-08-10,Spain,8618,73,322980,28576
2020-08-11,Spain,3632,5,326612,28581
2020-08-12,Spain,3172,-2,329784,28579
2020-08-13,Spain,7550,26,337334,28605
2020-08-14,Spain,5479,12,342813,28617
2020-08-15,Spain,0,0,342813,28617
2020-08-16,Spain,0,0,342813,28617
2020-08-17,Spain,16269,29,359082,28646
2020-08-18,Spain,5114,24,364196,28670
2020-08-19,Spain,6671,127,370867,28797
2020-08-20,Spain,7039,16,377906,28813
2020-08-21,Spain,8148,25,386054,28838
2020-08-22,Spain,0,0,386054,28838
2020-08-23,Spain,0,0,386054,28838
2020-08-24,Spain,19382,34,405436,28872
2020-08-25,Spain,7117,52,412553,28924
2020-08-26,Spain,7296,47,419849,28971
2020-08-27,Spain,9658,25,429507,28996
2020-08-28,Spain,9779,15,439286,29011
2020-08-29,Spain,0,0,439286,29011
2020-08-30,Spain,0,0,439286,29011
2020-08-31,Spain,23572,83,462858,29094
2020-09-01,Spain,8115,58,470973,29152
2020-09-02,Spain,8581,42,479554,29194
2020-09-03,Spain,8959,40,488513,29234
2020-09-04,Spain,10476,184,498989,29418
2020-09-05,Spain,0,0,498989,29418
2020-09-06,Spain,0,0,498989,29418
2020-09-07,Spain,26560,98,525549,29516
2020-09-08,Spain,8964,78,534513,29594
2020-09-09,Spain,8866,34,543379,29628
2020-09-10,Spain,10764,71,554143,29699
2020-09-11,Spain,12183,48,566326,29747
2020-09-12,Spain,0,0,566326,29747
2020-09-13,Spain,0,0,566326,29747
2020-09-14,Spain,27404,101,593730,29848
2020-09-15,Spain,9437,156,603167,30004
2020-09-16,Spain,11193,239,614360,30243
2020-09-17,Spain,11291,162,625651,30405
2020-09-18,Spain,14389,90,640040,30495
2020-09-19,Spain,0,0,640040,30495
2020-09-20,Spain,0,0,640040,30495
2020-09-21,Spain,31428,168,671468,30663
2020-09-22,Spain,10799,241,682267,30904
2020-09-23,Spain,11289,130,693556,31034
2020-09-24,Spain,10653,84,704209,31118
2020-09-25,Spain,12272,114,716481,31232
2020-09-26,Spain,0,0,716481,31232
2020-09-27,Spain,0,0,716481,31232
2020-09-28,Spain,31785,179,748266,31411
2020-09-29,Spain,0,0,748266,31411
2020-09-30,Spain,20922,380,769188,31791
2020-10-01,Spain,9419,182,778607,31973
2020-10-02,Spain,11325,113,789932,32086
2020-10-03,Spain,0,0,789932,32086
2020-10-04,Spain,0,0,789932,32086
2020-10-05,Spain,23480,139,813412,32225
2020-10-06,Spain,11998,261,825410,32486
2020-10-07,Spain,10491,76,835901,32562
2020-10-08,Spain,12423,126,848324,32688
2020-10-09,Spain,12788,241,861112,32929
2020-10-10,Spain,0,0,861112,32929
2020-10-11,Spain,0,0,861112,32929
2020-10-12,Spain,27856,195,888968,33124
2020-10-13,Spain,7118,80,896086,33204
2020-10-14,Spain,11970,209,908056,33413
2020-10-15,Spain,13318,140,921374,33553
2020-10-16,Spain,15186,222,936560,33775
2020-10-17,Spain,0,0,936560,33775
2020-10-18,Spain,0,0,936560,33775
2020-10-19,Spain,37889,217,974449,33992
2020-10-20,Spain,13873,218,988322,34210
2020-10-21,Spain,16973,156,1005295,34366
2020-10-22,Spain,20986,155,1026281,34521
2020-10-23,Spain,19851,231,1046132,34752
2020-10-24,Spain,0,0,1046132,34752
2020-10-25,Spain,0,0,1046132,34752
2020-10-26,Spain,52188,279,1098320,35031
2020-10-27,Spain,18418,267,1116738,35298
2020-10-28,Spain,19765,168,1136503,35466
2020-10-29,Spain,23580,173,1160083,35639
2020-10-30,Spain,25595,239,1185678,35878
2020-10-31,Spain,0,0,1185678,35878
2020-11-01,Spain,0,0,1185678,35878
2020-11-02,Spain,55019,379,1240697,36257
2020-11-03,Spain,18669,238,1259366,36495
2020-11-04,Spain,25042,1623,1284408,38118
2020-11-05,Spain,21908,368,1306316,38486
2020-11-06,Spain,22516,347,1328832,38833
2020-11-07,Spain,0,0,1328832,38833
2020-11-08,Spain,0,0,1328832,38833
2020-11-09,Spain,52386,512,1381218,39345
2020-11-10,Spain,0,0,1381218,39345
2020-11-11,Spain,36491,760,1417709,40105
2020-11-12,Spain,19511,356,1437220,40461
2020-11-13,Spain,21371,308,1458591,40769
2020-11-14,Spain,0,0,1458591,40769
2020-11-15,Spain,0,0,1458591,40769
2020-11-16,Spain,38273,484,1496864,41253
2020-11-17,Spain,13159,435,1510023,41688
2020-11-18,Spain,15318,351,1525341,42039
2020-11-19,Spain,16233,252,1541574,42291
2020-11-20,Spain,15156,328,1556730,42619
2020-11-21,Spain,0,0,1556730,42619
2020-11-22,Spain,0,0,1556730,42619
2020-11-23,Spain,25886,512,1582616,43131
2020-11-24,Spain,12228,537,1594844,43668
2020-11-25,Spain,10222,369,1605066,44037
2020-11-26,Spain,12289,337,1617355,44374
2020-11-27,Spain,10853,294,1628208,44668
2020-11-28,Spain,0,0,1628208,44668
2020-11-29,Spain,0,0,1628208,44668
2020-11-30,Spain,19979,401,1648187,45069
2020-12-01,Spain,8257,442,1656444,45511
2020-12-02,Spain,9331,273,1665775,45784
2020-12-03,Spain,10127,254,1675902,46038
2020-12-04,Spain,8745,214,1684647,46252
2020-12-05,Spain,0,0,1684647,46252
2020-12-06,Spain,0,0,1684647,46252
2020-12-07,Spain,17681,394,1702328,46646
2020-12-08,Spain,0,0,1702328,46646
2020-12-09,Spain,9773,373,1712101,47019
2020-12-10,Spain,7955,325,1720056,47344
2020-12-11,Spain,10519,280,1730575,47624
2020-12-12,Spain,0,0,1730575,47624
2020-12-13,Spain,0,0,1730575,47624
2020-12-14,Spain,21309,389,1751884,48013
2020-12-15,Spain,10328,388,1762212,48401
2020-12-16,Spain,11078,195,1773290,48596
2020-12-17,Spain,12131,181,1785421,48777
2020-12-18,Spain,11815,149,1797236,48926
2020-12-19,Spain,0,0,1797236,48926
2020-12-20,Spain,0,0,1797236,48926
2020-12-21,Spain,22013,334,1819249,49260
2020-12-22,Spain,10654,260,1829903,49520
2020-12-23,Spain,12386,178,1842289,49698
2020-12-24,Spain,12662,126,1854951,49824
2020-12-25,Spain,0,0,1854951,49824
2020-12-26,Spain,0,0,1854951,49824
2020-12-27,Spain,0,0,1854951,49824
2020-12-28,Spain,24462,298,1879413,50122
2020-12-29,Spain,14089,320,1893502,50442
2020-12-30,Spain,16716,247,1910218,50689
2020-12-31,Spain,18047,148,1928265,50837
2021-01-01,Spain,0,0,1928265,50837
2021-01-02,Spain,0,0,1928265,50837
2021-01-03,Spain,0,0,1928265,50837
2021-01-04,Spain,30579,241,1958844,51078
2021-01-05,Spain,23700,352,1982544,51430
2021-01-06,Spain,0,0,1982544,51430
2021-01-07,Spain,42360,245,2024904,51675
2021-01-08,Spain,25456,199,2050360,51874
2021-01-09,Spain,0,0,2050360,51874
2021-01-10,Spain,0,0,2050360,51874
2021-01-11,Spain,61422,401,2111782,52275
2021-01-12,Spain,25438,408,2137220,52683
2021-01-13,Spain,38869,195,2176089,52878
2021-01-14,Spain,35878,201,2211967,53079
2021-01-15,Spain,40197,235,2252164,53314
2021-01-16,Spain,0,0,2252164,53314
2021-01-17,Spain,0,0,2252164,53314
2021-01-18,Spain,84287,455,2336451,53769
2021-01-19,Spain,34291,404,2370742,54173
2021-01-20,Spain,41576,464,2412318,54637
2021-01-21,Spain,44357,404,2456675,55041
2021-01-22,Spain,42885,400,2499560,55441
2021-01-23,Spain,0,0,2499560,55441
2021-01-24,Spain,0,0,2499560,55441
2021-01-25,Spain,93822,767,2593382,56208
2021-01-26,Spain,36435,586,2629817,56794
2021-01-27,Spain,40285,497,2670102,57291
2021-01-28,Spain,34899,515,2705001,57806
2021-01-29,Spain,38118,513,2743119,58319
2021-01-30,Spain,0,0,2743119,58319
2021-01-31,Spain,0,0,2743119,58319
2021-02-01,Spain,79686,762,2822805,59081
2021-02-02,Spain,29064,724,2851869,59805
2021-02-03,Spain,31596,565,2883465,60370
2021-02-04,Spain,29960,432,2913425,60802
2021-02-05,Spain,28565,584,2941990,61386
2021-02-06,Spain,0,0,2941990,61386
2021-02-07,Spain,0,0,2941990,61386
2021-02-08,Spain,47095,909,2989085,62295
2021-02-09,Spain,16402,766,3005487,63061
2021-02-10,Spain,18114,643,3023601,63704
2021-02-11,Spain,17853,513,3041454,64217
2021-02-12,Spain,14581,530,3056035,64747
2021-02-13,Spain,0,0,3056035,64747
2021-02-14,Spain,0,0,3056035,64747
2021-02-15,Spain,30251,702,3086286,65449
2021-02-16,Spain,10057,530,3096343,65979
2021-02-17,Spain,10829,337,3107172,66316
2021-02-18,Spain,14515,388,3121687,66704
2021-02-19,Spain,11435,397,3133122,67101
2021-02-20,Spain,0,0,3133122,67101
2021-02-21,Spain,0,0,3133122,67101
2021-02-22,Spain,20849,535,3153971,67636
2021-02-23,Spain,7461,443,3161432,68079
2021-02-24,Spain,9212,389,3170644,68468
2021-02-25,Spain,9568,345,3180212,68813
2021-02-26,Spain,8341,329,3188553,69142
2021-02-27,Spain,0,0,3188553,69142
2021-02-28,Spain,0,0,3188553,69142
2021-03-01,Spain,15978,467,3204531,69609
2021-03-02,Spain,-74347,192,3130184,69801
2021-03-03,Spain,6137,446,3136321,70247
2021-03-04,Spain,6037,254,3142358,70501
2021-03-05,Spain,6654,637,3149012,71138
2021-03-06,Spain,0,0,3149012,71138
2021-03-07,Spain,0,0,3149012,71138
2021-03-08,Spain,11958,298,3160970,71436
2021-03-09,Spain,4012,291,3164982,71727
2021-03-10,Spain,7119,234,3172101,71961
2021-03-11,Spain,6255,124,3178356,72085
2021-03-12,Spain,5348,173,3183704,72258
2021-03-13,Spain,0,0,3183704,72258
2021-03-14,Spain,0,0,3183704,72258
2021-03-15,Spain,11358,166,3195062,72424
2021-03-16,Spain,4962,141,3200024,72565
2021-03-17,Spain,6092,228,3206116,72793
2021-03-18,Spain,6216,117,3212332,72910
2021-03-19,Spain,0,0,3212332,72910
2021-03-20,Spain,0,0,3212332,72910
2021-03-21,Spain,0,0,3212332,72910
2021-03-22,Spain,16471,633,3228803,73543
2021-03-23,Spain,5516,201,3234319,73744
2021-03-24,Spain,0,0,3234319,73744
2021-03-25,Spain,13419,676,3247738,74420
2021-03-26,Spain,7586,590,3255324,75010
2021-03-27,Spain,0,0,3255324,75010
2021-03-28,Spain,0,0,3255324,75010
2021-03-29,Spain,15501,189,3270825,75199
2021-03-30,Spain,4994,106,3275819,75305
2021-03-31,Spain,8534,154,3284353,75459
2021-04-01,Spain,7041,82,3291394,75541
2021-04-02,Spain,0,0,3291394,75541
2021-04-03,Spain,9571,157,3300965,75698
2021-04-04,Spain,0,0,3300965,75698
2021-04-05,Spain,10360,85,3311325,75783
2021-04-06,Spain,6623,128,3317948,75911
2021-04-07,Spain,8788,126,3326736,76037
2021-04-08,Spain,9901,142,3336637,76179
2020-01-27,Sri Lanka,1,0,1,0
2020-01-28,Sri Lanka,0,0,1,0
2020-01-29,Sri Lanka,0,0,1,0
2020-01-30,Sri Lanka,0,0,1,0
2020-01-31,Sri Lanka,0,0,1,0
2020-02-01,Sri Lanka,0,0,1,0
2020-02-02,Sri Lanka,0,0,1,0
2020-02-03,Sri Lanka,0,0,1,0
2020-02-04,Sri Lanka,0,0,1,0
2020-02-05,Sri Lanka,0,0,1,0
2020-02-06,Sri Lanka,0,0,1,0
2020-02-07,Sri Lanka,0,0,1,0
2020-02-08,Sri Lanka,0,0,1,0
2020-02-09,Sri Lanka,0,0,1,0
2020-02-10,Sri Lanka,0,0,1,0
2020-02-11,Sri Lanka,0,0,1,0
2020-02-12,Sri Lanka,0,0,1,0
2020-02-13,Sri Lanka,0,0,1,0
2020-02-14,Sri Lanka,0,0,1,0
2020-02-15,Sri Lanka,0,0,1,0
2020-02-16,Sri Lanka,0,0,1,0
2020-02-17,Sri Lanka,0,0,1,0
2020-02-18,Sri Lanka,0,0,1,0
2020-02-19,Sri Lanka,0,0,1,0
2020-02-20,Sri Lanka,0,0,1,0
2020-02-21,Sri Lanka,0,0,1,0
2020-02-22,Sri Lanka,0,0,1,0
2020-02-23,Sri Lanka,0,0,1,0
2020-02-24,Sri Lanka,0,0,1,0
2020-02-25,Sri Lanka,0,0,1,0
2020-02-26,Sri Lanka,0,0,1,0
2020-02-27,Sri Lanka,0,0,1,0
2020-02-28,Sri Lanka,0,0,1,0
2020-02-29,Sri Lanka,0,0,1,0
2020-03-01,Sri Lanka,0,0,1,0
2020-03-02,Sri Lanka,0,0,1,0
2020-03-03,Sri Lanka,0,0,1,0
2020-03-04,Sri Lanka,0,0,1,0
2020-03-05,Sri Lanka,0,0,1,0
2020-03-06,Sri Lanka,0,0,1,0
2020-03-07,Sri Lanka,0,0,1,0
2020-03-08,Sri Lanka,0,0,1,0
2020-03-09,Sri Lanka,0,0,1,0
2020-03-10,Sri Lanka,0,0,1,0
2020-03-11,Sri Lanka,1,0,2,0
2020-03-12,Sri Lanka,0,0,2,0
2020-03-13,Sri Lanka,4,0,6,0
2020-03-14,Sri Lanka,4,0,10,0
2020-03-15,Sri Lanka,8,0,18,0
2020-03-16,Sri Lanka,10,0,28,0
2020-03-17,Sri Lanka,16,0,44,0
2020-03-18,Sri Lanka,7,0,51,0
2020-03-19,Sri Lanka,9,0,60,0
2020-03-20,Sri Lanka,13,0,73,0
2020-03-21,Sri Lanka,4,0,77,0
2020-03-22,Sri Lanka,5,0,82,0
2020-03-23,Sri Lanka,15,0,97,0
2020-03-24,Sri Lanka,5,0,102,0
2020-03-25,Sri Lanka,0,0,102,0
2020-03-26,Sri Lanka,4,0,106,0
2020-03-27,Sri Lanka,0,0,106,0
2020-03-28,Sri Lanka,7,1,113,1
2020-03-29,Sri Lanka,4,0,117,1
2020-03-30,Sri Lanka,5,1,122,2
2020-03-31,Sri Lanka,21,0,143,2
2020-04-01,Sri Lanka,3,1,146,3
2020-04-02,Sri Lanka,5,1,151,4
2020-04-03,Sri Lanka,8,0,159,4
2020-04-04,Sri Lanka,7,1,166,5
2020-04-05,Sri Lanka,10,0,176,5
2020-04-06,Sri Lanka,2,0,178,5
2020-04-07,Sri Lanka,7,1,185,6
2020-04-08,Sri Lanka,4,1,189,7
2020-04-09,Sri Lanka,1,0,190,7
2020-04-10,Sri Lanka,0,0,190,7
2020-04-11,Sri Lanka,8,0,198,7
2020-04-12,Sri Lanka,12,0,210,7
2020-04-13,Sri Lanka,7,0,217,7
2020-04-14,Sri Lanka,16,0,233,7
2020-04-15,Sri Lanka,5,0,238,7
2020-04-16,Sri Lanka,0,0,238,7
2020-04-17,Sri Lanka,6,0,244,7
2020-04-18,Sri Lanka,10,0,254,7
2020-04-19,Sri Lanka,17,0,271,7
2020-04-20,Sri Lanka,33,0,304,7
2020-04-21,Sri Lanka,6,0,310,7
2020-04-22,Sri Lanka,20,0,330,7
2020-04-23,Sri Lanka,38,0,368,7
2020-04-24,Sri Lanka,52,0,420,7
2020-04-25,Sri Lanka,40,0,460,7
2020-04-26,Sri Lanka,63,0,523,7
2020-04-27,Sri Lanka,65,0,588,7
2020-04-28,Sri Lanka,31,0,619,7
2020-04-29,Sri Lanka,30,0,649,7
2020-04-30,Sri Lanka,14,0,663,7
2020-05-01,Sri Lanka,27,0,690,7
2020-05-02,Sri Lanka,15,0,705,7
2020-05-03,Sri Lanka,13,0,718,7
2020-05-04,Sri Lanka,33,1,751,8
2020-05-05,Sri Lanka,20,1,771,9
2020-05-06,Sri Lanka,26,0,797,9
2020-05-07,Sri Lanka,27,0,824,9
2020-05-08,Sri Lanka,11,0,835,9
2020-05-09,Sri Lanka,12,0,847,9
2020-05-10,Sri Lanka,16,0,863,9
2020-05-11,Sri Lanka,6,0,869,9
2020-05-12,Sri Lanka,20,0,889,9
2020-05-13,Sri Lanka,26,0,915,9
2020-05-14,Sri Lanka,10,0,925,9
2020-05-15,Sri Lanka,10,0,935,9
2020-05-16,Sri Lanka,25,0,960,9
2020-05-17,Sri Lanka,21,0,981,9
2020-05-18,Sri Lanka,11,0,992,9
2020-05-19,Sri Lanka,35,0,1027,9
2020-05-20,Sri Lanka,1,0,1028,9
2020-05-21,Sri Lanka,27,0,1055,9
2020-05-22,Sri Lanka,13,0,1068,9
2020-05-23,Sri Lanka,21,0,1089,9
2020-05-24,Sri Lanka,52,0,1141,9
2020-05-25,Sri Lanka,41,1,1182,10
2020-05-26,Sri Lanka,137,0,1319,10
2020-05-27,Sri Lanka,150,0,1469,10
2020-05-28,Sri Lanka,61,0,1530,10
2020-05-29,Sri Lanka,28,0,1558,10
2020-05-30,Sri Lanka,62,0,1620,10
2020-05-31,Sri Lanka,13,0,1633,10
2020-06-01,Sri Lanka,10,1,1643,11
2020-06-02,Sri Lanka,40,0,1683,11
2020-06-03,Sri Lanka,66,0,1749,11
2020-06-04,Sri Lanka,48,0,1797,11
2020-06-05,Sri Lanka,4,0,1801,11
2020-06-06,Sri Lanka,13,0,1814,11
2020-06-07,Sri Lanka,21,0,1835,11
2020-06-08,Sri Lanka,22,0,1857,11
2020-06-09,Sri Lanka,2,0,1859,11
2020-06-10,Sri Lanka,10,0,1869,11
2020-06-11,Sri Lanka,8,0,1877,11
2020-06-12,Sri Lanka,3,0,1880,11
2020-06-13,Sri Lanka,4,0,1884,11
2020-06-14,Sri Lanka,5,0,1889,11
2020-06-15,Sri Lanka,16,0,1905,11
2020-06-16,Sri Lanka,10,0,1915,11
2020-06-17,Sri Lanka,9,0,1924,11
2020-06-18,Sri Lanka,23,0,1947,11
2020-06-19,Sri Lanka,3,0,1950,11
2020-06-20,Sri Lanka,0,0,1950,11
2020-06-21,Sri Lanka,0,0,1950,11
2020-06-22,Sri Lanka,1,0,1951,11
2020-06-23,Sri Lanka,40,0,1991,11
2020-06-24,Sri Lanka,10,0,2001,11
2020-06-25,Sri Lanka,9,0,2010,11
2020-06-26,Sri Lanka,4,0,2014,11
2020-06-27,Sri Lanka,19,0,2033,11
2020-06-28,Sri Lanka,4,0,2037,11
2020-06-29,Sri Lanka,2,0,2039,11
2020-06-30,Sri Lanka,8,0,2047,11
2020-07-01,Sri Lanka,7,0,2054,11
2020-07-02,Sri Lanka,12,0,2066,11
2020-07-03,Sri Lanka,3,0,2069,11
2020-07-04,Sri Lanka,5,0,2074,11
2020-07-05,Sri Lanka,2,0,2076,11
2020-07-06,Sri Lanka,1,0,2077,11
2020-07-07,Sri Lanka,4,0,2081,11
2020-07-08,Sri Lanka,13,0,2094,11
2020-07-09,Sri Lanka,60,0,2154,11
2020-07-10,Sri Lanka,300,0,2454,11
2020-07-11,Sri Lanka,57,0,2511,11
2020-07-12,Sri Lanka,106,0,2617,11
2020-07-13,Sri Lanka,29,0,2646,11
2020-07-14,Sri Lanka,19,0,2665,11
2020-07-15,Sri Lanka,6,0,2671,11
2020-07-16,Sri Lanka,16,0,2687,11
2020-07-17,Sri Lanka,10,0,2697,11
2020-07-18,Sri Lanka,6,0,2703,11
2020-07-19,Sri Lanka,21,0,2724,11
2020-07-20,Sri Lanka,6,0,2730,11
2020-07-21,Sri Lanka,0,0,2730,11
2020-07-22,Sri Lanka,22,0,2752,11
2020-07-23,Sri Lanka,1,0,2753,11
2020-07-24,Sri Lanka,11,0,2764,11
2020-07-25,Sri Lanka,6,0,2770,11
2020-07-26,Sri Lanka,12,0,2782,11
2020-07-27,Sri Lanka,23,0,2805,11
2020-07-28,Sri Lanka,5,0,2810,11
2020-07-29,Sri Lanka,0,0,2810,11
2020-07-30,Sri Lanka,4,0,2814,11
2020-07-31,Sri Lanka,1,0,2815,11
2020-08-01,Sri Lanka,0,0,2815,11
2020-08-02,Sri Lanka,8,0,2823,11
2020-08-03,Sri Lanka,5,0,2828,11
2020-08-04,Sri Lanka,6,0,2834,11
2020-08-05,Sri Lanka,5,0,2839,11
2020-08-06,Sri Lanka,0,0,2839,11
2020-08-07,Sri Lanka,0,0,2839,11
2020-08-08,Sri Lanka,2,0,2841,11
2020-08-09,Sri Lanka,3,0,2844,11
2020-08-10,Sri Lanka,27,0,2871,11
2020-08-11,Sri Lanka,9,0,2880,11
2020-08-12,Sri Lanka,1,0,2881,11
2020-08-13,Sri Lanka,1,0,2882,11
2020-08-14,Sri Lanka,4,0,2886,11
2020-08-15,Sri Lanka,4,0,2890,11
2020-08-16,Sri Lanka,3,0,2893,11
2020-08-17,Sri Lanka,7,0,2900,11
2020-08-18,Sri Lanka,2,0,2902,11
2020-08-19,Sri Lanka,0,0,2902,11
2020-08-20,Sri Lanka,16,0,2918,11
2020-08-21,Sri Lanka,23,0,2941,11
2020-08-22,Sri Lanka,6,1,2947,12
2020-08-23,Sri Lanka,6,0,2953,12
2020-08-24,Sri Lanka,6,0,2959,12
2020-08-25,Sri Lanka,12,0,2971,12
2020-08-26,Sri Lanka,13,0,2984,12
2020-08-27,Sri Lanka,2,0,2986,12
2020-08-28,Sri Lanka,3,0,2989,12
2020-08-29,Sri Lanka,6,0,2995,12
2020-08-30,Sri Lanka,17,0,3012,12
2020-08-31,Sri Lanka,37,0,3049,12
2020-09-01,Sri Lanka,43,0,3092,12
2020-09-02,Sri Lanka,9,0,3101,12
2020-09-03,Sri Lanka,10,0,3111,12
2020-09-04,Sri Lanka,4,0,3115,12
2020-09-05,Sri Lanka,6,0,3121,12
2020-09-06,Sri Lanka,2,0,3123,12
2020-09-07,Sri Lanka,0,0,3123,12
2020-09-08,Sri Lanka,17,0,3140,12
2020-09-09,Sri Lanka,7,0,3147,12
2020-09-10,Sri Lanka,8,0,3155,12
2020-09-11,Sri Lanka,14,0,3169,12
2020-09-12,Sri Lanka,26,0,3195,12
2020-09-13,Sri Lanka,39,0,3234,12
2020-09-14,Sri Lanka,28,1,3262,13
2020-09-15,Sri Lanka,9,0,3271,13
2020-09-16,Sri Lanka,0,0,3271,13
2020-09-17,Sri Lanka,5,0,3276,13
2020-09-18,Sri Lanka,5,0,3281,13
2020-09-19,Sri Lanka,2,0,3283,13
2020-09-20,Sri Lanka,4,0,3287,13
2020-09-21,Sri Lanka,12,0,3299,13
2020-09-22,Sri Lanka,14,0,3313,13
2020-09-23,Sri Lanka,11,0,3324,13
2020-09-24,Sri Lanka,9,0,3333,13
2020-09-25,Sri Lanka,12,0,3345,13
2020-09-26,Sri Lanka,4,0,3349,13
2020-09-27,Sri Lanka,11,0,3360,13
2020-09-28,Sri Lanka,3,0,3363,13
2020-09-29,Sri Lanka,11,0,3374,13
2020-09-30,Sri Lanka,6,0,3380,13
2020-10-01,Sri Lanka,2,0,3382,13
2020-10-02,Sri Lanka,6,0,3388,13
2020-10-03,Sri Lanka,7,0,3395,13
2020-10-04,Sri Lanka,7,0,3402,13
2020-10-05,Sri Lanka,111,0,3513,13
2020-10-06,Sri Lanka,739,0,4252,13
2020-10-07,Sri Lanka,207,0,4459,13
2020-10-08,Sri Lanka,29,0,4488,13
2020-10-09,Sri Lanka,35,0,4523,13
2020-10-10,Sri Lanka,105,0,4628,13
2020-10-11,Sri Lanka,124,0,4752,13
2020-10-12,Sri Lanka,92,0,4844,13
2020-10-13,Sri Lanka,194,0,5038,13
2020-10-14,Sri Lanka,132,0,5170,13
2020-10-15,Sri Lanka,74,0,5244,13
2020-10-16,Sri Lanka,110,0,5354,13
2020-10-17,Sri Lanka,121,0,5475,13
2020-10-18,Sri Lanka,63,0,5538,13
2020-10-19,Sri Lanka,87,0,5625,13
2020-10-20,Sri Lanka,186,0,5811,13
2020-10-21,Sri Lanka,167,0,5978,13
2020-10-22,Sri Lanka,309,1,6287,14
2020-10-23,Sri Lanka,866,0,7153,14
2020-10-24,Sri Lanka,368,1,7521,15
2020-10-25,Sri Lanka,351,1,7872,16
2020-10-26,Sri Lanka,541,0,8413,16
2020-10-27,Sri Lanka,457,3,8870,19
2020-10-28,Sri Lanka,335,0,9205,19
2020-10-29,Sri Lanka,586,0,9791,19
2020-10-30,Sri Lanka,633,0,10424,19
2020-10-31,Sri Lanka,239,1,10663,20
2020-11-01,Sri Lanka,397,1,11060,21
2020-11-02,Sri Lanka,275,0,11335,21
2020-11-03,Sri Lanka,409,2,11744,23
2020-11-04,Sri Lanka,443,1,12187,24
2020-11-05,Sri Lanka,383,5,12570,29
2020-11-06,Sri Lanka,400,1,12970,30
2020-11-07,Sri Lanka,449,4,13419,34
2020-11-08,Sri Lanka,510,1,13929,35
2020-11-09,Sri Lanka,356,1,14285,36
2020-11-10,Sri Lanka,430,5,14715,41
2020-11-11,Sri Lanka,635,5,15350,46
2020-11-12,Sri Lanka,373,2,15723,48
2020-11-13,Sri Lanka,468,5,16191,53
2020-11-14,Sri Lanka,392,0,16583,53
2020-11-15,Sri Lanka,704,5,17287,58
2020-11-16,Sri Lanka,387,3,17674,61
2020-11-17,Sri Lanka,401,5,18075,66
2020-11-18,Sri Lanka,327,3,18402,69
2020-11-19,Sri Lanka,439,4,18841,73
2020-11-20,Sri Lanka,439,1,19280,74
2020-11-21,Sri Lanka,491,9,19771,83
2020-11-22,Sri Lanka,400,4,20171,87
2020-11-23,Sri Lanka,337,3,20508,90
2020-11-24,Sri Lanka,459,4,20967,94
2020-11-25,Sri Lanka,502,2,21469,96
2020-11-26,Sri Lanka,559,3,22028,99
2020-11-27,Sri Lanka,473,8,22501,107
2020-11-28,Sri Lanka,487,2,22988,109
2020-11-29,Sri Lanka,496,7,23484,116
2020-11-30,Sri Lanka,503,2,23987,118
2020-12-01,Sri Lanka,545,4,24532,122
2020-12-02,Sri Lanka,878,2,25410,124
2020-12-03,Sri Lanka,628,5,26038,129
2020-12-04,Sri Lanka,521,1,26559,130
2020-12-05,Sri Lanka,669,7,27228,137
2020-12-06,Sri Lanka,649,3,27877,140
2020-12-07,Sri Lanka,703,2,28580,142
2020-12-08,Sri Lanka,798,0,29378,142
2020-12-09,Sri Lanka,694,2,30072,144
2020-12-10,Sri Lanka,541,2,30613,146
2020-12-11,Sri Lanka,762,1,31375,147
2020-12-12,Sri Lanka,760,2,32135,149
2020-12-13,Sri Lanka,655,3,32790,152
2020-12-14,Sri Lanka,688,2,33478,154
2020-12-15,Sri Lanka,643,0,34121,154
2020-12-16,Sri Lanka,616,6,34737,160
2020-12-17,Sri Lanka,650,0,35387,160
2020-12-18,Sri Lanka,662,5,36049,165
2020-12-19,Sri Lanka,618,6,36667,171
2020-12-20,Sri Lanka,594,5,37261,176
2020-12-21,Sri Lanka,370,5,37631,181
2020-12-22,Sri Lanka,428,2,38059,183
2020-12-23,Sri Lanka,580,1,38639,184
2020-12-24,Sri Lanka,592,1,39231,185
2020-12-25,Sri Lanka,551,1,39782,186
2020-12-26,Sri Lanka,598,1,40380,187
2020-12-27,Sri Lanka,674,4,41054,191
2020-12-28,Sri Lanka,549,3,41603,194
2020-12-29,Sri Lanka,453,1,42056,195
2020-12-30,Sri Lanka,646,4,42702,199
2020-12-31,Sri Lanka,597,5,43299,204
2021-01-01,Sri Lanka,557,4,43856,208
2021-01-02,Sri Lanka,515,3,44371,211
2021-01-03,Sri Lanka,403,0,44774,211
2021-01-04,Sri Lanka,468,4,45242,215
2021-01-05,Sri Lanka,484,2,45726,217
2021-01-06,Sri Lanka,522,2,46248,219
2021-01-07,Sri Lanka,532,3,46780,222
2021-01-08,Sri Lanka,525,3,47305,225
2021-01-09,Sri Lanka,535,4,47840,229
2021-01-10,Sri Lanka,540,3,48380,232
2021-01-11,Sri Lanka,569,8,48949,240
2021-01-12,Sri Lanka,588,4,49537,244
2021-01-13,Sri Lanka,692,3,50229,247
2021-01-14,Sri Lanka,670,4,50899,251
2021-01-15,Sri Lanka,695,4,51594,255
2021-01-16,Sri Lanka,719,1,52313,256
2021-01-17,Sri Lanka,749,8,53062,264
2021-01-18,Sri Lanka,688,6,53750,270
2021-01-19,Sri Lanka,669,3,54419,273
2021-01-20,Sri Lanka,770,1,55189,274
2021-01-21,Sri Lanka,887,2,56076,276
2021-01-22,Sri Lanka,787,2,56863,278
2021-01-23,Sri Lanka,724,2,57587,280
2021-01-24,Sri Lanka,843,3,58430,283
2021-01-25,Sri Lanka,737,4,59167,287
2021-01-26,Sri Lanka,755,1,59922,288
2021-01-27,Sri Lanka,772,2,60694,290
2021-01-28,Sri Lanka,892,7,61586,297
2021-01-29,Sri Lanka,859,8,62445,305
2021-01-30,Sri Lanka,848,8,63293,313
2021-01-31,Sri Lanka,864,3,64157,316
2021-02-01,Sri Lanka,826,7,64983,323
2021-02-02,Sri Lanka,715,7,65698,330
2021-02-03,Sri Lanka,711,2,66409,332
2021-02-04,Sri Lanka,706,7,67115,339
2021-02-05,Sri Lanka,735,4,67850,343
2021-02-06,Sri Lanka,726,8,68576,351
2021-02-07,Sri Lanka,772,5,69348,356
2021-02-08,Sri Lanka,887,9,70235,365
2021-02-09,Sri Lanka,976,5,71211,370
2021-02-10,Sri Lanka,963,5,72174,375
2021-02-11,Sri Lanka,942,4,73116,379
2021-02-12,Sri Lanka,940,5,74056,384
2021-02-13,Sri Lanka,796,6,74852,390
2021-02-14,Sri Lanka,802,7,75654,397
2021-02-15,Sri Lanka,774,6,76428,403
2021-02-16,Sri Lanka,756,6,77184,409
2021-02-17,Sri Lanka,722,13,77906,422
2021-02-18,Sri Lanka,514,8,78420,430
2021-02-19,Sri Lanka,517,3,78937,433
2021-02-20,Sri Lanka,543,2,79480,435
2021-02-21,Sri Lanka,519,10,79999,445
2021-02-22,Sri Lanka,518,5,80517,450
2021-02-23,Sri Lanka,492,3,81009,453
2021-02-24,Sri Lanka,458,4,81467,457
2021-02-25,Sri Lanka,466,2,81933,459
2021-02-26,Sri Lanka,497,5,82430,464
2021-02-27,Sri Lanka,460,0,82890,464
2021-02-28,Sri Lanka,204,0,83094,464
2021-03-01,Sri Lanka,458,12,83552,476
2021-03-02,Sri Lanka,318,7,83870,483
2021-03-03,Sri Lanka,356,1,84226,484
2021-03-04,Sri Lanka,384,5,84610,489
2021-03-05,Sri Lanka,350,4,84960,493
2021-03-06,Sri Lanka,190,0,85150,493
2021-03-07,Sri Lanka,545,9,85695,502
2021-03-08,Sri Lanka,344,5,86039,507
2021-03-09,Sri Lanka,304,4,86343,511
2021-03-10,Sri Lanka,342,0,86685,511
2021-03-11,Sri Lanka,304,9,86989,520
2021-03-12,Sri Lanka,297,5,87286,525
2021-03-13,Sri Lanka,314,1,87600,526
2021-03-14,Sri Lanka,307,1,87907,527
2021-03-15,Sri Lanka,331,5,88238,532
2021-03-16,Sri Lanka,154,0,88392,532
2021-03-17,Sri Lanka,470,5,88862,537
2021-03-18,Sri Lanka,162,0,89024,537
2021-03-19,Sri Lanka,473,7,89497,544
2021-03-20,Sri Lanka,158,0,89655,544
2021-03-21,Sri Lanka,545,2,90200,546
2021-03-22,Sri Lanka,314,5,90514,551
2021-03-23,Sri Lanka,251,1,90765,552
2021-03-24,Sri Lanka,253,0,91018,552
2021-03-25,Sri Lanka,271,2,91289,554
2021-03-26,Sri Lanka,272,3,91561,557
2021-03-27,Sri Lanka,278,1,91839,558
2021-03-28,Sri Lanka,249,3,92088,561
2021-03-29,Sri Lanka,215,5,92303,566
2021-03-30,Sri Lanka,139,0,92442,566
2021-03-31,Sri Lanka,264,2,92706,568
2021-04-01,Sri Lanka,211,3,92917,571
2021-04-02,Sri Lanka,211,0,93128,571
2021-04-03,Sri Lanka,167,4,93295,575
2021-04-04,Sri Lanka,141,6,93436,581
2021-04-05,Sri Lanka,159,0,93595,581
2021-04-06,Sri Lanka,95,5,93690,586
2021-04-07,Sri Lanka,220,2,93910,588
2021-04-08,Sri Lanka,343,3,94253,591
2020-03-12,Sudan,0,0,0,0
2020-03-13,Sudan,0,1,0,1
2020-03-14,Sudan,1,0,1,1
2020-03-15,Sudan,0,0,1,1
2020-03-16,Sudan,0,0,1,1
2020-03-17,Sudan,0,0,1,1
2020-03-18,Sudan,0,0,1,1
2020-03-19,Sudan,0,0,1,1
2020-03-20,Sudan,0,0,1,1
2020-03-21,Sudan,1,0,2,1
2020-03-22,Sudan,0,0,2,1
2020-03-23,Sudan,0,0,2,1
2020-03-24,Sudan,1,0,3,1
2020-03-25,Sudan,0,0,3,1
2020-03-26,Sudan,0,0,3,1
2020-03-27,Sudan,0,0,3,1
2020-03-28,Sudan,2,0,5,1
2020-03-29,Sudan,0,0,5,1
2020-03-30,Sudan,1,1,6,2
2020-03-31,Sudan,1,0,7,2
2020-04-01,Sudan,0,0,7,2
2020-04-02,Sudan,0,0,7,2
2020-04-03,Sudan,3,0,10,2
2020-04-04,Sudan,0,0,10,2
2020-04-05,Sudan,2,0,12,2
2020-04-06,Sudan,0,0,12,2
2020-04-07,Sudan,2,0,14,2
2020-04-08,Sudan,0,0,14,2
2020-04-09,Sudan,0,0,14,2
2020-04-10,Sudan,1,0,15,2
2020-04-11,Sudan,4,0,19,2
2020-04-12,Sudan,0,0,19,2
2020-04-13,Sudan,0,2,19,4
2020-04-14,Sudan,10,1,29,5
2020-04-15,Sudan,3,0,32,5
2020-04-16,Sudan,0,0,32,5
2020-04-17,Sudan,0,1,32,6
2020-04-18,Sudan,34,4,66,10
2020-04-19,Sudan,0,0,66,10
2020-04-20,Sudan,26,2,92,12
2020-04-21,Sudan,15,0,107,12
2020-04-22,Sudan,33,1,140,13
2020-04-23,Sudan,22,3,162,16
2020-04-24,Sudan,12,0,174,16
2020-04-25,Sudan,39,1,213,17
2020-04-26,Sudan,24,4,237,21
2020-04-27,Sudan,38,1,275,22
2020-04-28,Sudan,43,3,318,25
2020-04-29,Sudan,57,3,375,28
2020-04-30,Sudan,0,3,375,31
2020-05-01,Sudan,67,5,442,36
2020-05-02,Sudan,91,5,533,41
2020-05-03,Sudan,59,0,592,41
2020-05-04,Sudan,86,0,678,41
2020-05-05,Sudan,100,4,778,45
2020-05-06,Sudan,74,4,852,49
2020-05-07,Sudan,78,3,930,52
2020-05-08,Sudan,0,7,930,59
2020-05-09,Sudan,181,5,1111,64
2020-05-10,Sudan,53,6,1164,70
2020-05-11,Sudan,201,4,1365,74
2020-05-12,Sudan,161,6,1526,80
2020-05-13,Sudan,134,10,1660,90
2020-05-14,Sudan,158,0,1818,90
2020-05-15,Sudan,146,1,1964,91
2020-05-16,Sudan,0,6,1964,97
2020-05-17,Sudan,325,0,2289,97
2020-05-18,Sudan,302,8,2591,105
2020-05-19,Sudan,0,6,2591,111
2020-05-20,Sudan,137,0,2728,111
2020-05-21,Sudan,410,10,3138,121
2020-05-22,Sudan,0,16,3138,137
2020-05-23,Sudan,240,9,3378,146
2020-05-24,Sudan,256,19,3634,165
2020-05-25,Sudan,192,5,3826,170
2020-05-26,Sudan,150,0,3976,170
2020-05-27,Sudan,170,25,4146,195
2020-05-28,Sudan,200,0,4346,195
2020-05-29,Sudan,0,38,4346,233
2020-05-30,Sudan,175,29,4521,262
2020-05-31,Sudan,279,24,4800,286
2020-06-01,Sudan,226,12,5026,298
2020-06-02,Sudan,147,9,5173,307
2020-06-03,Sudan,137,7,5310,314
2020-06-04,Sudan,189,19,5499,333
2020-06-05,Sudan,215,14,5714,347
2020-06-06,Sudan,152,12,5866,359
2020-06-07,Sudan,215,0,6081,359
2020-06-08,Sudan,0,13,6081,372
2020-06-09,Sudan,161,17,6242,389
2020-06-10,Sudan,185,12,6427,401
2020-06-11,Sudan,155,12,6582,413
2020-06-12,Sudan,148,20,6730,433
2020-06-13,Sudan,149,14,6879,447
2020-06-14,Sudan,128,12,7007,459
2020-06-15,Sudan,213,9,7220,468
2020-06-16,Sudan,215,9,7435,477
2020-06-17,Sudan,305,10,7740,487
2020-06-18,Sudan,280,0,8020,487
2020-06-19,Sudan,0,19,8020,506
2020-06-20,Sudan,396,15,8416,521
2020-06-21,Sudan,164,0,8580,521
2020-06-22,Sudan,118,12,8698,533
2020-06-23,Sudan,98,15,8796,548
2020-06-24,Sudan,91,0,8887,548
2020-06-25,Sudan,0,8,8887,556
2020-06-26,Sudan,95,16,8982,572
2020-06-27,Sudan,275,0,9257,572
2020-06-28,Sudan,57,0,9314,572
2020-06-29,Sudan,6,0,9320,572
2020-06-30,Sudan,52,0,9372,572
2020-07-01,Sudan,128,30,9500,602
2020-07-02,Sudan,73,0,9573,602
2020-07-03,Sudan,116,2,9689,604
2020-07-04,Sudan,0,4,9689,608
2020-07-05,Sudan,78,0,9767,608
2020-07-06,Sudan,0,8,9767,616
2020-07-07,Sudan,127,6,9894,622
2020-07-08,Sudan,103,14,9997,636
2020-07-09,Sudan,87,5,10084,641
2020-07-10,Sudan,120,8,10204,649
2020-07-11,Sudan,0,1,10204,650
2020-07-12,Sudan,46,0,10250,650
2020-07-13,Sudan,0,7,10250,657
2020-07-14,Sudan,66,2,10316,659
2020-07-15,Sudan,101,9,10417,668
2020-07-16,Sudan,110,0,10527,668
2020-07-17,Sudan,0,0,10527,668
2020-07-18,Sudan,0,5,10527,673
2020-07-19,Sudan,235,20,10762,693
2020-07-20,Sudan,230,0,10992,693
2020-07-21,Sudan,0,0,10992,693
2020-07-22,Sudan,135,15,11127,708
2020-07-23,Sudan,110,0,11237,708
2020-07-24,Sudan,65,7,11302,715
2020-07-25,Sudan,0,2,11302,717
2020-07-26,Sudan,83,0,11385,717
2020-07-27,Sudan,39,3,11424,720
2020-07-28,Sudan,72,5,11496,725
2020-07-29,Sudan,83,0,11579,725
2020-07-30,Sudan,0,0,11579,725
2020-07-31,Sudan,0,21,11579,746
2020-08-01,Sudan,65,6,11644,752
2020-08-02,Sudan,94,0,11738,752
2020-08-03,Sudan,0,0,11738,752
2020-08-04,Sudan,42,11,11780,763
2020-08-05,Sudan,0,0,11780,763
2020-08-06,Sudan,70,0,11850,763
2020-08-07,Sudan,44,10,11894,773
2020-08-08,Sudan,0,0,11894,773
2020-08-09,Sudan,62,8,11956,781
2020-08-10,Sudan,77,0,12033,781
2020-08-11,Sudan,0,5,12033,786
2020-08-12,Sudan,82,0,12115,786
2020-08-13,Sudan,47,6,12162,792
2020-08-14,Sudan,49,1,12211,793
2020-08-15,Sudan,103,3,12314,796
2020-08-16,Sudan,96,2,12410,798
2020-08-17,Sudan,75,5,12485,803
2020-08-18,Sudan,61,2,12546,805
2020-08-19,Sudan,36,3,12582,808
2020-08-20,Sudan,41,4,12623,812
2020-08-21,Sudan,59,0,12682,812
2020-08-22,Sudan,154,3,12836,815
2020-08-23,Sudan,67,0,12903,815
2020-08-24,Sudan,71,3,12974,818
2020-08-25,Sudan,0,1,12974,819
2020-08-26,Sudan,71,0,13045,819
2020-08-27,Sudan,37,4,13082,823
2020-08-28,Sudan,107,0,13189,823
2020-08-29,Sudan,0,0,13189,823
2020-08-30,Sudan,0,0,13189,823
2020-08-31,Sudan,0,0,13189,823
2020-09-01,Sudan,0,0,13189,823
2020-09-02,Sudan,0,0,13189,823
2020-09-03,Sudan,0,0,13189,823
2020-09-04,Sudan,0,0,13189,823
2020-09-05,Sudan,218,9,13407,832
2020-09-06,Sudan,30,1,13437,833
2020-09-07,Sudan,0,0,13437,833
2020-09-08,Sudan,33,0,13470,833
2020-09-09,Sudan,0,0,13470,833
2020-09-10,Sudan,0,0,13470,833
2020-09-11,Sudan,46,1,13516,834
2020-09-12,Sudan,16,0,13532,834
2020-09-13,Sudan,0,1,13532,835
2020-09-14,Sudan,0,1,13532,836
2020-09-15,Sudan,3,0,13535,836
2020-09-16,Sudan,0,0,13535,836
2020-09-17,Sudan,0,0,13535,836
2020-09-18,Sudan,20,0,13555,836
2020-09-19,Sudan,0,0,13555,836
2020-09-20,Sudan,0,0,13555,836
2020-09-21,Sudan,21,0,13576,836
2020-09-22,Sudan,2,0,13578,836
2020-09-23,Sudan,0,0,13578,836
2020-09-24,Sudan,14,0,13592,836
2020-09-25,Sudan,12,0,13604,836
2020-09-26,Sudan,2,0,13606,836
2020-09-27,Sudan,4,0,13610,836
2020-09-28,Sudan,3,0,13613,836
2020-09-29,Sudan,27,0,13640,836
2020-09-30,Sudan,6,0,13646,836
2020-10-01,Sudan,7,0,13653,836
2020-10-02,Sudan,4,0,13657,836
2020-10-03,Sudan,1,0,13658,836
2020-10-04,Sudan,2,0,13660,836
2020-10-05,Sudan,0,0,13660,836
2020-10-06,Sudan,8,0,13668,836
2020-10-07,Sudan,0,0,13668,836
2020-10-08,Sudan,2,0,13670,836
2020-10-09,Sudan,3,0,13673,836
2020-10-10,Sudan,9,0,13682,836
2020-10-11,Sudan,3,0,13685,836
2020-10-12,Sudan,6,0,13691,836
2020-10-13,Sudan,0,0,13691,836
2020-10-14,Sudan,6,0,13697,836
2020-10-15,Sudan,0,0,13697,836
2020-10-16,Sudan,3,0,13700,836
2020-10-17,Sudan,0,0,13700,836
2020-10-18,Sudan,11,0,13711,836
2020-10-19,Sudan,13,0,13724,836
2020-10-20,Sudan,0,0,13724,836
2020-10-21,Sudan,4,0,13728,836
2020-10-22,Sudan,0,0,13728,836
2020-10-23,Sudan,5,0,13733,836
2020-10-24,Sudan,0,1,13733,837
2020-10-25,Sudan,9,0,13742,837
2020-10-26,Sudan,0,0,13742,837
2020-10-27,Sudan,5,0,13747,837
2020-10-28,Sudan,18,0,13765,837
2020-10-29,Sudan,12,0,13777,837
2020-10-30,Sudan,27,0,13804,837
2020-10-31,Sudan,0,0,13804,837
2020-11-01,Sudan,0,0,13804,837
2020-11-02,Sudan,15,0,13819,837
2020-11-03,Sudan,47,0,13866,837
2020-11-04,Sudan,39,0,13905,837
2020-11-05,Sudan,91,0,13996,837
2020-11-06,Sudan,37,0,14033,837
2020-11-07,Sudan,57,0,14090,837
2020-11-08,Sudan,65,278,14155,1115
2020-11-09,Sudan,50,1,14205,1116
2020-11-10,Sudan,96,0,14301,1116
2020-11-11,Sudan,45,0,14346,1116
2020-11-12,Sudan,55,0,14401,1116
2020-11-13,Sudan,97,0,14498,1116
2020-11-14,Sudan,128,0,14626,1116
2020-11-15,Sudan,102,0,14728,1116
2020-11-16,Sudan,319,3,15047,1119
2020-11-17,Sudan,106,56,15153,1175
2020-11-18,Sudan,146,0,15299,1175
2020-11-19,Sudan,231,4,15530,1179
2020-11-20,Sudan,309,6,15839,1185
2020-11-21,Sudan,213,8,16052,1193
2020-11-22,Sudan,135,4,16187,1197
2020-11-23,Sudan,244,0,16431,1197
2020-11-24,Sudan,218,5,16649,1202
2020-11-25,Sudan,215,8,16864,1210
2020-11-26,Sudan,204,5,17068,1215
2020-11-27,Sudan,336,0,17404,1215
2020-11-28,Sudan,223,20,17627,1235
2020-11-29,Sudan,183,0,17810,1235
2020-11-30,Sudan,235,14,18045,1249
2020-12-01,Sudan,209,6,18254,1255
2020-12-02,Sudan,281,10,18535,1265
2020-12-03,Sudan,349,6,18884,1271
2020-12-04,Sudan,312,0,19196,1271
2020-12-05,Sudan,272,19,19468,1290
2020-12-06,Sudan,279,5,19747,1295
2020-12-07,Sudan,337,6,20084,1301
2020-12-08,Sudan,212,0,20296,1301
2020-12-09,Sudan,172,6,20468,1307
2020-12-10,Sudan,376,12,20844,1319
2020-12-11,Sudan,303,21,21147,1340
2020-12-12,Sudan,239,4,21386,1344
2020-12-13,Sudan,205,3,21591,1347
2020-12-14,Sudan,273,8,21864,1355
2020-12-15,Sudan,218,17,22082,1372
2020-12-16,Sudan,183,12,22265,1384
2020-12-17,Sudan,356,24,22621,1408
2020-12-18,Sudan,202,0,22823,1408
2020-12-19,Sudan,167,17,22990,1425
2020-12-20,Sudan,110,9,23100,1434
2020-12-21,Sudan,216,16,23316,1450
2020-12-22,Sudan,256,18,23572,1468
2020-12-23,Sudan,274,0,23846,1468
2020-12-24,Sudan,212,0,24058,1468
2020-12-25,Sudan,283,0,24341,1468
2020-12-26,Sudan,247,0,24588,1468
2020-12-27,Sudan,106,0,24694,1468
2020-12-28,Sudan,194,0,24888,1468
2020-12-29,Sudan,172,0,25060,1468
2020-12-30,Sudan,178,0,25238,1468
2020-12-31,Sudan,262,0,25500,1468
2021-01-01,Sudan,230,0,25730,1468
2021-01-02,Sudan,152,0,25882,1468
2021-01-03,Sudan,157,0,26039,1468
2021-01-04,Sudan,240,0,26279,1468
2021-01-05,Sudan,0,0,26279,1468
2021-01-06,Sudan,0,0,26279,1468
2021-01-07,Sudan,0,0,26279,1468
2021-01-08,Sudan,0,0,26279,1468
2021-01-09,Sudan,0,0,26279,1468
2021-01-10,Sudan,1215,0,27494,1468
2021-01-11,Sudan,125,0,27619,1468
2021-01-12,Sudan,149,0,27768,1468
2021-01-13,Sudan,59,108,27827,1576
2021-01-14,Sudan,142,0,27969,1576
2021-01-15,Sudan,128,0,28097,1576
2021-01-16,Sudan,82,0,28179,1576
2021-01-17,Sudan,54,27,28233,1603
2021-01-18,Sudan,84,0,28317,1603
2021-01-19,Sudan,133,0,28450,1603
2021-01-20,Sudan,72,0,28522,1603
2021-01-21,Sudan,0,0,28522,1603
2021-01-22,Sudan,0,0,28522,1603
2021-01-23,Sudan,0,0,28522,1603
2021-01-24,Sudan,0,0,28522,1603
2021-01-25,Sudan,0,135,28522,1738
2021-01-26,Sudan,0,12,28522,1750
2021-01-27,Sudan,472,10,28994,1760
2021-01-28,Sudan,72,38,29066,1798
2021-01-29,Sudan,225,0,29291,1798
2021-01-30,Sudan,0,6,29291,1804
2021-01-31,Sudan,89,3,29380,1807
2021-02-01,Sudan,69,5,29449,1812
2021-02-02,Sudan,39,17,29488,1829
2021-02-03,Sudan,48,1,29536,1830
2021-02-04,Sudan,41,1,29577,1831
2021-02-05,Sudan,57,0,29634,1831
2021-02-06,Sudan,0,0,29634,1831
2021-02-07,Sudan,0,4,29634,1835
2021-02-08,Sudan,131,0,29765,1835
2021-02-09,Sudan,86,0,29851,1835
2021-02-10,Sudan,0,14,29851,1849
2021-02-11,Sudan,82,0,29933,1849
2021-02-12,Sudan,0,0,29933,1849
2021-02-13,Sudan,0,0,29933,1849
2021-02-14,Sudan,0,0,29933,1849
2021-02-15,Sudan,0,9,29933,1858
2021-02-16,Sudan,119,5,30052,1863
2021-02-17,Sudan,26,1,30078,1864
2021-02-18,Sudan,37,0,30115,1864
2021-02-19,Sudan,13,0,30128,1864
2021-02-20,Sudan,0,0,30128,1864
2021-02-21,Sudan,0,0,30128,1864
2021-02-22,Sudan,0,7,30128,1871
2021-02-23,Sudan,77,5,30205,1876
2021-02-24,Sudan,31,0,30236,1876
2021-02-25,Sudan,0,2,30236,1878
2021-02-26,Sudan,48,0,30284,1878
2021-02-27,Sudan,32,2,30316,1880
2021-02-28,Sudan,31,0,30347,1880
2021-03-01,Sudan,17,10,30364,1890
2021-03-02,Sudan,53,5,30417,1895
2021-03-03,Sudan,62,0,30479,1895
2021-03-04,Sudan,0,0,30479,1895
2021-03-05,Sudan,0,0,30479,1895
2021-03-06,Sudan,0,0,30479,1895
2021-03-07,Sudan,61,0,30540,1895
2021-03-08,Sudan,0,20,30540,1915
2021-03-09,Sudan,146,0,30686,1915
2021-03-10,Sudan,0,0,30686,1915
2021-03-11,Sudan,0,25,30686,1940
2021-03-12,Sudan,187,0,30873,1940
2021-03-13,Sudan,0,0,30873,1940
2021-03-14,Sudan,0,0,30873,1940
2021-03-15,Sudan,0,19,30873,1959
2021-03-16,Sudan,116,0,30989,1959
2021-03-17,Sudan,0,0,30989,1959
2021-03-18,Sudan,0,0,30989,1959
2021-03-19,Sudan,0,0,30989,1959
2021-03-20,Sudan,0,0,30989,1959
2021-03-21,Sudan,0,27,30989,1986
2021-03-22,Sudan,158,0,31147,1986
2021-03-23,Sudan,0,17,31147,2003
2021-03-24,Sudan,135,25,31282,2028
2021-03-25,Sudan,125,0,31407,2028
2021-03-26,Sudan,0,0,31407,2028
2021-03-27,Sudan,0,0,31407,2028
2021-03-28,Sudan,0,0,31407,2028
2021-03-29,Sudan,0,0,31407,2028
2021-03-30,Sudan,0,13,31407,2041
2021-03-31,Sudan,426,22,31833,2063
2021-04-01,Sudan,0,0,31833,2063
2021-04-02,Sudan,0,0,31833,2063
2021-04-03,Sudan,0,0,31833,2063
2021-04-04,Sudan,0,0,31833,2063
2021-04-05,Sudan,0,0,31833,2063
2021-04-06,Sudan,0,0,31833,2063
2021-04-07,Sudan,0,0,31833,2063
2021-04-08,Sudan,0,0,31833,2063
2020-03-14,Suriname,1,0,1,0
2020-03-15,Suriname,0,0,1,0
2020-03-16,Suriname,0,0,1,0
2020-03-17,Suriname,0,0,1,0
2020-03-18,Suriname,0,0,1,0
2020-03-19,Suriname,0,0,1,0
2020-03-20,Suriname,3,0,4,0
2020-03-21,Suriname,0,0,4,0
2020-03-22,Suriname,1,0,5,0
2020-03-23,Suriname,0,0,5,0
2020-03-24,Suriname,2,0,7,0
2020-03-25,Suriname,1,0,8,0
2020-03-26,Suriname,0,0,8,0
2020-03-27,Suriname,0,0,8,0
2020-03-28,Suriname,0,0,8,0
2020-03-29,Suriname,0,0,8,0
2020-03-30,Suriname,0,0,8,0
2020-03-31,Suriname,1,0,9,0
2020-04-01,Suriname,1,0,10,0
2020-04-02,Suriname,0,0,10,0
2020-04-03,Suriname,0,1,10,1
2020-04-04,Suriname,0,0,10,1
2020-04-05,Suriname,0,0,10,1
2020-04-06,Suriname,0,0,10,1
2020-04-07,Suriname,0,0,10,1
2020-04-08,Suriname,0,0,10,1
2020-04-09,Suriname,0,0,10,1
2020-04-10,Suriname,0,0,10,1
2020-04-11,Suriname,0,0,10,1
2020-04-12,Suriname,0,0,10,1
2020-04-13,Suriname,0,0,10,1
2020-04-14,Suriname,0,0,10,1
2020-04-15,Suriname,0,0,10,1
2020-04-16,Suriname,0,0,10,1
2020-04-17,Suriname,0,0,10,1
2020-04-18,Suriname,0,0,10,1
2020-04-19,Suriname,0,0,10,1
2020-04-20,Suriname,0,0,10,1
2020-04-21,Suriname,0,0,10,1
2020-04-22,Suriname,0,0,10,1
2020-04-23,Suriname,0,0,10,1
2020-04-24,Suriname,0,0,10,1
2020-04-25,Suriname,0,0,10,1
2020-04-26,Suriname,0,0,10,1
2020-04-27,Suriname,0,0,10,1
2020-04-28,Suriname,0,0,10,1
2020-04-29,Suriname,0,0,10,1
2020-04-30,Suriname,0,0,10,1
2020-05-01,Suriname,0,0,10,1
2020-05-02,Suriname,0,0,10,1
2020-05-03,Suriname,0,0,10,1
2020-05-04,Suriname,0,0,10,1
2020-05-05,Suriname,0,0,10,1
2020-05-06,Suriname,0,0,10,1
2020-05-07,Suriname,0,0,10,1
2020-05-08,Suriname,0,0,10,1
2020-05-09,Suriname,0,0,10,1
2020-05-10,Suriname,0,0,10,1
2020-05-11,Suriname,0,0,10,1
2020-05-12,Suriname,0,0,10,1
2020-05-13,Suriname,0,0,10,1
2020-05-14,Suriname,0,0,10,1
2020-05-15,Suriname,0,0,10,1
2020-05-16,Suriname,0,0,10,1
2020-05-17,Suriname,0,0,10,1
2020-05-18,Suriname,1,0,11,1
2020-05-19,Suriname,0,0,11,1
2020-05-20,Suriname,0,0,11,1
2020-05-21,Suriname,0,0,11,1
2020-05-22,Suriname,0,0,11,1
2020-05-23,Suriname,0,0,11,1
2020-05-24,Suriname,0,0,11,1
2020-05-25,Suriname,0,0,11,1
2020-05-26,Suriname,0,0,11,1
2020-05-27,Suriname,1,0,12,1
2020-05-28,Suriname,0,0,12,1
2020-05-29,Suriname,0,0,12,1
2020-05-30,Suriname,2,0,14,1
2020-05-31,Suriname,9,0,23,1
2020-06-01,Suriname,21,0,44,1
2020-06-02,Suriname,10,0,54,1
2020-06-03,Suriname,20,0,74,1
2020-06-04,Suriname,8,0,82,1
2020-06-05,Suriname,8,0,90,1
2020-06-06,Suriname,10,0,100,1
2020-06-07,Suriname,22,0,122,1
2020-06-08,Suriname,6,1,128,2
2020-06-09,Suriname,9,0,137,2
2020-06-10,Suriname,7,0,144,2
2020-06-11,Suriname,24,0,168,2
2020-06-12,Suriname,19,1,187,3
2020-06-13,Suriname,9,0,196,3
2020-06-14,Suriname,12,0,208,3
2020-06-15,Suriname,21,2,229,5
2020-06-16,Suriname,7,1,236,6
2020-06-17,Suriname,25,0,261,6
2020-06-18,Suriname,16,1,277,7
2020-06-19,Suriname,16,1,293,8
2020-06-20,Suriname,10,0,303,8
2020-06-21,Suriname,11,0,314,8
2020-06-22,Suriname,5,0,319,8
2020-06-23,Suriname,0,1,319,9
2020-06-24,Suriname,38,1,357,10
2020-06-25,Suriname,16,0,373,10
2020-06-26,Suriname,16,0,389,10
2020-06-27,Suriname,78,1,467,11
2020-06-28,Suriname,23,0,490,11
2020-06-29,Suriname,11,2,501,13
2020-06-30,Suriname,14,0,515,13
2020-07-01,Suriname,20,0,535,13
2020-07-02,Suriname,12,0,547,13
2020-07-03,Suriname,14,0,561,13
2020-07-04,Suriname,4,1,565,14
2020-07-05,Suriname,29,0,594,14
2020-07-06,Suriname,20,0,614,14
2020-07-07,Suriname,20,1,634,15
2020-07-08,Suriname,31,2,665,17
2020-07-09,Suriname,29,0,694,17
2020-07-10,Suriname,32,1,726,18
2020-07-11,Suriname,15,0,741,18
2020-07-12,Suriname,0,0,741,18
2020-07-13,Suriname,39,0,780,18
2020-07-14,Suriname,21,0,801,18
2020-07-15,Suriname,36,0,837,18
2020-07-16,Suriname,67,0,904,18
2020-07-17,Suriname,39,1,943,19
2020-07-18,Suriname,58,1,1001,20
2020-07-19,Suriname,28,1,1029,21
2020-07-20,Suriname,50,0,1079,21
2020-07-21,Suriname,52,0,1131,21
2020-07-22,Suriname,45,0,1176,21
2020-07-23,Suriname,58,2,1234,23
2020-07-24,Suriname,71,0,1305,23
2020-07-25,Suriname,76,0,1381,23
2020-07-26,Suriname,58,0,1439,23
2020-07-27,Suriname,44,1,1483,24
2020-07-28,Suriname,27,0,1510,24
2020-07-29,Suriname,97,2,1607,26
2020-07-30,Suriname,0,0,1607,26
2020-07-31,Suriname,43,0,1650,26
2020-08-01,Suriname,110,0,1760,26
2020-08-02,Suriname,89,1,1849,27
2020-08-03,Suriname,44,0,1893,27
2020-08-04,Suriname,88,0,1981,27
2020-08-05,Suriname,69,0,2050,27
2020-08-06,Suriname,46,2,2096,29
2020-08-07,Suriname,107,0,2203,29
2020-08-08,Suriname,103,0,2306,29
2020-08-09,Suriname,85,0,2391,29
2020-08-10,Suriname,98,1,2489,30
2020-08-11,Suriname,70,9,2559,39
2020-08-12,Suriname,94,0,2653,39
2020-08-13,Suriname,108,1,2761,40
2020-08-14,Suriname,77,1,2838,41
2020-08-15,Suriname,123,1,2961,42
2020-08-16,Suriname,55,5,3016,47
2020-08-17,Suriname,61,1,3077,48
2020-08-18,Suriname,139,6,3216,54
2020-08-19,Suriname,79,0,3295,54
2020-08-20,Suriname,71,1,3366,55
2020-08-21,Suriname,94,1,3460,56
2020-08-22,Suriname,109,1,3569,57
2020-08-23,Suriname,38,1,3607,58
2020-08-24,Suriname,25,2,3632,60
2020-08-25,Suriname,66,1,3698,61
2020-08-26,Suriname,26,1,3724,62
2020-08-27,Suriname,69,4,3793,66
2020-08-28,Suriname,55,0,3848,66
2020-08-29,Suriname,106,1,3954,67
2020-08-30,Suriname,55,0,4009,67
2020-08-31,Suriname,25,4,4034,71
2020-09-01,Suriname,55,1,4089,72
2020-09-02,Suriname,60,0,4149,72
2020-09-03,Suriname,66,1,4215,73
2020-09-04,Suriname,37,2,4252,75
2020-09-05,Suriname,68,1,4320,76
2020-09-06,Suriname,26,9,4346,85
2020-09-07,Suriname,14,6,4360,91
2020-09-08,Suriname,59,0,4419,91
2020-09-09,Suriname,28,1,4447,92
2020-09-10,Suriname,30,1,4477,93
2020-09-11,Suriname,52,0,4529,93
2020-09-12,Suriname,50,0,4579,93
2020-09-13,Suriname,3,0,4582,93
2020-09-14,Suriname,29,2,4611,95
2020-09-15,Suriname,14,0,4625,95
2020-09-16,Suriname,20,0,4645,95
2020-09-17,Suriname,26,0,4671,95
2020-09-18,Suriname,20,1,4691,96
2020-09-19,Suriname,18,1,4709,97
2020-09-20,Suriname,14,0,4723,97
2020-09-21,Suriname,17,0,4740,97
2020-09-22,Suriname,19,3,4759,100
2020-09-23,Suriname,20,1,4779,101
2020-09-24,Suriname,10,1,4789,102
2020-09-25,Suriname,28,0,4817,102
2020-09-26,Suriname,14,0,4831,102
2020-09-27,Suriname,4,0,4835,102
2020-09-28,Suriname,1,0,4836,102
2020-09-29,Suriname,27,2,4863,104
2020-09-30,Suriname,14,0,4877,104
2020-10-01,Suriname,14,1,4891,105
2020-10-02,Suriname,8,0,4899,105
2020-10-03,Suriname,25,1,4924,106
2020-10-04,Suriname,17,0,4941,106
2020-10-05,Suriname,13,0,4954,106
2020-10-06,Suriname,11,0,4965,106
2020-10-07,Suriname,14,0,4979,106
2020-10-08,Suriname,25,0,5004,106
2020-10-09,Suriname,14,0,5018,106
2020-10-10,Suriname,17,1,5035,107
2020-10-11,Suriname,16,0,5051,107
2020-10-12,Suriname,7,0,5058,107
2020-10-13,Suriname,14,0,5072,107
2020-10-14,Suriname,11,1,5083,108
2020-10-15,Suriname,11,1,5094,109
2020-10-16,Suriname,19,0,5113,109
2020-10-17,Suriname,10,0,5123,109
2020-10-18,Suriname,7,0,5130,109
2020-10-19,Suriname,3,0,5133,109
2020-10-20,Suriname,11,0,5144,109
2020-10-21,Suriname,6,0,5150,109
2020-10-22,Suriname,4,0,5154,109
2020-10-23,Suriname,1,0,5155,109
2020-10-24,Suriname,11,0,5166,109
2020-10-25,Suriname,4,0,5170,109
2020-10-26,Suriname,10,1,5180,110
2020-10-27,Suriname,7,1,5187,111
2020-10-28,Suriname,5,0,5192,111
2020-10-29,Suriname,5,0,5197,111
2020-10-30,Suriname,4,0,5201,111
2020-10-31,Suriname,2,0,5203,111
2020-11-01,Suriname,7,0,5210,111
2020-11-02,Suriname,2,0,5212,111
2020-11-03,Suriname,6,0,5218,111
2020-11-04,Suriname,2,1,5220,112
2020-11-05,Suriname,5,0,5225,112
2020-11-06,Suriname,2,0,5227,112
2020-11-07,Suriname,7,1,5234,113
2020-11-08,Suriname,5,0,5239,113
2020-11-09,Suriname,2,0,5241,113
2020-11-10,Suriname,4,0,5245,113
2020-11-11,Suriname,9,0,5254,113
2020-11-12,Suriname,7,1,5261,114
2020-11-13,Suriname,7,0,5268,114
2020-11-14,Suriname,6,0,5274,114
2020-11-15,Suriname,0,0,5274,114
2020-11-16,Suriname,1,1,5275,115
2020-11-17,Suriname,3,1,5278,116
2020-11-18,Suriname,4,0,5282,116
2020-11-19,Suriname,2,0,5284,116
2020-11-20,Suriname,5,0,5289,116
2020-11-21,Suriname,6,0,5295,116
2020-11-22,Suriname,1,0,5296,116
2020-11-23,Suriname,1,0,5297,116
2020-11-24,Suriname,3,1,5300,117
2020-11-25,Suriname,5,0,5305,117
2020-11-26,Suriname,2,0,5307,117
2020-11-27,Suriname,4,0,5311,117
2020-11-28,Suriname,1,0,5312,117
2020-11-29,Suriname,0,0,5312,117
2020-11-30,Suriname,0,0,5312,117
2020-12-01,Suriname,7,0,5319,117
2020-12-02,Suriname,1,0,5320,117
2020-12-03,Suriname,2,0,5322,117
2020-12-04,Suriname,0,0,5322,117
2020-12-05,Suriname,2,0,5324,117
2020-12-06,Suriname,0,0,5324,117
2020-12-07,Suriname,1,0,5325,117
2020-12-08,Suriname,1,0,5326,117
2020-12-09,Suriname,7,0,5333,117
2020-12-10,Suriname,4,0,5337,117
2020-12-11,Suriname,2,0,5339,117
2020-12-12,Suriname,1,0,5340,117
2020-12-13,Suriname,13,0,5353,117
2020-12-14,Suriname,6,0,5359,117
2020-12-15,Suriname,22,0,5381,117
2020-12-16,Suriname,20,0,5401,117
2020-12-17,Suriname,27,0,5428,117
2020-12-18,Suriname,31,0,5459,117
2020-12-19,Suriname,52,1,5511,118
2020-12-20,Suriname,41,0,5552,118
2020-12-21,Suriname,31,0,5583,118
2020-12-22,Suriname,86,0,5669,118
2020-12-23,Suriname,65,0,5734,118
2020-12-24,Suriname,76,0,5810,118
2020-12-25,Suriname,70,1,5880,119
2020-12-26,Suriname,58,0,5938,119
2020-12-27,Suriname,40,0,5978,119
2020-12-28,Suriname,35,1,6013,120
2020-12-29,Suriname,85,0,6098,120
2020-12-30,Suriname,83,1,6181,121
2020-12-31,Suriname,29,1,6210,122
2021-01-01,Suriname,67,1,6277,123
2021-01-02,Suriname,66,0,6343,123
2021-01-03,Suriname,50,0,6393,123
2021-01-04,Suriname,100,1,6493,124
2021-01-05,Suriname,93,1,6586,125
2021-01-06,Suriname,80,1,6666,126
2021-01-07,Suriname,84,4,6750,130
2021-01-08,Suriname,104,1,6854,131
2021-01-09,Suriname,94,1,6948,132
2021-01-10,Suriname,60,1,7008,133
2021-01-11,Suriname,56,5,7064,138
2021-01-12,Suriname,114,0,7178,138
2021-01-13,Suriname,69,1,7247,139
2021-01-14,Suriname,53,0,7300,139
2021-01-15,Suriname,109,0,7409,139
2021-01-16,Suriname,60,2,7469,141
2021-01-17,Suriname,58,0,7527,141
2021-01-18,Suriname,97,4,7624,145
2021-01-19,Suriname,85,1,7709,146
2021-01-20,Suriname,74,0,7783,146
2021-01-21,Suriname,97,0,7880,146
2021-01-22,Suriname,65,2,7945,148
2021-01-23,Suriname,55,0,8000,148
2021-01-24,Suriname,57,1,8057,149
2021-01-25,Suriname,55,0,8112,149
2021-01-26,Suriname,62,1,8174,150
2021-01-27,Suriname,69,2,8243,152
2021-01-28,Suriname,50,2,8293,154
2021-01-29,Suriname,71,0,8364,154
2021-01-30,Suriname,39,0,8403,154
2021-01-31,Suriname,35,0,8438,154
2021-02-01,Suriname,11,2,8449,156
2021-02-02,Suriname,48,0,8497,156
2021-02-03,Suriname,59,0,8556,156
2021-02-04,Suriname,39,2,8595,158
2021-02-05,Suriname,24,0,8619,158
2021-02-06,Suriname,31,2,8650,160
2021-02-07,Suriname,21,1,8671,161
2021-02-08,Suriname,19,1,8690,162
2021-02-09,Suriname,20,1,8710,163
2021-02-10,Suriname,29,1,8739,164
2021-02-11,Suriname,26,2,8765,166
2021-02-12,Suriname,13,0,8778,166
2021-02-13,Suriname,16,0,8794,166
2021-02-14,Suriname,9,0,8803,166
2021-02-15,Suriname,8,1,8811,167
2021-02-16,Suriname,9,0,8820,167
2021-02-17,Suriname,12,1,8832,168
2021-02-18,Suriname,6,0,8838,168
2021-02-19,Suriname,16,0,8854,168
2021-02-20,Suriname,2,0,8856,168
2021-02-21,Suriname,12,0,8868,168
2021-02-22,Suriname,1,1,8869,169
2021-02-23,Suriname,11,1,8880,170
2021-02-24,Suriname,12,0,8892,170
2021-02-25,Suriname,9,0,8901,170
2021-02-26,Suriname,12,0,8913,170
2021-02-27,Suriname,6,0,8919,170
2021-02-28,Suriname,10,2,8929,172
2021-03-01,Suriname,4,1,8933,173
2021-03-02,Suriname,6,0,8939,173
2021-03-03,Suriname,14,0,8953,173
2021-03-04,Suriname,6,2,8959,175
2021-03-05,Suriname,7,0,8966,175
2021-03-06,Suriname,5,0,8971,175
2021-03-07,Suriname,6,0,8977,175
2021-03-08,Suriname,3,0,8980,175
2021-03-09,Suriname,5,0,8985,175
2021-03-10,Suriname,5,0,8990,175
2021-03-11,Suriname,7,1,8997,176
2021-03-12,Suriname,15,0,9012,176
2021-03-13,Suriname,10,0,9022,176
2021-03-14,Suriname,2,0,9024,176
2021-03-15,Suriname,4,0,9028,176
2021-03-16,Suriname,6,0,9034,176
2021-03-17,Suriname,8,0,9042,176
2021-03-18,Suriname,7,0,9049,176
2021-03-19,Suriname,6,0,9055,176
2021-03-20,Suriname,6,0,9061,176
2021-03-21,Suriname,5,0,9066,176
2021-03-22,Suriname,1,1,9067,177
2021-03-23,Suriname,7,0,9074,177
2021-03-24,Suriname,3,0,9077,177
2021-03-25,Suriname,8,0,9085,177
2021-03-26,Suriname,3,0,9088,177
2021-03-27,Suriname,7,0,9095,177
2021-03-28,Suriname,2,0,9097,177
2021-03-29,Suriname,7,0,9104,177
2021-03-30,Suriname,5,0,9109,177
2021-03-31,Suriname,13,0,9122,177
2021-04-01,Suriname,0,0,9122,177
2021-04-02,Suriname,8,0,9130,177
2021-04-03,Suriname,23,0,9153,177
2021-04-04,Suriname,10,0,9163,177
2021-04-05,Suriname,11,0,9174,177
2021-04-06,Suriname,10,1,9184,178
2021-04-07,Suriname,16,0,9200,178
2021-04-08,Suriname,54,0,9254,178
2020-02-01,Sweden,1,0,1,0
2020-02-02,Sweden,0,0,1,0
2020-02-03,Sweden,0,0,1,0
2020-02-04,Sweden,0,0,1,0
2020-02-05,Sweden,0,0,1,0
2020-02-06,Sweden,0,0,1,0
2020-02-07,Sweden,0,0,1,0
2020-02-08,Sweden,0,0,1,0
2020-02-09,Sweden,0,0,1,0
2020-02-10,Sweden,0,0,1,0
2020-02-11,Sweden,0,0,1,0
2020-02-12,Sweden,0,0,1,0
2020-02-13,Sweden,0,0,1,0
2020-02-14,Sweden,0,0,1,0
2020-02-15,Sweden,0,0,1,0
2020-02-16,Sweden,0,0,1,0
2020-02-17,Sweden,0,0,1,0
2020-02-18,Sweden,0,0,1,0
2020-02-19,Sweden,0,0,1,0
2020-02-20,Sweden,0,0,1,0
2020-02-21,Sweden,0,0,1,0
2020-02-22,Sweden,0,0,1,0
2020-02-23,Sweden,0,0,1,0
2020-02-24,Sweden,0,0,1,0
2020-02-25,Sweden,0,0,1,0
2020-02-26,Sweden,1,0,2,0
2020-02-27,Sweden,1,0,3,0
2020-02-28,Sweden,8,0,11,0
2020-02-29,Sweden,3,0,14,0
2020-03-01,Sweden,0,0,14,0
2020-03-02,Sweden,5,0,19,0
2020-03-03,Sweden,13,0,32,0
2020-03-04,Sweden,30,0,62,0
2020-03-05,Sweden,25,0,87,0
2020-03-06,Sweden,59,0,146,0
2020-03-07,Sweden,33,0,179,0
2020-03-08,Sweden,46,0,225,0
2020-03-09,Sweden,101,0,326,0
2020-03-10,Sweden,98,1,424,1
2020-03-11,Sweden,196,0,620,1
2020-03-12,Sweden,151,1,771,2
2020-03-13,Sweden,152,1,923,3
2020-03-14,Sweden,71,2,994,5
2020-03-15,Sweden,69,2,1063,7
2020-03-16,Sweden,83,1,1146,8
2020-03-17,Sweden,119,6,1265,14
2020-03-18,Sweden,145,7,1410,21
2020-03-19,Sweden,143,9,1553,30
2020-03-20,Sweden,180,8,1733,38
2020-03-21,Sweden,135,11,1868,49
2020-03-22,Sweden,118,11,1986,60
2020-03-23,Sweden,182,21,2168,81
2020-03-24,Sweden,230,22,2398,103
2020-03-25,Sweden,314,31,2712,134
2020-03-26,Sweden,286,32,2998,166
2020-03-27,Sweden,365,35,3363,201
2020-03-28,Sweden,300,38,3663,239
2020-03-29,Sweden,280,45,3943,284
2020-03-30,Sweden,416,48,4359,332
2020-03-31,Sweden,475,53,4834,385
2020-04-01,Sweden,486,70,5320,455
2020-04-02,Sweden,554,80,5874,535
2020-04-03,Sweden,601,70,6475,605
2020-04-04,Sweden,357,-232,6832,373
2020-04-05,Sweden,340,28,7172,401
2020-04-06,Sweden,389,76,7561,477
2020-04-07,Sweden,738,114,8299,591
2020-04-08,Sweden,655,96,8954,687
2020-04-09,Sweden,645,106,9599,793
2020-04-10,Sweden,454,77,10053,870
2020-04-11,Sweden,395,17,10448,887
2020-04-12,Sweden,464,12,10912,899
2020-04-13,Sweden,437,20,11349,919
2020-04-14,Sweden,479,114,11828,1033
2020-04-15,Sweden,604,170,12432,1203
2020-04-16,Sweden,623,130,13055,1333
2020-04-17,Sweden,688,67,13743,1400
2020-04-18,Sweden,532,111,14275,1511
2020-04-19,Sweden,388,29,14663,1540
2020-04-20,Sweden,461,40,15124,1580
2020-04-21,Sweden,707,185,15831,1765
2020-04-22,Sweden,722,172,16553,1937
2020-04-23,Sweden,758,84,17311,2021
2020-04-24,Sweden,779,131,18090,2152
2020-04-25,Sweden,473,40,18563,2192
2020-04-26,Sweden,300,2,18863,2194
2020-04-27,Sweden,563,80,19426,2274
2020-04-28,Sweden,742,81,20168,2355
2020-04-29,Sweden,798,107,20966,2462
2020-04-30,Sweden,635,124,21601,2586
2020-05-01,Sweden,532,67,22133,2653
2020-05-02,Sweden,299,16,22432,2669
2020-05-03,Sweden,261,10,22693,2679
2020-05-04,Sweden,476,90,23169,2769
2020-05-05,Sweden,657,85,23826,2854
2020-05-06,Sweden,746,87,24572,2941
2020-05-07,Sweden,787,99,25359,3040
2020-05-08,Sweden,700,135,26059,3175
2020-05-09,Sweden,509,45,26568,3220
2020-05-10,Sweden,278,5,26846,3225
2020-05-11,Sweden,455,31,27301,3256
2020-05-12,Sweden,754,57,28055,3313
2020-05-13,Sweden,700,147,28755,3460
2020-05-14,Sweden,660,69,29415,3529
2020-05-15,Sweden,688,117,30103,3646
2020-05-16,Sweden,358,28,30461,3674
2020-05-17,Sweden,259,5,30720,3679
2020-05-18,Sweden,431,19,31151,3698
2020-05-19,Sweden,667,45,31818,3743
2020-05-20,Sweden,808,88,32626,3831
2020-05-21,Sweden,610,40,33236,3871
2020-05-22,Sweden,532,54,33768,3925
2020-05-23,Sweden,403,67,34171,3992
2020-05-24,Sweden,210,6,34381,3998
2020-05-25,Sweden,490,31,34871,4029
2020-05-26,Sweden,746,96,35617,4125
2020-05-27,Sweden,800,95,36417,4220
2020-05-28,Sweden,774,46,37191,4266
2020-05-29,Sweden,773,84,37964,4350
2020-05-30,Sweden,432,45,38396,4395
2020-05-31,Sweden,265,0,38661,4395
2020-06-01,Sweden,648,8,39309,4403
2020-06-02,Sweden,901,65,40210,4468
2020-06-03,Sweden,1046,74,41256,4542
2020-06-04,Sweden,1039,20,42295,4562
2020-06-05,Sweden,1146,77,43441,4639
2020-06-06,Sweden,783,17,44224,4656
2020-06-07,Sweden,462,3,44686,4659
2020-06-08,Sweden,677,35,45363,4694
2020-06-09,Sweden,936,23,46299,4717
2020-06-10,Sweden,1437,78,47736,4795
2020-06-11,Sweden,1294,19,49030,4814
2020-06-12,Sweden,1337,40,50367,4854
2020-06-13,Sweden,1042,20,51409,4874
2020-06-14,Sweden,418,0,51827,4874
2020-06-15,Sweden,684,17,52511,4891
2020-06-16,Sweden,1218,48,53729,4939
2020-06-17,Sweden,1457,102,55186,5041
2020-06-18,Sweden,1496,12,56682,5053
2020-06-19,Sweden,1213,0,57895,5053
2020-06-20,Sweden,702,0,58597,5053
2020-06-21,Sweden,321,0,58918,5053
2020-06-22,Sweden,800,0,59718,5053
2020-06-23,Sweden,1312,108,61030,5161
2020-06-24,Sweden,1698,48,62728,5209
2020-06-25,Sweden,1281,21,64009,5230
2020-06-26,Sweden,1203,50,65212,5280
2020-06-27,Sweden,760,0,65972,5280
2020-06-28,Sweden,420,0,66392,5280
2020-06-29,Sweden,727,0,67119,5280
2020-06-30,Sweden,805,53,67924,5333
2020-07-01,Sweden,684,37,68608,5370
2020-07-02,Sweden,689,41,69297,5411
2020-07-03,Sweden,699,9,69996,5420
2020-07-04,Sweden,370,0,70366,5420
2020-07-05,Sweden,315,0,70681,5420
2020-07-06,Sweden,251,0,70932,5420
2020-07-07,Sweden,278,27,71210,5447
2020-07-08,Sweden,537,35,71747,5482
2020-07-09,Sweden,335,18,72082,5500
2020-07-10,Sweden,377,26,72459,5526
2020-07-11,Sweden,314,0,72773,5526
2020-07-12,Sweden,106,0,72879,5526
2020-07-13,Sweden,170,0,73049,5526
2020-07-14,Sweden,315,19,73364,5545
2020-07-15,Sweden,299,27,73663,5572
2020-07-16,Sweden,273,21,73936,5593
2020-07-17,Sweden,299,26,74235,5619
2020-07-18,Sweden,200,0,74435,5619
2020-07-19,Sweden,110,0,74545,5619
2020-07-20,Sweden,131,0,74676,5619
2020-07-21,Sweden,226,27,74902,5646
2020-07-22,Sweden,297,21,75199,5667
2020-07-23,Sweden,220,9,75419,5676
2020-07-24,Sweden,262,21,75681,5697
2020-07-25,Sweden,138,0,75819,5697
2020-07-26,Sweden,42,0,75861,5697
2020-07-27,Sweden,71,0,75932,5697
2020-07-28,Sweden,283,5,76215,5702
2020-07-29,Sweden,301,28,76516,5730
2020-07-30,Sweden,302,9,76818,5739
2020-07-31,Sweden,258,4,77076,5743
2020-08-01,Sweden,303,0,77379,5743
2020-08-02,Sweden,38,0,77417,5743
2020-08-03,Sweden,165,0,77582,5743
2020-08-04,Sweden,334,4,77916,5747
2020-08-05,Sweden,425,13,78341,5760
2020-08-06,Sweden,378,6,78719,5766
2020-08-07,Sweden,380,-3,79099,5763
2020-08-08,Sweden,260,0,79359,5763
2020-08-09,Sweden,73,0,79432,5763
2020-08-10,Sweden,196,0,79628,5763
2020-08-11,Sweden,417,7,80045,5770
2020-08-12,Sweden,444,4,80489,5774
2020-08-13,Sweden,362,2,80851,5776
2020-08-14,Sweden,344,7,81195,5783
2020-08-15,Sweden,226,0,81421,5783
2020-08-16,Sweden,63,0,81484,5783
2020-08-17,Sweden,174,0,81658,5783
2020-08-18,Sweden,314,7,81972,5790
2020-08-19,Sweden,351,12,82323,5802
2020-08-20,Sweden,333,3,82656,5805
2020-08-21,Sweden,298,5,82954,5810
2020-08-22,Sweden,160,0,83114,5810
2020-08-23,Sweden,57,0,83171,5810
2020-08-24,Sweden,182,0,83353,5810
2020-08-25,Sweden,225,4,83578,5814
2020-08-26,Sweden,246,3,83824,5817
2020-08-27,Sweden,134,3,83958,5820
2020-08-28,Sweden,0,1,83958,5821
2020-08-29,Sweden,0,0,83958,5821
2020-08-30,Sweden,0,0,83958,5821
2020-08-31,Sweden,421,0,84379,5821
2020-09-01,Sweden,142,-8,84521,5813
2020-09-02,Sweden,11,7,84532,5820
2020-09-03,Sweden,197,12,84729,5832
2020-09-04,Sweden,256,3,84985,5835
2020-09-05,Sweden,0,0,84985,5835
2020-09-06,Sweden,0,0,84985,5835
2020-09-07,Sweden,573,0,85558,5835
2020-09-08,Sweden,149,3,85707,5838
2020-09-09,Sweden,173,4,85880,5842
2020-09-10,Sweden,314,1,86194,5843
2020-09-11,Sweden,311,3,86505,5846
2020-09-12,Sweden,0,0,86505,5846
2020-09-13,Sweden,0,0,86505,5846
2020-09-14,Sweden,0,0,86505,5846
2020-09-15,Sweden,840,0,87345,5846
2020-09-16,Sweden,230,14,87575,5860
2020-09-17,Sweden,310,4,87885,5864
2020-09-18,Sweden,352,1,88237,5865
2020-09-19,Sweden,0,0,88237,5865
2020-09-20,Sweden,0,0,88237,5865
2020-09-21,Sweden,0,0,88237,5865
2020-09-22,Sweden,1199,0,89436,5865
2020-09-23,Sweden,320,11,89756,5876
2020-09-24,Sweden,533,2,90289,5878
2020-09-25,Sweden,634,2,90923,5880
2020-09-26,Sweden,0,0,90923,5880
2020-09-27,Sweden,0,0,90923,5880
2020-09-28,Sweden,0,0,90923,5880
2020-09-29,Sweden,1543,0,92466,5880
2020-09-30,Sweden,397,13,92863,5893
2020-10-01,Sweden,752,0,93615,5893
2020-10-02,Sweden,668,2,94283,5895
2020-10-03,Sweden,0,0,94283,5895
2020-10-04,Sweden,0,0,94283,5895
2020-10-05,Sweden,0,0,94283,5895
2020-10-06,Sweden,1862,0,96145,5895
2020-10-07,Sweden,532,-3,96677,5892
2020-10-08,Sweden,855,0,97532,5892
2020-10-09,Sweden,919,2,98451,5894
2020-10-10,Sweden,0,0,98451,5894
2020-10-11,Sweden,0,0,98451,5894
2020-10-12,Sweden,0,0,98451,5894
2020-10-13,Sweden,2203,0,100654,5894
2020-10-14,Sweden,678,13,101332,5907
2020-10-15,Sweden,1075,3,102407,5910
2020-10-16,Sweden,793,8,103200,5918
2020-10-17,Sweden,0,0,103200,5918
2020-10-18,Sweden,0,0,103200,5918
2020-10-19,Sweden,0,0,103200,5918
2020-10-20,Sweden,3180,0,106380,5918
2020-10-21,Sweden,975,11,107355,5929
2020-10-22,Sweden,1614,1,108969,5930
2020-10-23,Sweden,1625,3,110594,5933
2020-10-24,Sweden,0,0,110594,5933
2020-10-25,Sweden,0,0,110594,5933
2020-10-26,Sweden,0,0,110594,5933
2020-10-27,Sweden,5191,0,115785,5933
2020-10-28,Sweden,2128,-6,117913,5927
2020-10-29,Sweden,3254,7,121167,5934
2020-10-30,Sweden,3188,4,124355,5938
2020-10-31,Sweden,0,0,124355,5938
2020-11-01,Sweden,0,0,124355,5938
2020-11-02,Sweden,0,0,124355,5938
2020-11-03,Sweden,10177,0,134532,5938
2020-11-04,Sweden,3198,59,137730,5997
2020-11-05,Sweden,4034,5,141764,6002
2020-11-06,Sweden,4697,20,146461,6022
2020-11-07,Sweden,0,0,146461,6022
2020-11-08,Sweden,0,0,146461,6022
2020-11-09,Sweden,0,0,146461,6022
2020-11-10,Sweden,15779,0,162240,6022
2020-11-11,Sweden,4467,60,166707,6082
2020-11-12,Sweden,4658,40,171365,6122
2020-11-13,Sweden,5990,42,177355,6164
2020-11-14,Sweden,0,0,177355,6164
2020-11-15,Sweden,0,0,177355,6164
2020-11-16,Sweden,0,0,177355,6164
2020-11-17,Sweden,15084,0,192439,6164
2020-11-18,Sweden,4007,157,196446,6321
2020-11-19,Sweden,4609,19,201055,6340
2020-11-20,Sweden,7240,66,208295,6406
2020-11-21,Sweden,0,0,208295,6406
2020-11-22,Sweden,0,0,208295,6406
2020-11-23,Sweden,0,0,208295,6406
2020-11-24,Sweden,17265,0,225560,6406
2020-11-25,Sweden,4954,149,230514,6555
2020-11-26,Sweden,5841,67,236355,6622
2020-11-27,Sweden,6774,59,243129,6681
2020-11-28,Sweden,0,0,243129,6681
2020-11-29,Sweden,0,0,243129,6681
2020-11-30,Sweden,0,0,243129,6681
2020-12-01,Sweden,17629,0,260758,6681
2020-12-02,Sweden,5400,291,266158,6972
2020-12-03,Sweden,6485,35,272643,7007
2020-12-04,Sweden,6269,60,278912,7067
2020-12-05,Sweden,0,0,278912,7067
2020-12-06,Sweden,0,0,278912,7067
2020-12-07,Sweden,0,0,278912,7067
2020-12-08,Sweden,18820,0,297732,7067
2020-12-09,Sweden,7061,229,304793,7296
2020-12-10,Sweden,7935,58,312728,7354
2020-12-11,Sweden,7370,160,320098,7514
2020-12-12,Sweden,0,0,320098,7514
2020-12-13,Sweden,0,0,320098,7514
2020-12-14,Sweden,0,0,320098,7514
2020-12-15,Sweden,20931,0,341029,7514
2020-12-16,Sweden,7556,288,348585,7802
2020-12-17,Sweden,8881,91,357466,7893
2020-12-18,Sweden,9654,100,367120,7993
2020-12-19,Sweden,0,0,367120,7993
2020-12-20,Sweden,0,0,367120,7993
2020-12-21,Sweden,0,0,367120,7993
2020-12-22,Sweden,22319,0,389439,7993
2020-12-23,Sweden,6609,286,396048,8279
2020-12-24,Sweden,0,0,396048,8279
2020-12-25,Sweden,0,0,396048,8279
2020-12-26,Sweden,0,0,396048,8279
2020-12-27,Sweden,0,0,396048,8279
2020-12-28,Sweden,0,0,396048,8279
2020-12-29,Sweden,32485,0,428533,8279
2020-12-30,Sweden,8846,448,437379,8727
2020-12-31,Sweden,0,0,437379,8727
2021-01-01,Sweden,0,0,437379,8727
2021-01-02,Sweden,0,0,437379,8727
2021-01-03,Sweden,0,0,437379,8727
2021-01-04,Sweden,0,0,437379,8727
2021-01-05,Sweden,32369,238,469748,8965
2021-01-06,Sweden,0,0,469748,8965
2021-01-07,Sweden,12536,297,482284,9262
2021-01-08,Sweden,7187,171,489471,9433
2021-01-09,Sweden,0,0,489471,9433
2021-01-10,Sweden,0,0,489471,9433
2021-01-11,Sweden,0,0,489471,9433
2021-01-12,Sweden,17395,0,506866,9433
2021-01-13,Sweden,5337,401,512203,9834
2021-01-14,Sweden,6580,351,518783,10185
2021-01-15,Sweden,4703,138,523486,10323
2021-01-16,Sweden,0,0,523486,10323
2021-01-17,Sweden,0,0,523486,10323
2021-01-18,Sweden,0,0,523486,10323
2021-01-19,Sweden,9779,0,533265,10323
2021-01-20,Sweden,4702,474,537967,10797
2021-01-21,Sweden,4985,124,542952,10921
2021-01-22,Sweden,4214,84,547166,11005
2021-01-23,Sweden,0,0,547166,11005
2021-01-24,Sweden,0,0,547166,11005
2021-01-25,Sweden,0,0,547166,11005
2021-01-26,Sweden,9123,242,556289,11247
2021-01-27,Sweden,4183,178,560472,11425
2021-01-28,Sweden,4085,95,564557,11520
2021-01-29,Sweden,2400,71,566957,11591
2021-01-30,Sweden,0,0,566957,11591
2021-01-31,Sweden,0,0,566957,11591
2021-02-01,Sweden,0,0,566957,11591
2021-02-02,Sweden,9649,224,576606,11815
2021-02-03,Sweden,4310,124,580916,11939
2021-02-04,Sweden,3758,89,584674,12028
2021-02-05,Sweden,3388,87,588062,12115
2021-02-06,Sweden,0,0,588062,12115
2021-02-07,Sweden,0,0,588062,12115
2021-02-08,Sweden,0,0,588062,12115
2021-02-09,Sweden,8112,73,596174,12188
2021-02-10,Sweden,4070,138,600244,12326
2021-02-11,Sweden,4333,44,604577,12370
2021-02-12,Sweden,3834,58,608411,12428
2021-02-13,Sweden,0,0,608411,12428
2021-02-14,Sweden,0,0,608411,12428
2021-02-15,Sweden,0,0,608411,12428
2021-02-16,Sweden,9458,59,617869,12487
2021-02-17,Sweden,4233,82,622102,12569
2021-02-18,Sweden,4920,29,627022,12598
2021-02-19,Sweden,4144,51,631166,12649
2021-02-20,Sweden,0,0,631166,12649
2021-02-21,Sweden,0,0,631166,12649
2021-02-22,Sweden,0,0,631166,12649
2021-02-23,Sweden,10933,64,642099,12713
2021-02-24,Sweden,5371,80,647470,12793
2021-02-25,Sweden,4995,5,652465,12798
2021-02-26,Sweden,4844,28,657309,12826
2021-02-27,Sweden,0,0,657309,12826
2021-02-28,Sweden,0,0,657309,12826
2021-03-01,Sweden,0,0,657309,12826
2021-03-02,Sweden,11804,56,669113,12882
2021-03-03,Sweden,6179,82,675292,12964
2021-03-04,Sweden,4838,13,680130,12977
2021-03-05,Sweden,4831,26,684961,13003
2021-03-06,Sweden,0,0,684961,13003
2021-03-07,Sweden,0,0,684961,13003
2021-03-08,Sweden,0,0,684961,13003
2021-03-09,Sweden,11014,39,695975,13042
2021-03-10,Sweden,5917,46,701892,13088
2021-03-11,Sweden,5300,23,707192,13111
2021-03-12,Sweden,5335,35,712527,13146
2021-03-13,Sweden,0,0,712527,13146
2021-03-14,Sweden,0,0,712527,13146
2021-03-15,Sweden,0,0,712527,13146
2021-03-16,Sweden,12762,26,725289,13172
2021-03-17,Sweden,6781,56,732070,13228
2021-03-18,Sweden,6467,8,738537,13236
2021-03-19,Sweden,5735,26,744272,13262
2021-03-20,Sweden,0,0,744272,13262
2021-03-21,Sweden,0,0,744272,13262
2021-03-22,Sweden,0,0,744272,13262
2021-03-23,Sweden,14063,53,758335,13315
2021-03-24,Sweden,7649,42,765984,13357
2021-03-25,Sweden,7706,16,773690,13373
2021-03-26,Sweden,6328,29,780018,13402
2021-03-27,Sweden,0,0,780018,13402
2021-03-28,Sweden,0,0,780018,13402
2021-03-29,Sweden,0,0,780018,13402
2021-03-30,Sweden,16427,28,796445,13430
2021-03-31,Sweden,8441,35,804886,13465
2021-04-01,Sweden,8305,33,813191,13498
2021-04-02,Sweden,0,0,813191,13498
2021-04-03,Sweden,0,0,813191,13498
2021-04-04,Sweden,0,0,813191,13498
2021-04-05,Sweden,0,0,813191,13498
2021-04-06,Sweden,21802,35,834993,13533
2021-04-07,Sweden,6814,45,841807,13578
2021-04-08,Sweden,7822,17,849629,13595
2020-02-25,Switzerland,1,0,1,0
2020-02-26,Switzerland,0,0,1,0
2020-02-27,Switzerland,7,0,8,0
2020-02-28,Switzerland,0,0,8,0
2020-02-29,Switzerland,10,0,18,0
2020-03-01,Switzerland,9,0,27,0
2020-03-02,Switzerland,15,0,42,0
2020-03-03,Switzerland,14,0,56,0
2020-03-04,Switzerland,34,0,90,0
2020-03-05,Switzerland,24,1,114,1
2020-03-06,Switzerland,100,0,214,1
2020-03-07,Switzerland,54,0,268,1
2020-03-08,Switzerland,69,1,337,2
2020-03-09,Switzerland,37,0,374,2
2020-03-10,Switzerland,117,1,491,3
2020-03-11,Switzerland,161,1,652,4
2020-03-12,Switzerland,0,0,652,4
2020-03-13,Switzerland,487,7,1139,11
2020-03-14,Switzerland,220,2,1359,13
2020-03-15,Switzerland,841,1,2200,14
2020-03-16,Switzerland,0,0,2200,14
2020-03-17,Switzerland,500,13,2700,27
2020-03-18,Switzerland,328,1,3028,28
2020-03-19,Switzerland,1047,13,4075,41
2020-03-20,Switzerland,1219,13,5294,54
2020-03-21,Switzerland,1281,21,6575,75
2020-03-22,Switzerland,899,23,7474,98
2020-03-23,Switzerland,1321,22,8795,120
2020-03-24,Switzerland,1082,2,9877,122
2020-03-25,Switzerland,1020,31,10897,153
2020-03-26,Switzerland,914,38,11811,191
2020-03-27,Switzerland,1117,40,12928,231
2020-03-28,Switzerland,1148,33,14076,264
2020-03-29,Switzerland,753,36,14829,300
2020-03-30,Switzerland,1093,59,15922,359
2020-03-31,Switzerland,683,74,16605,433
2020-04-01,Switzerland,1163,55,17768,488
2020-04-02,Switzerland,1059,48,18827,536
2020-04-03,Switzerland,779,55,19606,591
2020-04-04,Switzerland,899,75,20505,666
2020-04-05,Switzerland,595,49,21100,715
2020-04-06,Switzerland,557,50,21657,765
2020-04-07,Switzerland,596,56,22253,821
2020-04-08,Switzerland,1027,74,23280,895
2020-04-09,Switzerland,771,53,24051,948
2020-04-10,Switzerland,500,54,24551,1002
2020-04-11,Switzerland,556,34,25107,1036
2020-04-12,Switzerland,308,70,25415,1106
2020-04-13,Switzerland,273,32,25688,1138
2020-04-14,Switzerland,248,36,25936,1174
2020-04-15,Switzerland,400,65,26336,1239
2020-04-16,Switzerland,396,42,26732,1281
2020-04-17,Switzerland,346,46,27078,1327
2020-04-18,Switzerland,326,41,27404,1368
2020-04-19,Switzerland,336,25,27740,1393
2020-04-20,Switzerland,204,36,27944,1429
2020-04-21,Switzerland,119,49,28063,1478
2020-04-22,Switzerland,205,31,28268,1509
2020-04-23,Switzerland,228,40,28496,1549
2020-04-24,Switzerland,181,40,28677,1589
2020-04-25,Switzerland,217,10,28894,1599
2020-04-26,Switzerland,167,11,29061,1610
2020-04-27,Switzerland,103,55,29164,1665
2020-04-28,Switzerland,100,34,29264,1699
2020-04-29,Switzerland,143,17,29407,1716
2020-04-30,Switzerland,179,21,29586,1737
2020-05-01,Switzerland,119,17,29705,1754
2020-05-02,Switzerland,112,8,29817,1762
2020-05-03,Switzerland,88,0,29905,1762
2020-05-04,Switzerland,76,22,29981,1784
2020-05-05,Switzerland,28,11,30009,1795
2020-05-06,Switzerland,51,10,30060,1805
2020-05-07,Switzerland,66,5,30126,1810
2020-05-08,Switzerland,81,13,30207,1823
2020-05-09,Switzerland,44,7,30251,1830
2020-05-10,Switzerland,54,3,30305,1833
2020-05-11,Switzerland,39,12,30344,1845
2020-05-12,Switzerland,36,22,30380,1867
2020-05-13,Switzerland,33,3,30413,1870
2020-05-14,Switzerland,50,2,30463,1872
2020-05-15,Switzerland,51,6,30514,1878
2020-05-16,Switzerland,58,1,30572,1879
2020-05-17,Switzerland,15,2,30587,1881
2020-05-18,Switzerland,10,5,30597,1886
2020-05-19,Switzerland,21,5,30618,1891
2020-05-20,Switzerland,40,1,30658,1892
2020-05-21,Switzerland,36,6,30694,1898
2020-05-22,Switzerland,13,5,30707,1903
2020-05-23,Switzerland,18,2,30725,1905
2020-05-24,Switzerland,11,1,30736,1906
2020-05-25,Switzerland,10,7,30746,1913
2020-05-26,Switzerland,15,2,30761,1915
2020-05-27,Switzerland,15,2,30776,1917
2020-05-28,Switzerland,20,2,30796,1919
2020-05-29,Switzerland,32,0,30828,1919
2020-05-30,Switzerland,17,0,30845,1919
2020-05-31,Switzerland,17,1,30862,1920
2020-06-01,Switzerland,9,0,30871,1920
2020-06-02,Switzerland,3,0,30874,1920
2020-06-03,Switzerland,19,1,30893,1921
2020-06-04,Switzerland,20,0,30913,1921
2020-06-05,Switzerland,23,0,30936,1921
2020-06-06,Switzerland,20,0,30956,1921
2020-06-07,Switzerland,9,0,30965,1921
2020-06-08,Switzerland,7,2,30972,1923
2020-06-09,Switzerland,16,11,30988,1934
2020-06-10,Switzerland,23,2,31011,1936
2020-06-11,Switzerland,33,1,31044,1937
2020-06-12,Switzerland,19,1,31063,1938
2020-06-13,Switzerland,31,0,31094,1938
2020-06-14,Switzerland,23,0,31117,1938
2020-06-15,Switzerland,14,1,31131,1939
2020-06-16,Switzerland,23,15,31154,1954
2020-06-17,Switzerland,33,2,31187,1956
2020-06-18,Switzerland,13,0,31200,1956
2020-06-19,Switzerland,35,0,31235,1956
2020-06-20,Switzerland,8,0,31243,1956
2020-06-21,Switzerland,49,0,31292,1956
2020-06-22,Switzerland,18,0,31310,1956
2020-06-23,Switzerland,22,0,31332,1956
2020-06-24,Switzerland,44,2,31376,1958
2020-06-25,Switzerland,52,0,31428,1958
2020-06-26,Switzerland,58,4,31486,1962
2020-06-27,Switzerland,69,0,31555,1962
2020-06-28,Switzerland,62,0,31617,1962
2020-06-29,Switzerland,35,0,31652,1962
2020-06-30,Switzerland,62,1,31714,1963
2020-07-01,Switzerland,137,2,31851,1965
2020-07-02,Switzerland,116,0,31967,1965
2020-07-03,Switzerland,134,0,32101,1965
2020-07-04,Switzerland,97,0,32198,1965
2020-07-05,Switzerland,70,0,32268,1965
2020-07-06,Switzerland,47,0,32315,1965
2020-07-07,Switzerland,54,1,32369,1966
2020-07-08,Switzerland,129,0,32498,1966
2020-07-09,Switzerland,88,0,32586,1966
2020-07-10,Switzerland,104,0,32690,1966
2020-07-11,Switzerland,127,2,32817,1968
2020-07-12,Switzerland,66,0,32883,1968
2020-07-13,Switzerland,63,0,32946,1968
2020-07-14,Switzerland,70,0,33016,1968
2020-07-15,Switzerland,132,0,33148,1968
2020-07-16,Switzerland,142,1,33290,1969
2020-07-17,Switzerland,92,0,33382,1969
2020-07-18,Switzerland,110,0,33492,1969
2020-07-19,Switzerland,99,0,33591,1969
2020-07-20,Switzerland,43,2,33634,1971
2020-07-21,Switzerland,108,1,33742,1972
2020-07-22,Switzerland,141,0,33883,1972
2020-07-23,Switzerland,117,3,34000,1975
2020-07-24,Switzerland,154,2,34154,1977
2020-07-25,Switzerland,148,0,34302,1977
2020-07-26,Switzerland,110,0,34412,1977
2020-07-27,Switzerland,65,1,34477,1978
2020-07-28,Switzerland,132,0,34609,1978
2020-07-29,Switzerland,193,1,34802,1979
2020-07-30,Switzerland,220,1,35022,1980
2020-07-31,Switzerland,210,1,35232,1981
2020-08-01,Switzerland,180,0,35412,1981
2020-08-02,Switzerland,138,0,35550,1981
2020-08-03,Switzerland,66,0,35616,1981
2020-08-04,Switzerland,130,0,35746,1981
2020-08-05,Switzerland,181,3,35927,1984
2020-08-06,Switzerland,181,1,36108,1985
2020-08-07,Switzerland,161,1,36269,1986
2020-08-08,Switzerland,182,0,36451,1986
2020-08-09,Switzerland,152,0,36603,1986
2020-08-10,Switzerland,105,1,36708,1987
2020-08-11,Switzerland,187,3,36895,1990
2020-08-12,Switzerland,274,1,37169,1991
2020-08-13,Switzerland,234,0,37403,1991
2020-08-14,Switzerland,268,0,37671,1991
2020-08-15,Switzerland,253,0,37924,1991
2020-08-16,Switzerland,200,0,38124,1991
2020-08-17,Switzerland,128,0,38252,1991
2020-08-18,Switzerland,197,1,38449,1992
2020-08-19,Switzerland,311,4,38760,1996
2020-08-20,Switzerland,266,2,39026,1998
2020-08-21,Switzerland,306,2,39332,2000
2020-08-22,Switzerland,295,0,39627,2000
2020-08-23,Switzerland,276,1,39903,2001
2020-08-24,Switzerland,157,0,40060,2001
2020-08-25,Switzerland,202,1,40262,2002
2020-08-26,Switzerland,383,1,40645,2003
2020-08-27,Switzerland,361,0,41006,2003
2020-08-28,Switzerland,340,1,41346,2004
2020-08-29,Switzerland,376,1,41722,2005
2020-08-30,Switzerland,292,0,42014,2005
2020-08-31,Switzerland,163,1,42177,2006
2020-09-01,Switzerland,216,5,42393,2011
2020-09-02,Switzerland,370,0,42763,2011
2020-09-03,Switzerland,364,2,43127,2013
2020-09-04,Switzerland,405,0,43532,2013
2020-09-05,Switzerland,425,0,43957,2013
2020-09-06,Switzerland,444,0,44401,2013
2020-09-07,Switzerland,191,1,44592,2014
2020-09-08,Switzerland,245,4,44837,2018
2020-09-09,Switzerland,469,1,45306,2019
2020-09-10,Switzerland,405,1,45711,2020
2020-09-11,Switzerland,528,0,46239,2020
2020-09-12,Switzerland,465,0,46704,2020
2020-09-13,Switzerland,475,1,47179,2021
2020-09-14,Switzerland,257,4,47436,2025
2020-09-15,Switzerland,315,3,47751,2028
2020-09-16,Switzerland,514,11,48265,2039
2020-09-17,Switzerland,530,3,48795,2042
2020-09-18,Switzerland,488,3,49283,2045
2020-09-19,Switzerland,0,0,49283,2045
2020-09-20,Switzerland,0,0,49283,2045
2020-09-21,Switzerland,1095,5,50378,2050
2020-09-22,Switzerland,286,4,50664,2054
2020-09-23,Switzerland,437,6,51101,2060
2020-09-24,Switzerland,391,1,51492,2061
2020-09-25,Switzerland,372,3,51864,2064
2020-09-26,Switzerland,0,0,51864,2064
2020-09-27,Switzerland,0,0,51864,2064
2020-09-28,Switzerland,782,1,52646,2065
2020-09-29,Switzerland,225,4,52871,2069
2020-09-30,Switzerland,411,5,53282,2074
2020-10-01,Switzerland,550,0,53832,2074
2020-10-02,Switzerland,552,1,54384,2075
2020-10-03,Switzerland,0,1,54384,2076
2020-10-04,Switzerland,0,1,54384,2077
2020-10-05,Switzerland,1548,1,55932,2078
2020-10-06,Switzerland,700,3,56632,2081
2020-10-07,Switzerland,1077,1,57709,2082
2020-10-08,Switzerland,1172,5,58881,2087
2020-10-09,Switzerland,1487,1,60368,2088
2020-10-10,Switzerland,0,0,60368,2088
2020-10-11,Switzerland,0,0,60368,2088
2020-10-12,Switzerland,4068,8,64436,2096
2020-10-13,Switzerland,1445,7,65881,2103
2020-10-14,Switzerland,2823,6,68704,2109
2020-10-15,Switzerland,2613,6,71317,2115
2020-10-16,Switzerland,3105,7,74422,2122
2020-10-17,Switzerland,0,0,74422,2122
2020-10-18,Switzerland,0,1,74422,2123
2020-10-19,Switzerland,8737,15,83159,2138
2020-10-20,Switzerland,3008,7,86167,2145
2020-10-21,Switzerland,5596,-106,91763,2039
2020-10-22,Switzerland,5256,7,97019,2046
2020-10-23,Switzerland,6634,21,103653,2067
2020-10-24,Switzerland,0,14,103653,2081
2020-10-25,Switzerland,0,2,103653,2083
2020-10-26,Switzerland,17440,28,121093,2111
2020-10-27,Switzerland,5949,36,127042,2147
2020-10-28,Switzerland,8616,11,135658,2158
2020-10-29,Switzerland,9386,42,145044,2200
2020-10-30,Switzerland,9207,77,154251,2277
2020-10-31,Switzerland,0,20,154251,2297
2020-11-01,Switzerland,0,29,154251,2326
2020-11-02,Switzerland,21926,78,176177,2404
2020-11-03,Switzerland,6126,67,182303,2471
2020-11-04,Switzerland,10073,84,192376,2555
2020-11-05,Switzerland,10128,73,202504,2628
2020-11-06,Switzerland,9409,82,211913,2710
2020-11-07,Switzerland,0,39,211913,2749
2020-11-08,Switzerland,0,23,211913,2772
2020-11-09,Switzerland,17309,130,229222,2902
2020-11-10,Switzerland,5980,111,235202,3013
2020-11-11,Switzerland,8270,100,243472,3113
2020-11-12,Switzerland,6924,103,250396,3216
2020-11-13,Switzerland,6739,99,257135,3315
2020-11-14,Switzerland,0,36,257135,3351
2020-11-15,Switzerland,0,18,257135,3369
2020-11-16,Switzerland,12839,167,269974,3536
2020-11-17,Switzerland,4560,128,274534,3664
2020-11-18,Switzerland,6114,101,280648,3765
2020-11-19,Switzerland,5007,114,285655,3879
2020-11-20,Switzerland,4946,113,290601,3992
2020-11-21,Switzerland,0,39,290601,4031
2020-11-22,Switzerland,0,25,290601,4056
2020-11-23,Switzerland,9751,166,300352,4222
2020-11-24,Switzerland,4241,86,304593,4308
2020-11-25,Switzerland,4876,85,309469,4393
2020-11-26,Switzerland,4509,116,313978,4509
2020-11-27,Switzerland,4312,62,318290,4571
2020-11-28,Switzerland,0,50,318290,4621
2020-11-29,Switzerland,0,29,318290,4650
2020-11-30,Switzerland,8782,165,327072,4815
2020-12-01,Switzerland,3802,125,330874,4940
2020-12-02,Switzerland,4786,105,335660,5045
2020-12-03,Switzerland,4455,136,340115,5181
2020-12-04,Switzerland,4382,112,344497,5293
2020-12-05,Switzerland,0,31,344497,5324
2020-12-06,Switzerland,0,25,344497,5349
2020-12-07,Switzerland,9809,146,354306,5495
2020-12-08,Switzerland,4262,98,358568,5593
2020-12-09,Switzerland,5086,117,363654,5710
2020-12-10,Switzerland,5041,114,368695,5824
2020-12-11,Switzerland,5136,104,373831,5928
2020-12-12,Switzerland,0,48,373831,5976
2020-12-13,Switzerland,0,9,373831,5985
2020-12-14,Switzerland,10726,169,384557,6154
2020-12-15,Switzerland,4271,112,388828,6266
2020-12-16,Switzerland,5625,113,394453,6379
2020-12-17,Switzerland,5058,108,399511,6487
2020-12-18,Switzerland,4478,74,403989,6561
2020-12-19,Switzerland,0,41,403989,6602
2020-12-20,Switzerland,0,20,403989,6622
2020-12-21,Switzerland,10002,159,413991,6781
2020-12-22,Switzerland,4275,143,418266,6924
2020-12-23,Switzerland,5033,105,423299,7029
2020-12-24,Switzerland,4898,69,428197,7098
2020-12-25,Switzerland,0,61,428197,7159
2020-12-26,Switzerland,0,34,428197,7193
2020-12-27,Switzerland,0,17,428197,7210
2020-12-28,Switzerland,10087,152,438284,7362
2020-12-29,Switzerland,4197,131,442481,7493
2020-12-30,Switzerland,5424,101,447905,7594
2020-12-31,Switzerland,4391,51,452296,7645
2021-01-01,Switzerland,0,59,452296,7704
2021-01-02,Switzerland,0,25,452296,7729
2021-01-03,Switzerland,0,18,452296,7747
2021-01-04,Switzerland,9665,171,461961,7918
2021-01-05,Switzerland,4020,100,465981,8018
2021-01-06,Switzerland,4808,91,470789,8109
2021-01-07,Switzerland,3975,69,474764,8178
2021-01-08,Switzerland,3219,52,477983,8230
2021-01-09,Switzerland,0,23,477983,8253
2021-01-10,Switzerland,0,14,477983,8267
2021-01-11,Switzerland,6523,97,484506,8364
2021-01-12,Switzerland,2851,106,487357,8470
2021-01-13,Switzerland,3001,51,490358,8521
2021-01-14,Switzerland,2474,65,492832,8586
2021-01-15,Switzerland,2396,60,495228,8646
2021-01-16,Switzerland,0,29,495228,8675
2021-01-17,Switzerland,0,7,495228,8682
2021-01-18,Switzerland,4703,110,499931,8792
2021-01-19,Switzerland,2260,67,502191,8859
2021-01-20,Switzerland,2727,65,504918,8924
2021-01-21,Switzerland,2205,47,507123,8971
2021-01-22,Switzerland,2156,63,509279,9034
2021-01-23,Switzerland,0,16,509279,9050
2021-01-24,Switzerland,0,15,509279,9065
2021-01-25,Switzerland,4320,81,513599,9146
2021-01-26,Switzerland,1884,58,515483,9204
2021-01-27,Switzerland,2222,56,517705,9260
2021-01-28,Switzerland,1699,48,519404,9308
2021-01-29,Switzerland,1916,46,521320,9354
2021-01-30,Switzerland,0,16,521320,9370
2021-01-31,Switzerland,0,11,521320,9381
2021-02-01,Switzerland,3775,71,525095,9452
2021-02-02,Switzerland,1633,37,526728,9489
2021-02-03,Switzerland,1796,41,528524,9530
2021-02-04,Switzerland,1765,26,530289,9556
2021-02-05,Switzerland,1584,28,531873,9584
2021-02-06,Switzerland,0,22,531873,9606
2021-02-07,Switzerland,0,7,531873,9613
2021-02-08,Switzerland,3280,38,535153,9651
2021-02-09,Switzerland,1363,36,536516,9687
2021-02-10,Switzerland,1602,24,538118,9711
2021-02-11,Switzerland,1356,18,539474,9729
2021-02-12,Switzerland,1253,18,540727,9747
2021-02-13,Switzerland,0,8,540727,9755
2021-02-14,Switzerland,0,10,540727,9765
2021-02-15,Switzerland,2480,11,543207,9776
2021-02-16,Switzerland,1075,41,544282,9817
2021-02-17,Switzerland,1253,32,545535,9849
2021-02-18,Switzerland,1219,27,546754,9876
2021-02-19,Switzerland,1021,7,547775,9883
2021-02-20,Switzerland,0,3,547775,9886
2021-02-21,Switzerland,0,1,547775,9887
2021-02-22,Switzerland,2449,20,550224,9907
2021-02-23,Switzerland,1131,23,551355,9930
2021-02-24,Switzerland,1343,12,552698,9942
2021-02-25,Switzerland,1169,12,553867,9954
2021-02-26,Switzerland,1065,7,554932,9961
2021-02-27,Switzerland,0,5,554932,9966
2021-02-28,Switzerland,0,0,554932,9966
2021-03-01,Switzerland,2560,22,557492,9988
2021-03-02,Switzerland,1130,17,558622,10005
2021-03-03,Switzerland,1223,9,559845,10014
2021-03-04,Switzerland,1223,8,561068,10022
2021-03-05,Switzerland,1222,19,562290,10041
2021-03-06,Switzerland,0,5,562290,10046
2021-03-07,Switzerland,0,2,562290,10048
2021-03-08,Switzerland,2744,8,565034,10056
2021-03-09,Switzerland,1378,9,566412,10065
2021-03-10,Switzerland,1491,17,567903,10082
2021-03-11,Switzerland,1409,8,569312,10090
2021-03-12,Switzerland,1333,14,570645,10104
2021-03-13,Switzerland,0,4,570645,10108
2021-03-14,Switzerland,0,4,570645,10112
2021-03-15,Switzerland,3170,6,573815,10118
2021-03-16,Switzerland,1438,29,575253,10147
2021-03-17,Switzerland,1858,16,577111,10163
2021-03-18,Switzerland,1750,20,578861,10183
2021-03-19,Switzerland,1748,20,580609,10203
2021-03-20,Switzerland,0,0,580609,10203
2021-03-21,Switzerland,0,10,580609,10213
2021-03-22,Switzerland,3643,26,584252,10239
2021-03-23,Switzerland,1844,8,586096,10247
2021-03-24,Switzerland,2022,29,588118,10276
2021-03-25,Switzerland,2046,8,590164,10284
2021-03-26,Switzerland,2053,14,592217,10298
2021-03-27,Switzerland,0,1,592217,10299
2021-03-28,Switzerland,0,1,592217,10300
2021-03-29,Switzerland,4573,5,596790,10305
2021-03-30,Switzerland,1923,17,598713,10322
2021-03-31,Switzerland,2411,15,601124,10337
2021-04-01,Switzerland,1968,13,603092,10350
2021-04-02,Switzerland,2250,1,605342,10351
2021-04-03,Switzerland,0,0,605342,10351
2021-04-04,Switzerland,0,2,605342,10353
2021-04-05,Switzerland,0,24,605342,10377
2021-04-06,Switzerland,4932,26,610274,10403
2021-04-07,Switzerland,2301,29,612575,10432
2021-04-08,Switzerland,2449,13,615024,10445
2020-03-22,Syria,1,0,1,0
2020-03-23,Syria,0,0,1,0
2020-03-24,Syria,0,0,1,0
2020-03-25,Syria,4,0,5,0
2020-03-26,Syria,0,0,5,0
2020-03-27,Syria,0,0,5,0
2020-03-28,Syria,0,0,5,0
2020-03-29,Syria,4,1,9,1
2020-03-30,Syria,1,1,10,2
2020-03-31,Syria,0,0,10,2
2020-04-01,Syria,0,0,10,2
2020-04-02,Syria,6,0,16,2
2020-04-03,Syria,0,0,16,2
2020-04-04,Syria,0,0,16,2
2020-04-05,Syria,3,0,19,2
2020-04-06,Syria,0,0,19,2
2020-04-07,Syria,0,0,19,2
2020-04-08,Syria,0,0,19,2
2020-04-09,Syria,0,0,19,2
2020-04-10,Syria,0,0,19,2
2020-04-11,Syria,6,0,25,2
2020-04-12,Syria,0,0,25,2
2020-04-13,Syria,0,0,25,2
2020-04-14,Syria,4,0,29,2
2020-04-15,Syria,4,0,33,2
2020-04-16,Syria,0,0,33,2
2020-04-17,Syria,5,0,38,2
2020-04-18,Syria,0,0,38,2
2020-04-19,Syria,1,1,39,3
2020-04-20,Syria,0,0,39,3
2020-04-21,Syria,3,0,42,3
2020-04-22,Syria,0,0,42,3
2020-04-23,Syria,0,0,42,3
2020-04-24,Syria,0,0,42,3
2020-04-25,Syria,0,0,42,3
2020-04-26,Syria,1,0,43,3
2020-04-27,Syria,0,0,43,3
2020-04-28,Syria,0,0,43,3
2020-04-29,Syria,0,0,43,3
2020-04-30,Syria,0,0,43,3
2020-05-01,Syria,1,0,44,3
2020-05-02,Syria,0,0,44,3
2020-05-03,Syria,0,0,44,3
2020-05-04,Syria,0,0,44,3
2020-05-05,Syria,0,0,44,3
2020-05-06,Syria,1,0,45,3
2020-05-07,Syria,0,0,45,3
2020-05-08,Syria,2,0,47,3
2020-05-09,Syria,0,0,47,3
2020-05-10,Syria,0,0,47,3
2020-05-11,Syria,0,0,47,3
2020-05-12,Syria,0,0,47,3
2020-05-13,Syria,1,0,48,3
2020-05-14,Syria,0,0,48,3
2020-05-15,Syria,2,0,50,3
2020-05-16,Syria,1,0,51,3
2020-05-17,Syria,7,0,58,3
2020-05-18,Syria,0,0,58,3
2020-05-19,Syria,0,0,58,3
2020-05-20,Syria,0,0,58,3
2020-05-21,Syria,0,0,58,3
2020-05-22,Syria,1,1,59,4
2020-05-23,Syria,11,0,70,4
2020-05-24,Syria,16,0,86,4
2020-05-25,Syria,20,0,106,4
2020-05-26,Syria,15,0,121,4
2020-05-27,Syria,0,0,121,4
2020-05-28,Syria,1,0,122,4
2020-05-29,Syria,0,0,122,4
2020-05-30,Syria,0,0,122,4
2020-05-31,Syria,0,1,122,5
2020-06-01,Syria,1,0,123,5
2020-06-02,Syria,0,1,123,6
2020-06-03,Syria,0,0,123,6
2020-06-04,Syria,1,0,124,6
2020-06-05,Syria,0,0,124,6
2020-06-06,Syria,1,0,125,6
2020-06-07,Syria,16,0,141,6
2020-06-08,Syria,3,0,144,6
2020-06-09,Syria,2,0,146,6
2020-06-10,Syria,6,0,152,6
2020-06-11,Syria,12,0,164,6
2020-06-12,Syria,0,0,164,6
2020-06-13,Syria,6,0,170,6
2020-06-14,Syria,7,0,177,6
2020-06-15,Syria,0,0,177,6
2020-06-16,Syria,0,0,177,6
2020-06-17,Syria,1,1,178,7
2020-06-18,Syria,9,0,187,7
2020-06-19,Syria,0,0,187,7
2020-06-20,Syria,11,0,198,7
2020-06-21,Syria,6,0,204,7
2020-06-22,Syria,15,0,219,7
2020-06-23,Syria,12,0,231,7
2020-06-24,Syria,0,0,231,7
2020-06-25,Syria,11,0,242,7
2020-06-26,Syria,13,1,255,8
2020-06-27,Syria,1,1,256,9
2020-06-28,Syria,0,0,256,9
2020-06-29,Syria,13,0,269,9
2020-06-30,Syria,10,0,279,9
2020-07-01,Syria,14,0,293,9
2020-07-02,Syria,19,0,312,9
2020-07-03,Syria,16,1,328,10
2020-07-04,Syria,10,0,338,10
2020-07-05,Syria,20,3,358,13
2020-07-06,Syria,14,1,372,14
2020-07-07,Syria,0,0,372,14
2020-07-08,Syria,0,0,372,14
2020-07-09,Syria,0,0,372,14
2020-07-10,Syria,22,2,394,16
2020-07-11,Syria,0,0,394,16
2020-07-12,Syria,0,0,394,16
2020-07-13,Syria,23,3,417,19
2020-07-14,Syria,22,2,439,21
2020-07-15,Syria,19,1,458,22
2020-07-16,Syria,19,0,477,22
2020-07-17,Syria,19,3,496,25
2020-07-18,Syria,0,0,496,25
2020-07-19,Syria,0,0,496,25
2020-07-20,Syria,26,4,522,29
2020-07-21,Syria,18,2,540,31
2020-07-22,Syria,21,1,561,32
2020-07-23,Syria,23,3,584,35
2020-07-24,Syria,24,0,608,35
2020-07-25,Syria,19,1,627,36
2020-07-26,Syria,23,2,650,38
2020-07-27,Syria,24,2,674,40
2020-07-28,Syria,20,0,694,40
2020-07-29,Syria,23,0,717,40
2020-07-30,Syria,21,1,738,41
2020-07-31,Syria,19,2,757,43
2020-08-01,Syria,23,0,780,43
2020-08-02,Syria,29,1,809,44
2020-08-03,Syria,38,2,847,46
2020-08-04,Syria,45,0,892,46
2020-08-05,Syria,52,2,944,48
2020-08-06,Syria,55,0,999,48
2020-08-07,Syria,61,0,1060,48
2020-08-08,Syria,65,2,1125,50
2020-08-09,Syria,63,2,1188,52
2020-08-10,Syria,67,0,1255,52
2020-08-11,Syria,72,1,1327,53
2020-08-12,Syria,0,0,1327,53
2020-08-13,Syria,105,2,1432,55
2020-08-14,Syria,83,3,1515,58
2020-08-15,Syria,78,2,1593,60
2020-08-16,Syria,84,4,1677,64
2020-08-17,Syria,87,4,1764,68
2020-08-18,Syria,80,5,1844,73
2020-08-19,Syria,83,5,1927,78
2020-08-20,Syria,81,4,2008,82
2020-08-21,Syria,65,1,2073,83
2020-08-22,Syria,70,2,2143,85
2020-08-23,Syria,74,4,2217,89
2020-08-24,Syria,76,3,2293,92
2020-08-25,Syria,72,3,2365,95
2020-08-26,Syria,75,3,2440,98
2020-08-27,Syria,64,2,2504,100
2020-08-28,Syria,59,3,2563,103
2020-08-29,Syria,65,3,2628,106
2020-08-30,Syria,75,3,2703,109
2020-08-31,Syria,62,3,2765,112
2020-09-01,Syria,65,4,2830,116
2020-09-02,Syria,68,4,2898,120
2020-09-03,Syria,75,4,2973,124
2020-09-04,Syria,68,3,3041,127
2020-09-05,Syria,63,3,3104,130
2020-09-06,Syria,67,4,3171,134
2020-09-07,Syria,58,3,3229,137
2020-09-08,Syria,60,3,3289,140
2020-09-09,Syria,62,3,3351,143
2020-09-10,Syria,65,4,3416,147
2020-09-11,Syria,60,3,3476,150
2020-09-12,Syria,30,2,3506,152
2020-09-13,Syria,34,3,3540,155
2020-09-14,Syria,36,2,3576,157
2020-09-15,Syria,38,3,3614,160
2020-09-16,Syria,40,3,3654,163
2020-09-17,Syria,37,2,3691,165
2020-09-18,Syria,40,3,3731,168
2020-09-19,Syria,34,2,3765,170
2020-09-20,Syria,35,2,3800,172
2020-09-21,Syria,33,3,3833,175
2020-09-22,Syria,44,3,3877,178
2020-09-23,Syria,47,3,3924,181
2020-09-24,Syria,42,2,3966,183
2020-09-25,Syria,35,2,4001,185
2020-09-26,Syria,37,3,4038,188
2020-09-27,Syria,34,4,4072,192
2020-09-28,Syria,30,2,4102,194
2020-09-29,Syria,46,3,4148,197
2020-09-30,Syria,52,3,4200,200
2020-10-01,Syria,47,2,4247,202
2020-10-02,Syria,42,1,4289,203
2020-10-03,Syria,40,1,4329,204
2020-10-04,Syria,37,1,4366,205
2020-10-05,Syria,45,2,4411,207
2020-10-06,Syria,46,2,4457,209
2020-10-07,Syria,47,3,4504,212
2020-10-08,Syria,62,3,4566,215
2020-10-09,Syria,50,3,4616,218
2020-10-10,Syria,57,3,4673,221
2020-10-11,Syria,45,3,4718,224
2020-10-12,Syria,56,4,4774,228
2020-10-13,Syria,52,3,4826,231
2020-10-14,Syria,57,3,4883,234
2020-10-15,Syria,48,4,4931,238
2020-10-16,Syria,56,3,4987,241
2020-10-17,Syria,46,4,5033,245
2020-10-18,Syria,44,3,5077,248
2020-10-19,Syria,57,3,5134,251
2020-10-20,Syria,46,3,5180,254
2020-10-21,Syria,44,3,5224,257
2020-10-22,Syria,43,3,5267,260
2020-10-23,Syria,52,4,5319,264
2020-10-24,Syria,40,3,5359,267
2020-10-25,Syria,49,2,5408,269
2020-10-26,Syria,53,3,5461,272
2020-10-27,Syria,67,3,5528,275
2020-10-28,Syria,52,3,5580,278
2020-10-29,Syria,53,3,5633,281
2020-10-30,Syria,50,4,5683,285
2020-10-31,Syria,45,3,5728,288
2020-11-01,Syria,61,4,5789,292
2020-11-02,Syria,54,3,5843,295
2020-11-03,Syria,45,3,5888,298
2020-11-04,Syria,76,3,5964,301
2020-11-05,Syria,76,4,6040,305
2020-11-06,Syria,62,4,6102,309
2020-11-07,Syria,45,4,6147,313
2020-11-08,Syria,68,4,6215,317
2020-11-09,Syria,69,4,6284,321
2020-11-10,Syria,68,4,6352,325
2020-11-11,Syria,69,4,6421,329
2020-11-12,Syria,65,4,6486,333
2020-11-13,Syria,66,4,6552,337
2020-11-14,Syria,61,4,6613,341
2020-11-15,Syria,71,4,6684,345
2020-11-16,Syria,75,5,6759,350
2020-11-17,Syria,77,4,6836,354
2020-11-18,Syria,83,4,6919,358
2020-11-19,Syria,72,5,6991,363
2020-11-20,Syria,88,5,7079,368
2020-11-21,Syria,75,4,7154,372
2020-11-22,Syria,71,4,7225,376
2020-11-23,Syria,70,4,7295,380
2020-11-24,Syria,74,5,7369,385
2020-11-25,Syria,90,6,7459,391
2020-11-26,Syria,83,8,7542,399
2020-11-27,Syria,93,5,7635,404
2020-11-28,Syria,80,5,7715,409
2020-11-29,Syria,82,4,7797,413
2020-11-30,Syria,90,4,7887,417
2020-12-01,Syria,86,5,7973,422
2020-12-02,Syria,86,4,8059,426
2020-12-03,Syria,88,6,8147,432
2020-12-04,Syria,86,5,8233,437
2020-12-05,Syria,87,5,8320,442
2020-12-06,Syria,83,5,8403,447
2020-12-07,Syria,87,5,8490,452
2020-12-08,Syria,90,6,8580,458
2020-12-09,Syria,95,7,8675,465
2020-12-10,Syria,112,11,8787,476
2020-12-11,Syria,124,15,8911,491
2020-12-12,Syria,130,15,9041,506
2020-12-13,Syria,125,12,9166,518
2020-12-14,Syria,136,12,9302,530
2020-12-15,Syria,150,13,9452,543
2020-12-16,Syria,151,11,9603,554
2020-12-17,Syria,156,17,9759,571
2020-12-18,Syria,169,20,9928,591
2020-12-19,Syria,122,10,10050,601
2020-12-20,Syria,145,9,10195,610
2020-12-21,Syria,123,11,10318,621
2020-12-22,Syria,124,9,10442,630
2020-12-23,Syria,129,11,10571,641
2020-12-24,Syria,130,11,10701,652
2020-12-25,Syria,120,8,10821,660
2020-12-26,Syria,111,9,10932,669
2020-12-27,Syria,101,9,11033,678
2020-12-28,Syria,105,8,11138,686
2020-12-29,Syria,105,10,11243,696
2020-12-30,Syria,101,8,11344,704
2020-12-31,Syria,90,7,11434,711
2021-01-01,Syria,92,6,11526,717
2021-01-02,Syria,90,6,11616,723
2021-01-03,Syria,94,6,11710,729
2021-01-04,Syria,89,5,11799,734
2021-01-05,Syria,91,7,11890,741
2021-01-06,Syria,98,6,11988,747
2021-01-07,Syria,96,8,12084,755
2021-01-08,Syria,95,8,12179,763
2021-01-09,Syria,95,5,12274,768
2021-01-10,Syria,90,6,12364,774
2021-01-11,Syria,98,7,12462,781
2021-01-12,Syria,96,9,12558,790
2021-01-13,Syria,102,9,12660,799
2021-01-14,Syria,100,10,12760,809
2021-01-15,Syria,90,8,12850,817
2021-01-16,Syria,92,7,12942,824
2021-01-17,Syria,94,8,13036,832
2021-01-18,Syria,96,9,13132,841
2021-01-19,Syria,92,9,13224,850
2021-01-20,Syria,89,8,13313,858
2021-01-21,Syria,85,8,13398,866
2021-01-22,Syria,81,7,13479,873
2021-01-23,Syria,78,6,13557,879
2021-01-24,Syria,71,6,13628,885
2021-01-25,Syria,69,5,13697,890
2021-01-26,Syria,65,5,13762,895
2021-01-27,Syria,61,5,13823,900
2021-01-28,Syria,62,6,13885,906
2021-01-29,Syria,59,5,13944,911
2021-01-30,Syria,54,5,13998,916
2021-01-31,Syria,50,5,14048,921
2021-02-01,Syria,48,5,14096,926
2021-02-02,Syria,46,3,14142,929
2021-02-03,Syria,60,4,14202,933
2021-02-04,Syria,65,5,14267,938
2021-02-05,Syria,71,5,14338,943
2021-02-06,Syria,70,4,14408,947
2021-02-07,Syria,69,5,14477,952
2021-02-08,Syria,74,6,14551,958
2021-02-09,Syria,60,3,14611,961
2021-02-10,Syria,57,4,14668,965
2021-02-11,Syria,56,3,14724,968
2021-02-12,Syria,41,3,14765,971
2021-02-13,Syria,55,4,14820,975
2021-02-14,Syria,43,3,14863,978
2021-02-15,Syria,43,3,14906,981
2021-02-16,Syria,45,3,14951,984
2021-02-17,Syria,50,3,15001,987
2021-02-18,Syria,44,3,15045,990
2021-02-19,Syria,49,4,15094,994
2021-02-20,Syria,49,2,15143,996
2021-02-21,Syria,36,2,15179,998
2021-02-22,Syria,51,3,15230,1001
2021-02-23,Syria,52,3,15282,1004
2021-02-24,Syria,61,4,15343,1008
2021-02-25,Syria,62,6,15405,1014
2021-02-26,Syria,62,4,15467,1018
2021-02-27,Syria,66,5,15533,1023
2021-02-28,Syria,55,4,15588,1027
2021-03-01,Syria,54,5,15642,1032
2021-03-02,Syria,54,7,15696,1039
2021-03-03,Syria,57,6,15753,1045
2021-03-04,Syria,62,5,15815,1050
2021-03-05,Syria,55,4,15870,1054
2021-03-06,Syria,55,4,15925,1058
2021-03-07,Syria,56,5,15981,1063
2021-03-08,Syria,61,5,16042,1068
2021-03-09,Syria,75,6,16117,1074
2021-03-10,Syria,70,5,16187,1079
2021-03-11,Syria,70,6,16257,1085
2021-03-12,Syria,71,5,16328,1090
2021-03-13,Syria,73,4,16401,1094
2021-03-14,Syria,77,5,16478,1099
2021-03-15,Syria,78,5,16556,1104
2021-03-16,Syria,100,6,16656,1110
2021-03-17,Syria,120,10,16776,1120
2021-03-18,Syria,149,10,16925,1130
2021-03-19,Syria,152,11,17077,1141
2021-03-20,Syria,163,12,17240,1153
2021-03-21,Syria,171,10,17411,1163
2021-03-22,Syria,172,12,17583,1175
2021-03-23,Syria,160,8,17743,1183
2021-03-24,Syria,153,12,17896,1195
2021-03-25,Syria,150,11,18046,1206
2021-03-26,Syria,155,10,18201,1216
2021-03-27,Syria,155,11,18356,1227
2021-03-28,Syria,142,12,18498,1239
2021-03-29,Syria,140,8,18638,1247
2021-03-30,Syria,137,7,18775,1254
2021-03-31,Syria,134,11,18909,1265
2021-04-01,Syria,130,9,19039,1274
2021-04-02,Syria,125,14,19164,1288
2021-04-03,Syria,120,11,19284,1299
2021-04-04,Syria,120,14,19404,1313
2021-04-05,Syria,122,10,19526,1323
2021-04-06,Syria,115,9,19641,1332
2021-04-07,Syria,120,10,19761,1342
2021-04-08,Syria,122,10,19883,1352
2020-01-22,Taiwan,0,0,1,0
2020-01-23,Taiwan,0,0,1,0
2020-01-24,Taiwan,2,0,3,0
2020-01-25,Taiwan,0,0,3,0
2020-01-26,Taiwan,1,0,4,0
2020-01-27,Taiwan,1,0,5,0
2020-01-28,Taiwan,3,0,8,0
2020-01-29,Taiwan,0,0,8,0
2020-01-30,Taiwan,1,0,9,0
2020-01-31,Taiwan,1,0,10,0
2020-02-01,Taiwan,0,0,10,0
2020-02-02,Taiwan,0,0,10,0
2020-02-03,Taiwan,0,0,10,0
2020-02-04,Taiwan,1,0,11,0
2020-02-05,Taiwan,0,0,11,0
2020-02-06,Taiwan,5,0,16,0
2020-02-07,Taiwan,0,0,16,0
2020-02-08,Taiwan,1,0,17,0
2020-02-09,Taiwan,1,0,18,0
2020-02-10,Taiwan,0,0,18,0
2020-02-11,Taiwan,0,0,18,0
2020-02-12,Taiwan,0,0,18,0
2020-02-13,Taiwan,0,0,18,0
2020-02-14,Taiwan,0,0,18,0
2020-02-15,Taiwan,0,0,18,0
2020-02-16,Taiwan,2,1,20,1
2020-02-17,Taiwan,2,0,22,1
2020-02-18,Taiwan,0,0,22,1
2020-02-19,Taiwan,1,0,23,1
2020-02-20,Taiwan,1,0,24,1
2020-02-21,Taiwan,2,0,26,1
2020-02-22,Taiwan,0,0,26,1
2020-02-23,Taiwan,2,0,28,1
2020-02-24,Taiwan,2,0,30,1
2020-02-25,Taiwan,1,0,31,1
2020-02-26,Taiwan,1,0,32,1
2020-02-27,Taiwan,0,0,32,1
2020-02-28,Taiwan,2,0,34,1
2020-02-29,Taiwan,5,0,39,1
2020-03-01,Taiwan,1,0,40,1
2020-03-02,Taiwan,1,0,41,1
2020-03-03,Taiwan,1,0,42,1
2020-03-04,Taiwan,0,0,42,1
2020-03-05,Taiwan,2,0,44,1
2020-03-06,Taiwan,1,0,45,1
2020-03-07,Taiwan,0,0,45,1
2020-03-08,Taiwan,0,0,45,1
2020-03-09,Taiwan,0,0,45,1
2020-03-10,Taiwan,2,0,47,1
2020-03-11,Taiwan,1,0,48,1
2020-03-12,Taiwan,1,0,49,1
2020-03-13,Taiwan,1,0,50,1
2020-03-14,Taiwan,3,0,53,1
2020-03-15,Taiwan,6,0,59,1
2020-03-16,Taiwan,8,0,67,1
2020-03-17,Taiwan,10,0,77,1
2020-03-18,Taiwan,23,0,100,1
2020-03-19,Taiwan,8,0,108,1
2020-03-20,Taiwan,27,1,135,2
2020-03-21,Taiwan,18,0,153,2
2020-03-22,Taiwan,16,0,169,2
2020-03-23,Taiwan,26,0,195,2
2020-03-24,Taiwan,20,0,215,2
2020-03-25,Taiwan,20,0,235,2
2020-03-26,Taiwan,17,0,252,2
2020-03-27,Taiwan,15,0,267,2
2020-03-28,Taiwan,16,0,283,2
2020-03-29,Taiwan,15,0,298,2
2020-03-30,Taiwan,8,3,306,5
2020-03-31,Taiwan,16,0,322,5
2020-04-01,Taiwan,7,0,329,5
2020-04-02,Taiwan,10,0,339,5
2020-04-03,Taiwan,9,0,348,5
2020-04-04,Taiwan,7,0,355,5
2020-04-05,Taiwan,8,0,363,5
2020-04-06,Taiwan,10,0,373,5
2020-04-07,Taiwan,3,0,376,5
2020-04-08,Taiwan,3,0,379,5
2020-04-09,Taiwan,1,0,380,5
2020-04-10,Taiwan,2,1,382,6
2020-04-11,Taiwan,3,0,385,6
2020-04-12,Taiwan,3,0,388,6
2020-04-13,Taiwan,5,0,393,6
2020-04-14,Taiwan,0,0,393,6
2020-04-15,Taiwan,2,0,395,6
2020-04-16,Taiwan,0,0,395,6
2020-04-17,Taiwan,0,0,395,6
2020-04-18,Taiwan,3,0,398,6
2020-04-19,Taiwan,22,0,420,6
2020-04-20,Taiwan,2,0,422,6
2020-04-21,Taiwan,3,0,425,6
2020-04-22,Taiwan,1,0,426,6
2020-04-23,Taiwan,1,0,427,6
2020-04-24,Taiwan,1,0,428,6
2020-04-25,Taiwan,1,0,429,6
2020-04-26,Taiwan,0,0,429,6
2020-04-27,Taiwan,0,0,429,6
2020-04-28,Taiwan,0,0,429,6
2020-04-29,Taiwan,0,0,429,6
2020-04-30,Taiwan,0,0,429,6
2020-05-01,Taiwan,0,0,429,6
2020-05-02,Taiwan,3,0,432,6
2020-05-03,Taiwan,4,0,436,6
2020-05-04,Taiwan,2,0,438,6
2020-05-05,Taiwan,0,0,438,6
2020-05-06,Taiwan,1,0,439,6
2020-05-07,Taiwan,1,0,440,6
2020-05-08,Taiwan,0,0,440,6
2020-05-09,Taiwan,0,0,440,6
2020-05-10,Taiwan,0,0,440,6
2020-05-11,Taiwan,0,1,440,7
2020-05-12,Taiwan,0,0,440,7
2020-05-13,Taiwan,0,0,440,7
2020-05-14,Taiwan,0,0,440,7
2020-05-15,Taiwan,0,0,440,7
2020-05-16,Taiwan,0,0,440,7
2020-05-17,Taiwan,0,0,440,7
2020-05-18,Taiwan,0,0,440,7
2020-05-19,Taiwan,0,0,440,7
2020-05-20,Taiwan,0,0,440,7
2020-05-21,Taiwan,0,0,440,7
2020-05-22,Taiwan,1,0,441,7
2020-05-23,Taiwan,0,0,441,7
2020-05-24,Taiwan,0,0,441,7
2020-05-25,Taiwan,0,0,441,7
2020-05-26,Taiwan,0,0,441,7
2020-05-27,Taiwan,0,0,441,7
2020-05-28,Taiwan,0,0,441,7
2020-05-29,Taiwan,1,0,442,7
2020-05-30,Taiwan,0,0,442,7
2020-05-31,Taiwan,0,0,442,7
2020-06-01,Taiwan,1,0,443,7
2020-06-02,Taiwan,0,0,443,7
2020-06-03,Taiwan,0,0,443,7
2020-06-04,Taiwan,0,0,443,7
2020-06-05,Taiwan,0,0,443,7
2020-06-06,Taiwan,0,0,443,7
2020-06-07,Taiwan,0,0,443,7
2020-06-08,Taiwan,0,0,443,7
2020-06-09,Taiwan,0,0,443,7
2020-06-10,Taiwan,0,0,443,7
2020-06-11,Taiwan,0,0,443,7
2020-06-12,Taiwan,0,0,443,7
2020-06-13,Taiwan,0,0,443,7
2020-06-14,Taiwan,0,0,443,7
2020-06-15,Taiwan,2,0,445,7
2020-06-16,Taiwan,0,0,445,7
2020-06-17,Taiwan,0,0,445,7
2020-06-18,Taiwan,1,0,446,7
2020-06-19,Taiwan,0,0,446,7
2020-06-20,Taiwan,0,0,446,7
2020-06-21,Taiwan,0,0,446,7
2020-06-22,Taiwan,0,0,446,7
2020-06-23,Taiwan,0,0,446,7
2020-06-24,Taiwan,0,0,446,7
2020-06-25,Taiwan,1,0,447,7
2020-06-26,Taiwan,0,0,447,7
2020-06-27,Taiwan,0,0,447,7
2020-06-28,Taiwan,0,0,447,7
2020-06-29,Taiwan,0,0,447,7
2020-06-30,Taiwan,0,0,447,7
2020-07-01,Taiwan,0,0,447,7
2020-07-02,Taiwan,1,0,448,7
2020-07-03,Taiwan,1,0,449,7
2020-07-04,Taiwan,0,0,449,7
2020-07-05,Taiwan,0,0,449,7
2020-07-06,Taiwan,0,0,449,7
2020-07-07,Taiwan,0,0,449,7
2020-07-08,Taiwan,0,0,449,7
2020-07-09,Taiwan,0,0,449,7
2020-07-10,Taiwan,0,0,449,7
2020-07-11,Taiwan,2,0,451,7
2020-07-12,Taiwan,0,0,451,7
2020-07-13,Taiwan,0,0,451,7
2020-07-14,Taiwan,0,0,451,7
2020-07-15,Taiwan,0,0,451,7
2020-07-16,Taiwan,0,0,451,7
2020-07-17,Taiwan,0,0,451,7
2020-07-18,Taiwan,0,0,451,7
2020-07-19,Taiwan,0,0,451,7
2020-07-20,Taiwan,0,0,451,7
2020-07-21,Taiwan,0,0,451,7
2020-07-22,Taiwan,4,0,455,7
2020-07-23,Taiwan,0,0,455,7
2020-07-24,Taiwan,3,0,458,7
2020-07-25,Taiwan,0,0,458,7
2020-07-26,Taiwan,0,0,458,7
2020-07-27,Taiwan,4,0,462,7
2020-07-28,Taiwan,5,0,467,7
2020-07-29,Taiwan,0,0,467,7
2020-07-30,Taiwan,0,0,467,7
2020-07-31,Taiwan,0,0,467,7
2020-08-01,Taiwan,7,0,474,7
2020-08-02,Taiwan,1,0,475,7
2020-08-03,Taiwan,-1,0,474,7
2020-08-04,Taiwan,2,0,476,7
2020-08-05,Taiwan,0,0,476,7
2020-08-06,Taiwan,1,0,477,7
2020-08-07,Taiwan,0,0,477,7
2020-08-08,Taiwan,2,0,479,7
2020-08-09,Taiwan,-2,0,477,7
2020-08-10,Taiwan,0,0,477,7
2020-08-11,Taiwan,3,0,480,7
2020-08-12,Taiwan,1,0,481,7
2020-08-13,Taiwan,0,0,481,7
2020-08-14,Taiwan,0,0,481,7
2020-08-15,Taiwan,1,0,482,7
2020-08-16,Taiwan,2,0,484,7
2020-08-17,Taiwan,1,0,485,7
2020-08-18,Taiwan,1,0,486,7
2020-08-19,Taiwan,0,0,486,7
2020-08-20,Taiwan,0,0,486,7
2020-08-21,Taiwan,1,0,487,7
2020-08-22,Taiwan,0,0,487,7
2020-08-23,Taiwan,0,0,487,7
2020-08-24,Taiwan,0,0,487,7
2020-08-25,Taiwan,0,0,487,7
2020-08-26,Taiwan,0,0,487,7
2020-08-27,Taiwan,0,0,487,7
2020-08-28,Taiwan,0,0,487,7
2020-08-29,Taiwan,1,0,488,7
2020-08-30,Taiwan,0,0,488,7
2020-08-31,Taiwan,0,0,488,7
2020-09-01,Taiwan,0,0,488,7
2020-09-02,Taiwan,1,0,489,7
2020-09-03,Taiwan,0,0,489,7
2020-09-04,Taiwan,1,0,490,7
2020-09-05,Taiwan,2,0,492,7
2020-09-06,Taiwan,1,0,493,7
2020-09-07,Taiwan,1,0,494,7
2020-09-08,Taiwan,1,0,495,7
2020-09-09,Taiwan,0,0,495,7
2020-09-10,Taiwan,1,0,496,7
2020-09-11,Taiwan,2,0,498,7
2020-09-12,Taiwan,0,0,498,7
2020-09-13,Taiwan,0,0,498,7
2020-09-14,Taiwan,1,0,499,7
2020-09-15,Taiwan,0,0,499,7
2020-09-16,Taiwan,1,0,500,7
2020-09-17,Taiwan,3,0,503,7
2020-09-18,Taiwan,0,0,503,7
2020-09-19,Taiwan,3,0,506,7
2020-09-20,Taiwan,1,0,507,7
2020-09-21,Taiwan,2,0,509,7
2020-09-22,Taiwan,0,0,509,7
2020-09-23,Taiwan,0,0,509,7
2020-09-24,Taiwan,0,0,509,7
2020-09-25,Taiwan,1,0,510,7
2020-09-26,Taiwan,0,0,510,7
2020-09-27,Taiwan,0,0,510,7
2020-09-28,Taiwan,3,0,513,7
2020-09-29,Taiwan,0,0,513,7
2020-09-30,Taiwan,1,0,514,7
2020-10-01,Taiwan,1,0,515,7
2020-10-02,Taiwan,2,0,517,7
2020-10-03,Taiwan,0,0,517,7
2020-10-04,Taiwan,0,0,517,7
2020-10-05,Taiwan,1,0,518,7
2020-10-06,Taiwan,3,0,521,7
2020-10-07,Taiwan,2,0,523,7
2020-10-08,Taiwan,1,0,524,7
2020-10-09,Taiwan,3,0,527,7
2020-10-10,Taiwan,0,0,527,7
2020-10-11,Taiwan,0,0,527,7
2020-10-12,Taiwan,2,0,529,7
2020-10-13,Taiwan,1,0,530,7
2020-10-14,Taiwan,0,0,530,7
2020-10-15,Taiwan,1,0,531,7
2020-10-16,Taiwan,4,0,535,7
2020-10-17,Taiwan,0,0,535,7
2020-10-18,Taiwan,0,0,535,7
2020-10-19,Taiwan,5,0,540,7
2020-10-20,Taiwan,3,0,543,7
2020-10-21,Taiwan,1,0,544,7
2020-10-22,Taiwan,4,0,548,7
2020-10-23,Taiwan,0,0,548,7
2020-10-24,Taiwan,2,0,550,7
2020-10-25,Taiwan,0,0,550,7
2020-10-26,Taiwan,0,0,550,7
2020-10-27,Taiwan,0,0,550,7
2020-10-28,Taiwan,0,0,550,7
2020-10-29,Taiwan,3,0,553,7
2020-10-30,Taiwan,1,0,554,7
2020-10-31,Taiwan,1,0,555,7
2020-11-01,Taiwan,3,0,558,7
2020-11-02,Taiwan,5,0,563,7
2020-11-03,Taiwan,4,0,567,7
2020-11-04,Taiwan,1,0,568,7
2020-11-05,Taiwan,1,0,569,7
2020-11-06,Taiwan,4,0,573,7
2020-11-07,Taiwan,0,0,573,7
2020-11-08,Taiwan,4,0,577,7
2020-11-09,Taiwan,1,0,578,7
2020-11-10,Taiwan,2,0,580,7
2020-11-11,Taiwan,4,0,584,7
2020-11-12,Taiwan,5,0,589,7
2020-11-13,Taiwan,8,0,597,7
2020-11-14,Taiwan,3,0,600,7
2020-11-15,Taiwan,2,0,602,7
2020-11-16,Taiwan,1,0,603,7
2020-11-17,Taiwan,2,0,605,7
2020-11-18,Taiwan,2,0,607,7
2020-11-19,Taiwan,2,0,609,7
2020-11-20,Taiwan,2,0,611,7
2020-11-21,Taiwan,0,0,611,7
2020-11-22,Taiwan,6,0,617,7
2020-11-23,Taiwan,1,0,618,7
2020-11-24,Taiwan,0,0,618,7
2020-11-25,Taiwan,5,0,623,7
2020-11-26,Taiwan,2,0,625,7
2020-11-27,Taiwan,14,0,639,7
2020-11-28,Taiwan,9,0,648,7
2020-11-29,Taiwan,3,0,651,7
2020-11-30,Taiwan,24,0,675,7
2020-12-01,Taiwan,4,0,679,7
2020-12-02,Taiwan,6,0,685,7
2020-12-03,Taiwan,1,0,686,7
2020-12-04,Taiwan,4,0,690,7
2020-12-05,Taiwan,4,0,694,7
2020-12-06,Taiwan,22,0,716,7
2020-12-07,Taiwan,0,0,716,7
2020-12-08,Taiwan,2,0,718,7
2020-12-09,Taiwan,2,0,720,7
2020-12-10,Taiwan,4,0,724,7
2020-12-11,Taiwan,1,0,725,7
2020-12-12,Taiwan,8,0,733,7
2020-12-13,Taiwan,3,0,736,7
2020-12-14,Taiwan,4,0,740,7
2020-12-15,Taiwan,2,0,742,7
2020-12-16,Taiwan,7,0,749,7
2020-12-17,Taiwan,8,0,757,7
2020-12-18,Taiwan,2,0,759,7
2020-12-19,Taiwan,4,0,763,7
2020-12-20,Taiwan,3,0,766,7
2020-12-21,Taiwan,0,0,766,7
2020-12-22,Taiwan,4,0,770,7
2020-12-23,Taiwan,6,0,776,7
2020-12-24,Taiwan,0,0,776,7
2020-12-25,Taiwan,4,0,780,7
2020-12-26,Taiwan,3,0,783,7
2020-12-27,Taiwan,2,0,785,7
2020-12-28,Taiwan,8,0,793,7
2020-12-29,Taiwan,2,0,795,7
2020-12-30,Taiwan,2,0,797,7
2020-12-31,Taiwan,2,0,799,7
2021-01-01,Taiwan,3,0,802,7
2021-01-02,Taiwan,6,0,808,7
2021-01-03,Taiwan,4,0,812,7
2021-01-04,Taiwan,3,0,815,7
2021-01-05,Taiwan,2,0,817,7
2021-01-06,Taiwan,2,0,819,7
2021-01-07,Taiwan,3,0,822,7
2021-01-08,Taiwan,3,0,825,7
2021-01-09,Taiwan,3,0,828,7
2021-01-10,Taiwan,0,0,828,7
2021-01-11,Taiwan,6,0,834,7
2021-01-12,Taiwan,4,0,838,7
2021-01-13,Taiwan,4,0,842,7
2021-01-14,Taiwan,0,0,842,7
2021-01-15,Taiwan,1,0,843,7
2021-01-16,Taiwan,8,0,851,7
2021-01-17,Taiwan,4,0,855,7
2021-01-18,Taiwan,7,0,862,7
2021-01-19,Taiwan,6,0,868,7
2021-01-20,Taiwan,2,0,870,7
2021-01-21,Taiwan,11,0,881,7
2021-01-22,Taiwan,0,0,881,7
2021-01-23,Taiwan,3,0,884,7
2021-01-24,Taiwan,5,0,889,7
2021-01-25,Taiwan,0,0,889,7
2021-01-26,Taiwan,1,0,890,7
2021-01-27,Taiwan,3,0,893,7
2021-01-28,Taiwan,2,0,895,7
2021-01-29,Taiwan,4,0,899,7
2021-01-30,Taiwan,10,1,909,8
2021-01-31,Taiwan,2,0,911,8
2021-02-01,Taiwan,1,0,912,8
2021-02-02,Taiwan,3,0,915,8
2021-02-03,Taiwan,2,0,917,8
2021-02-04,Taiwan,2,1,919,9
2021-02-05,Taiwan,4,0,923,9
2021-02-06,Taiwan,1,0,924,9
2021-02-07,Taiwan,3,0,927,9
2021-02-08,Taiwan,1,0,928,9
2021-02-09,Taiwan,5,0,933,9
2021-02-10,Taiwan,2,0,935,9
2021-02-11,Taiwan,1,0,936,9
2021-02-12,Taiwan,1,0,937,9
2021-02-13,Taiwan,0,0,937,9
2021-02-14,Taiwan,0,0,937,9
2021-02-15,Taiwan,0,0,937,9
2021-02-16,Taiwan,0,0,937,9
2021-02-17,Taiwan,1,0,938,9
2021-02-18,Taiwan,2,0,940,9
2021-02-19,Taiwan,1,0,941,9
2021-02-20,Taiwan,1,0,942,9
2021-02-21,Taiwan,0,0,942,9
2021-02-22,Taiwan,0,0,942,9
2021-02-23,Taiwan,0,0,942,9
2021-02-24,Taiwan,4,0,946,9
2021-02-25,Taiwan,5,0,951,9
2021-02-26,Taiwan,0,0,951,9
2021-02-27,Taiwan,3,0,954,9
2021-02-28,Taiwan,1,0,955,9
2021-03-01,Taiwan,0,0,955,9
2021-03-02,Taiwan,0,0,955,9
2021-03-03,Taiwan,3,0,958,9
2021-03-04,Taiwan,2,0,960,9
2021-03-05,Taiwan,0,0,960,9
2021-03-06,Taiwan,7,1,967,10
2021-03-07,Taiwan,2,0,969,10
2021-03-08,Taiwan,7,0,976,10
2021-03-09,Taiwan,1,0,977,10
2021-03-10,Taiwan,1,0,978,10
2021-03-11,Taiwan,0,0,978,10
2021-03-12,Taiwan,6,0,984,10
2021-03-13,Taiwan,0,0,984,10
2021-03-14,Taiwan,1,0,985,10
2021-03-15,Taiwan,5,0,990,10
2021-03-16,Taiwan,0,0,990,10
2021-03-17,Taiwan,0,0,990,10
2021-03-18,Taiwan,8,0,998,10
2021-03-19,Taiwan,6,0,1004,10
2021-03-20,Taiwan,1,0,1005,10
2021-03-21,Taiwan,1,0,1006,10
2021-03-22,Taiwan,0,0,1006,10
2021-03-23,Taiwan,1,0,1007,10
2021-03-24,Taiwan,2,0,1009,10
2021-03-25,Taiwan,3,0,1012,10
2021-03-26,Taiwan,1,0,1013,10
2021-03-27,Taiwan,7,0,1020,10
2021-03-28,Taiwan,2,0,1022,10
2021-03-29,Taiwan,1,0,1023,10
2021-03-30,Taiwan,1,0,1024,10
2021-03-31,Taiwan,6,0,1030,10
2021-04-01,Taiwan,6,0,1036,10
2021-04-02,Taiwan,3,0,1039,10
2021-04-03,Taiwan,6,0,1045,10
2021-04-04,Taiwan,2,0,1047,10
2021-04-05,Taiwan,1,0,1048,10
2021-04-06,Taiwan,2,0,1050,10
2021-04-07,Taiwan,0,0,1050,10
2021-04-08,Taiwan,0,0,1050,10
2020-04-30,Tajikistan,15,0,15,0
2020-05-01,Tajikistan,0,0,15,0
2020-05-02,Tajikistan,61,2,76,2
2020-05-03,Tajikistan,52,0,128,2
2020-05-04,Tajikistan,102,1,230,3
2020-05-05,Tajikistan,63,2,293,5
2020-05-06,Tajikistan,86,3,379,8
2020-05-07,Tajikistan,82,4,461,12
2020-05-08,Tajikistan,61,0,522,12
2020-05-09,Tajikistan,90,8,612,20
2020-05-10,Tajikistan,0,0,612,20
2020-05-11,Tajikistan,49,1,661,21
2020-05-12,Tajikistan,68,0,729,21
2020-05-13,Tajikistan,72,2,801,23
2020-05-14,Tajikistan,106,6,907,29
2020-05-15,Tajikistan,211,4,1118,33
2020-05-16,Tajikistan,204,3,1322,36
2020-05-17,Tajikistan,202,3,1524,39
2020-05-18,Tajikistan,205,2,1729,41
2020-05-19,Tajikistan,207,0,1936,41
2020-05-20,Tajikistan,204,0,2140,41
2020-05-21,Tajikistan,210,3,2350,44
2020-05-22,Tajikistan,201,0,2551,44
2020-05-23,Tajikistan,187,0,2738,44
2020-05-24,Tajikistan,191,2,2929,46
2020-05-25,Tajikistan,171,0,3100,46
2020-05-26,Tajikistan,166,1,3266,47
2020-05-27,Tajikistan,158,0,3424,47
2020-05-28,Tajikistan,139,0,3563,47
2020-05-29,Tajikistan,123,0,3686,47
2020-05-30,Tajikistan,121,0,3807,47
2020-05-31,Tajikistan,123,0,3930,47
2020-06-01,Tajikistan,83,0,4013,47
2020-06-02,Tajikistan,87,0,4100,47
2020-06-03,Tajikistan,91,1,4191,48
2020-06-04,Tajikistan,98,0,4289,48
2020-06-05,Tajikistan,81,0,4370,48
2020-06-06,Tajikistan,83,0,4453,48
2020-06-07,Tajikistan,76,0,4529,48
2020-06-08,Tajikistan,80,0,4609,48
2020-06-09,Tajikistan,81,0,4690,48
2020-06-10,Tajikistan,73,0,4763,48
2020-06-11,Tajikistan,71,1,4834,49
2020-06-12,Tajikistan,68,0,4902,49
2020-06-13,Tajikistan,69,1,4971,50
2020-06-14,Tajikistan,64,0,5035,50
2020-06-15,Tajikistan,62,0,5097,50
2020-06-16,Tajikistan,63,0,5160,50
2020-06-17,Tajikistan,61,1,5221,51
2020-06-18,Tajikistan,58,0,5279,51
2020-06-19,Tajikistan,59,0,5338,51
2020-06-20,Tajikistan,61,1,5399,52
2020-06-21,Tajikistan,58,0,5457,52
2020-06-22,Tajikistan,56,0,5513,52
2020-06-23,Tajikistan,54,0,5567,52
2020-06-24,Tajikistan,63,0,5630,52
2020-06-25,Tajikistan,61,0,5691,52
2020-06-26,Tajikistan,56,0,5747,52
2020-06-27,Tajikistan,52,0,5799,52
2020-06-28,Tajikistan,50,0,5849,52
2020-06-29,Tajikistan,51,0,5900,52
2020-06-30,Tajikistan,0,0,5900,52
2020-07-01,Tajikistan,105,0,6005,52
2020-07-02,Tajikistan,53,0,6058,52
2020-07-03,Tajikistan,0,0,6058,52
2020-07-04,Tajikistan,101,0,6159,52
2020-07-05,Tajikistan,54,1,6213,53
2020-07-06,Tajikistan,49,0,6262,53
2020-07-07,Tajikistan,53,0,6315,53
2020-07-08,Tajikistan,49,1,6364,54
2020-07-09,Tajikistan,46,0,6410,54
2020-07-10,Tajikistan,47,1,6457,55
2020-07-11,Tajikistan,49,0,6506,55
2020-07-12,Tajikistan,46,0,6552,55
2020-07-13,Tajikistan,44,0,6596,55
2020-07-14,Tajikistan,47,1,6643,56
2020-07-15,Tajikistan,52,0,6695,56
2020-07-16,Tajikistan,46,0,6741,56
2020-07-17,Tajikistan,45,0,6786,56
2020-07-18,Tajikistan,48,1,6834,57
2020-07-19,Tajikistan,44,0,6878,57
2020-07-20,Tajikistan,43,0,6921,57
2020-07-21,Tajikistan,46,0,6967,57
2020-07-22,Tajikistan,48,1,7015,58
2020-07-23,Tajikistan,45,0,7060,58
2020-07-24,Tajikistan,44,0,7104,58
2020-07-25,Tajikistan,46,1,7150,59
2020-07-26,Tajikistan,42,0,7192,59
2020-07-27,Tajikistan,43,1,7235,60
2020-07-28,Tajikistan,41,0,7276,60
2020-07-29,Tajikistan,44,0,7320,60
2020-07-30,Tajikistan,46,0,7366,60
2020-07-31,Tajikistan,43,0,7409,60
2020-08-01,Tajikistan,42,0,7451,60
2020-08-02,Tajikistan,44,1,7495,61
2020-08-03,Tajikistan,43,0,7538,61
2020-08-04,Tajikistan,45,0,7583,61
2020-08-05,Tajikistan,42,0,7625,61
2020-08-06,Tajikistan,40,1,7665,62
2020-08-07,Tajikistan,41,0,7706,62
2020-08-08,Tajikistan,0,0,7706,62
2020-08-09,Tajikistan,39,0,7745,62
2020-08-10,Tajikistan,82,0,7827,62
2020-08-11,Tajikistan,44,1,7871,63
2020-08-12,Tajikistan,41,0,7912,63
2020-08-13,Tajikistan,38,0,7950,63
2020-08-14,Tajikistan,39,0,7989,63
2020-08-15,Tajikistan,40,1,8029,64
2020-08-16,Tajikistan,36,0,8065,64
2020-08-17,Tajikistan,34,0,8099,64
2020-08-18,Tajikistan,32,1,8131,65
2020-08-19,Tajikistan,35,0,8166,65
2020-08-20,Tajikistan,37,1,8203,66
2020-08-21,Tajikistan,38,0,8241,66
2020-08-22,Tajikistan,36,0,8277,66
2020-08-23,Tajikistan,34,0,8311,66
2020-08-24,Tajikistan,35,1,8346,67
2020-08-25,Tajikistan,33,0,8379,67
2020-08-26,Tajikistan,34,0,8413,67
2020-08-27,Tajikistan,36,1,8449,68
2020-08-28,Tajikistan,32,0,8481,68
2020-08-29,Tajikistan,35,0,8516,68
2020-08-30,Tajikistan,0,0,8516,68
2020-08-31,Tajikistan,67,0,8583,68
2020-09-01,Tajikistan,36,0,8619,68
2020-09-02,Tajikistan,35,1,8654,69
2020-09-03,Tajikistan,36,0,8690,69
2020-09-04,Tajikistan,34,0,8724,69
2020-09-05,Tajikistan,33,1,8757,70
2020-09-06,Tajikistan,35,0,8792,70
2020-09-07,Tajikistan,32,0,8824,70
2020-09-08,Tajikistan,36,0,8860,70
2020-09-09,Tajikistan,39,1,8899,71
2020-09-10,Tajikistan,40,1,8939,72
2020-09-11,Tajikistan,38,0,8977,72
2020-09-12,Tajikistan,37,0,9014,72
2020-09-13,Tajikistan,35,0,9049,72
2020-09-14,Tajikistan,39,0,9088,72
2020-09-15,Tajikistan,41,1,9129,73
2020-09-16,Tajikistan,42,0,9171,73
2020-09-17,Tajikistan,43,0,9214,73
2020-09-18,Tajikistan,45,0,9259,73
2020-09-19,Tajikistan,44,0,9303,73
2020-09-20,Tajikistan,43,0,9346,73
2020-09-21,Tajikistan,42,0,9388,73
2020-09-22,Tajikistan,44,0,9432,73
2020-09-23,Tajikistan,43,1,9475,74
2020-09-24,Tajikistan,45,0,9520,74
2020-09-25,Tajikistan,42,0,9562,74
2020-09-26,Tajikistan,43,1,9605,75
2020-09-27,Tajikistan,41,0,9646,75
2020-09-28,Tajikistan,39,0,9685,75
2020-09-29,Tajikistan,41,0,9726,75
2020-09-30,Tajikistan,43,1,9769,76
2020-10-01,Tajikistan,42,1,9811,77
2020-10-02,Tajikistan,41,0,9852,77
2020-10-03,Tajikistan,43,0,9895,77
2020-10-04,Tajikistan,40,1,9935,78
2020-10-05,Tajikistan,39,0,9974,78
2020-10-06,Tajikistan,40,0,10014,78
2020-10-07,Tajikistan,41,0,10055,78
2020-10-08,Tajikistan,42,0,10097,78
2020-10-09,Tajikistan,40,1,10137,79
2020-10-10,Tajikistan,43,0,10180,79
2020-10-11,Tajikistan,42,0,10222,79
2020-10-12,Tajikistan,38,0,10260,79
2020-10-13,Tajikistan,37,0,10297,79
2020-10-14,Tajikistan,39,0,10336,79
2020-10-15,Tajikistan,38,1,10374,80
2020-10-16,Tajikistan,40,0,10414,80
2020-10-17,Tajikistan,41,0,10455,80
2020-10-18,Tajikistan,38,0,10493,80
2020-10-19,Tajikistan,40,0,10533,80
2020-10-20,Tajikistan,41,0,10574,80
2020-10-21,Tajikistan,39,0,10613,80
2020-10-22,Tajikistan,40,1,10653,81
2020-10-23,Tajikistan,42,0,10695,81
2020-10-24,Tajikistan,41,0,10736,81
2020-10-25,Tajikistan,40,0,10776,81
2020-10-26,Tajikistan,43,0,10819,81
2020-10-27,Tajikistan,41,0,10860,81
2020-10-28,Tajikistan,40,1,10900,82
2020-10-29,Tajikistan,39,0,10939,82
2020-10-30,Tajikistan,38,0,10977,82
2020-10-31,Tajikistan,40,0,11017,82
2020-11-01,Tajikistan,37,0,11054,82
2020-11-02,Tajikistan,42,0,11096,82
2020-11-03,Tajikistan,43,1,11139,83
2020-11-04,Tajikistan,41,0,11180,83
2020-11-05,Tajikistan,39,0,11219,83
2020-11-06,Tajikistan,37,0,11256,83
2020-11-07,Tajikistan,38,0,11294,83
2020-11-08,Tajikistan,42,0,11336,83
2020-11-09,Tajikistan,40,0,11376,83
2020-11-10,Tajikistan,41,1,11417,84
2020-11-11,Tajikistan,39,0,11456,84
2020-11-12,Tajikistan,40,0,11496,84
2020-11-13,Tajikistan,38,1,11534,85
2020-11-14,Tajikistan,39,0,11573,85
2020-11-15,Tajikistan,37,0,11610,85
2020-11-16,Tajikistan,39,0,11649,85
2020-11-17,Tajikistan,40,0,11689,85
2020-11-18,Tajikistan,42,1,11731,86
2020-11-19,Tajikistan,41,0,11772,86
2020-11-20,Tajikistan,43,0,11815,86
2020-11-21,Tajikistan,39,0,11854,86
2020-11-22,Tajikistan,40,0,11894,86
2020-11-23,Tajikistan,38,0,11932,86
2020-11-24,Tajikistan,39,0,11971,86
2020-11-25,Tajikistan,37,0,12008,86
2020-11-26,Tajikistan,36,0,12044,86
2020-11-27,Tajikistan,38,0,12082,86
2020-11-28,Tajikistan,36,0,12118,86
2020-11-29,Tajikistan,37,0,12155,86
2020-11-30,Tajikistan,39,0,12194,86
2020-12-01,Tajikistan,37,0,12231,86
2020-12-02,Tajikistan,38,1,12269,87
2020-12-03,Tajikistan,39,0,12308,87
2020-12-04,Tajikistan,41,0,12349,87
2020-12-05,Tajikistan,40,0,12389,87
2020-12-06,Tajikistan,39,0,12428,87
2020-12-07,Tajikistan,41,0,12469,87
2020-12-08,Tajikistan,42,1,12511,88
2020-12-09,Tajikistan,40,0,12551,88
2020-12-10,Tajikistan,37,0,12588,88
2020-12-11,Tajikistan,0,0,12588,88
2020-12-12,Tajikistan,36,1,12624,89
2020-12-13,Tajikistan,80,-1,12704,88
2020-12-14,Tajikistan,37,0,12741,88
2020-12-15,Tajikistan,36,0,12777,88
2020-12-16,Tajikistan,38,1,12815,89
2020-12-17,Tajikistan,37,0,12852,89
2020-12-18,Tajikistan,36,0,12888,89
2020-12-19,Tajikistan,35,0,12923,89
2020-12-20,Tajikistan,37,0,12960,89
2020-12-21,Tajikistan,38,0,12998,89
2020-12-22,Tajikistan,36,0,13034,89
2020-12-23,Tajikistan,37,0,13071,89
2020-12-24,Tajikistan,35,0,13106,89
2020-12-25,Tajikistan,32,0,13138,89
2020-12-26,Tajikistan,34,1,13172,90
2020-12-27,Tajikistan,33,0,13205,90
2020-12-28,Tajikistan,32,0,13237,90
2020-12-29,Tajikistan,28,0,13265,90
2020-12-30,Tajikistan,31,0,13296,90
2020-12-31,Tajikistan,0,0,13296,90
2021-01-01,Tajikistan,0,0,13296,90
2021-01-02,Tajikistan,4,0,13300,90
2021-01-03,Tajikistan,0,0,13300,90
2021-01-04,Tajikistan,0,0,13300,90
2021-01-05,Tajikistan,5,0,13305,90
2021-01-06,Tajikistan,0,0,13305,90
2021-01-07,Tajikistan,0,0,13305,90
2021-01-08,Tajikistan,0,0,13305,90
2021-01-09,Tajikistan,0,0,13305,90
2021-01-10,Tajikistan,3,0,13308,90
2021-01-11,Tajikistan,0,0,13308,90
2021-01-12,Tajikistan,0,0,13308,90
2021-01-13,Tajikistan,0,0,13308,90
2021-01-14,Tajikistan,0,0,13308,90
2021-01-15,Tajikistan,0,0,13308,90
2021-01-16,Tajikistan,0,0,13308,90
2021-01-17,Tajikistan,0,0,13308,90
2021-01-18,Tajikistan,0,0,13308,90
2021-01-19,Tajikistan,0,0,13308,90
2021-01-20,Tajikistan,0,0,13308,90
2021-01-21,Tajikistan,0,0,13308,90
2021-01-22,Tajikistan,0,0,13308,90
2021-01-23,Tajikistan,0,0,13308,90
2021-01-24,Tajikistan,0,0,13308,90
2021-01-25,Tajikistan,0,0,13308,90
2021-01-26,Tajikistan,0,0,13308,90
2021-01-27,Tajikistan,0,0,13308,90
2021-01-28,Tajikistan,0,0,13308,90
2021-01-29,Tajikistan,0,0,13308,90
2021-01-30,Tajikistan,0,0,13308,90
2021-01-31,Tajikistan,0,0,13308,90
2021-02-01,Tajikistan,0,0,13308,90
2021-02-02,Tajikistan,0,0,13308,90
2021-02-03,Tajikistan,0,0,13308,90
2021-02-04,Tajikistan,0,0,13308,90
2021-02-05,Tajikistan,0,0,13308,90
2021-02-06,Tajikistan,0,0,13308,90
2021-02-07,Tajikistan,0,0,13308,90
2021-02-08,Tajikistan,0,0,13308,90
2021-02-09,Tajikistan,0,0,13308,90
2021-02-10,Tajikistan,0,0,13308,90
2021-02-11,Tajikistan,0,0,13308,90
2021-02-12,Tajikistan,0,0,13308,90
2021-02-13,Tajikistan,0,0,13308,90
2021-02-14,Tajikistan,0,0,13308,90
2021-02-15,Tajikistan,0,0,13308,90
2021-02-16,Tajikistan,0,0,13308,90
2021-02-17,Tajikistan,0,0,13308,90
2021-02-18,Tajikistan,0,0,13308,90
2021-02-19,Tajikistan,0,0,13308,90
2021-02-20,Tajikistan,0,0,13308,90
2021-02-21,Tajikistan,0,0,13308,90
2021-02-22,Tajikistan,0,0,13308,90
2021-02-23,Tajikistan,0,0,13308,90
2021-02-24,Tajikistan,0,0,13308,90
2021-02-25,Tajikistan,0,0,13308,90
2021-02-26,Tajikistan,0,0,13308,90
2021-02-27,Tajikistan,0,0,13308,90
2021-02-28,Tajikistan,0,0,13308,90
2021-03-01,Tajikistan,0,0,13308,90
2021-03-02,Tajikistan,0,0,13308,90
2021-03-03,Tajikistan,0,0,13308,90
2021-03-04,Tajikistan,0,0,13308,90
2021-03-05,Tajikistan,0,0,13308,90
2021-03-06,Tajikistan,0,0,13308,90
2021-03-07,Tajikistan,0,0,13308,90
2021-03-08,Tajikistan,0,0,13308,90
2021-03-09,Tajikistan,0,0,13308,90
2021-03-10,Tajikistan,0,0,13308,90
2021-03-11,Tajikistan,0,0,13308,90
2021-03-12,Tajikistan,0,0,13308,90
2021-03-13,Tajikistan,0,0,13308,90
2021-03-14,Tajikistan,0,0,13308,90
2021-03-15,Tajikistan,0,0,13308,90
2021-03-16,Tajikistan,0,0,13308,90
2021-03-17,Tajikistan,0,0,13308,90
2021-03-18,Tajikistan,0,0,13308,90
2021-03-19,Tajikistan,0,0,13308,90
2021-03-20,Tajikistan,0,0,13308,90
2021-03-21,Tajikistan,0,0,13308,90
2021-03-22,Tajikistan,0,0,13308,90
2021-03-23,Tajikistan,0,0,13308,90
2021-03-24,Tajikistan,0,0,13308,90
2021-03-25,Tajikistan,0,0,13308,90
2021-03-26,Tajikistan,0,0,13308,90
2021-03-27,Tajikistan,0,0,13308,90
2021-03-28,Tajikistan,0,0,13308,90
2021-03-29,Tajikistan,0,0,13308,90
2021-03-30,Tajikistan,0,0,13308,90
2021-03-31,Tajikistan,0,0,13308,90
2021-04-01,Tajikistan,0,0,13308,90
2021-04-02,Tajikistan,0,0,13308,90
2021-04-03,Tajikistan,0,0,13308,90
2021-04-04,Tajikistan,0,0,13308,90
2021-04-05,Tajikistan,0,0,13308,90
2021-04-06,Tajikistan,0,0,13308,90
2021-04-07,Tajikistan,0,0,13308,90
2021-04-08,Tajikistan,0,0,13308,90
2020-03-16,Tanzania,1,0,1,0
2020-03-17,Tanzania,0,0,1,0
2020-03-18,Tanzania,2,0,3,0
2020-03-19,Tanzania,3,0,6,0
2020-03-20,Tanzania,0,0,6,0
2020-03-21,Tanzania,0,0,6,0
2020-03-22,Tanzania,6,0,12,0
2020-03-23,Tanzania,0,0,12,0
2020-03-24,Tanzania,0,0,12,0
2020-03-25,Tanzania,0,0,12,0
2020-03-26,Tanzania,1,0,13,0
2020-03-27,Tanzania,0,0,13,0
2020-03-28,Tanzania,1,0,14,0
2020-03-29,Tanzania,0,0,14,0
2020-03-30,Tanzania,5,0,19,0
2020-03-31,Tanzania,0,1,19,1
2020-04-01,Tanzania,1,0,20,1
2020-04-02,Tanzania,0,0,20,1
2020-04-03,Tanzania,0,0,20,1
2020-04-04,Tanzania,0,0,20,1
2020-04-05,Tanzania,2,0,22,1
2020-04-06,Tanzania,2,0,24,1
2020-04-07,Tanzania,0,0,24,1
2020-04-08,Tanzania,1,0,25,1
2020-04-09,Tanzania,0,0,25,1
2020-04-10,Tanzania,7,2,32,3
2020-04-11,Tanzania,0,0,32,3
2020-04-12,Tanzania,0,0,32,3
2020-04-13,Tanzania,17,0,49,3
2020-04-14,Tanzania,4,0,53,3
2020-04-15,Tanzania,35,1,88,4
2020-04-16,Tanzania,6,0,94,4
2020-04-17,Tanzania,53,1,147,5
2020-04-18,Tanzania,0,0,147,5
2020-04-19,Tanzania,23,2,170,7
2020-04-20,Tanzania,84,3,254,10
2020-04-21,Tanzania,0,0,254,10
2020-04-22,Tanzania,30,0,284,10
2020-04-23,Tanzania,0,0,284,10
2020-04-24,Tanzania,15,0,299,10
2020-04-25,Tanzania,0,0,299,10
2020-04-26,Tanzania,0,0,299,10
2020-04-27,Tanzania,0,0,299,10
2020-04-28,Tanzania,0,0,299,10
2020-04-29,Tanzania,181,6,480,16
2020-04-30,Tanzania,0,0,480,16
2020-05-01,Tanzania,0,0,480,16
2020-05-02,Tanzania,0,0,480,16
2020-05-03,Tanzania,0,0,480,16
2020-05-04,Tanzania,0,0,480,16
2020-05-05,Tanzania,0,0,480,16
2020-05-06,Tanzania,0,0,480,16
2020-05-07,Tanzania,0,0,480,16
2020-05-08,Tanzania,29,5,509,21
2020-05-09,Tanzania,0,0,509,21
2020-05-10,Tanzania,0,0,509,21
2020-05-11,Tanzania,0,0,509,21
2020-05-12,Tanzania,0,0,509,21
2020-05-13,Tanzania,0,0,509,21
2020-05-14,Tanzania,0,0,509,21
2020-05-15,Tanzania,0,0,509,21
2020-05-16,Tanzania,0,0,509,21
2020-05-17,Tanzania,0,0,509,21
2020-05-18,Tanzania,0,0,509,21
2020-05-19,Tanzania,0,0,509,21
2020-05-20,Tanzania,0,0,509,21
2020-05-21,Tanzania,0,0,509,21
2020-05-22,Tanzania,0,0,509,21
2020-05-23,Tanzania,0,0,509,21
2020-05-24,Tanzania,0,0,509,21
2020-05-25,Tanzania,0,0,509,21
2020-05-26,Tanzania,0,0,509,21
2020-05-27,Tanzania,0,0,509,21
2020-05-28,Tanzania,0,0,509,21
2020-05-29,Tanzania,0,0,509,21
2020-05-30,Tanzania,0,0,509,21
2020-05-31,Tanzania,0,0,509,21
2020-06-01,Tanzania,0,0,509,21
2020-06-02,Tanzania,0,0,509,21
2020-06-03,Tanzania,0,0,509,21
2020-06-04,Tanzania,0,0,509,21
2020-06-05,Tanzania,0,0,509,21
2020-06-06,Tanzania,0,0,509,21
2020-06-07,Tanzania,0,0,509,21
2020-06-08,Tanzania,0,0,509,21
2020-06-09,Tanzania,0,0,509,21
2020-06-10,Tanzania,0,0,509,21
2020-06-11,Tanzania,0,0,509,21
2020-06-12,Tanzania,0,0,509,21
2020-06-13,Tanzania,0,0,509,21
2020-06-14,Tanzania,0,0,509,21
2020-06-15,Tanzania,0,0,509,21
2020-06-16,Tanzania,0,0,509,21
2020-06-17,Tanzania,0,0,509,21
2020-06-18,Tanzania,0,0,509,21
2020-06-19,Tanzania,0,0,509,21
2020-06-20,Tanzania,0,0,509,21
2020-06-21,Tanzania,0,0,509,21
2020-06-22,Tanzania,0,0,509,21
2020-06-23,Tanzania,0,0,509,21
2020-06-24,Tanzania,0,0,509,21
2020-06-25,Tanzania,0,0,509,21
2020-06-26,Tanzania,0,0,509,21
2020-06-27,Tanzania,0,0,509,21
2020-06-28,Tanzania,0,0,509,21
2020-06-29,Tanzania,0,0,509,21
2020-06-30,Tanzania,0,0,509,21
2020-07-01,Tanzania,0,0,509,21
2020-07-02,Tanzania,0,0,509,21
2020-07-03,Tanzania,0,0,509,21
2020-07-04,Tanzania,0,0,509,21
2020-07-05,Tanzania,0,0,509,21
2020-07-06,Tanzania,0,0,509,21
2020-07-07,Tanzania,0,0,509,21
2020-07-08,Tanzania,0,0,509,21
2020-07-09,Tanzania,0,0,509,21
2020-07-10,Tanzania,0,0,509,21
2020-07-11,Tanzania,0,0,509,21
2020-07-12,Tanzania,0,0,509,21
2020-07-13,Tanzania,0,0,509,21
2020-07-14,Tanzania,0,0,509,21
2020-07-15,Tanzania,0,0,509,21
2020-07-16,Tanzania,0,0,509,21
2020-07-17,Tanzania,0,0,509,21
2020-07-18,Tanzania,0,0,509,21
2020-07-19,Tanzania,0,0,509,21
2020-07-20,Tanzania,0,0,509,21
2020-07-21,Tanzania,0,0,509,21
2020-07-22,Tanzania,0,0,509,21
2020-07-23,Tanzania,0,0,509,21
2020-07-24,Tanzania,0,0,509,21
2020-07-25,Tanzania,0,0,509,21
2020-07-26,Tanzania,0,0,509,21
2020-07-27,Tanzania,0,0,509,21
2020-07-28,Tanzania,0,0,509,21
2020-07-29,Tanzania,0,0,509,21
2020-07-30,Tanzania,0,0,509,21
2020-07-31,Tanzania,0,0,509,21
2020-08-01,Tanzania,0,0,509,21
2020-08-02,Tanzania,0,0,509,21
2020-08-03,Tanzania,0,0,509,21
2020-08-04,Tanzania,0,0,509,21
2020-08-05,Tanzania,0,0,509,21
2020-08-06,Tanzania,0,0,509,21
2020-08-07,Tanzania,0,0,509,21
2020-08-08,Tanzania,0,0,509,21
2020-08-09,Tanzania,0,0,509,21
2020-08-10,Tanzania,0,0,509,21
2020-08-11,Tanzania,0,0,509,21
2020-08-12,Tanzania,0,0,509,21
2020-08-13,Tanzania,0,0,509,21
2020-08-14,Tanzania,0,0,509,21
2020-08-15,Tanzania,0,0,509,21
2020-08-16,Tanzania,0,0,509,21
2020-08-17,Tanzania,0,0,509,21
2020-08-18,Tanzania,0,0,509,21
2020-08-19,Tanzania,0,0,509,21
2020-08-20,Tanzania,0,0,509,21
2020-08-21,Tanzania,0,0,509,21
2020-08-22,Tanzania,0,0,509,21
2020-08-23,Tanzania,0,0,509,21
2020-08-24,Tanzania,0,0,509,21
2020-08-25,Tanzania,0,0,509,21
2020-08-26,Tanzania,0,0,509,21
2020-08-27,Tanzania,0,0,509,21
2020-08-28,Tanzania,0,0,509,21
2020-08-29,Tanzania,0,0,509,21
2020-08-30,Tanzania,0,0,509,21
2020-08-31,Tanzania,0,0,509,21
2020-09-01,Tanzania,0,0,509,21
2020-09-02,Tanzania,0,0,509,21
2020-09-03,Tanzania,0,0,509,21
2020-09-04,Tanzania,0,0,509,21
2020-09-05,Tanzania,0,0,509,21
2020-09-06,Tanzania,0,0,509,21
2020-09-07,Tanzania,0,0,509,21
2020-09-08,Tanzania,0,0,509,21
2020-09-09,Tanzania,0,0,509,21
2020-09-10,Tanzania,0,0,509,21
2020-09-11,Tanzania,0,0,509,21
2020-09-12,Tanzania,0,0,509,21
2020-09-13,Tanzania,0,0,509,21
2020-09-14,Tanzania,0,0,509,21
2020-09-15,Tanzania,0,0,509,21
2020-09-16,Tanzania,0,0,509,21
2020-09-17,Tanzania,0,0,509,21
2020-09-18,Tanzania,0,0,509,21
2020-09-19,Tanzania,0,0,509,21
2020-09-20,Tanzania,0,0,509,21
2020-09-21,Tanzania,0,0,509,21
2020-09-22,Tanzania,0,0,509,21
2020-09-23,Tanzania,0,0,509,21
2020-09-24,Tanzania,0,0,509,21
2020-09-25,Tanzania,0,0,509,21
2020-09-26,Tanzania,0,0,509,21
2020-09-27,Tanzania,0,0,509,21
2020-09-28,Tanzania,0,0,509,21
2020-09-29,Tanzania,0,0,509,21
2020-09-30,Tanzania,0,0,509,21
2020-10-01,Tanzania,0,0,509,21
2020-10-02,Tanzania,0,0,509,21
2020-10-03,Tanzania,0,0,509,21
2020-10-04,Tanzania,0,0,509,21
2020-10-05,Tanzania,0,0,509,21
2020-10-06,Tanzania,0,0,509,21
2020-10-07,Tanzania,0,0,509,21
2020-10-08,Tanzania,0,0,509,21
2020-10-09,Tanzania,0,0,509,21
2020-10-10,Tanzania,0,0,509,21
2020-10-11,Tanzania,0,0,509,21
2020-10-12,Tanzania,0,0,509,21
2020-10-13,Tanzania,0,0,509,21
2020-10-14,Tanzania,0,0,509,21
2020-10-15,Tanzania,0,0,509,21
2020-10-16,Tanzania,0,0,509,21
2020-10-17,Tanzania,0,0,509,21
2020-10-18,Tanzania,0,0,509,21
2020-10-19,Tanzania,0,0,509,21
2020-10-20,Tanzania,0,0,509,21
2020-10-21,Tanzania,0,0,509,21
2020-10-22,Tanzania,0,0,509,21
2020-10-23,Tanzania,0,0,509,21
2020-10-24,Tanzania,0,0,509,21
2020-10-25,Tanzania,0,0,509,21
2020-10-26,Tanzania,0,0,509,21
2020-10-27,Tanzania,0,0,509,21
2020-10-28,Tanzania,0,0,509,21
2020-10-29,Tanzania,0,0,509,21
2020-10-30,Tanzania,0,0,509,21
2020-10-31,Tanzania,0,0,509,21
2020-11-01,Tanzania,0,0,509,21
2020-11-02,Tanzania,0,0,509,21
2020-11-03,Tanzania,0,0,509,21
2020-11-04,Tanzania,0,0,509,21
2020-11-05,Tanzania,0,0,509,21
2020-11-06,Tanzania,0,0,509,21
2020-11-07,Tanzania,0,0,509,21
2020-11-08,Tanzania,0,0,509,21
2020-11-09,Tanzania,0,0,509,21
2020-11-10,Tanzania,0,0,509,21
2020-11-11,Tanzania,0,0,509,21
2020-11-12,Tanzania,0,0,509,21
2020-11-13,Tanzania,0,0,509,21
2020-11-14,Tanzania,0,0,509,21
2020-11-15,Tanzania,0,0,509,21
2020-11-16,Tanzania,0,0,509,21
2020-11-17,Tanzania,0,0,509,21
2020-11-18,Tanzania,0,0,509,21
2020-11-19,Tanzania,0,0,509,21
2020-11-20,Tanzania,0,0,509,21
2020-11-21,Tanzania,0,0,509,21
2020-11-22,Tanzania,0,0,509,21
2020-11-23,Tanzania,0,0,509,21
2020-11-24,Tanzania,0,0,509,21
2020-11-25,Tanzania,0,0,509,21
2020-11-26,Tanzania,0,0,509,21
2020-11-27,Tanzania,0,0,509,21
2020-11-28,Tanzania,0,0,509,21
2020-11-29,Tanzania,0,0,509,21
2020-11-30,Tanzania,0,0,509,21
2020-12-01,Tanzania,0,0,509,21
2020-12-02,Tanzania,0,0,509,21
2020-12-03,Tanzania,0,0,509,21
2020-12-04,Tanzania,0,0,509,21
2020-12-05,Tanzania,0,0,509,21
2020-12-06,Tanzania,0,0,509,21
2020-12-07,Tanzania,0,0,509,21
2020-12-08,Tanzania,0,0,509,21
2020-12-09,Tanzania,0,0,509,21
2020-12-10,Tanzania,0,0,509,21
2020-12-11,Tanzania,0,0,509,21
2020-12-12,Tanzania,0,0,509,21
2020-12-13,Tanzania,0,0,509,21
2020-12-14,Tanzania,0,0,509,21
2020-12-15,Tanzania,0,0,509,21
2020-12-16,Tanzania,0,0,509,21
2020-12-17,Tanzania,0,0,509,21
2020-12-18,Tanzania,0,0,509,21
2020-12-19,Tanzania,0,0,509,21
2020-12-20,Tanzania,0,0,509,21
2020-12-21,Tanzania,0,0,509,21
2020-12-22,Tanzania,0,0,509,21
2020-12-23,Tanzania,0,0,509,21
2020-12-24,Tanzania,0,0,509,21
2020-12-25,Tanzania,0,0,509,21
2020-12-26,Tanzania,0,0,509,21
2020-12-27,Tanzania,0,0,509,21
2020-12-28,Tanzania,0,0,509,21
2020-12-29,Tanzania,0,0,509,21
2020-12-30,Tanzania,0,0,509,21
2020-12-31,Tanzania,0,0,509,21
2021-01-01,Tanzania,0,0,509,21
2021-01-02,Tanzania,0,0,509,21
2021-01-03,Tanzania,0,0,509,21
2021-01-04,Tanzania,0,0,509,21
2021-01-05,Tanzania,0,0,509,21
2021-01-06,Tanzania,0,0,509,21
2021-01-07,Tanzania,0,0,509,21
2021-01-08,Tanzania,0,0,509,21
2021-01-09,Tanzania,0,0,509,21
2021-01-10,Tanzania,0,0,509,21
2021-01-11,Tanzania,0,0,509,21
2021-01-12,Tanzania,0,0,509,21
2021-01-13,Tanzania,0,0,509,21
2021-01-14,Tanzania,0,0,509,21
2021-01-15,Tanzania,0,0,509,21
2021-01-16,Tanzania,0,0,509,21
2021-01-17,Tanzania,0,0,509,21
2021-01-18,Tanzania,0,0,509,21
2021-01-19,Tanzania,0,0,509,21
2021-01-20,Tanzania,0,0,509,21
2021-01-21,Tanzania,0,0,509,21
2021-01-22,Tanzania,0,0,509,21
2021-01-23,Tanzania,0,0,509,21
2021-01-24,Tanzania,0,0,509,21
2021-01-25,Tanzania,0,0,509,21
2021-01-26,Tanzania,0,0,509,21
2021-01-27,Tanzania,0,0,509,21
2021-01-28,Tanzania,0,0,509,21
2021-01-29,Tanzania,0,0,509,21
2021-01-30,Tanzania,0,0,509,21
2021-01-31,Tanzania,0,0,509,21
2021-02-01,Tanzania,0,0,509,21
2021-02-02,Tanzania,0,0,509,21
2021-02-03,Tanzania,0,0,509,21
2021-02-04,Tanzania,0,0,509,21
2021-02-05,Tanzania,0,0,509,21
2021-02-06,Tanzania,0,0,509,21
2021-02-07,Tanzania,0,0,509,21
2021-02-08,Tanzania,0,0,509,21
2021-02-09,Tanzania,0,0,509,21
2021-02-10,Tanzania,0,0,509,21
2021-02-11,Tanzania,0,0,509,21
2021-02-12,Tanzania,0,0,509,21
2021-02-13,Tanzania,0,0,509,21
2021-02-14,Tanzania,0,0,509,21
2021-02-15,Tanzania,0,0,509,21
2021-02-16,Tanzania,0,0,509,21
2021-02-17,Tanzania,0,0,509,21
2021-02-18,Tanzania,0,0,509,21
2021-02-19,Tanzania,0,0,509,21
2021-02-20,Tanzania,0,0,509,21
2021-02-21,Tanzania,0,0,509,21
2021-02-22,Tanzania,0,0,509,21
2021-02-23,Tanzania,0,0,509,21
2021-02-24,Tanzania,0,0,509,21
2021-02-25,Tanzania,0,0,509,21
2021-02-26,Tanzania,0,0,509,21
2021-02-27,Tanzania,0,0,509,21
2021-02-28,Tanzania,0,0,509,21
2021-03-01,Tanzania,0,0,509,21
2021-03-02,Tanzania,0,0,509,21
2021-03-03,Tanzania,0,0,509,21
2021-03-04,Tanzania,0,0,509,21
2021-03-05,Tanzania,0,0,509,21
2021-03-06,Tanzania,0,0,509,21
2021-03-07,Tanzania,0,0,509,21
2021-03-08,Tanzania,0,0,509,21
2021-03-09,Tanzania,0,0,509,21
2021-03-10,Tanzania,0,0,509,21
2021-03-11,Tanzania,0,0,509,21
2021-03-12,Tanzania,0,0,509,21
2021-03-13,Tanzania,0,0,509,21
2021-03-14,Tanzania,0,0,509,21
2021-03-15,Tanzania,0,0,509,21
2021-03-16,Tanzania,0,0,509,21
2021-03-17,Tanzania,0,0,509,21
2021-03-18,Tanzania,0,0,509,21
2021-03-19,Tanzania,0,0,509,21
2021-03-20,Tanzania,0,0,509,21
2021-03-21,Tanzania,0,0,509,21
2021-03-22,Tanzania,0,0,509,21
2021-03-23,Tanzania,0,0,509,21
2021-03-24,Tanzania,0,0,509,21
2021-03-25,Tanzania,0,0,509,21
2021-03-26,Tanzania,0,0,509,21
2021-03-27,Tanzania,0,0,509,21
2021-03-28,Tanzania,0,0,509,21
2021-03-29,Tanzania,0,0,509,21
2021-03-30,Tanzania,0,0,509,21
2021-03-31,Tanzania,0,0,509,21
2021-04-01,Tanzania,0,0,509,21
2021-04-02,Tanzania,0,0,509,21
2021-04-03,Tanzania,0,0,509,21
2021-04-04,Tanzania,0,0,509,21
2021-04-05,Tanzania,0,0,509,21
2021-04-06,Tanzania,0,0,509,21
2021-04-07,Tanzania,0,0,509,21
2021-04-08,Tanzania,0,0,509,21
2020-01-22,Thailand,0,0,4,0
2020-01-23,Thailand,0,0,4,0
2020-01-24,Thailand,1,0,5,0
2020-01-25,Thailand,1,0,6,0
2020-01-26,Thailand,2,0,8,0
2020-01-27,Thailand,0,0,8,0
2020-01-28,Thailand,6,0,14,0
2020-01-29,Thailand,0,0,14,0
2020-01-30,Thailand,0,0,14,0
2020-01-31,Thailand,5,0,19,0
2020-02-01,Thailand,0,0,19,0
2020-02-02,Thailand,0,0,19,0
2020-02-03,Thailand,0,0,19,0
2020-02-04,Thailand,6,0,25,0
2020-02-05,Thailand,0,0,25,0
2020-02-06,Thailand,0,0,25,0
2020-02-07,Thailand,0,0,25,0
2020-02-08,Thailand,7,0,32,0
2020-02-09,Thailand,0,0,32,0
2020-02-10,Thailand,0,0,32,0
2020-02-11,Thailand,1,0,33,0
2020-02-12,Thailand,0,0,33,0
2020-02-13,Thailand,0,0,33,0
2020-02-14,Thailand,0,0,33,0
2020-02-15,Thailand,1,0,34,0
2020-02-16,Thailand,0,0,34,0
2020-02-17,Thailand,1,0,35,0
2020-02-18,Thailand,0,0,35,0
2020-02-19,Thailand,0,0,35,0
2020-02-20,Thailand,0,0,35,0
2020-02-21,Thailand,0,0,35,0
2020-02-22,Thailand,0,0,35,0
2020-02-23,Thailand,0,0,35,0
2020-02-24,Thailand,0,0,35,0
2020-02-25,Thailand,2,0,37,0
2020-02-26,Thailand,3,0,40,0
2020-02-27,Thailand,0,0,40,0
2020-02-28,Thailand,1,0,41,0
2020-02-29,Thailand,1,0,42,0
2020-03-01,Thailand,0,1,42,1
2020-03-02,Thailand,1,0,43,1
2020-03-03,Thailand,0,0,43,1
2020-03-04,Thailand,0,0,43,1
2020-03-05,Thailand,4,0,47,1
2020-03-06,Thailand,1,0,48,1
2020-03-07,Thailand,2,0,50,1
2020-03-08,Thailand,0,0,50,1
2020-03-09,Thailand,0,0,50,1
2020-03-10,Thailand,3,0,53,1
2020-03-11,Thailand,6,0,59,1
2020-03-12,Thailand,11,0,70,1
2020-03-13,Thailand,5,0,75,1
2020-03-14,Thailand,7,0,82,1
2020-03-15,Thailand,32,0,114,1
2020-03-16,Thailand,33,0,147,1
2020-03-17,Thailand,30,0,177,1
2020-03-18,Thailand,35,0,212,1
2020-03-19,Thailand,60,0,272,1
2020-03-20,Thailand,50,0,322,1
2020-03-21,Thailand,89,0,411,1
2020-03-22,Thailand,188,0,599,1
2020-03-23,Thailand,122,0,721,1
2020-03-24,Thailand,106,3,827,4
2020-03-25,Thailand,107,0,934,4
2020-03-26,Thailand,111,0,1045,4
2020-03-27,Thailand,91,1,1136,5
2020-03-28,Thailand,109,1,1245,6
2020-03-29,Thailand,143,1,1388,7
2020-03-30,Thailand,136,2,1524,9
2020-03-31,Thailand,127,1,1651,10
2020-04-01,Thailand,120,2,1771,12
2020-04-02,Thailand,104,3,1875,15
2020-04-03,Thailand,103,4,1978,19
2020-04-04,Thailand,89,1,2067,20
2020-04-05,Thailand,102,3,2169,23
2020-04-06,Thailand,51,3,2220,26
2020-04-07,Thailand,38,1,2258,27
2020-04-08,Thailand,111,3,2369,30
2020-04-09,Thailand,54,2,2423,32
2020-04-10,Thailand,50,1,2473,33
2020-04-11,Thailand,45,2,2518,35
2020-04-12,Thailand,33,3,2551,38
2020-04-13,Thailand,28,2,2579,40
2020-04-14,Thailand,34,1,2613,41
2020-04-15,Thailand,30,2,2643,43
2020-04-16,Thailand,29,3,2672,46
2020-04-17,Thailand,28,1,2700,47
2020-04-18,Thailand,33,0,2733,47
2020-04-19,Thailand,32,0,2765,47
2020-04-20,Thailand,27,0,2792,47
2020-04-21,Thailand,19,1,2811,48
2020-04-22,Thailand,15,1,2826,49
2020-04-23,Thailand,13,1,2839,50
2020-04-24,Thailand,15,0,2854,50
2020-04-25,Thailand,53,1,2907,51
2020-04-26,Thailand,15,0,2922,51
2020-04-27,Thailand,9,1,2931,52
2020-04-28,Thailand,7,2,2938,54
2020-04-29,Thailand,9,0,2947,54
2020-04-30,Thailand,7,0,2954,54
2020-05-01,Thailand,6,0,2960,54
2020-05-02,Thailand,6,0,2966,54
2020-05-03,Thailand,3,0,2969,54
2020-05-04,Thailand,18,0,2987,54
2020-05-05,Thailand,1,0,2988,54
2020-05-06,Thailand,1,1,2989,55
2020-05-07,Thailand,3,0,2992,55
2020-05-08,Thailand,8,0,3000,55
2020-05-09,Thailand,4,1,3004,56
2020-05-10,Thailand,5,0,3009,56
2020-05-11,Thailand,6,0,3015,56
2020-05-12,Thailand,2,0,3017,56
2020-05-13,Thailand,0,0,3017,56
2020-05-14,Thailand,1,0,3018,56
2020-05-15,Thailand,7,0,3025,56
2020-05-16,Thailand,0,0,3025,56
2020-05-17,Thailand,3,0,3028,56
2020-05-18,Thailand,3,0,3031,56
2020-05-19,Thailand,2,0,3033,56
2020-05-20,Thailand,1,0,3034,56
2020-05-21,Thailand,3,0,3037,56
2020-05-22,Thailand,0,0,3037,56
2020-05-23,Thailand,3,0,3040,56
2020-05-24,Thailand,0,0,3040,56
2020-05-25,Thailand,2,1,3042,57
2020-05-26,Thailand,3,0,3045,57
2020-05-27,Thailand,9,0,3054,57
2020-05-28,Thailand,11,0,3065,57
2020-05-29,Thailand,11,0,3076,57
2020-05-30,Thailand,1,0,3077,57
2020-05-31,Thailand,4,0,3081,57
2020-06-01,Thailand,1,0,3082,57
2020-06-02,Thailand,1,1,3083,58
2020-06-03,Thailand,1,0,3084,58
2020-06-04,Thailand,17,0,3101,58
2020-06-05,Thailand,1,0,3102,58
2020-06-06,Thailand,2,0,3104,58
2020-06-07,Thailand,8,0,3112,58
2020-06-08,Thailand,7,0,3119,58
2020-06-09,Thailand,2,0,3121,58
2020-06-10,Thailand,4,0,3125,58
2020-06-11,Thailand,0,0,3125,58
2020-06-12,Thailand,4,0,3129,58
2020-06-13,Thailand,5,0,3134,58
2020-06-14,Thailand,1,0,3135,58
2020-06-15,Thailand,0,0,3135,58
2020-06-16,Thailand,0,0,3135,58
2020-06-17,Thailand,0,0,3135,58
2020-06-18,Thailand,6,0,3141,58
2020-06-19,Thailand,5,0,3146,58
2020-06-20,Thailand,1,0,3147,58
2020-06-21,Thailand,1,0,3148,58
2020-06-22,Thailand,3,0,3151,58
2020-06-23,Thailand,5,0,3156,58
2020-06-24,Thailand,1,0,3157,58
2020-06-25,Thailand,1,0,3158,58
2020-06-26,Thailand,4,0,3162,58
2020-06-27,Thailand,0,0,3162,58
2020-06-28,Thailand,0,0,3162,58
2020-06-29,Thailand,7,0,3169,58
2020-06-30,Thailand,2,0,3171,58
2020-07-01,Thailand,2,0,3173,58
2020-07-02,Thailand,6,0,3179,58
2020-07-03,Thailand,1,0,3180,58
2020-07-04,Thailand,5,0,3185,58
2020-07-05,Thailand,5,0,3190,58
2020-07-06,Thailand,5,0,3195,58
2020-07-07,Thailand,0,0,3195,58
2020-07-08,Thailand,2,0,3197,58
2020-07-09,Thailand,5,0,3202,58
2020-07-10,Thailand,0,0,3202,58
2020-07-11,Thailand,14,0,3216,58
2020-07-12,Thailand,1,0,3217,58
2020-07-13,Thailand,3,0,3220,58
2020-07-14,Thailand,7,0,3227,58
2020-07-15,Thailand,5,0,3232,58
2020-07-16,Thailand,4,0,3236,58
2020-07-17,Thailand,3,0,3239,58
2020-07-18,Thailand,7,0,3246,58
2020-07-19,Thailand,3,0,3249,58
2020-07-20,Thailand,1,0,3250,58
2020-07-21,Thailand,5,0,3255,58
2020-07-22,Thailand,-2,0,3253,58
2020-07-23,Thailand,16,0,3269,58
2020-07-24,Thailand,10,0,3279,58
2020-07-25,Thailand,3,0,3282,58
2020-07-26,Thailand,9,0,3291,58
2020-07-27,Thailand,4,0,3295,58
2020-07-28,Thailand,2,0,3297,58
2020-07-29,Thailand,1,0,3298,58
2020-07-30,Thailand,6,0,3304,58
2020-07-31,Thailand,6,0,3310,58
2020-08-01,Thailand,2,0,3312,58
2020-08-02,Thailand,5,0,3317,58
2020-08-03,Thailand,3,0,3320,58
2020-08-04,Thailand,1,0,3321,58
2020-08-05,Thailand,7,0,3328,58
2020-08-06,Thailand,2,0,3330,58
2020-08-07,Thailand,15,0,3345,58
2020-08-08,Thailand,3,0,3348,58
2020-08-09,Thailand,3,0,3351,58
2020-08-10,Thailand,0,0,3351,58
2020-08-11,Thailand,0,0,3351,58
2020-08-12,Thailand,5,0,3356,58
2020-08-13,Thailand,3,0,3359,58
2020-08-14,Thailand,17,0,3376,58
2020-08-15,Thailand,0,0,3376,58
2020-08-16,Thailand,1,0,3377,58
2020-08-17,Thailand,1,0,3378,58
2020-08-18,Thailand,3,0,3381,58
2020-08-19,Thailand,1,0,3382,58
2020-08-20,Thailand,7,0,3389,58
2020-08-21,Thailand,1,0,3390,58
2020-08-22,Thailand,0,0,3390,58
2020-08-23,Thailand,5,0,3395,58
2020-08-24,Thailand,2,0,3397,58
2020-08-25,Thailand,5,0,3402,58
2020-08-26,Thailand,1,0,3403,58
2020-08-27,Thailand,1,0,3404,58
2020-08-28,Thailand,6,0,3410,58
2020-08-29,Thailand,1,0,3411,58
2020-08-30,Thailand,0,0,3411,58
2020-08-31,Thailand,1,0,3412,58
2020-09-01,Thailand,5,0,3417,58
2020-09-02,Thailand,8,0,3425,58
2020-09-03,Thailand,2,0,3427,58
2020-09-04,Thailand,4,0,3431,58
2020-09-05,Thailand,7,0,3438,58
2020-09-06,Thailand,6,0,3444,58
2020-09-07,Thailand,1,0,3445,58
2020-09-08,Thailand,1,0,3446,58
2020-09-09,Thailand,1,0,3447,58
2020-09-10,Thailand,7,0,3454,58
2020-09-11,Thailand,7,0,3461,58
2020-09-12,Thailand,5,0,3466,58
2020-09-13,Thailand,7,0,3473,58
2020-09-14,Thailand,2,0,3475,58
2020-09-15,Thailand,5,0,3480,58
2020-09-16,Thailand,10,0,3490,58
2020-09-17,Thailand,0,0,3490,58
2020-09-18,Thailand,7,0,3497,58
2020-09-19,Thailand,3,1,3500,59
2020-09-20,Thailand,6,0,3506,59
2020-09-21,Thailand,5,0,3511,59
2020-09-22,Thailand,3,0,3514,59
2020-09-23,Thailand,2,0,3516,59
2020-09-24,Thailand,3,0,3519,59
2020-09-25,Thailand,3,0,3522,59
2020-09-26,Thailand,1,0,3523,59
2020-09-27,Thailand,22,0,3545,59
2020-09-28,Thailand,14,0,3559,59
2020-09-29,Thailand,5,0,3564,59
2020-09-30,Thailand,5,0,3569,59
2020-10-01,Thailand,6,0,3575,59
2020-10-02,Thailand,8,0,3583,59
2020-10-03,Thailand,2,0,3585,59
2020-10-04,Thailand,5,0,3590,59
2020-10-05,Thailand,10,0,3600,59
2020-10-06,Thailand,15,0,3615,59
2020-10-07,Thailand,7,0,3622,59
2020-10-08,Thailand,6,0,3628,59
2020-10-09,Thailand,6,0,3634,59
2020-10-10,Thailand,2,0,3636,59
2020-10-11,Thailand,5,0,3641,59
2020-10-12,Thailand,2,0,3643,59
2020-10-13,Thailand,9,0,3652,59
2020-10-14,Thailand,13,0,3665,59
2020-10-15,Thailand,10,0,3675,59
2020-10-16,Thailand,11,0,3686,59
2020-10-17,Thailand,-7,0,3679,59
2020-10-18,Thailand,12,0,3691,59
2020-10-19,Thailand,9,0,3700,59
2020-10-20,Thailand,9,0,3709,59
2020-10-21,Thailand,10,0,3719,59
2020-10-22,Thailand,8,0,3727,59
2020-10-23,Thailand,4,0,3731,59
2020-10-24,Thailand,5,0,3736,59
2020-10-25,Thailand,7,0,3743,59
2020-10-26,Thailand,3,0,3746,59
2020-10-27,Thailand,13,0,3759,59
2020-10-28,Thailand,4,0,3763,59
2020-10-29,Thailand,12,0,3775,59
2020-10-30,Thailand,5,0,3780,59
2020-10-31,Thailand,4,0,3784,59
2020-11-01,Thailand,3,0,3787,59
2020-11-02,Thailand,10,0,3797,59
2020-11-03,Thailand,7,0,3804,59
2020-11-04,Thailand,6,0,3810,59
2020-11-05,Thailand,8,1,3818,60
2020-11-06,Thailand,12,0,3830,60
2020-11-07,Thailand,7,0,3837,60
2020-11-08,Thailand,3,0,3840,60
2020-11-09,Thailand,4,0,3844,60
2020-11-10,Thailand,3,0,3847,60
2020-11-11,Thailand,5,0,3852,60
2020-11-12,Thailand,9,0,3861,60
2020-11-13,Thailand,5,0,3866,60
2020-11-14,Thailand,8,0,3874,60
2020-11-15,Thailand,1,0,3875,60
2020-11-16,Thailand,3,0,3878,60
2020-11-17,Thailand,2,0,3880,60
2020-11-18,Thailand,8,0,3888,60
2020-11-19,Thailand,4,0,3892,60
2020-11-20,Thailand,7,0,3899,60
2020-11-21,Thailand,23,0,3922,60
2020-11-22,Thailand,-2,0,3920,60
2020-11-23,Thailand,-10,0,3910,60
2020-11-24,Thailand,16,0,3926,60
2020-11-25,Thailand,16,0,3942,60
2020-11-26,Thailand,19,0,3961,60
2020-11-27,Thailand,5,0,3966,60
2020-11-28,Thailand,11,0,3977,60
2020-11-29,Thailand,21,0,3998,60
2020-11-30,Thailand,10,0,4008,60
2020-12-01,Thailand,18,0,4026,60
2020-12-02,Thailand,13,0,4039,60
2020-12-03,Thailand,14,0,4053,60
2020-12-04,Thailand,19,0,4072,60
2020-12-05,Thailand,14,0,4086,60
2020-12-06,Thailand,21,0,4107,60
2020-12-07,Thailand,19,0,4126,60
2020-12-08,Thailand,25,0,4151,60
2020-12-09,Thailand,18,0,4169,60
2020-12-10,Thailand,11,0,4180,60
2020-12-11,Thailand,12,0,4192,60
2020-12-12,Thailand,17,0,4209,60
2020-12-13,Thailand,28,0,4237,60
2020-12-14,Thailand,9,0,4246,60
2020-12-15,Thailand,15,0,4261,60
2020-12-16,Thailand,20,0,4281,60
2020-12-17,Thailand,16,0,4297,60
2020-12-18,Thailand,34,0,4331,60
2020-12-19,Thailand,576,0,4907,60
2020-12-20,Thailand,382,0,5289,60
2020-12-21,Thailand,427,0,5716,60
2020-12-22,Thailand,46,0,5762,60
2020-12-23,Thailand,67,0,5829,60
2020-12-24,Thailand,81,0,5910,60
2020-12-25,Thailand,110,0,6020,60
2020-12-26,Thailand,121,0,6141,60
2020-12-27,Thailand,144,0,6285,60
2020-12-28,Thailand,155,1,6440,61
2020-12-29,Thailand,250,0,6690,61
2020-12-30,Thailand,194,0,6884,61
2020-12-31,Thailand,279,2,7163,63
2021-01-01,Thailand,216,1,7379,64
2021-01-02,Thailand,315,0,7694,64
2021-01-03,Thailand,745,1,8439,65
2021-01-04,Thailand,527,0,8966,65
2021-01-05,Thailand,365,1,9331,66
2021-01-06,Thailand,305,1,9636,67
2021-01-07,Thailand,205,0,9841,67
2021-01-08,Thailand,212,0,10053,67
2021-01-09,Thailand,245,0,10298,67
2021-01-10,Thailand,249,0,10547,67
2021-01-11,Thailand,287,0,10834,67
2021-01-12,Thailand,157,0,10991,67
2021-01-13,Thailand,0,0,10991,67
2021-01-14,Thailand,459,2,11450,69
2021-01-15,Thailand,230,1,11680,70
2021-01-16,Thailand,374,0,12054,70
2021-01-17,Thailand,369,0,12423,70
2021-01-18,Thailand,171,0,12594,70
2021-01-19,Thailand,59,1,12653,71
2021-01-20,Thailand,142,0,12795,71
2021-01-21,Thailand,0,0,12795,71
2021-01-22,Thailand,309,0,13104,71
2021-01-23,Thailand,198,1,13302,72
2021-01-24,Thailand,198,1,13500,73
2021-01-25,Thailand,1146,2,14646,75
2021-01-26,Thailand,0,0,14646,75
2021-01-27,Thailand,819,1,15465,76
2021-01-28,Thailand,756,0,16221,76
2021-01-29,Thailand,1732,1,17953,77
2021-01-30,Thailand,829,0,18782,77
2021-01-31,Thailand,836,0,19618,77
2021-02-01,Thailand,836,2,20454,79
2021-02-02,Thailand,795,0,21249,79
2021-02-03,Thailand,0,0,21249,79
2021-02-04,Thailand,809,0,22058,79
2021-02-05,Thailand,1076,0,23134,79
2021-02-06,Thailand,237,0,23371,79
2021-02-07,Thailand,186,0,23557,79
2021-02-08,Thailand,0,0,23557,79
2021-02-09,Thailand,189,0,23746,79
2021-02-10,Thailand,358,1,24104,80
2021-02-11,Thailand,175,0,24279,80
2021-02-12,Thailand,0,0,24279,80
2021-02-13,Thailand,126,0,24405,80
2021-02-14,Thailand,166,0,24571,80
2021-02-15,Thailand,143,2,24714,82
2021-02-16,Thailand,72,0,24786,82
2021-02-17,Thailand,175,0,24961,82
2021-02-18,Thailand,150,1,25111,83
2021-02-19,Thailand,130,0,25241,83
2021-02-20,Thailand,82,0,25323,83
2021-02-21,Thailand,181,0,25504,83
2021-02-22,Thailand,0,0,25504,83
2021-02-23,Thailand,188,0,25692,83
2021-02-24,Thailand,0,0,25692,83
2021-02-25,Thailand,72,0,25764,83
2021-02-26,Thailand,45,0,25809,83
2021-02-27,Thailand,142,0,25951,83
2021-02-28,Thailand,80,0,26031,83
2021-03-01,Thailand,0,0,26031,83
2021-03-02,Thailand,42,1,26073,84
2021-03-03,Thailand,35,1,26108,85
2021-03-04,Thailand,54,0,26162,85
2021-03-05,Thailand,79,0,26241,85
2021-03-06,Thailand,64,0,26305,85
2021-03-07,Thailand,136,0,26441,85
2021-03-08,Thailand,0,0,26441,85
2021-03-09,Thailand,60,0,26501,85
2021-03-10,Thailand,39,0,26540,85
2021-03-11,Thailand,58,0,26598,85
2021-03-12,Thailand,81,0,26679,85
2021-03-13,Thailand,78,1,26757,86
2021-03-14,Thailand,170,1,26927,87
2021-03-15,Thailand,78,0,27005,87
2021-03-16,Thailand,149,1,27154,88
2021-03-17,Thailand,248,1,27402,89
2021-03-18,Thailand,92,0,27494,89
2021-03-19,Thailand,100,1,27594,90
2021-03-20,Thailand,119,0,27713,90
2021-03-21,Thailand,90,0,27803,90
2021-03-22,Thailand,73,1,27876,91
2021-03-23,Thailand,470,1,28346,92
2021-03-24,Thailand,97,0,28443,92
2021-03-25,Thailand,0,0,28443,92
2021-03-26,Thailand,134,0,28577,92
2021-03-27,Thailand,80,1,28657,93
2021-03-28,Thailand,77,1,28734,94
2021-03-29,Thailand,39,0,28773,94
2021-03-30,Thailand,48,0,28821,94
2021-03-31,Thailand,42,0,28863,94
2021-04-01,Thailand,26,0,28889,94
2021-04-02,Thailand,58,0,28947,94
2021-04-03,Thailand,84,1,29031,95
2021-04-04,Thailand,96,0,29127,95
2021-04-05,Thailand,194,0,29321,95
2021-04-06,Thailand,250,0,29571,95
2021-04-07,Thailand,334,0,29905,95
2021-04-08,Thailand,405,0,30310,95
2020-03-22,Timor,1,0,1,0
2020-03-23,Timor,0,0,1,0
2020-03-24,Timor,0,0,1,0
2020-03-25,Timor,0,0,1,0
2020-03-26,Timor,0,0,1,0
2020-03-27,Timor,0,0,1,0
2020-03-28,Timor,0,0,1,0
2020-03-29,Timor,0,0,1,0
2020-03-30,Timor,0,0,1,0
2020-03-31,Timor,0,0,1,0
2020-04-01,Timor,0,0,1,0
2020-04-02,Timor,0,0,1,0
2020-04-03,Timor,0,0,1,0
2020-04-04,Timor,0,0,1,0
2020-04-05,Timor,0,0,1,0
2020-04-06,Timor,0,0,1,0
2020-04-07,Timor,0,0,1,0
2020-04-08,Timor,0,0,1,0
2020-04-09,Timor,0,0,1,0
2020-04-10,Timor,1,0,2,0
2020-04-11,Timor,0,0,2,0
2020-04-12,Timor,0,0,2,0
2020-04-13,Timor,2,0,4,0
2020-04-14,Timor,2,0,6,0
2020-04-15,Timor,2,0,8,0
2020-04-16,Timor,10,0,18,0
2020-04-17,Timor,0,0,18,0
2020-04-18,Timor,0,0,18,0
2020-04-19,Timor,1,0,19,0
2020-04-20,Timor,3,0,22,0
2020-04-21,Timor,1,0,23,0
2020-04-22,Timor,0,0,23,0
2020-04-23,Timor,0,0,23,0
2020-04-24,Timor,1,0,24,0
2020-04-25,Timor,0,0,24,0
2020-04-26,Timor,0,0,24,0
2020-04-27,Timor,0,0,24,0
2020-04-28,Timor,0,0,24,0
2020-04-29,Timor,0,0,24,0
2020-04-30,Timor,0,0,24,0
2020-05-01,Timor,0,0,24,0
2020-05-02,Timor,0,0,24,0
2020-05-03,Timor,0,0,24,0
2020-05-04,Timor,0,0,24,0
2020-05-05,Timor,0,0,24,0
2020-05-06,Timor,0,0,24,0
2020-05-07,Timor,0,0,24,0
2020-05-08,Timor,0,0,24,0
2020-05-09,Timor,0,0,24,0
2020-05-10,Timor,0,0,24,0
2020-05-11,Timor,0,0,24,0
2020-05-12,Timor,0,0,24,0
2020-05-13,Timor,0,0,24,0
2020-05-14,Timor,0,0,24,0
2020-05-15,Timor,0,0,24,0
2020-05-16,Timor,0,0,24,0
2020-05-17,Timor,0,0,24,0
2020-05-18,Timor,0,0,24,0
2020-05-19,Timor,0,0,24,0
2020-05-20,Timor,0,0,24,0
2020-05-21,Timor,0,0,24,0
2020-05-22,Timor,0,0,24,0
2020-05-23,Timor,0,0,24,0
2020-05-24,Timor,0,0,24,0
2020-05-25,Timor,0,0,24,0
2020-05-26,Timor,0,0,24,0
2020-05-27,Timor,0,0,24,0
2020-05-28,Timor,0,0,24,0
2020-05-29,Timor,0,0,24,0
2020-05-30,Timor,0,0,24,0
2020-05-31,Timor,0,0,24,0
2020-06-01,Timor,0,0,24,0
2020-06-02,Timor,0,0,24,0
2020-06-03,Timor,0,0,24,0
2020-06-04,Timor,0,0,24,0
2020-06-05,Timor,0,0,24,0
2020-06-06,Timor,0,0,24,0
2020-06-07,Timor,0,0,24,0
2020-06-08,Timor,0,0,24,0
2020-06-09,Timor,0,0,24,0
2020-06-10,Timor,0,0,24,0
2020-06-11,Timor,0,0,24,0
2020-06-12,Timor,0,0,24,0
2020-06-13,Timor,0,0,24,0
2020-06-14,Timor,0,0,24,0
2020-06-15,Timor,0,0,24,0
2020-06-16,Timor,0,0,24,0
2020-06-17,Timor,0,0,24,0
2020-06-18,Timor,0,0,24,0
2020-06-19,Timor,0,0,24,0
2020-06-20,Timor,0,0,24,0
2020-06-21,Timor,0,0,24,0
2020-06-22,Timor,0,0,24,0
2020-06-23,Timor,0,0,24,0
2020-06-24,Timor,0,0,24,0
2020-06-25,Timor,0,0,24,0
2020-06-26,Timor,0,0,24,0
2020-06-27,Timor,0,0,24,0
2020-06-28,Timor,0,0,24,0
2020-06-29,Timor,0,0,24,0
2020-06-30,Timor,0,0,24,0
2020-07-01,Timor,0,0,24,0
2020-07-02,Timor,0,0,24,0
2020-07-03,Timor,0,0,24,0
2020-07-04,Timor,0,0,24,0
2020-07-05,Timor,0,0,24,0
2020-07-06,Timor,0,0,24,0
2020-07-07,Timor,0,0,24,0
2020-07-08,Timor,0,0,24,0
2020-07-09,Timor,0,0,24,0
2020-07-10,Timor,0,0,24,0
2020-07-11,Timor,0,0,24,0
2020-07-12,Timor,0,0,24,0
2020-07-13,Timor,0,0,24,0
2020-07-14,Timor,0,0,24,0
2020-07-15,Timor,0,0,24,0
2020-07-16,Timor,0,0,24,0
2020-07-17,Timor,0,0,24,0
2020-07-18,Timor,0,0,24,0
2020-07-19,Timor,0,0,24,0
2020-07-20,Timor,0,0,24,0
2020-07-21,Timor,0,0,24,0
2020-07-22,Timor,0,0,24,0
2020-07-23,Timor,0,0,24,0
2020-07-24,Timor,0,0,24,0
2020-07-25,Timor,0,0,24,0
2020-07-26,Timor,0,0,24,0
2020-07-27,Timor,0,0,24,0
2020-07-28,Timor,0,0,24,0
2020-07-29,Timor,0,0,24,0
2020-07-30,Timor,0,0,24,0
2020-07-31,Timor,0,0,24,0
2020-08-01,Timor,0,0,24,0
2020-08-02,Timor,0,0,24,0
2020-08-03,Timor,0,0,24,0
2020-08-04,Timor,1,0,25,0
2020-08-05,Timor,0,0,25,0
2020-08-06,Timor,0,0,25,0
2020-08-07,Timor,0,0,25,0
2020-08-08,Timor,0,0,25,0
2020-08-09,Timor,0,0,25,0
2020-08-10,Timor,0,0,25,0
2020-08-11,Timor,0,0,25,0
2020-08-12,Timor,0,0,25,0
2020-08-13,Timor,0,0,25,0
2020-08-14,Timor,0,0,25,0
2020-08-15,Timor,0,0,25,0
2020-08-16,Timor,0,0,25,0
2020-08-17,Timor,0,0,25,0
2020-08-18,Timor,0,0,25,0
2020-08-19,Timor,0,0,25,0
2020-08-20,Timor,0,0,25,0
2020-08-21,Timor,0,0,25,0
2020-08-22,Timor,1,0,26,0
2020-08-23,Timor,0,0,26,0
2020-08-24,Timor,0,0,26,0
2020-08-25,Timor,0,0,26,0
2020-08-26,Timor,0,0,26,0
2020-08-27,Timor,1,0,27,0
2020-08-28,Timor,0,0,27,0
2020-08-29,Timor,0,0,27,0
2020-08-30,Timor,0,0,27,0
2020-08-31,Timor,0,0,27,0
2020-09-01,Timor,0,0,27,0
2020-09-02,Timor,0,0,27,0
2020-09-03,Timor,0,0,27,0
2020-09-04,Timor,0,0,27,0
2020-09-05,Timor,0,0,27,0
2020-09-06,Timor,0,0,27,0
2020-09-07,Timor,0,0,27,0
2020-09-08,Timor,0,0,27,0
2020-09-09,Timor,0,0,27,0
2020-09-10,Timor,0,0,27,0
2020-09-11,Timor,0,0,27,0
2020-09-12,Timor,0,0,27,0
2020-09-13,Timor,0,0,27,0
2020-09-14,Timor,0,0,27,0
2020-09-15,Timor,0,0,27,0
2020-09-16,Timor,0,0,27,0
2020-09-17,Timor,0,0,27,0
2020-09-18,Timor,0,0,27,0
2020-09-19,Timor,0,0,27,0
2020-09-20,Timor,0,0,27,0
2020-09-21,Timor,0,0,27,0
2020-09-22,Timor,0,0,27,0
2020-09-23,Timor,0,0,27,0
2020-09-24,Timor,0,0,27,0
2020-09-25,Timor,0,0,27,0
2020-09-26,Timor,0,0,27,0
2020-09-27,Timor,0,0,27,0
2020-09-28,Timor,0,0,27,0
2020-09-29,Timor,1,0,28,0
2020-09-30,Timor,0,0,28,0
2020-10-01,Timor,0,0,28,0
2020-10-02,Timor,0,0,28,0
2020-10-03,Timor,0,0,28,0
2020-10-04,Timor,0,0,28,0
2020-10-05,Timor,0,0,28,0
2020-10-06,Timor,0,0,28,0
2020-10-07,Timor,0,0,28,0
2020-10-08,Timor,0,0,28,0
2020-10-09,Timor,0,0,28,0
2020-10-10,Timor,0,0,28,0
2020-10-11,Timor,0,0,28,0
2020-10-12,Timor,1,0,29,0
2020-10-13,Timor,0,0,29,0
2020-10-14,Timor,0,0,29,0
2020-10-15,Timor,0,0,29,0
2020-10-16,Timor,0,0,29,0
2020-10-17,Timor,0,0,29,0
2020-10-18,Timor,0,0,29,0
2020-10-19,Timor,0,0,29,0
2020-10-20,Timor,0,0,29,0
2020-10-21,Timor,0,0,29,0
2020-10-22,Timor,0,0,29,0
2020-10-23,Timor,0,0,29,0
2020-10-24,Timor,0,0,29,0
2020-10-25,Timor,0,0,29,0
2020-10-26,Timor,1,0,30,0
2020-10-27,Timor,0,0,30,0
2020-10-28,Timor,0,0,30,0
2020-10-29,Timor,0,0,30,0
2020-10-30,Timor,0,0,30,0
2020-10-31,Timor,0,0,30,0
2020-11-01,Timor,0,0,30,0
2020-11-02,Timor,0,0,30,0
2020-11-03,Timor,0,0,30,0
2020-11-04,Timor,0,0,30,0
2020-11-05,Timor,0,0,30,0
2020-11-06,Timor,0,0,30,0
2020-11-07,Timor,0,0,30,0
2020-11-08,Timor,0,0,30,0
2020-11-09,Timor,0,0,30,0
2020-11-10,Timor,0,0,30,0
2020-11-11,Timor,0,0,30,0
2020-11-12,Timor,0,0,30,0
2020-11-13,Timor,0,0,30,0
2020-11-14,Timor,0,0,30,0
2020-11-15,Timor,0,0,30,0
2020-11-16,Timor,0,0,30,0
2020-11-17,Timor,0,0,30,0
2020-11-18,Timor,0,0,30,0
2020-11-19,Timor,0,0,30,0
2020-11-20,Timor,0,0,30,0
2020-11-21,Timor,0,0,30,0
2020-11-22,Timor,0,0,30,0
2020-11-23,Timor,0,0,30,0
2020-11-24,Timor,0,0,30,0
2020-11-25,Timor,0,0,30,0
2020-11-26,Timor,0,0,30,0
2020-11-27,Timor,0,0,30,0
2020-11-28,Timor,0,0,30,0
2020-11-29,Timor,0,0,30,0
2020-11-30,Timor,0,0,30,0
2020-12-01,Timor,0,0,30,0
2020-12-02,Timor,1,0,31,0
2020-12-03,Timor,0,0,31,0
2020-12-04,Timor,0,0,31,0
2020-12-05,Timor,0,0,31,0
2020-12-06,Timor,0,0,31,0
2020-12-07,Timor,0,0,31,0
2020-12-08,Timor,0,0,31,0
2020-12-09,Timor,0,0,31,0
2020-12-10,Timor,0,0,31,0
2020-12-11,Timor,0,0,31,0
2020-12-12,Timor,0,0,31,0
2020-12-13,Timor,0,0,31,0
2020-12-14,Timor,0,0,31,0
2020-12-15,Timor,0,0,31,0
2020-12-16,Timor,0,0,31,0
2020-12-17,Timor,0,0,31,0
2020-12-18,Timor,0,0,31,0
2020-12-19,Timor,0,0,31,0
2020-12-20,Timor,0,0,31,0
2020-12-21,Timor,0,0,31,0
2020-12-22,Timor,0,0,31,0
2020-12-23,Timor,2,0,33,0
2020-12-24,Timor,8,0,41,0
2020-12-25,Timor,0,0,41,0
2020-12-26,Timor,0,0,41,0
2020-12-27,Timor,0,0,41,0
2020-12-28,Timor,3,0,44,0
2020-12-29,Timor,0,0,44,0
2020-12-30,Timor,0,0,44,0
2020-12-31,Timor,0,0,44,0
2021-01-01,Timor,0,0,44,0
2021-01-02,Timor,0,0,44,0
2021-01-03,Timor,2,0,46,0
2021-01-04,Timor,3,0,49,0
2021-01-05,Timor,0,0,49,0
2021-01-06,Timor,0,0,49,0
2021-01-07,Timor,0,0,49,0
2021-01-08,Timor,0,0,49,0
2021-01-09,Timor,0,0,49,0
2021-01-10,Timor,0,0,49,0
2021-01-11,Timor,0,0,49,0
2021-01-12,Timor,0,0,49,0
2021-01-13,Timor,2,0,51,0
2021-01-14,Timor,0,0,51,0
2021-01-15,Timor,0,0,51,0
2021-01-16,Timor,1,0,52,0
2021-01-17,Timor,0,0,52,0
2021-01-18,Timor,0,0,52,0
2021-01-19,Timor,0,0,52,0
2021-01-20,Timor,1,0,53,0
2021-01-21,Timor,0,0,53,0
2021-01-22,Timor,0,0,53,0
2021-01-23,Timor,11,0,64,0
2021-01-24,Timor,3,0,67,0
2021-01-25,Timor,0,0,67,0
2021-01-26,Timor,0,0,67,0
2021-01-27,Timor,1,0,68,0
2021-01-28,Timor,0,0,68,0
2021-01-29,Timor,1,0,69,0
2021-01-30,Timor,1,0,70,0
2021-01-31,Timor,0,0,70,0
2021-02-01,Timor,0,0,70,0
2021-02-02,Timor,5,0,75,0
2021-02-03,Timor,2,0,77,0
2021-02-04,Timor,3,0,80,0
2021-02-05,Timor,0,0,80,0
2021-02-06,Timor,0,0,80,0
2021-02-07,Timor,0,0,80,0
2021-02-08,Timor,0,0,80,0
2021-02-09,Timor,6,0,86,0
2021-02-10,Timor,0,0,86,0
2021-02-11,Timor,14,0,100,0
2021-02-12,Timor,0,0,100,0
2021-02-13,Timor,1,0,101,0
2021-02-14,Timor,1,0,102,0
2021-02-15,Timor,0,0,102,0
2021-02-16,Timor,0,0,102,0
2021-02-17,Timor,0,0,102,0
2021-02-18,Timor,1,0,103,0
2021-02-19,Timor,0,0,103,0
2021-02-20,Timor,0,0,103,0
2021-02-21,Timor,0,0,103,0
2021-02-22,Timor,0,0,103,0
2021-02-23,Timor,4,0,107,0
2021-02-24,Timor,2,0,109,0
2021-02-25,Timor,1,0,110,0
2021-02-26,Timor,0,0,110,0
2021-02-27,Timor,1,0,111,0
2021-02-28,Timor,2,0,113,0
2021-03-01,Timor,0,0,113,0
2021-03-02,Timor,0,0,113,0
2021-03-03,Timor,0,0,113,0
2021-03-04,Timor,0,0,113,0
2021-03-05,Timor,6,0,119,0
2021-03-06,Timor,0,0,119,0
2021-03-07,Timor,3,0,122,0
2021-03-08,Timor,7,0,129,0
2021-03-09,Timor,13,0,142,0
2021-03-10,Timor,3,0,145,0
2021-03-11,Timor,14,0,159,0
2021-03-12,Timor,11,0,170,0
2021-03-13,Timor,8,0,178,0
2021-03-14,Timor,18,0,196,0
2021-03-15,Timor,7,0,203,0
2021-03-16,Timor,5,0,208,0
2021-03-17,Timor,8,0,216,0
2021-03-18,Timor,13,0,229,0
2021-03-19,Timor,23,0,252,0
2021-03-20,Timor,19,0,271,0
2021-03-21,Timor,55,0,326,0
2021-03-22,Timor,9,0,335,0
2021-03-23,Timor,16,0,351,0
2021-03-24,Timor,21,0,372,0
2021-03-25,Timor,22,0,394,0
2021-03-26,Timor,58,0,452,0
2021-03-27,Timor,28,0,480,0
2021-03-28,Timor,11,0,491,0
2021-03-29,Timor,21,0,512,0
2021-03-30,Timor,51,0,563,0
2021-03-31,Timor,41,0,604,0
2021-04-01,Timor,39,0,643,0
2021-04-02,Timor,34,0,677,0
2021-04-03,Timor,37,0,714,0
2021-04-04,Timor,0,0,714,0
2021-04-05,Timor,52,0,766,0
2021-04-06,Timor,13,1,779,1
2021-04-07,Timor,0,0,779,1
2021-04-08,Timor,8,0,787,1
2020-03-06,Togo,1,0,1,0
2020-03-07,Togo,0,0,1,0
2020-03-08,Togo,0,0,1,0
2020-03-09,Togo,0,0,1,0
2020-03-10,Togo,0,0,1,0
2020-03-11,Togo,0,0,1,0
2020-03-12,Togo,0,0,1,0
2020-03-13,Togo,0,0,1,0
2020-03-14,Togo,0,0,1,0
2020-03-15,Togo,0,0,1,0
2020-03-16,Togo,0,0,1,0
2020-03-17,Togo,0,0,1,0
2020-03-18,Togo,0,0,1,0
2020-03-19,Togo,0,0,1,0
2020-03-20,Togo,8,0,9,0
2020-03-21,Togo,7,0,16,0
2020-03-22,Togo,0,0,16,0
2020-03-23,Togo,2,0,18,0
2020-03-24,Togo,2,0,20,0
2020-03-25,Togo,3,0,23,0
2020-03-26,Togo,0,0,23,0
2020-03-27,Togo,2,1,25,1
2020-03-28,Togo,0,0,25,1
2020-03-29,Togo,0,0,25,1
2020-03-30,Togo,5,0,30,1
2020-03-31,Togo,4,0,34,1
2020-04-01,Togo,2,1,36,2
2020-04-02,Togo,3,0,39,2
2020-04-03,Togo,1,1,40,3
2020-04-04,Togo,1,0,41,3
2020-04-05,Togo,3,0,44,3
2020-04-06,Togo,14,0,58,3
2020-04-07,Togo,7,0,65,3
2020-04-08,Togo,5,0,70,3
2020-04-09,Togo,3,0,73,3
2020-04-10,Togo,3,0,76,3
2020-04-11,Togo,0,0,76,3
2020-04-12,Togo,0,0,76,3
2020-04-13,Togo,1,0,77,3
2020-04-14,Togo,0,0,77,3
2020-04-15,Togo,4,0,81,3
2020-04-16,Togo,0,2,81,5
2020-04-17,Togo,2,0,83,5
2020-04-18,Togo,1,0,84,5
2020-04-19,Togo,0,0,84,5
2020-04-20,Togo,0,1,84,6
2020-04-21,Togo,2,0,86,6
2020-04-22,Togo,2,0,88,6
2020-04-23,Togo,0,0,88,6
2020-04-24,Togo,2,0,90,6
2020-04-25,Togo,6,0,96,6
2020-04-26,Togo,2,0,98,6
2020-04-27,Togo,0,0,98,6
2020-04-28,Togo,1,0,99,6
2020-04-29,Togo,10,1,109,7
2020-04-30,Togo,7,2,116,9
2020-05-01,Togo,7,0,123,9
2020-05-02,Togo,0,0,123,9
2020-05-03,Togo,1,0,124,9
2020-05-04,Togo,2,0,126,9
2020-05-05,Togo,2,0,128,9
2020-05-06,Togo,0,0,128,9
2020-05-07,Togo,7,0,135,9
2020-05-08,Togo,10,1,145,10
2020-05-09,Togo,8,0,153,10
2020-05-10,Togo,21,1,174,11
2020-05-11,Togo,7,0,181,11
2020-05-12,Togo,18,0,199,11
2020-05-13,Togo,20,0,219,11
2020-05-14,Togo,19,0,238,11
2020-05-15,Togo,25,0,263,11
2020-05-16,Togo,35,0,298,11
2020-05-17,Togo,3,0,301,11
2020-05-18,Togo,29,1,330,12
2020-05-19,Togo,8,0,338,12
2020-05-20,Togo,2,0,340,12
2020-05-21,Togo,14,0,354,12
2020-05-22,Togo,9,0,363,12
2020-05-23,Togo,10,0,373,12
2020-05-24,Togo,8,0,381,12
2020-05-25,Togo,5,1,386,13
2020-05-26,Togo,5,0,391,13
2020-05-27,Togo,4,0,395,13
2020-05-28,Togo,27,0,422,13
2020-05-29,Togo,6,0,428,13
2020-05-30,Togo,5,0,433,13
2020-05-31,Togo,9,0,442,13
2020-06-01,Togo,1,0,443,13
2020-06-02,Togo,2,0,445,13
2020-06-03,Togo,7,0,452,13
2020-06-04,Togo,13,0,465,13
2020-06-05,Togo,20,0,485,13
2020-06-06,Togo,2,0,487,13
2020-06-07,Togo,8,0,495,13
2020-06-08,Togo,2,0,497,13
2020-06-09,Togo,4,0,501,13
2020-06-10,Togo,21,0,522,13
2020-06-11,Togo,2,0,524,13
2020-06-12,Togo,1,0,525,13
2020-06-13,Togo,5,0,530,13
2020-06-14,Togo,0,0,530,13
2020-06-15,Togo,1,0,531,13
2020-06-16,Togo,6,0,537,13
2020-06-17,Togo,7,0,544,13
2020-06-18,Togo,3,0,547,13
2020-06-19,Togo,8,0,555,13
2020-06-20,Togo,6,0,561,13
2020-06-21,Togo,8,0,569,13
2020-06-22,Togo,0,0,569,13
2020-06-23,Togo,7,0,576,13
2020-06-24,Togo,7,1,583,14
2020-06-25,Togo,5,0,588,14
2020-06-26,Togo,3,0,591,14
2020-06-27,Togo,24,0,615,14
2020-06-28,Togo,27,0,642,14
2020-06-29,Togo,1,0,643,14
2020-06-30,Togo,7,0,650,14
2020-07-01,Togo,11,0,661,14
2020-07-02,Togo,6,0,667,14
2020-07-03,Togo,4,0,671,14
2020-07-04,Togo,5,1,676,15
2020-07-05,Togo,4,0,680,15
2020-07-06,Togo,0,0,680,15
2020-07-07,Togo,9,0,689,15
2020-07-08,Togo,6,0,695,15
2020-07-09,Togo,9,0,704,15
2020-07-10,Togo,6,0,710,15
2020-07-11,Togo,0,0,710,15
2020-07-12,Togo,10,0,720,15
2020-07-13,Togo,1,0,721,15
2020-07-14,Togo,10,0,731,15
2020-07-15,Togo,9,0,740,15
2020-07-16,Togo,9,0,749,15
2020-07-17,Togo,17,0,766,15
2020-07-18,Togo,8,0,774,15
2020-07-19,Togo,4,0,778,15
2020-07-20,Togo,5,0,783,15
2020-07-21,Togo,7,0,790,15
2020-07-22,Togo,16,1,806,16
2020-07-23,Togo,22,0,828,16
2020-07-24,Togo,11,1,839,17
2020-07-25,Togo,14,0,853,17
2020-07-26,Togo,15,1,868,18
2020-07-27,Togo,6,0,874,18
2020-07-28,Togo,22,0,896,18
2020-07-29,Togo,0,0,896,18
2020-07-30,Togo,12,0,908,18
2020-07-31,Togo,33,1,941,19
2020-08-01,Togo,17,0,958,19
2020-08-02,Togo,3,0,961,19
2020-08-03,Togo,15,0,976,19
2020-08-04,Togo,12,0,988,19
2020-08-05,Togo,13,2,1001,21
2020-08-06,Togo,11,1,1012,22
2020-08-07,Togo,16,0,1028,22
2020-08-08,Togo,18,1,1046,23
2020-08-09,Togo,14,0,1060,23
2020-08-10,Togo,7,2,1067,25
2020-08-11,Togo,3,1,1070,26
2020-08-12,Togo,22,0,1092,26
2020-08-13,Togo,12,0,1104,26
2020-08-14,Togo,20,0,1124,26
2020-08-15,Togo,6,1,1130,27
2020-08-16,Togo,17,0,1147,27
2020-08-17,Togo,7,0,1154,27
2020-08-18,Togo,19,0,1173,27
2020-08-19,Togo,17,0,1190,27
2020-08-20,Togo,22,0,1212,27
2020-08-21,Togo,27,0,1239,27
2020-08-22,Togo,36,0,1275,27
2020-08-23,Togo,2,0,1277,27
2020-08-24,Togo,18,0,1295,27
2020-08-25,Togo,14,0,1309,27
2020-08-26,Togo,17,0,1326,27
2020-08-27,Togo,0,0,1326,27
2020-08-28,Togo,39,0,1365,27
2020-08-29,Togo,25,0,1390,27
2020-08-30,Togo,6,0,1396,27
2020-08-31,Togo,4,1,1400,28
2020-09-01,Togo,16,0,1416,28
2020-09-02,Togo,18,2,1434,30
2020-09-03,Togo,9,1,1443,31
2020-09-04,Togo,14,0,1457,31
2020-09-05,Togo,20,1,1477,32
2020-09-06,Togo,11,0,1488,32
2020-09-07,Togo,5,1,1493,33
2020-09-08,Togo,20,1,1513,34
2020-09-09,Togo,15,2,1528,36
2020-09-10,Togo,9,1,1537,37
2020-09-11,Togo,11,0,1548,37
2020-09-12,Togo,7,0,1555,37
2020-09-13,Togo,17,0,1572,37
2020-09-14,Togo,6,3,1578,40
2020-09-15,Togo,17,0,1595,40
2020-09-16,Togo,13,0,1608,40
2020-09-17,Togo,10,1,1618,41
2020-09-18,Togo,22,0,1640,41
2020-09-19,Togo,19,0,1659,41
2020-09-20,Togo,7,0,1666,41
2020-09-21,Togo,3,0,1669,41
2020-09-22,Togo,14,0,1683,41
2020-09-23,Togo,18,0,1701,41
2020-09-24,Togo,6,3,1707,44
2020-09-25,Togo,15,0,1722,44
2020-09-26,Togo,14,2,1736,46
2020-09-27,Togo,7,0,1743,46
2020-09-28,Togo,6,1,1749,47
2020-09-29,Togo,10,1,1759,48
2020-09-30,Togo,25,0,1784,48
2020-10-01,Togo,25,0,1809,48
2020-10-02,Togo,9,0,1818,48
2020-10-03,Togo,22,0,1840,48
2020-10-04,Togo,14,0,1854,48
2020-10-05,Togo,10,0,1864,48
2020-10-06,Togo,17,1,1881,49
2020-10-07,Togo,17,0,1898,49
2020-10-08,Togo,9,0,1907,49
2020-10-09,Togo,14,0,1921,49
2020-10-10,Togo,14,0,1935,49
2020-10-11,Togo,5,0,1940,49
2020-10-12,Togo,9,0,1949,49
2020-10-13,Togo,23,1,1972,50
2020-10-14,Togo,11,1,1983,51
2020-10-15,Togo,13,0,1996,51
2020-10-16,Togo,31,0,2027,51
2020-10-17,Togo,22,0,2049,51
2020-10-18,Togo,8,0,2057,51
2020-10-19,Togo,14,0,2071,51
2020-10-20,Togo,33,0,2104,51
2020-10-21,Togo,16,0,2120,51
2020-10-22,Togo,19,1,2139,52
2020-10-23,Togo,23,0,2162,52
2020-10-24,Togo,25,0,2187,52
2020-10-25,Togo,13,0,2200,52
2020-10-26,Togo,4,1,2204,53
2020-10-27,Togo,25,1,2229,54
2020-10-28,Togo,9,0,2238,54
2020-10-29,Togo,58,1,2296,55
2020-10-30,Togo,16,0,2312,55
2020-10-31,Togo,19,2,2331,57
2020-11-01,Togo,26,0,2357,57
2020-11-02,Togo,7,0,2364,57
2020-11-03,Togo,17,0,2381,57
2020-11-04,Togo,25,0,2406,57
2020-11-05,Togo,36,0,2442,57
2020-11-06,Togo,18,0,2460,57
2020-11-07,Togo,23,0,2483,57
2020-11-08,Togo,33,0,2516,57
2020-11-09,Togo,7,0,2523,57
2020-11-10,Togo,35,0,2558,57
2020-11-11,Togo,35,2,2593,59
2020-11-12,Togo,12,1,2605,60
2020-11-13,Togo,22,0,2627,60
2020-11-14,Togo,24,1,2651,61
2020-11-15,Togo,24,0,2675,61
2020-11-16,Togo,18,0,2693,61
2020-11-17,Togo,29,1,2722,62
2020-11-18,Togo,30,1,2752,63
2020-11-19,Togo,19,0,2771,63
2020-11-20,Togo,25,1,2796,64
2020-11-21,Togo,33,0,2829,64
2020-11-22,Togo,14,0,2843,64
2020-11-23,Togo,11,0,2854,64
2020-11-24,Togo,18,0,2872,64
2020-11-25,Togo,17,0,2889,64
2020-11-26,Togo,15,0,2904,64
2020-11-27,Togo,22,0,2926,64
2020-11-28,Togo,20,0,2946,64
2020-11-29,Togo,16,0,2962,64
2020-11-30,Togo,12,0,2974,64
2020-12-01,Togo,23,0,2997,64
2020-12-02,Togo,17,1,3014,65
2020-12-03,Togo,25,0,3039,65
2020-12-04,Togo,12,0,3051,65
2020-12-05,Togo,0,0,3051,65
2020-12-06,Togo,44,0,3095,65
2020-12-07,Togo,16,0,3111,65
2020-12-08,Togo,21,0,3132,65
2020-12-09,Togo,19,0,3151,65
2020-12-10,Togo,31,1,3182,66
2020-12-11,Togo,20,0,3202,66
2020-12-12,Togo,19,0,3221,66
2020-12-13,Togo,30,0,3251,66
2020-12-14,Togo,15,0,3266,66
2020-12-15,Togo,29,0,3295,66
2020-12-16,Togo,20,0,3315,66
2020-12-17,Togo,15,0,3330,66
2020-12-18,Togo,20,0,3350,66
2020-12-19,Togo,46,0,3396,66
2020-12-20,Togo,20,0,3416,66
2020-12-21,Togo,20,0,3436,66
2020-12-22,Togo,31,0,3467,66
2020-12-23,Togo,27,2,3494,68
2020-12-24,Togo,26,0,3520,68
2020-12-25,Togo,26,0,3546,68
2020-12-26,Togo,9,0,3555,68
2020-12-27,Togo,0,0,3555,68
2020-12-28,Togo,21,0,3576,68
2020-12-29,Togo,28,0,3604,68
2020-12-30,Togo,7,0,3611,68
2020-12-31,Togo,22,0,3633,68
2021-01-01,Togo,29,0,3662,68
2021-01-02,Togo,21,0,3683,68
2021-01-03,Togo,19,0,3702,68
2021-01-04,Togo,20,1,3722,69
2021-01-05,Togo,48,0,3770,69
2021-01-06,Togo,37,1,3807,70
2021-01-07,Togo,38,2,3845,72
2021-01-08,Togo,49,0,3894,72
2021-01-09,Togo,38,0,3932,72
2021-01-10,Togo,25,0,3957,72
2021-01-11,Togo,21,1,3978,73
2021-01-12,Togo,67,0,4045,73
2021-01-13,Togo,64,0,4109,73
2021-01-14,Togo,56,0,4165,73
2021-01-15,Togo,55,0,4220,73
2021-01-16,Togo,52,0,4272,73
2021-01-17,Togo,30,0,4302,73
2021-01-18,Togo,22,1,4324,74
2021-01-19,Togo,59,0,4383,74
2021-01-20,Togo,76,0,4459,74
2021-01-21,Togo,46,0,4505,74
2021-01-22,Togo,40,0,4545,74
2021-01-23,Togo,91,0,4636,74
2021-01-24,Togo,26,1,4662,75
2021-01-25,Togo,20,1,4682,76
2021-01-26,Togo,0,0,4682,76
2021-01-27,Togo,188,0,4870,76
2021-01-28,Togo,52,0,4922,76
2021-01-29,Togo,0,0,4922,76
2021-01-30,Togo,119,1,5041,77
2021-01-31,Togo,33,0,5074,77
2021-02-01,Togo,18,2,5092,79
2021-02-02,Togo,74,0,5166,79
2021-02-03,Togo,58,0,5224,79
2021-02-04,Togo,66,0,5290,79
2021-02-05,Togo,66,0,5356,79
2021-02-06,Togo,80,0,5436,79
2021-02-07,Togo,47,1,5483,80
2021-02-08,Togo,13,0,5496,80
2021-02-09,Togo,80,0,5576,80
2021-02-10,Togo,30,0,5606,80
2021-02-11,Togo,81,0,5687,80
2021-02-12,Togo,70,0,5757,80
2021-02-13,Togo,66,0,5823,80
2021-02-14,Togo,51,1,5874,81
2021-02-15,Togo,8,0,5882,81
2021-02-16,Togo,71,0,5953,81
2021-02-17,Togo,54,0,6007,81
2021-02-18,Togo,78,0,6085,81
2021-02-19,Togo,97,0,6182,81
2021-02-20,Togo,86,0,6268,81
2021-02-21,Togo,51,0,6319,81
2021-02-22,Togo,29,0,6348,81
2021-02-23,Togo,118,0,6466,81
2021-02-24,Togo,82,1,6548,82
2021-02-25,Togo,89,0,6637,82
2021-02-26,Togo,93,0,6730,82
2021-02-27,Togo,121,1,6851,83
2021-02-28,Togo,50,1,6901,84
2021-03-01,Togo,32,1,6933,85
2021-03-02,Togo,153,0,7086,85
2021-03-03,Togo,102,0,7188,85
2021-03-04,Togo,135,3,7323,88
2021-03-05,Togo,105,0,7428,88
2021-03-06,Togo,93,2,7521,90
2021-03-07,Togo,49,2,7570,92
2021-03-08,Togo,28,0,7598,92
2021-03-09,Togo,82,0,7680,92
2021-03-10,Togo,57,0,7737,92
2021-03-11,Togo,120,1,7857,93
2021-03-12,Togo,96,0,7953,93
2021-03-13,Togo,0,0,7953,93
2021-03-14,Togo,117,2,8070,95
2021-03-15,Togo,152,1,8222,96
2021-03-16,Togo,100,1,8322,97
2021-03-17,Togo,150,1,8472,98
2021-03-18,Togo,110,4,8582,102
2021-03-19,Togo,113,0,8695,102
2021-03-20,Togo,144,0,8839,102
2021-03-21,Togo,79,2,8918,104
2021-03-22,Togo,42,0,8960,104
2021-03-23,Togo,187,1,9147,105
2021-03-24,Togo,0,0,9147,105
2021-03-25,Togo,359,2,9506,107
2021-03-26,Togo,170,0,9676,107
2021-03-27,Togo,0,0,9676,107
2021-03-28,Togo,279,0,9955,107
2021-03-29,Togo,37,0,9992,107
2021-03-30,Togo,257,2,10249,109
2021-03-31,Togo,0,0,10249,109
2021-04-01,Togo,405,1,10654,110
2021-04-02,Togo,194,0,10848,110
2021-04-03,Togo,216,0,11064,110
2021-04-04,Togo,123,2,11187,112
2021-04-05,Togo,62,0,11249,112
2021-04-06,Togo,61,1,11310,113
2021-04-07,Togo,191,0,11501,113
2021-04-08,Togo,148,2,11649,115
2020-03-14,Trinidad and Tobago,2,0,2,0
2020-03-15,Trinidad and Tobago,0,0,2,0
2020-03-16,Trinidad and Tobago,2,0,4,0
2020-03-17,Trinidad and Tobago,1,0,5,0
2020-03-18,Trinidad and Tobago,2,0,7,0
2020-03-19,Trinidad and Tobago,2,0,9,0
2020-03-20,Trinidad and Tobago,0,0,9,0
2020-03-21,Trinidad and Tobago,40,0,49,0
2020-03-22,Trinidad and Tobago,1,0,50,0
2020-03-23,Trinidad and Tobago,1,0,51,0
2020-03-24,Trinidad and Tobago,6,0,57,0
2020-03-25,Trinidad and Tobago,3,1,60,1
2020-03-26,Trinidad and Tobago,5,0,65,1
2020-03-27,Trinidad and Tobago,1,1,66,2
2020-03-28,Trinidad and Tobago,8,1,74,3
2020-03-29,Trinidad and Tobago,4,0,78,3
2020-03-30,Trinidad and Tobago,4,0,82,3
2020-03-31,Trinidad and Tobago,5,0,87,3
2020-04-01,Trinidad and Tobago,3,2,90,5
2020-04-02,Trinidad and Tobago,4,0,94,5
2020-04-03,Trinidad and Tobago,4,1,98,6
2020-04-04,Trinidad and Tobago,5,0,103,6
2020-04-05,Trinidad and Tobago,1,1,104,7
2020-04-06,Trinidad and Tobago,1,1,105,8
2020-04-07,Trinidad and Tobago,2,0,107,8
2020-04-08,Trinidad and Tobago,0,0,107,8
2020-04-09,Trinidad and Tobago,2,0,109,8
2020-04-10,Trinidad and Tobago,0,0,109,8
2020-04-11,Trinidad and Tobago,3,0,112,8
2020-04-12,Trinidad and Tobago,1,0,113,8
2020-04-13,Trinidad and Tobago,0,0,113,8
2020-04-14,Trinidad and Tobago,0,0,113,8
2020-04-15,Trinidad and Tobago,1,0,114,8
2020-04-16,Trinidad and Tobago,0,0,114,8
2020-04-17,Trinidad and Tobago,0,0,114,8
2020-04-18,Trinidad and Tobago,0,0,114,8
2020-04-19,Trinidad and Tobago,0,0,114,8
2020-04-20,Trinidad and Tobago,0,0,114,8
2020-04-21,Trinidad and Tobago,1,0,115,8
2020-04-22,Trinidad and Tobago,0,0,115,8
2020-04-23,Trinidad and Tobago,0,0,115,8
2020-04-24,Trinidad and Tobago,0,0,115,8
2020-04-25,Trinidad and Tobago,0,0,115,8
2020-04-26,Trinidad and Tobago,0,0,115,8
2020-04-27,Trinidad and Tobago,1,0,116,8
2020-04-28,Trinidad and Tobago,0,0,116,8
2020-04-29,Trinidad and Tobago,0,0,116,8
2020-04-30,Trinidad and Tobago,0,0,116,8
2020-05-01,Trinidad and Tobago,0,0,116,8
2020-05-02,Trinidad and Tobago,0,0,116,8
2020-05-03,Trinidad and Tobago,0,0,116,8
2020-05-04,Trinidad and Tobago,0,0,116,8
2020-05-05,Trinidad and Tobago,0,0,116,8
2020-05-06,Trinidad and Tobago,0,0,116,8
2020-05-07,Trinidad and Tobago,0,0,116,8
2020-05-08,Trinidad and Tobago,0,0,116,8
2020-05-09,Trinidad and Tobago,0,0,116,8
2020-05-10,Trinidad and Tobago,0,0,116,8
2020-05-11,Trinidad and Tobago,0,0,116,8
2020-05-12,Trinidad and Tobago,0,0,116,8
2020-05-13,Trinidad and Tobago,0,0,116,8
2020-05-14,Trinidad and Tobago,0,0,116,8
2020-05-15,Trinidad and Tobago,0,0,116,8
2020-05-16,Trinidad and Tobago,0,0,116,8
2020-05-17,Trinidad and Tobago,0,0,116,8
2020-05-18,Trinidad and Tobago,0,0,116,8
2020-05-19,Trinidad and Tobago,0,0,116,8
2020-05-20,Trinidad and Tobago,0,0,116,8
2020-05-21,Trinidad and Tobago,0,0,116,8
2020-05-22,Trinidad and Tobago,0,0,116,8
2020-05-23,Trinidad and Tobago,0,0,116,8
2020-05-24,Trinidad and Tobago,0,0,116,8
2020-05-25,Trinidad and Tobago,0,0,116,8
2020-05-26,Trinidad and Tobago,0,0,116,8
2020-05-27,Trinidad and Tobago,0,0,116,8
2020-05-28,Trinidad and Tobago,0,0,116,8
2020-05-29,Trinidad and Tobago,0,0,116,8
2020-05-30,Trinidad and Tobago,1,0,117,8
2020-05-31,Trinidad and Tobago,0,0,117,8
2020-06-01,Trinidad and Tobago,0,0,117,8
2020-06-02,Trinidad and Tobago,0,0,117,8
2020-06-03,Trinidad and Tobago,0,0,117,8
2020-06-04,Trinidad and Tobago,0,0,117,8
2020-06-05,Trinidad and Tobago,0,0,117,8
2020-06-06,Trinidad and Tobago,0,0,117,8
2020-06-07,Trinidad and Tobago,0,0,117,8
2020-06-08,Trinidad and Tobago,0,0,117,8
2020-06-09,Trinidad and Tobago,0,0,117,8
2020-06-10,Trinidad and Tobago,0,0,117,8
2020-06-11,Trinidad and Tobago,0,0,117,8
2020-06-12,Trinidad and Tobago,0,0,117,8
2020-06-13,Trinidad and Tobago,0,0,117,8
2020-06-14,Trinidad and Tobago,6,0,123,8
2020-06-15,Trinidad and Tobago,0,0,123,8
2020-06-16,Trinidad and Tobago,0,0,123,8
2020-06-17,Trinidad and Tobago,0,0,123,8
2020-06-18,Trinidad and Tobago,0,0,123,8
2020-06-19,Trinidad and Tobago,0,0,123,8
2020-06-20,Trinidad and Tobago,0,0,123,8
2020-06-21,Trinidad and Tobago,0,0,123,8
2020-06-22,Trinidad and Tobago,0,0,123,8
2020-06-23,Trinidad and Tobago,0,0,123,8
2020-06-24,Trinidad and Tobago,0,0,123,8
2020-06-25,Trinidad and Tobago,0,0,123,8
2020-06-26,Trinidad and Tobago,1,0,124,8
2020-06-27,Trinidad and Tobago,2,0,126,8
2020-06-28,Trinidad and Tobago,0,0,126,8
2020-06-29,Trinidad and Tobago,0,0,126,8
2020-06-30,Trinidad and Tobago,4,0,130,8
2020-07-01,Trinidad and Tobago,0,0,130,8
2020-07-02,Trinidad and Tobago,0,0,130,8
2020-07-03,Trinidad and Tobago,0,0,130,8
2020-07-04,Trinidad and Tobago,0,0,130,8
2020-07-05,Trinidad and Tobago,3,0,133,8
2020-07-06,Trinidad and Tobago,0,0,133,8
2020-07-07,Trinidad and Tobago,0,0,133,8
2020-07-08,Trinidad and Tobago,0,0,133,8
2020-07-09,Trinidad and Tobago,0,0,133,8
2020-07-10,Trinidad and Tobago,0,0,133,8
2020-07-11,Trinidad and Tobago,0,0,133,8
2020-07-12,Trinidad and Tobago,0,0,133,8
2020-07-13,Trinidad and Tobago,0,0,133,8
2020-07-14,Trinidad and Tobago,0,0,133,8
2020-07-15,Trinidad and Tobago,0,0,133,8
2020-07-16,Trinidad and Tobago,0,0,133,8
2020-07-17,Trinidad and Tobago,3,0,136,8
2020-07-18,Trinidad and Tobago,1,0,137,8
2020-07-19,Trinidad and Tobago,0,0,137,8
2020-07-20,Trinidad and Tobago,0,0,137,8
2020-07-21,Trinidad and Tobago,2,0,139,8
2020-07-22,Trinidad and Tobago,2,0,141,8
2020-07-23,Trinidad and Tobago,0,0,141,8
2020-07-24,Trinidad and Tobago,1,0,142,8
2020-07-25,Trinidad and Tobago,5,0,147,8
2020-07-26,Trinidad and Tobago,0,0,147,8
2020-07-27,Trinidad and Tobago,1,0,148,8
2020-07-28,Trinidad and Tobago,5,0,153,8
2020-07-29,Trinidad and Tobago,3,0,156,8
2020-07-30,Trinidad and Tobago,8,0,164,8
2020-07-31,Trinidad and Tobago,5,0,169,8
2020-08-01,Trinidad and Tobago,4,0,173,8
2020-08-02,Trinidad and Tobago,9,0,182,8
2020-08-03,Trinidad and Tobago,0,0,182,8
2020-08-04,Trinidad and Tobago,12,0,194,8
2020-08-05,Trinidad and Tobago,5,0,199,8
2020-08-06,Trinidad and Tobago,11,0,210,8
2020-08-07,Trinidad and Tobago,15,0,225,8
2020-08-08,Trinidad and Tobago,50,0,275,8
2020-08-09,Trinidad and Tobago,4,0,279,8
2020-08-10,Trinidad and Tobago,2,0,281,8
2020-08-11,Trinidad and Tobago,19,0,300,8
2020-08-12,Trinidad and Tobago,26,0,326,8
2020-08-13,Trinidad and Tobago,78,0,404,8
2020-08-14,Trinidad and Tobago,22,2,426,10
2020-08-15,Trinidad and Tobago,71,0,497,10
2020-08-16,Trinidad and Tobago,55,1,552,11
2020-08-17,Trinidad and Tobago,36,1,588,12
2020-08-18,Trinidad and Tobago,41,0,629,12
2020-08-19,Trinidad and Tobago,57,0,686,12
2020-08-20,Trinidad and Tobago,81,0,767,12
2020-08-21,Trinidad and Tobago,97,0,864,12
2020-08-22,Trinidad and Tobago,66,1,930,13
2020-08-23,Trinidad and Tobago,77,1,1007,14
2020-08-24,Trinidad and Tobago,92,1,1099,15
2020-08-25,Trinidad and Tobago,153,0,1252,15
2020-08-26,Trinidad and Tobago,159,0,1411,15
2020-08-27,Trinidad and Tobago,18,0,1429,15
2020-08-28,Trinidad and Tobago,125,4,1554,19
2020-08-29,Trinidad and Tobago,91,0,1645,19
2020-08-30,Trinidad and Tobago,38,2,1683,21
2020-08-31,Trinidad and Tobago,76,1,1759,22
2020-09-01,Trinidad and Tobago,38,5,1797,27
2020-09-02,Trinidad and Tobago,123,1,1920,28
2020-09-03,Trinidad and Tobago,64,1,1984,29
2020-09-04,Trinidad and Tobago,56,2,2040,31
2020-09-05,Trinidad and Tobago,190,2,2230,33
2020-09-06,Trinidad and Tobago,20,1,2250,34
2020-09-07,Trinidad and Tobago,27,3,2277,37
2020-09-08,Trinidad and Tobago,114,2,2391,39
2020-09-09,Trinidad and Tobago,197,0,2588,39
2020-09-10,Trinidad and Tobago,110,4,2698,43
2020-09-11,Trinidad and Tobago,127,7,2825,50
2020-09-12,Trinidad and Tobago,168,1,2993,51
2020-09-13,Trinidad and Tobago,49,2,3042,53
2020-09-14,Trinidad and Tobago,99,2,3141,55
2020-09-15,Trinidad and Tobago,82,1,3223,56
2020-09-16,Trinidad and Tobago,104,2,3327,58
2020-09-17,Trinidad and Tobago,107,2,3434,60
2020-09-18,Trinidad and Tobago,217,0,3651,60
2020-09-19,Trinidad and Tobago,202,1,3853,61
2020-09-20,Trinidad and Tobago,48,4,3901,65
2020-09-21,Trinidad and Tobago,44,0,3945,65
2020-09-22,Trinidad and Tobago,81,0,4026,65
2020-09-23,Trinidad and Tobago,110,2,4136,67
2020-09-24,Trinidad and Tobago,99,0,4235,67
2020-09-25,Trinidad and Tobago,42,3,4277,70
2020-09-26,Trinidad and Tobago,35,0,4312,70
2020-09-27,Trinidad and Tobago,50,1,4362,71
2020-09-28,Trinidad and Tobago,24,1,4386,72
2020-09-29,Trinidad and Tobago,77,2,4463,74
2020-09-30,Trinidad and Tobago,68,2,4531,76
2020-10-01,Trinidad and Tobago,39,0,4570,76
2020-10-02,Trinidad and Tobago,59,0,4629,76
2020-10-03,Trinidad and Tobago,86,3,4715,79
2020-10-04,Trinidad and Tobago,48,2,4763,81
2020-10-05,Trinidad and Tobago,4,1,4767,82
2020-10-06,Trinidad and Tobago,79,1,4846,83
2020-10-07,Trinidad and Tobago,41,1,4887,84
2020-10-08,Trinidad and Tobago,76,2,4963,86
2020-10-09,Trinidad and Tobago,58,3,5021,89
2020-10-10,Trinidad and Tobago,22,1,5043,90
2020-10-11,Trinidad and Tobago,0,0,5043,90
2020-10-12,Trinidad and Tobago,73,2,5116,92
2020-10-13,Trinidad and Tobago,11,1,5127,93
2020-10-14,Trinidad and Tobago,27,0,5154,93
2020-10-15,Trinidad and Tobago,40,0,5194,93
2020-10-16,Trinidad and Tobago,47,2,5241,95
2020-10-17,Trinidad and Tobago,40,0,5281,95
2020-10-18,Trinidad and Tobago,16,1,5297,96
2020-10-19,Trinidad and Tobago,1,1,5298,97
2020-10-20,Trinidad and Tobago,35,1,5333,98
2020-10-21,Trinidad and Tobago,59,3,5392,101
2020-10-22,Trinidad and Tobago,54,2,5446,103
2020-10-23,Trinidad and Tobago,41,1,5487,104
2020-10-24,Trinidad and Tobago,16,1,5503,105
2020-10-25,Trinidad and Tobago,8,0,5511,105
2020-10-26,Trinidad and Tobago,24,1,5535,106
2020-10-27,Trinidad and Tobago,33,0,5568,106
2020-10-28,Trinidad and Tobago,26,1,5594,107
2020-10-29,Trinidad and Tobago,42,0,5636,107
2020-10-30,Trinidad and Tobago,32,0,5668,107
2020-10-31,Trinidad and Tobago,24,1,5692,108
2020-11-01,Trinidad and Tobago,12,1,5704,109
2020-11-02,Trinidad and Tobago,0,0,5704,109
2020-11-03,Trinidad and Tobago,50,1,5754,110
2020-11-04,Trinidad and Tobago,10,0,5764,110
2020-11-05,Trinidad and Tobago,10,1,5774,111
2020-11-06,Trinidad and Tobago,24,0,5798,111
2020-11-07,Trinidad and Tobago,40,0,5838,111
2020-11-08,Trinidad and Tobago,11,0,5849,111
2020-11-09,Trinidad and Tobago,0,0,5849,111
2020-11-10,Trinidad and Tobago,31,0,5880,111
2020-11-11,Trinidad and Tobago,24,0,5904,111
2020-11-12,Trinidad and Tobago,26,0,5930,111
2020-11-13,Trinidad and Tobago,50,0,5980,111
2020-11-14,Trinidad and Tobago,97,1,6077,112
2020-11-15,Trinidad and Tobago,3,0,6080,112
2020-11-16,Trinidad and Tobago,16,0,6096,112
2020-11-17,Trinidad and Tobago,39,1,6135,113
2020-11-18,Trinidad and Tobago,45,0,6180,113
2020-11-19,Trinidad and Tobago,53,0,6233,113
2020-11-20,Trinidad and Tobago,28,0,6261,113
2020-11-21,Trinidad and Tobago,63,2,6324,115
2020-11-22,Trinidad and Tobago,126,0,6450,115
2020-11-23,Trinidad and Tobago,25,0,6475,115
2020-11-24,Trinidad and Tobago,13,0,6488,115
2020-11-25,Trinidad and Tobago,15,1,6503,116
2020-11-26,Trinidad and Tobago,67,0,6570,116
2020-11-27,Trinidad and Tobago,16,2,6586,118
2020-11-28,Trinidad and Tobago,44,0,6630,118
2020-11-29,Trinidad and Tobago,30,2,6660,120
2020-11-30,Trinidad and Tobago,9,0,6669,120
2020-12-01,Trinidad and Tobago,16,0,6685,120
2020-12-02,Trinidad and Tobago,19,1,6704,121
2020-12-03,Trinidad and Tobago,21,0,6725,121
2020-12-04,Trinidad and Tobago,10,0,6735,121
2020-12-05,Trinidad and Tobago,16,1,6751,122
2020-12-06,Trinidad and Tobago,16,0,6767,122
2020-12-07,Trinidad and Tobago,8,0,6775,122
2020-12-08,Trinidad and Tobago,7,0,6782,122
2020-12-09,Trinidad and Tobago,26,0,6808,122
2020-12-10,Trinidad and Tobago,25,0,6833,122
2020-12-11,Trinidad and Tobago,19,0,6852,122
2020-12-12,Trinidad and Tobago,12,0,6864,122
2020-12-13,Trinidad and Tobago,15,0,6879,122
2020-12-14,Trinidad and Tobago,6,1,6885,123
2020-12-15,Trinidad and Tobago,15,0,6900,123
2020-12-16,Trinidad and Tobago,17,0,6917,123
2020-12-17,Trinidad and Tobago,23,0,6940,123
2020-12-18,Trinidad and Tobago,15,0,6955,123
2020-12-19,Trinidad and Tobago,19,0,6974,123
2020-12-20,Trinidad and Tobago,26,0,7000,123
2020-12-21,Trinidad and Tobago,12,2,7012,125
2020-12-22,Trinidad and Tobago,12,0,7024,125
2020-12-23,Trinidad and Tobago,47,0,7071,125
2020-12-24,Trinidad and Tobago,18,0,7089,125
2020-12-25,Trinidad and Tobago,8,0,7097,125
2020-12-26,Trinidad and Tobago,7,0,7104,125
2020-12-27,Trinidad and Tobago,8,0,7112,125
2020-12-28,Trinidad and Tobago,3,0,7115,125
2020-12-29,Trinidad and Tobago,12,0,7127,125
2020-12-30,Trinidad and Tobago,5,1,7132,126
2020-12-31,Trinidad and Tobago,18,1,7150,127
2021-01-01,Trinidad and Tobago,8,0,7158,127
2021-01-02,Trinidad and Tobago,4,0,7162,127
2021-01-03,Trinidad and Tobago,6,0,7168,127
2021-01-04,Trinidad and Tobago,10,0,7178,127
2021-01-05,Trinidad and Tobago,8,0,7186,127
2021-01-06,Trinidad and Tobago,10,0,7196,127
2021-01-07,Trinidad and Tobago,14,0,7210,127
2021-01-08,Trinidad and Tobago,9,0,7219,127
2021-01-09,Trinidad and Tobago,25,1,7244,128
2021-01-10,Trinidad and Tobago,21,0,7265,128
2021-01-11,Trinidad and Tobago,8,0,7273,128
2021-01-12,Trinidad and Tobago,13,0,7286,128
2021-01-13,Trinidad and Tobago,19,1,7305,129
2021-01-14,Trinidad and Tobago,15,1,7320,130
2021-01-15,Trinidad and Tobago,23,0,7343,130
2021-01-16,Trinidad and Tobago,27,1,7370,131
2021-01-17,Trinidad and Tobago,23,1,7393,132
2021-01-18,Trinidad and Tobago,6,0,7399,132
2021-01-19,Trinidad and Tobago,16,0,7415,132
2021-01-20,Trinidad and Tobago,15,1,7430,133
2021-01-21,Trinidad and Tobago,20,0,7450,133
2021-01-22,Trinidad and Tobago,6,0,7456,133
2021-01-23,Trinidad and Tobago,6,1,7462,134
2021-01-24,Trinidad and Tobago,11,0,7473,134
2021-01-25,Trinidad and Tobago,17,0,7490,134
2021-01-26,Trinidad and Tobago,6,0,7496,134
2021-01-27,Trinidad and Tobago,13,0,7509,134
2021-01-28,Trinidad and Tobago,11,0,7520,134
2021-01-29,Trinidad and Tobago,13,0,7533,134
2021-01-30,Trinidad and Tobago,9,0,7542,134
2021-01-31,Trinidad and Tobago,22,0,7564,134
2021-02-01,Trinidad and Tobago,2,0,7566,134
2021-02-02,Trinidad and Tobago,12,0,7578,134
2021-02-03,Trinidad and Tobago,8,1,7586,135
2021-02-04,Trinidad and Tobago,21,0,7607,135
2021-02-05,Trinidad and Tobago,0,0,7607,135
2021-02-06,Trinidad and Tobago,5,0,7612,135
2021-02-07,Trinidad and Tobago,4,0,7616,135
2021-02-08,Trinidad and Tobago,0,0,7616,135
2021-02-09,Trinidad and Tobago,1,1,7617,136
2021-02-10,Trinidad and Tobago,14,0,7631,136
2021-02-11,Trinidad and Tobago,1,0,7632,136
2021-02-12,Trinidad and Tobago,5,1,7637,137
2021-02-13,Trinidad and Tobago,5,1,7642,138
2021-02-14,Trinidad and Tobago,0,0,7642,138
2021-02-15,Trinidad and Tobago,4,0,7646,138
2021-02-16,Trinidad and Tobago,10,0,7656,138
2021-02-17,Trinidad and Tobago,7,0,7663,138
2021-02-18,Trinidad and Tobago,3,0,7666,138
2021-02-19,Trinidad and Tobago,0,0,7666,138
2021-02-20,Trinidad and Tobago,10,1,7676,139
2021-02-21,Trinidad and Tobago,4,0,7680,139
2021-02-22,Trinidad and Tobago,2,0,7682,139
2021-02-23,Trinidad and Tobago,4,0,7686,139
2021-02-24,Trinidad and Tobago,4,0,7690,139
2021-02-25,Trinidad and Tobago,7,0,7697,139
2021-02-26,Trinidad and Tobago,7,0,7704,139
2021-02-27,Trinidad and Tobago,1,0,7705,139
2021-02-28,Trinidad and Tobago,8,0,7713,139
2021-03-01,Trinidad and Tobago,3,0,7716,139
2021-03-02,Trinidad and Tobago,1,0,7717,139
2021-03-03,Trinidad and Tobago,6,0,7723,139
2021-03-04,Trinidad and Tobago,4,0,7727,139
2021-03-05,Trinidad and Tobago,2,0,7729,139
2021-03-06,Trinidad and Tobago,3,0,7732,139
2021-03-07,Trinidad and Tobago,4,0,7736,139
2021-03-08,Trinidad and Tobago,0,1,7736,140
2021-03-09,Trinidad and Tobago,0,0,7736,140
2021-03-10,Trinidad and Tobago,7,0,7743,140
2021-03-11,Trinidad and Tobago,10,0,7753,140
2021-03-12,Trinidad and Tobago,6,0,7759,140
2021-03-13,Trinidad and Tobago,10,0,7769,140
2021-03-14,Trinidad and Tobago,14,0,7783,140
2021-03-15,Trinidad and Tobago,5,0,7788,140
2021-03-16,Trinidad and Tobago,2,0,7790,140
2021-03-17,Trinidad and Tobago,17,0,7807,140
2021-03-18,Trinidad and Tobago,5,0,7812,140
2021-03-19,Trinidad and Tobago,9,0,7821,140
2021-03-20,Trinidad and Tobago,18,0,7839,140
2021-03-21,Trinidad and Tobago,16,0,7855,140
2021-03-22,Trinidad and Tobago,6,0,7861,140
2021-03-23,Trinidad and Tobago,4,1,7865,141
2021-03-24,Trinidad and Tobago,38,0,7903,141
2021-03-25,Trinidad and Tobago,21,0,7924,141
2021-03-26,Trinidad and Tobago,15,0,7939,141
2021-03-27,Trinidad and Tobago,15,1,7954,142
2021-03-28,Trinidad and Tobago,23,0,7977,142
2021-03-29,Trinidad and Tobago,9,0,7986,142
2021-03-30,Trinidad and Tobago,18,0,8004,142
2021-03-31,Trinidad and Tobago,22,0,8026,142
2021-04-01,Trinidad and Tobago,46,3,8072,145
2021-04-02,Trinidad and Tobago,44,0,8116,145
2021-04-03,Trinidad and Tobago,20,0,8136,145
2021-04-04,Trinidad and Tobago,42,0,8178,145
2021-04-05,Trinidad and Tobago,14,0,8192,145
2021-04-06,Trinidad and Tobago,22,0,8214,145
2021-04-07,Trinidad and Tobago,21,0,8235,145
2021-04-08,Trinidad and Tobago,41,0,8276,145
2020-03-04,Tunisia,1,0,1,0
2020-03-05,Tunisia,0,0,1,0
2020-03-06,Tunisia,0,0,1,0
2020-03-07,Tunisia,0,0,1,0
2020-03-08,Tunisia,1,0,2,0
2020-03-09,Tunisia,0,0,2,0
2020-03-10,Tunisia,3,0,5,0
2020-03-11,Tunisia,2,0,7,0
2020-03-12,Tunisia,0,0,7,0
2020-03-13,Tunisia,9,0,16,0
2020-03-14,Tunisia,2,0,18,0
2020-03-15,Tunisia,0,0,18,0
2020-03-16,Tunisia,2,0,20,0
2020-03-17,Tunisia,4,0,24,0
2020-03-18,Tunisia,5,0,29,0
2020-03-19,Tunisia,10,1,39,1
2020-03-20,Tunisia,15,0,54,1
2020-03-21,Tunisia,6,0,60,1
2020-03-22,Tunisia,15,2,75,3
2020-03-23,Tunisia,14,0,89,3
2020-03-24,Tunisia,25,1,114,4
2020-03-25,Tunisia,59,1,173,5
2020-03-26,Tunisia,24,1,197,6
2020-03-27,Tunisia,30,0,227,6
2020-03-28,Tunisia,51,2,278,8
2020-03-29,Tunisia,34,0,312,8
2020-03-30,Tunisia,0,0,312,8
2020-03-31,Tunisia,82,2,394,10
2020-04-01,Tunisia,29,2,423,12
2020-04-02,Tunisia,32,2,455,14
2020-04-03,Tunisia,40,4,495,18
2020-04-04,Tunisia,58,0,553,18
2020-04-05,Tunisia,21,4,574,22
2020-04-06,Tunisia,22,0,596,22
2020-04-07,Tunisia,27,1,623,23
2020-04-08,Tunisia,5,1,628,24
2020-04-09,Tunisia,15,1,643,25
2020-04-10,Tunisia,28,0,671,25
2020-04-11,Tunisia,14,3,685,28
2020-04-12,Tunisia,22,3,707,31
2020-04-13,Tunisia,19,3,726,34
2020-04-14,Tunisia,21,0,747,34
2020-04-15,Tunisia,33,1,780,35
2020-04-16,Tunisia,42,2,822,37
2020-04-17,Tunisia,42,0,864,37
2020-04-18,Tunisia,0,0,864,37
2020-04-19,Tunisia,15,1,879,38
2020-04-20,Tunisia,5,0,884,38
2020-04-21,Tunisia,0,0,884,38
2020-04-22,Tunisia,25,0,909,38
2020-04-23,Tunisia,9,0,918,38
2020-04-24,Tunisia,4,0,922,38
2020-04-25,Tunisia,17,0,939,38
2020-04-26,Tunisia,10,0,949,38
2020-04-27,Tunisia,18,1,967,39
2020-04-28,Tunisia,8,1,975,40
2020-04-29,Tunisia,5,0,980,40
2020-04-30,Tunisia,14,1,994,41
2020-05-01,Tunisia,4,0,998,41
2020-05-02,Tunisia,11,1,1009,42
2020-05-03,Tunisia,4,0,1013,42
2020-05-04,Tunisia,5,1,1018,43
2020-05-05,Tunisia,4,0,1022,43
2020-05-06,Tunisia,3,0,1025,43
2020-05-07,Tunisia,1,1,1026,44
2020-05-08,Tunisia,4,1,1030,45
2020-05-09,Tunisia,2,0,1032,45
2020-05-10,Tunisia,0,0,1032,45
2020-05-11,Tunisia,0,0,1032,45
2020-05-12,Tunisia,0,0,1032,45
2020-05-13,Tunisia,0,0,1032,45
2020-05-14,Tunisia,0,0,1032,45
2020-05-15,Tunisia,3,0,1035,45
2020-05-16,Tunisia,2,0,1037,45
2020-05-17,Tunisia,0,0,1037,45
2020-05-18,Tunisia,6,1,1043,46
2020-05-19,Tunisia,1,1,1044,47
2020-05-20,Tunisia,1,0,1045,47
2020-05-21,Tunisia,1,0,1046,47
2020-05-22,Tunisia,2,0,1048,47
2020-05-23,Tunisia,0,1,1048,48
2020-05-24,Tunisia,3,0,1051,48
2020-05-25,Tunisia,0,0,1051,48
2020-05-26,Tunisia,0,0,1051,48
2020-05-27,Tunisia,0,0,1051,48
2020-05-28,Tunisia,17,0,1068,48
2020-05-29,Tunisia,3,0,1071,48
2020-05-30,Tunisia,5,0,1076,48
2020-05-31,Tunisia,1,0,1077,48
2020-06-01,Tunisia,7,0,1084,48
2020-06-02,Tunisia,2,0,1086,48
2020-06-03,Tunisia,1,1,1087,49
2020-06-04,Tunisia,0,0,1087,49
2020-06-05,Tunisia,0,0,1087,49
2020-06-06,Tunisia,0,0,1087,49
2020-06-07,Tunisia,0,0,1087,49
2020-06-08,Tunisia,0,0,1087,49
2020-06-09,Tunisia,0,0,1087,49
2020-06-10,Tunisia,0,0,1087,49
2020-06-11,Tunisia,0,0,1087,49
2020-06-12,Tunisia,6,0,1093,49
2020-06-13,Tunisia,1,0,1094,49
2020-06-14,Tunisia,2,0,1096,49
2020-06-15,Tunisia,14,0,1110,49
2020-06-16,Tunisia,15,0,1125,49
2020-06-17,Tunisia,3,1,1128,50
2020-06-18,Tunisia,4,0,1132,50
2020-06-19,Tunisia,14,0,1146,50
2020-06-20,Tunisia,10,0,1156,50
2020-06-21,Tunisia,1,0,1157,50
2020-06-22,Tunisia,2,0,1159,50
2020-06-23,Tunisia,0,0,1159,50
2020-06-24,Tunisia,1,0,1160,50
2020-06-25,Tunisia,2,0,1162,50
2020-06-26,Tunisia,2,0,1164,50
2020-06-27,Tunisia,4,0,1168,50
2020-06-28,Tunisia,1,0,1169,50
2020-06-29,Tunisia,3,0,1172,50
2020-06-30,Tunisia,2,0,1174,50
2020-07-01,Tunisia,1,0,1175,50
2020-07-02,Tunisia,3,0,1178,50
2020-07-03,Tunisia,3,0,1181,50
2020-07-04,Tunisia,5,0,1186,50
2020-07-05,Tunisia,2,0,1188,50
2020-07-06,Tunisia,11,0,1199,50
2020-07-07,Tunisia,6,0,1205,50
2020-07-08,Tunisia,16,0,1221,50
2020-07-09,Tunisia,10,0,1231,50
2020-07-10,Tunisia,9,0,1240,50
2020-07-11,Tunisia,5,0,1245,50
2020-07-12,Tunisia,18,0,1263,50
2020-07-13,Tunisia,39,0,1302,50
2020-07-14,Tunisia,4,0,1306,50
2020-07-15,Tunisia,13,0,1319,50
2020-07-16,Tunisia,8,0,1327,50
2020-07-17,Tunisia,9,0,1336,50
2020-07-18,Tunisia,12,0,1348,50
2020-07-19,Tunisia,26,0,1374,50
2020-07-20,Tunisia,7,0,1381,50
2020-07-21,Tunisia,8,0,1389,50
2020-07-22,Tunisia,5,0,1394,50
2020-07-23,Tunisia,12,0,1406,50
2020-07-24,Tunisia,19,0,1425,50
2020-07-25,Tunisia,18,0,1443,50
2020-07-26,Tunisia,9,0,1452,50
2020-07-27,Tunisia,3,0,1455,50
2020-07-28,Tunisia,13,0,1468,50
2020-07-29,Tunisia,20,0,1488,50
2020-07-30,Tunisia,26,0,1514,50
2020-07-31,Tunisia,21,0,1535,50
2020-08-01,Tunisia,17,1,1552,51
2020-08-02,Tunisia,9,0,1561,51
2020-08-03,Tunisia,4,0,1565,51
2020-08-04,Tunisia,19,0,1584,51
2020-08-05,Tunisia,17,0,1601,51
2020-08-06,Tunisia,41,0,1642,51
2020-08-07,Tunisia,14,0,1656,51
2020-08-08,Tunisia,22,0,1678,51
2020-08-09,Tunisia,19,0,1697,51
2020-08-10,Tunisia,20,0,1717,51
2020-08-11,Tunisia,21,1,1738,52
2020-08-12,Tunisia,42,0,1780,52
2020-08-13,Tunisia,67,1,1847,53
2020-08-14,Tunisia,56,0,1903,53
2020-08-15,Tunisia,120,1,2023,54
2020-08-16,Tunisia,84,0,2107,54
2020-08-17,Tunisia,78,2,2185,56
2020-08-18,Tunisia,129,1,2314,57
2020-08-19,Tunisia,113,3,2427,60
2020-08-20,Tunisia,116,3,2543,63
2020-08-21,Tunisia,64,1,2607,64
2020-08-22,Tunisia,131,4,2738,68
2020-08-23,Tunisia,80,3,2818,71
2020-08-24,Tunisia,75,0,2893,71
2020-08-25,Tunisia,176,0,3069,71
2020-08-26,Tunisia,137,0,3206,71
2020-08-27,Tunisia,117,2,3323,73
2020-08-28,Tunisia,138,1,3461,74
2020-08-29,Tunisia,111,2,3572,76
2020-08-30,Tunisia,113,0,3685,76
2020-08-31,Tunisia,118,1,3803,77
2020-09-01,Tunisia,160,3,3963,80
2020-09-02,Tunisia,233,1,4196,81
2020-09-03,Tunisia,198,3,4394,84
2020-09-04,Tunisia,148,3,4542,87
2020-09-05,Tunisia,234,6,4776,93
2020-09-06,Tunisia,265,0,5041,93
2020-09-07,Tunisia,83,1,5124,94
2020-09-08,Tunisia,293,2,5417,96
2020-09-09,Tunisia,0,0,5417,96
2020-09-10,Tunisia,465,3,5882,99
2020-09-11,Tunisia,377,4,6259,103
2020-09-12,Tunisia,376,4,6635,107
2020-09-13,Tunisia,0,0,6635,107
2020-09-14,Tunisia,747,10,7382,117
2020-09-15,Tunisia,241,6,7623,123
2020-09-16,Tunisia,477,6,8100,129
2020-09-17,Tunisia,470,4,8570,133
2020-09-18,Tunisia,0,0,8570,133
2020-09-19,Tunisia,540,5,9110,138
2020-09-20,Tunisia,1622,21,10732,159
2020-09-21,Tunisia,528,5,11260,164
2020-09-22,Tunisia,0,0,11260,164
2020-09-23,Tunisia,1219,10,12479,174
2020-09-24,Tunisia,826,6,13305,180
2020-09-25,Tunisia,1087,11,14392,191
2020-09-26,Tunisia,0,0,14392,191
2020-09-27,Tunisia,1722,23,16114,214
2020-09-28,Tunisia,0,0,16114,214
2020-09-29,Tunisia,1291,32,17405,246
2020-09-30,Tunisia,1008,19,18413,265
2020-10-01,Tunisia,0,0,18413,265
2020-10-02,Tunisia,1308,6,19721,271
2020-10-03,Tunisia,1223,5,20944,276
2020-10-04,Tunisia,1286,45,22230,321
2020-10-05,Tunisia,0,0,22230,321
2020-10-06,Tunisia,0,0,22230,321
2020-10-07,Tunisia,2312,43,24542,364
2020-10-08,Tunisia,2357,45,26899,409
2020-10-09,Tunisia,0,0,26899,409
2020-10-10,Tunisia,4360,47,31259,456
2020-10-11,Tunisia,1297,22,32556,478
2020-10-12,Tunisia,0,0,32556,478
2020-10-13,Tunisia,0,0,32556,478
2020-10-14,Tunisia,2234,34,34790,512
2020-10-15,Tunisia,0,0,34790,512
2020-10-16,Tunisia,0,0,34790,512
2020-10-17,Tunisia,5752,114,40542,626
2020-10-18,Tunisia,0,0,40542,626
2020-10-19,Tunisia,2185,61,42727,687
2020-10-20,Tunisia,1723,24,44450,711
2020-10-21,Tunisia,1442,29,45892,740
2020-10-22,Tunisia,0,0,45892,740
2020-10-23,Tunisia,1322,44,47214,784
2020-10-24,Tunisia,1585,35,48799,819
2020-10-25,Tunisia,0,0,48799,819
2020-10-26,Tunisia,3600,164,52399,983
2020-10-27,Tunisia,0,0,52399,983
2020-10-28,Tunisia,1879,170,54278,1153
2020-10-29,Tunisia,0,0,54278,1153
2020-10-30,Tunisia,3751,100,58029,1253
2020-10-31,Tunisia,1784,64,59813,1317
2020-11-01,Tunisia,1302,31,61115,1348
2020-11-02,Tunisia,791,33,61906,1381
2020-11-03,Tunisia,1220,102,63126,1483
2020-11-04,Tunisia,1237,29,64363,1512
2020-11-05,Tunisia,1971,65,66334,1577
2020-11-06,Tunisia,0,0,66334,1577
2020-11-07,Tunisia,3209,217,69543,1794
2020-11-08,Tunisia,1576,79,71119,1873
2020-11-09,Tunisia,450,47,71569,1920
2020-11-10,Tunisia,1424,86,72993,2006
2020-11-11,Tunisia,1529,94,74522,2100
2020-11-12,Tunisia,1584,51,76106,2151
2020-11-13,Tunisia,1562,58,77668,2209
2020-11-14,Tunisia,1671,70,79339,2279
2020-11-15,Tunisia,1065,66,80404,2345
2020-11-16,Tunisia,599,51,81003,2396
2020-11-17,Tunisia,720,49,81723,2445
2020-11-18,Tunisia,2049,96,83772,2541
2020-11-19,Tunisia,0,0,83772,2541
2020-11-20,Tunisia,2493,143,86265,2684
2020-11-21,Tunisia,1206,68,87471,2752
2020-11-22,Tunisia,1240,69,88711,2821
2020-11-23,Tunisia,485,41,89196,2862
2020-11-24,Tunisia,1017,73,90213,2935
2020-11-25,Tunisia,1094,48,91307,2983
2020-11-26,Tunisia,1168,51,92475,3034
2020-11-27,Tunisia,1295,72,93770,3106
2020-11-28,Tunisia,1210,47,94980,3153
2020-11-29,Tunisia,1271,66,96251,3219
2020-11-30,Tunisia,518,41,96769,3260
2020-12-01,Tunisia,0,0,96769,3260
2020-12-02,Tunisia,2511,99,99280,3359
2020-12-03,Tunisia,0,0,99280,3359
2020-12-04,Tunisia,2620,122,101900,3481
2020-12-05,Tunisia,1091,45,102991,3526
2020-12-06,Tunisia,1011,35,104002,3561
2020-12-07,Tunisia,327,35,104329,3596
2020-12-08,Tunisia,1116,72,105445,3668
2020-12-09,Tunisia,1411,49,106856,3717
2020-12-10,Tunisia,958,41,107814,3758
2020-12-11,Tunisia,1290,43,109104,3801
2020-12-12,Tunisia,1289,35,110393,3836
2020-12-13,Tunisia,968,58,111361,3894
2020-12-14,Tunisia,0,0,111361,3894
2020-12-15,Tunisia,1880,62,113241,3956
2020-12-16,Tunisia,1306,41,114547,3997
2020-12-17,Tunisia,1419,35,115966,4032
2020-12-18,Tunisia,1616,58,117582,4090
2020-12-19,Tunisia,1569,36,119151,4126
2020-12-20,Tunisia,1536,32,120687,4158
2020-12-21,Tunisia,1031,41,121718,4199
2020-12-22,Tunisia,1605,38,123323,4237
2020-12-23,Tunisia,1677,38,125000,4275
2020-12-24,Tunisia,1752,49,126752,4324
2020-12-25,Tunisia,1826,61,128578,4385
2020-12-26,Tunisia,1652,41,130230,4426
2020-12-27,Tunisia,1362,40,131592,4466
2020-12-28,Tunisia,1612,52,133204,4518
2020-12-29,Tunisia,1598,52,134802,4570
2020-12-30,Tunisia,2414,50,137216,4620
2020-12-31,Tunisia,1924,56,139140,4676
2021-01-01,Tunisia,1417,54,140557,4730
2021-01-02,Tunisia,1422,35,141979,4765
2021-01-03,Tunisia,1565,35,143544,4800
2021-01-04,Tunisia,1252,62,144796,4862
2021-01-05,Tunisia,2265,72,147061,4934
2021-01-06,Tunisia,2820,70,149881,5004
2021-01-07,Tunisia,2373,48,152254,5052
2021-01-08,Tunisia,2649,56,154903,5108
2021-01-09,Tunisia,2611,45,157514,5153
2021-01-10,Tunisia,1762,62,159276,5215
2021-01-11,Tunisia,3074,69,162350,5284
2021-01-12,Tunisia,2586,59,164936,5343
2021-01-13,Tunisia,3632,72,168568,5415
2021-01-14,Tunisia,2327,63,170895,5478
2021-01-15,Tunisia,4170,50,175065,5528
2021-01-16,Tunisia,2166,88,177231,5616
2021-01-17,Tunisia,2859,76,180090,5692
2021-01-18,Tunisia,1795,58,181885,5750
2021-01-19,Tunisia,2598,94,184483,5844
2021-01-20,Tunisia,3890,77,188373,5921
2021-01-21,Tunisia,2511,68,190884,5989
2021-01-22,Tunisia,2389,103,193273,6092
2021-01-23,Tunisia,2041,62,195314,6154
2021-01-24,Tunisia,2059,80,197373,6234
2021-01-25,Tunisia,1263,53,198636,6287
2021-01-26,Tunisia,2026,83,200662,6370
2021-01-27,Tunisia,1661,76,202323,6446
2021-01-28,Tunisia,2028,62,204351,6508
2021-01-29,Tunisia,1679,91,206030,6599
2021-01-30,Tunisia,1438,81,207468,6680
2021-01-31,Tunisia,1417,74,208885,6754
2021-02-01,Tunisia,1160,48,210045,6802
2021-02-02,Tunisia,1367,91,211412,6893
2021-02-03,Tunisia,1267,87,212679,6980
2021-02-04,Tunisia,1270,68,213949,7048
2021-02-05,Tunisia,1163,51,215112,7099
2021-02-06,Tunisia,1064,63,216176,7162
2021-02-07,Tunisia,910,52,217086,7214
2021-02-08,Tunisia,667,43,217753,7257
2021-02-09,Tunisia,811,75,218564,7332
2021-02-10,Tunisia,1086,46,219650,7378
2021-02-11,Tunisia,828,51,220478,7429
2021-02-12,Tunisia,977,32,221455,7461
2021-02-13,Tunisia,1049,47,222504,7508
2021-02-14,Tunisia,740,36,223244,7544
2021-02-15,Tunisia,305,31,223549,7575
2021-02-16,Tunisia,780,42,224329,7617
2021-02-17,Tunisia,787,34,225116,7651
2021-02-18,Tunisia,899,33,226015,7684
2021-02-19,Tunisia,725,35,226740,7719
2021-02-20,Tunisia,903,36,227643,7755
2021-02-21,Tunisia,719,38,228362,7793
2021-02-22,Tunisia,575,18,228937,7811
2021-02-23,Tunisia,844,32,229781,7843
2021-02-24,Tunisia,662,26,230443,7869
2021-02-25,Tunisia,855,42,231298,7911
2021-02-26,Tunisia,666,31,231964,7942
2021-02-27,Tunisia,651,32,232615,7974
2021-02-28,Tunisia,662,27,233277,8001
2021-03-01,Tunisia,392,21,233669,8022
2021-03-02,Tunisia,562,25,234231,8047
2021-03-03,Tunisia,777,27,235008,8074
2021-03-04,Tunisia,635,32,235643,8106
2021-03-05,Tunisia,713,24,236356,8130
2021-03-06,Tunisia,672,37,237028,8167
2021-03-07,Tunisia,676,34,237704,8201
2021-03-08,Tunisia,313,24,238017,8225
2021-03-09,Tunisia,596,43,238613,8268
2021-03-10,Tunisia,755,24,239368,8292
2021-03-11,Tunisia,609,21,239977,8313
2021-03-12,Tunisia,640,16,240617,8329
2021-03-13,Tunisia,640,30,241257,8359
2021-03-14,Tunisia,577,30,241834,8389
2021-03-15,Tunisia,290,15,242124,8404
2021-03-16,Tunisia,549,25,242673,8429
2021-03-17,Tunisia,766,34,243439,8463
2021-03-18,Tunisia,496,27,243935,8490
2021-03-19,Tunisia,841,16,244776,8506
2021-03-20,Tunisia,629,20,245405,8526
2021-03-21,Tunisia,301,20,245706,8546
2021-03-22,Tunisia,217,23,245923,8569
2021-03-23,Tunisia,584,41,246507,8610
2021-03-24,Tunisia,747,27,247254,8637
2021-03-25,Tunisia,783,26,248037,8663
2021-03-26,Tunisia,745,21,248782,8684
2021-03-27,Tunisia,921,21,249703,8705
2021-03-28,Tunisia,862,30,250565,8735
2021-03-29,Tunisia,604,25,251169,8760
2021-03-30,Tunisia,1002,28,252171,8788
2021-03-31,Tunisia,1847,24,254018,8812
2021-04-01,Tunisia,1290,31,255308,8843
2021-04-02,Tunisia,1623,47,256931,8890
2021-04-03,Tunisia,1404,41,258335,8931
2021-04-04,Tunisia,1709,34,260044,8965
2021-04-05,Tunisia,1133,28,261177,8993
2021-04-06,Tunisia,1866,46,263043,9039
2021-04-07,Tunisia,1951,48,264994,9087
2021-04-08,Tunisia,1833,49,266827,9136
2020-03-11,Turkey,1,0,1,0
2020-03-12,Turkey,0,0,1,0
2020-03-13,Turkey,4,0,5,0
2020-03-14,Turkey,0,0,5,0
2020-03-15,Turkey,1,0,6,0
2020-03-16,Turkey,12,0,18,0
2020-03-17,Turkey,29,1,47,1
2020-03-18,Turkey,51,0,98,1
2020-03-19,Turkey,94,2,192,3
2020-03-20,Turkey,167,1,359,4
2020-03-21,Turkey,311,5,670,9
2020-03-22,Turkey,566,21,1236,30
2020-03-23,Turkey,293,7,1529,37
2020-03-24,Turkey,343,7,1872,44
2020-03-25,Turkey,561,15,2433,59
2020-03-26,Turkey,1196,16,3629,75
2020-03-27,Turkey,2069,17,5698,92
2020-03-28,Turkey,1704,16,7402,108
2020-03-29,Turkey,1815,23,9217,131
2020-03-30,Turkey,1610,37,10827,168
2020-03-31,Turkey,2704,46,13531,214
2020-04-01,Turkey,2148,63,15679,277
2020-04-02,Turkey,2456,79,18135,356
2020-04-03,Turkey,2786,69,20921,425
2020-04-04,Turkey,3013,76,23934,501
2020-04-05,Turkey,3135,73,27069,574
2020-04-06,Turkey,3148,75,30217,649
2020-04-07,Turkey,3892,76,34109,725
2020-04-08,Turkey,4117,87,38226,812
2020-04-09,Turkey,4056,96,42282,908
2020-04-10,Turkey,4747,98,47029,1006
2020-04-11,Turkey,5138,95,52167,1101
2020-04-12,Turkey,4789,97,56956,1198
2020-04-13,Turkey,4093,98,61049,1296
2020-04-14,Turkey,4062,107,65111,1403
2020-04-15,Turkey,4281,115,69392,1518
2020-04-16,Turkey,4801,125,74193,1643
2020-04-17,Turkey,4353,126,78546,1769
2020-04-18,Turkey,3783,121,82329,1890
2020-04-19,Turkey,3977,127,86306,2017
2020-04-20,Turkey,4674,123,90980,2140
2020-04-21,Turkey,4611,119,95591,2259
2020-04-22,Turkey,3083,117,98674,2376
2020-04-23,Turkey,3116,115,101790,2491
2020-04-24,Turkey,3122,109,104912,2600
2020-04-25,Turkey,2861,106,107773,2706
2020-04-26,Turkey,2357,99,110130,2805
2020-04-27,Turkey,2131,95,112261,2900
2020-04-28,Turkey,2392,92,114653,2992
2020-04-29,Turkey,2936,89,117589,3081
2020-04-30,Turkey,2615,93,120204,3174
2020-05-01,Turkey,2188,84,122392,3258
2020-05-02,Turkey,1983,78,124375,3336
2020-05-03,Turkey,1670,61,126045,3397
2020-05-04,Turkey,1614,64,127659,3461
2020-05-05,Turkey,1832,59,129491,3520
2020-05-06,Turkey,2253,64,131744,3584
2020-05-07,Turkey,1977,57,133721,3641
2020-05-08,Turkey,1848,48,135569,3689
2020-05-09,Turkey,1546,50,137115,3739
2020-05-10,Turkey,1542,47,138657,3786
2020-05-11,Turkey,1114,55,139771,3841
2020-05-12,Turkey,1704,53,141475,3894
2020-05-13,Turkey,1639,58,143114,3952
2020-05-14,Turkey,1635,55,144749,4007
2020-05-15,Turkey,1708,48,146457,4055
2020-05-16,Turkey,1610,41,148067,4096
2020-05-17,Turkey,1368,44,149435,4140
2020-05-18,Turkey,1158,31,150593,4171
2020-05-19,Turkey,1022,28,151615,4199
2020-05-20,Turkey,972,23,152587,4222
2020-05-21,Turkey,961,27,153548,4249
2020-05-22,Turkey,952,27,154500,4276
2020-05-23,Turkey,1186,32,155686,4308
2020-05-24,Turkey,1141,32,156827,4340
2020-05-25,Turkey,987,29,157814,4369
2020-05-26,Turkey,948,28,158762,4397
2020-05-27,Turkey,1035,34,159797,4431
2020-05-28,Turkey,1182,30,160979,4461
2020-05-29,Turkey,1141,28,162120,4489
2020-05-30,Turkey,983,26,163103,4515
2020-05-31,Turkey,839,25,163942,4540
2020-06-01,Turkey,827,23,164769,4563
2020-06-02,Turkey,786,22,165555,4585
2020-06-03,Turkey,867,24,166422,4609
2020-06-04,Turkey,988,21,167410,4630
2020-06-05,Turkey,930,18,168340,4648
2020-06-06,Turkey,878,21,169218,4669
2020-06-07,Turkey,914,23,170132,4692
2020-06-08,Turkey,989,19,171121,4711
2020-06-09,Turkey,993,18,172114,4729
2020-06-10,Turkey,922,17,173036,4746
2020-06-11,Turkey,987,17,174023,4763
2020-06-12,Turkey,1195,15,175218,4778
2020-06-13,Turkey,1459,14,176677,4792
2020-06-14,Turkey,1562,15,178239,4807
2020-06-15,Turkey,1592,18,179831,4825
2020-06-16,Turkey,1467,17,181298,4842
2020-06-17,Turkey,1429,19,182727,4861
2020-06-18,Turkey,1304,21,184031,4882
2020-06-19,Turkey,1214,23,185245,4905
2020-06-20,Turkey,1248,22,186493,4927
2020-06-21,Turkey,1192,23,187685,4950
2020-06-22,Turkey,1212,24,188897,4974
2020-06-23,Turkey,1268,27,190165,5001
2020-06-24,Turkey,1492,24,191657,5025
2020-06-25,Turkey,1458,21,193115,5046
2020-06-26,Turkey,1396,19,194511,5065
2020-06-27,Turkey,1372,17,195883,5082
2020-06-28,Turkey,1356,15,197239,5097
2020-06-29,Turkey,1374,18,198613,5115
2020-06-30,Turkey,1293,16,199906,5131
2020-07-01,Turkey,1192,19,201098,5150
2020-07-02,Turkey,1186,17,202284,5167
2020-07-03,Turkey,1172,19,203456,5186
2020-07-04,Turkey,1154,20,204610,5206
2020-07-05,Turkey,1148,19,205758,5225
2020-07-06,Turkey,1086,16,206844,5241
2020-07-07,Turkey,1053,19,207897,5260
2020-07-08,Turkey,1041,22,208938,5282
2020-07-09,Turkey,1024,18,209962,5300
2020-07-10,Turkey,1003,23,210965,5323
2020-07-11,Turkey,1016,21,211981,5344
2020-07-12,Turkey,1012,19,212993,5363
2020-07-13,Turkey,1008,19,214001,5382
2020-07-14,Turkey,992,20,214993,5402
2020-07-15,Turkey,947,17,215940,5419
2020-07-16,Turkey,933,21,216873,5440
2020-07-17,Turkey,926,18,217799,5458
2020-07-18,Turkey,918,17,218717,5475
2020-07-19,Turkey,924,16,219641,5491
2020-07-20,Turkey,931,17,220572,5508
2020-07-21,Turkey,928,18,221500,5526
2020-07-22,Turkey,902,19,222402,5545
2020-07-23,Turkey,913,18,223315,5563
2020-07-24,Turkey,937,17,224252,5580
2020-07-25,Turkey,921,16,225173,5596
2020-07-26,Turkey,927,17,226100,5613
2020-07-27,Turkey,919,17,227019,5630
2020-07-28,Turkey,963,15,227982,5645
2020-07-29,Turkey,942,14,228924,5659
2020-07-30,Turkey,967,15,229891,5674
2020-07-31,Turkey,982,17,230873,5691
2020-08-01,Turkey,996,19,231869,5710
2020-08-02,Turkey,987,18,232856,5728
2020-08-03,Turkey,995,19,233851,5747
2020-08-04,Turkey,1083,18,234934,5765
2020-08-05,Turkey,1178,19,236112,5784
2020-08-06,Turkey,1153,14,237265,5798
2020-08-07,Turkey,1185,15,238450,5813
2020-08-08,Turkey,1172,16,239622,5829
2020-08-09,Turkey,1182,15,240804,5844
2020-08-10,Turkey,1193,14,241997,5858
2020-08-11,Turkey,1183,15,243180,5873
2020-08-12,Turkey,1212,18,244392,5891
2020-08-13,Turkey,1243,21,245635,5912
2020-08-14,Turkey,1226,22,246861,5934
2020-08-15,Turkey,1256,21,248117,5955
2020-08-16,Turkey,1192,19,249309,5974
2020-08-17,Turkey,1233,22,250542,5996
2020-08-18,Turkey,1263,20,251805,6016
2020-08-19,Turkey,1303,23,253108,6039
2020-08-20,Turkey,1412,19,254520,6058
2020-08-21,Turkey,1203,22,255723,6080
2020-08-22,Turkey,1309,22,257032,6102
2020-08-23,Turkey,1217,19,258249,6121
2020-08-24,Turkey,1443,18,259692,6139
2020-08-25,Turkey,1502,24,261194,6163
2020-08-26,Turkey,1313,20,262507,6183
2020-08-27,Turkey,1491,26,263998,6209
2020-08-28,Turkey,1517,36,265515,6245
2020-08-29,Turkey,1549,39,267064,6284
2020-08-30,Turkey,1482,42,268546,6326
2020-08-31,Turkey,1587,44,270133,6370
2020-09-01,Turkey,1572,47,271705,6417
2020-09-02,Turkey,1596,45,273301,6462
2020-09-03,Turkey,1642,49,274943,6511
2020-09-04,Turkey,1612,53,276555,6564
2020-09-05,Turkey,1673,56,278228,6620
2020-09-06,Turkey,1578,53,279806,6673
2020-09-07,Turkey,1703,57,281509,6730
2020-09-08,Turkey,1761,52,283270,6782
2020-09-09,Turkey,1673,55,284943,6837
2020-09-10,Turkey,1512,58,286455,6895
2020-09-11,Turkey,1671,56,288126,6951
2020-09-12,Turkey,1509,48,289635,6999
2020-09-13,Turkey,1527,57,291162,7056
2020-09-14,Turkey,1716,63,292878,7119
2020-09-15,Turkey,1742,67,294620,7186
2020-09-16,Turkey,1771,63,296391,7249
2020-09-17,Turkey,1648,66,298039,7315
2020-09-18,Turkey,1771,62,299810,7377
2020-09-19,Turkey,1538,68,301348,7445
2020-09-20,Turkey,1519,61,302867,7506
2020-09-21,Turkey,1743,68,304610,7574
2020-09-22,Turkey,1692,65,306302,7639
2020-09-23,Turkey,1767,72,308069,7711
2020-09-24,Turkey,1721,74,309790,7785
2020-09-25,Turkey,1665,73,311455,7858
2020-09-26,Turkey,1511,71,312966,7929
2020-09-27,Turkey,1467,68,314433,7997
2020-09-28,Turkey,1412,65,315845,8062
2020-09-29,Turkey,1427,68,317272,8130
2020-09-30,Turkey,1391,65,318663,8195
2020-10-01,Turkey,1407,67,320070,8262
2020-10-02,Turkey,1442,63,321512,8325
2020-10-03,Turkey,1502,59,323014,8384
2020-10-04,Turkey,1429,57,324443,8441
2020-10-05,Turkey,1603,57,326046,8498
2020-10-06,Turkey,1511,55,327557,8553
2020-10-07,Turkey,1581,56,329138,8609
2020-10-08,Turkey,1615,58,330753,8667
2020-10-09,Turkey,1629,55,332382,8722
2020-10-10,Turkey,1649,56,334031,8778
2020-10-11,Turkey,1502,59,335533,8837
2020-10-12,Turkey,1614,58,337147,8895
2020-10-13,Turkey,1632,62,338779,8957
2020-10-14,Turkey,1671,57,340450,9014
2020-10-15,Turkey,1693,66,342143,9080
2020-10-16,Turkey,1812,73,343955,9153
2020-10-17,Turkey,1723,71,345678,9224
2020-10-18,Turkey,1815,72,347493,9296
2020-10-19,Turkey,2026,75,349519,9371
2020-10-20,Turkey,1894,74,351413,9445
2020-10-21,Turkey,2013,68,353426,9513
2020-10-22,Turkey,2102,71,355528,9584
2020-10-23,Turkey,2165,74,357693,9658
2020-10-24,Turkey,2091,69,359784,9727
2020-10-25,Turkey,2017,72,361801,9799
2020-10-26,Turkey,2198,75,363999,9874
2020-10-27,Turkey,2209,76,366208,9950
2020-10-28,Turkey,2305,77,368513,10027
2020-10-29,Turkey,2319,72,370832,10099
2020-10-30,Turkey,2322,78,373154,10177
2020-10-31,Turkey,2213,75,375367,10252
2020-11-01,Turkey,2106,74,377473,10326
2020-11-02,Turkey,2302,76,379775,10402
2020-11-03,Turkey,2343,79,382118,10481
2020-11-04,Turkey,2391,77,384509,10558
2020-11-05,Turkey,2311,81,386820,10639
2020-11-06,Turkey,2436,83,389256,10722
2020-11-07,Turkey,2483,81,391739,10803
2020-11-08,Turkey,2516,84,394255,10887
2020-11-09,Turkey,2576,85,396831,10972
2020-11-10,Turkey,2529,87,399360,11059
2020-11-11,Turkey,2693,86,402053,11145
2020-11-12,Turkey,2841,88,404894,11233
2020-11-13,Turkey,3045,93,407939,11326
2020-11-14,Turkey,3116,92,411055,11418
2020-11-15,Turkey,3223,89,414278,11507
2020-11-16,Turkey,3316,94,417594,11601
2020-11-17,Turkey,3819,103,421413,11704
2020-11-18,Turkey,4215,116,425628,11820
2020-11-19,Turkey,4542,123,430170,11943
2020-11-20,Turkey,5103,141,435273,12084
2020-11-21,Turkey,5532,135,440805,12219
2020-11-22,Turkey,6017,139,446822,12358
2020-11-23,Turkey,6713,153,453535,12511
2020-11-24,Turkey,7381,161,460916,12672
2020-11-25,Turkey,6814,168,467730,12840
2020-11-26,Turkey,36008,174,503738,13014
2020-11-27,Turkey,44506,177,548244,13191
2020-11-28,Turkey,30103,182,578347,13373
2020-11-29,Turkey,29281,185,607628,13558
2020-11-30,Turkey,31219,188,638847,13746
2020-12-01,Turkey,30110,190,668957,13936
2020-12-02,Turkey,31923,193,700880,14129
2020-12-03,Turkey,32381,187,733261,14316
2020-12-04,Turkey,32736,193,765997,14509
2020-12-05,Turkey,31896,196,797893,14705
2020-12-06,Turkey,30402,195,828295,14900
2020-12-07,Turkey,32137,203,860432,15103
2020-12-08,Turkey,33198,211,893630,15314
2020-12-09,Turkey,31712,217,925342,15531
2020-12-10,Turkey,0,220,1748567,15751
2020-12-11,Turkey,32106,226,1780673,15977
2020-12-12,Turkey,29136,222,1809809,16199
2020-12-13,Turkey,26919,218,1836728,16417
2020-12-14,Turkey,29617,229,1866345,16646
2020-12-15,Turkey,32102,235,1898447,16881
2020-12-16,Turkey,29718,240,1928165,17121
2020-12-17,Turkey,27515,243,1955680,17364
2020-12-18,Turkey,26410,246,1982090,17610
2020-12-19,Turkey,22195,241,2004285,17851
2020-12-20,Turkey,20316,246,2024601,18097
2020-12-21,Turkey,19103,254,2043704,18351
2020-12-22,Turkey,19256,251,2062960,18602
2020-12-23,Turkey,19650,259,2082610,18861
2020-12-24,Turkey,18102,254,2100712,19115
2020-12-25,Turkey,17543,256,2118255,19371
2020-12-26,Turkey,15118,253,2133373,19624
2020-12-27,Turkey,14205,254,2147578,19878
2020-12-28,Turkey,15197,257,2162775,20135
2020-12-29,Turkey,15805,253,2178580,20388
2020-12-30,Turkey,15692,254,2194272,20642
2020-12-31,Turkey,14380,239,2208652,20881
2021-01-01,Turkey,12203,212,2220855,21093
2021-01-02,Turkey,11180,202,2232035,21295
2021-01-03,Turkey,9877,193,2241912,21488
2021-01-04,Turkey,13695,197,2255607,21685
2021-01-05,Turkey,14494,194,2270101,21879
2021-01-06,Turkey,13830,191,2283931,22070
2021-01-07,Turkey,12171,194,2296102,22264
2021-01-08,Turkey,11479,186,2307581,22450
2021-01-09,Turkey,9537,181,2317118,22631
2021-01-10,Turkey,9138,176,2326256,22807
2021-01-11,Turkey,10220,174,2336476,22981
2021-01-12,Turkey,9809,171,2346285,23152
2021-01-13,Turkey,9554,173,2355839,23325
2021-01-14,Turkey,8962,170,2364801,23495
2021-01-15,Turkey,8314,169,2373115,23664
2021-01-16,Turkey,7550,168,2380665,23832
2021-01-17,Turkey,6436,165,2387101,23997
2021-01-18,Turkey,5862,164,2392963,24161
2021-01-19,Turkey,6818,167,2399781,24328
2021-01-20,Turkey,6435,159,2406216,24487
2021-01-21,Turkey,6289,153,2412505,24640
2021-01-22,Turkey,5967,149,2418472,24789
2021-01-23,Turkey,5856,144,2424328,24933
2021-01-24,Turkey,5277,140,2429605,25073
2021-01-25,Turkey,5642,137,2435247,25210
2021-01-26,Turkey,7103,134,2442350,25344
2021-01-27,Turkey,7489,132,2449839,25476
2021-01-28,Turkey,7279,129,2457118,25605
2021-01-29,Turkey,6912,131,2464030,25736
2021-01-30,Turkey,6871,129,2470901,25865
2021-01-31,Turkey,6562,128,2477463,25993
2021-02-01,Turkey,7719,124,2485182,26117
2021-02-02,Turkey,7795,120,2492977,26237
2021-02-03,Turkey,8102,117,2501079,26354
2021-02-04,Turkey,7909,113,2508988,26467
2021-02-05,Turkey,7901,110,2516889,26577
2021-02-06,Turkey,7897,108,2524786,26685
2021-02-07,Turkey,6670,112,2531456,26797
2021-02-08,Turkey,8103,103,2539559,26900
2021-02-09,Turkey,8636,98,2548195,26998
2021-02-10,Turkey,8642,95,2556837,27093
2021-02-11,Turkey,7590,94,2564427,27187
2021-02-12,Turkey,7763,97,2572190,27284
2021-02-13,Turkey,7706,93,2579896,27377
2021-02-14,Turkey,6287,94,2586183,27471
2021-02-15,Turkey,7945,91,2594128,27562
2021-02-16,Turkey,7906,90,2602034,27652
2021-02-17,Turkey,7325,86,2609359,27738
2021-02-18,Turkey,7241,83,2616600,27821
2021-02-19,Turkey,7419,82,2624019,27903
2021-02-20,Turkey,7857,80,2631876,27983
2021-02-21,Turkey,6546,77,2638422,28060
2021-02-22,Turkey,8104,78,2646526,28138
2021-02-23,Turkey,9107,75,2655633,28213
2021-02-24,Turkey,9561,72,2665194,28285
2021-02-25,Turkey,9572,73,2674766,28358
2021-02-26,Turkey,9205,74,2683971,28432
2021-02-27,Turkey,9193,71,2693164,28503
2021-02-28,Turkey,8424,66,2701588,28569
2021-03-01,Turkey,9891,69,2711479,28638
2021-03-02,Turkey,11837,68,2723316,28706
2021-03-03,Turkey,11520,65,2734836,28771
2021-03-04,Turkey,11322,68,2746158,28839
2021-03-05,Turkey,11302,62,2757460,28901
2021-03-06,Turkey,11770,64,2769230,28965
2021-03-07,Turkey,11187,65,2780417,29030
2021-03-08,Turkey,13215,64,2793632,29094
2021-03-09,Turkey,13755,66,2807387,29160
2021-03-10,Turkey,14556,67,2821943,29227
2021-03-11,Turkey,14046,63,2835989,29290
2021-03-12,Turkey,14941,66,2850930,29356
2021-03-13,Turkey,15082,65,2866012,29421
2021-03-14,Turkey,13378,68,2879390,29489
2021-03-15,Turkey,15503,63,2894893,29552
2021-03-16,Turkey,16749,71,2911642,29623
2021-03-17,Turkey,18912,73,2930554,29696
2021-03-18,Turkey,20049,81,2950603,29777
2021-03-19,Turkey,21030,87,2971633,29864
2021-03-20,Turkey,21061,95,2992694,29959
2021-03-21,Turkey,20428,102,3013122,30061
2021-03-22,Turkey,22216,117,3035338,30178
2021-03-23,Turkey,26182,138,3061520,30316
2021-03-24,Turkey,29762,146,3091282,30462
2021-03-25,Turkey,28731,157,3120013,30619
2021-03-26,Turkey,29081,153,3149094,30772
2021-03-27,Turkey,30021,151,3179115,30923
2021-03-28,Turkey,29058,153,3208173,31076
2021-03-29,Turkey,32404,154,3240577,31230
2021-03-30,Turkey,37303,155,3277880,31385
2021-03-31,Turkey,39302,152,3317182,31537
2021-04-01,Turkey,40806,176,3357988,31713
2021-04-02,Turkey,42308,179,3400296,31892
2021-04-03,Turkey,44756,186,3445052,32078
2021-04-04,Turkey,41998,185,3487050,32263
2021-04-05,Turkey,42551,193,3529601,32456
2021-04-06,Turkey,49584,211,3579185,32667
2021-04-07,Turkey,54740,276,3633925,32943
2021-04-08,Turkey,55941,258,3689866,33201
2020-03-21,Uganda,1,0,1,0
2020-03-22,Uganda,0,0,1,0
2020-03-23,Uganda,8,0,9,0
2020-03-24,Uganda,0,0,9,0
2020-03-25,Uganda,5,0,14,0
2020-03-26,Uganda,0,0,14,0
2020-03-27,Uganda,9,0,23,0
2020-03-28,Uganda,7,0,30,0
2020-03-29,Uganda,3,0,33,0
2020-03-30,Uganda,0,0,33,0
2020-03-31,Uganda,11,0,44,0
2020-04-01,Uganda,0,0,44,0
2020-04-02,Uganda,1,0,45,0
2020-04-03,Uganda,3,0,48,0
2020-04-04,Uganda,0,0,48,0
2020-04-05,Uganda,4,0,52,0
2020-04-06,Uganda,0,0,52,0
2020-04-07,Uganda,0,0,52,0
2020-04-08,Uganda,1,0,53,0
2020-04-09,Uganda,0,0,53,0
2020-04-10,Uganda,0,0,53,0
2020-04-11,Uganda,0,0,53,0
2020-04-12,Uganda,1,0,54,0
2020-04-13,Uganda,0,0,54,0
2020-04-14,Uganda,1,0,55,0
2020-04-15,Uganda,0,0,55,0
2020-04-16,Uganda,0,0,55,0
2020-04-17,Uganda,1,0,56,0
2020-04-18,Uganda,-1,0,55,0
2020-04-19,Uganda,0,0,55,0
2020-04-20,Uganda,1,0,56,0
2020-04-21,Uganda,5,0,61,0
2020-04-22,Uganda,2,0,63,0
2020-04-23,Uganda,11,0,74,0
2020-04-24,Uganda,1,0,75,0
2020-04-25,Uganda,0,0,75,0
2020-04-26,Uganda,4,0,79,0
2020-04-27,Uganda,0,0,79,0
2020-04-28,Uganda,0,0,79,0
2020-04-29,Uganda,2,0,81,0
2020-04-30,Uganda,2,0,83,0
2020-05-01,Uganda,2,0,85,0
2020-05-02,Uganda,3,0,88,0
2020-05-03,Uganda,1,0,89,0
2020-05-04,Uganda,8,0,97,0
2020-05-05,Uganda,1,0,98,0
2020-05-06,Uganda,2,0,100,0
2020-05-07,Uganda,1,0,101,0
2020-05-08,Uganda,0,0,101,0
2020-05-09,Uganda,15,0,116,0
2020-05-10,Uganda,5,0,121,0
2020-05-11,Uganda,0,0,121,0
2020-05-12,Uganda,8,0,129,0
2020-05-13,Uganda,10,0,139,0
2020-05-14,Uganda,21,0,160,0
2020-05-15,Uganda,43,0,203,0
2020-05-16,Uganda,24,0,227,0
2020-05-17,Uganda,0,0,227,0
2020-05-18,Uganda,21,0,248,0
2020-05-19,Uganda,12,0,260,0
2020-05-20,Uganda,4,0,264,0
2020-05-21,Uganda,-104,0,160,0
2020-05-22,Uganda,15,0,175,0
2020-05-23,Uganda,23,0,198,0
2020-05-24,Uganda,0,0,198,0
2020-05-25,Uganda,24,0,222,0
2020-05-26,Uganda,31,0,253,0
2020-05-27,Uganda,28,0,281,0
2020-05-28,Uganda,36,0,317,0
2020-05-29,Uganda,12,0,329,0
2020-05-30,Uganda,84,0,413,0
2020-05-31,Uganda,4,0,417,0
2020-06-01,Uganda,40,0,457,0
2020-06-02,Uganda,32,0,489,0
2020-06-03,Uganda,18,0,507,0
2020-06-04,Uganda,15,0,522,0
2020-06-05,Uganda,35,0,557,0
2020-06-06,Uganda,36,0,593,0
2020-06-07,Uganda,23,0,616,0
2020-06-08,Uganda,30,0,646,0
2020-06-09,Uganda,11,0,657,0
2020-06-10,Uganda,8,0,665,0
2020-06-11,Uganda,14,0,679,0
2020-06-12,Uganda,7,0,686,0
2020-06-13,Uganda,8,0,694,0
2020-06-14,Uganda,2,0,696,0
2020-06-15,Uganda,9,0,705,0
2020-06-16,Uganda,19,0,724,0
2020-06-17,Uganda,8,0,732,0
2020-06-18,Uganda,9,0,741,0
2020-06-19,Uganda,14,0,755,0
2020-06-20,Uganda,8,0,763,0
2020-06-21,Uganda,7,0,770,0
2020-06-22,Uganda,4,0,774,0
2020-06-23,Uganda,23,0,797,0
2020-06-24,Uganda,8,0,805,0
2020-06-25,Uganda,16,0,821,0
2020-06-26,Uganda,12,0,833,0
2020-06-27,Uganda,15,0,848,0
2020-06-28,Uganda,11,0,859,0
2020-06-29,Uganda,11,0,870,0
2020-06-30,Uganda,19,0,889,0
2020-07-01,Uganda,4,0,893,0
2020-07-02,Uganda,9,0,902,0
2020-07-03,Uganda,9,0,911,0
2020-07-04,Uganda,16,0,927,0
2020-07-05,Uganda,12,0,939,0
2020-07-06,Uganda,14,0,953,0
2020-07-07,Uganda,18,0,971,0
2020-07-08,Uganda,6,0,977,0
2020-07-09,Uganda,23,0,1000,0
2020-07-10,Uganda,6,0,1006,0
2020-07-11,Uganda,7,0,1013,0
2020-07-12,Uganda,12,0,1025,0
2020-07-13,Uganda,4,0,1029,0
2020-07-14,Uganda,11,0,1040,0
2020-07-15,Uganda,3,0,1043,0
2020-07-16,Uganda,8,0,1051,0
2020-07-17,Uganda,5,0,1056,0
2020-07-18,Uganda,6,0,1062,0
2020-07-19,Uganda,3,0,1065,0
2020-07-20,Uganda,4,0,1069,0
2020-07-21,Uganda,3,0,1072,0
2020-07-22,Uganda,3,0,1075,0
2020-07-23,Uganda,4,0,1079,0
2020-07-24,Uganda,10,1,1089,1
2020-07-25,Uganda,14,0,1103,1
2020-07-26,Uganda,12,1,1115,2
2020-07-27,Uganda,13,0,1128,2
2020-07-28,Uganda,7,0,1135,2
2020-07-29,Uganda,5,0,1140,2
2020-07-30,Uganda,7,0,1147,2
2020-07-31,Uganda,7,1,1154,3
2020-08-01,Uganda,22,1,1176,4
2020-08-02,Uganda,6,0,1182,4
2020-08-03,Uganda,13,1,1195,5
2020-08-04,Uganda,8,0,1203,5
2020-08-05,Uganda,10,0,1213,5
2020-08-06,Uganda,10,0,1223,5
2020-08-07,Uganda,31,1,1254,6
2020-08-08,Uganda,13,0,1267,6
2020-08-09,Uganda,16,1,1283,7
2020-08-10,Uganda,14,2,1297,9
2020-08-11,Uganda,16,0,1313,9
2020-08-12,Uganda,19,0,1332,9
2020-08-13,Uganda,21,2,1353,11
2020-08-14,Uganda,32,1,1385,12
2020-08-15,Uganda,49,1,1434,13
2020-08-16,Uganda,66,0,1500,13
2020-08-17,Uganda,60,2,1560,15
2020-08-18,Uganda,43,0,1603,15
2020-08-19,Uganda,53,1,1656,16
2020-08-20,Uganda,94,3,1750,19
2020-08-21,Uganda,98,0,1848,19
2020-08-22,Uganda,318,1,2166,20
2020-08-23,Uganda,97,0,2263,20
2020-08-24,Uganda,99,2,2362,22
2020-08-25,Uganda,64,3,2426,25
2020-08-26,Uganda,98,1,2524,26
2020-08-27,Uganda,155,2,2679,28
2020-08-28,Uganda,77,0,2756,28
2020-08-29,Uganda,91,1,2847,29
2020-08-30,Uganda,81,1,2928,30
2020-08-31,Uganda,44,2,2972,32
2020-09-01,Uganda,65,0,3037,32
2020-09-02,Uganda,75,0,3112,32
2020-09-03,Uganda,176,1,3288,33
2020-09-04,Uganda,65,2,3353,35
2020-09-05,Uganda,186,4,3539,39
2020-09-06,Uganda,128,2,3667,41
2020-09-07,Uganda,109,3,3776,44
2020-09-08,Uganda,124,2,3900,46
2020-09-09,Uganda,201,0,4101,46
2020-09-10,Uganda,190,2,4291,48
2020-09-11,Uganda,86,1,4377,49
2020-09-12,Uganda,326,3,4703,52
2020-09-13,Uganda,96,3,4799,55
2020-09-14,Uganda,179,1,4978,56
2020-09-15,Uganda,145,2,5123,58
2020-09-16,Uganda,143,2,5266,60
2020-09-17,Uganda,114,0,5380,60
2020-09-18,Uganda,214,1,5594,61
2020-09-19,Uganda,423,2,6017,63
2020-09-20,Uganda,270,0,6287,63
2020-09-21,Uganda,181,0,6468,63
2020-09-22,Uganda,244,1,6712,64
2020-09-23,Uganda,167,5,6879,69
2020-09-24,Uganda,185,1,7064,70
2020-09-25,Uganda,154,1,7218,71
2020-09-26,Uganda,146,0,7364,71
2020-09-27,Uganda,166,2,7530,73
2020-09-28,Uganda,247,2,7777,75
2020-09-29,Uganda,240,0,8017,75
2020-09-30,Uganda,112,0,8129,75
2020-10-01,Uganda,158,0,8287,75
2020-10-02,Uganda,204,4,8491,79
2020-10-03,Uganda,171,0,8662,79
2020-10-04,Uganda,146,2,8808,81
2020-10-05,Uganda,157,1,8965,82
2020-10-06,Uganda,117,2,9082,84
2020-10-07,Uganda,178,1,9260,85
2020-10-08,Uganda,182,0,9442,85
2020-10-09,Uganda,96,1,9538,86
2020-10-10,Uganda,163,7,9701,93
2020-10-11,Uganda,100,0,9801,93
2020-10-12,Uganda,63,1,9864,94
2020-10-13,Uganda,81,1,9945,95
2020-10-14,Uganda,124,0,10069,95
2020-10-15,Uganda,48,1,10117,96
2020-10-16,Uganda,217,0,10334,96
2020-10-17,Uganda,121,0,10455,96
2020-10-18,Uganda,135,1,10590,97
2020-10-19,Uganda,101,0,10691,97
2020-10-20,Uganda,97,0,10788,97
2020-10-21,Uganda,145,1,10933,98
2020-10-22,Uganda,108,0,11041,98
2020-10-23,Uganda,122,1,11163,99
2020-10-24,Uganda,134,0,11297,99
2020-10-25,Uganda,146,2,11443,101
2020-10-26,Uganda,114,0,11557,101
2020-10-27,Uganda,64,2,11621,103
2020-10-28,Uganda,146,3,11767,106
2020-10-29,Uganda,434,2,12201,108
2020-10-30,Uganda,209,2,12410,110
2020-10-31,Uganda,85,1,12495,111
2020-11-01,Uganda,248,1,12743,112
2020-11-02,Uganda,228,2,12971,114
2020-11-03,Uganda,128,1,13099,115
2020-11-04,Uganda,252,2,13351,117
2020-11-05,Uganda,217,0,13568,117
2020-11-06,Uganda,284,14,13852,131
2020-11-07,Uganda,214,0,14066,131
2020-11-08,Uganda,337,1,14403,132
2020-11-09,Uganda,171,1,14574,133
2020-11-10,Uganda,130,0,14704,133
2020-11-11,Uganda,289,6,14993,139
2020-11-12,Uganda,224,4,15217,143
2020-11-13,Uganda,185,1,15402,144
2020-11-14,Uganda,387,0,15789,144
2020-11-15,Uganda,231,1,16020,145
2020-11-16,Uganda,237,5,16257,150
2020-11-17,Uganda,306,0,16563,150
2020-11-18,Uganda,342,7,16905,157
2020-11-19,Uganda,243,1,17148,158
2020-11-20,Uganda,283,10,17431,168
2020-11-21,Uganda,236,0,17667,168
2020-11-22,Uganda,301,4,17968,172
2020-11-23,Uganda,197,9,18165,181
2020-11-24,Uganda,241,5,18406,186
2020-11-25,Uganda,484,5,18890,191
2020-11-26,Uganda,225,0,19115,191
2020-11-27,Uganda,473,6,19588,197
2020-11-28,Uganda,356,4,19944,201
2020-11-29,Uganda,201,0,20145,201
2020-11-30,Uganda,314,4,20459,205
2020-12-01,Uganda,576,0,21035,205
2020-12-02,Uganda,374,1,21409,206
2020-12-03,Uganda,203,0,21612,206
2020-12-04,Uganda,286,0,21898,206
2020-12-05,Uganda,290,0,22188,206
2020-12-06,Uganda,311,0,22499,206
2020-12-07,Uganda,701,1,23200,207
2020-12-08,Uganda,0,0,23200,207
2020-12-09,Uganda,1859,12,25059,219
2020-12-10,Uganda,671,1,25730,220
2020-12-11,Uganda,639,0,26369,220
2020-12-12,Uganda,702,0,27071,220
2020-12-13,Uganda,461,1,27532,221
2020-12-14,Uganda,234,3,27766,224
2020-12-15,Uganda,402,1,28168,225
2020-12-16,Uganda,565,0,28733,225
2020-12-17,Uganda,628,3,29361,228
2020-12-18,Uganda,710,2,30071,230
2020-12-19,Uganda,631,0,30702,230
2020-12-20,Uganda,485,1,31187,231
2020-12-21,Uganda,197,7,31384,238
2020-12-22,Uganda,526,0,31910,238
2020-12-23,Uganda,489,7,32399,245
2020-12-24,Uganda,515,0,32914,245
2020-12-25,Uganda,446,0,33360,245
2020-12-26,Uganda,203,0,33563,245
2020-12-27,Uganda,248,3,33811,248
2020-12-28,Uganda,162,0,33973,248
2020-12-29,Uganda,308,2,34281,250
2020-12-30,Uganda,396,1,34677,251
2020-12-31,Uganda,539,0,35216,251
2021-01-01,Uganda,295,14,35511,265
2021-01-02,Uganda,201,9,35712,274
2021-01-03,Uganda,210,0,35922,274
2021-01-04,Uganda,128,0,36050,274
2021-01-05,Uganda,357,16,36407,290
2021-01-06,Uganda,295,4,36702,294
2021-01-07,Uganda,372,3,37074,297
2021-01-08,Uganda,222,3,37296,300
2021-01-09,Uganda,258,1,37554,301
2021-01-10,Uganda,188,0,37742,301
2021-01-11,Uganda,66,1,37808,302
2021-01-12,Uganda,140,1,37948,303
2021-01-13,Uganda,137,1,38085,304
2021-01-14,Uganda,0,0,38085,304
2021-01-15,Uganda,0,0,38085,304
2021-01-16,Uganda,0,0,38085,304
2021-01-17,Uganda,0,0,38085,304
2021-01-18,Uganda,0,0,38085,304
2021-01-19,Uganda,449,1,38534,305
2021-01-20,Uganda,94,0,38628,305
2021-01-21,Uganda,178,11,38806,316
2021-01-22,Uganda,129,1,38935,317
2021-01-23,Uganda,109,0,39044,317
2021-01-24,Uganda,105,0,39149,317
2021-01-25,Uganda,39,1,39188,318
2021-01-26,Uganda,73,0,39261,318
2021-01-27,Uganda,53,0,39314,318
2021-01-28,Uganda,110,0,39424,318
2021-01-29,Uganda,66,6,39490,324
2021-01-30,Uganda,43,0,39533,324
2021-01-31,Uganda,46,0,39579,324
2021-02-01,Uganda,27,1,39606,325
2021-02-02,Uganda,45,0,39651,325
2021-02-03,Uganda,34,2,39685,327
2021-02-04,Uganda,50,0,39735,327
2021-02-05,Uganda,54,0,39789,327
2021-02-06,Uganda,32,0,39821,327
2021-02-07,Uganda,27,0,39848,327
2021-02-08,Uganda,12,0,39860,327
2021-02-09,Uganda,23,0,39883,327
2021-02-10,Uganda,28,1,39911,328
2021-02-11,Uganda,31,0,39942,328
2021-02-12,Uganda,37,0,39979,328
2021-02-13,Uganda,40,0,40019,328
2021-02-14,Uganda,0,0,40019,328
2021-02-15,Uganda,36,0,40055,328
2021-02-16,Uganda,8,3,40063,331
2021-02-17,Uganda,39,0,40102,331
2021-02-18,Uganda,52,0,40154,331
2021-02-19,Uganda,14,0,40168,331
2021-02-20,Uganda,31,2,40199,333
2021-02-21,Uganda,14,0,40213,333
2021-02-22,Uganda,8,0,40221,333
2021-02-23,Uganda,22,0,40243,333
2021-02-24,Uganda,18,1,40261,334
2021-02-25,Uganda,39,0,40300,334
2021-02-26,Uganda,22,0,40322,334
2021-02-27,Uganda,13,0,40335,334
2021-02-28,Uganda,22,0,40357,334
2021-03-01,Uganda,10,0,40367,334
2021-03-02,Uganda,28,0,40395,334
2021-03-03,Uganda,13,0,40408,334
2021-03-04,Uganda,18,0,40426,334
2021-03-05,Uganda,26,0,40452,334
2021-03-06,Uganda,0,0,40452,334
2021-03-07,Uganda,12,0,40464,334
2021-03-08,Uganda,15,0,40479,334
2021-03-09,Uganda,11,0,40490,334
2021-03-10,Uganda,30,0,40520,334
2021-03-11,Uganda,15,0,40535,334
2021-03-12,Uganda,9,0,40544,334
2021-03-13,Uganda,0,0,40544,334
2021-03-14,Uganda,37,0,40581,334
2021-03-15,Uganda,10,0,40591,334
2021-03-16,Uganda,2,0,40593,334
2021-03-17,Uganda,14,0,40607,334
2021-03-18,Uganda,18,0,40625,334
2021-03-19,Uganda,26,0,40651,334
2021-03-20,Uganda,0,0,40651,334
2021-03-21,Uganda,20,0,40671,334
2021-03-22,Uganda,16,0,40687,334
2021-03-23,Uganda,32,0,40719,334
2021-03-24,Uganda,0,0,40719,334
2021-03-25,Uganda,15,0,40734,334
2021-03-26,Uganda,17,1,40751,335
2021-03-27,Uganda,16,0,40767,335
2021-03-28,Uganda,27,0,40794,335
2021-03-29,Uganda,26,0,40820,335
2021-03-30,Uganda,19,0,40839,335
2021-03-31,Uganda,28,0,40867,335
2021-04-01,Uganda,22,0,40889,335
2021-04-02,Uganda,35,0,40924,335
2021-04-03,Uganda,38,0,40962,335
2021-04-04,Uganda,0,0,40962,335
2021-04-05,Uganda,54,0,41016,335
2021-04-06,Uganda,7,0,41023,335
2021-04-07,Uganda,23,2,41046,337
2021-04-08,Uganda,16,0,41062,337
2020-03-03,Ukraine,1,0,1,0
2020-03-04,Ukraine,0,0,1,0
2020-03-05,Ukraine,0,0,1,0
2020-03-06,Ukraine,0,0,1,0
2020-03-07,Ukraine,0,0,1,0
2020-03-08,Ukraine,0,0,1,0
2020-03-09,Ukraine,0,0,1,0
2020-03-10,Ukraine,0,0,1,0
2020-03-11,Ukraine,0,0,1,0
2020-03-12,Ukraine,0,0,1,0
2020-03-13,Ukraine,2,1,3,1
2020-03-14,Ukraine,0,0,3,1
2020-03-15,Ukraine,0,0,3,1
2020-03-16,Ukraine,4,0,7,1
2020-03-17,Ukraine,7,1,14,2
2020-03-18,Ukraine,0,0,14,2
2020-03-19,Ukraine,2,0,16,2
2020-03-20,Ukraine,13,1,29,3
2020-03-21,Ukraine,18,0,47,3
2020-03-22,Ukraine,26,0,73,3
2020-03-23,Ukraine,0,0,73,3
2020-03-24,Ukraine,24,0,97,3
2020-03-25,Ukraine,48,2,145,5
2020-03-26,Ukraine,51,0,196,5
2020-03-27,Ukraine,114,0,310,5
2020-03-28,Ukraine,46,4,356,9
2020-03-29,Ukraine,119,1,475,10
2020-03-30,Ukraine,73,3,548,13
2020-03-31,Ukraine,97,4,645,17
2020-04-01,Ukraine,149,3,794,20
2020-04-02,Ukraine,103,2,897,22
2020-04-03,Ukraine,175,5,1072,27
2020-04-04,Ukraine,153,5,1225,32
2020-04-05,Ukraine,83,5,1308,37
2020-04-06,Ukraine,11,1,1319,38
2020-04-07,Ukraine,143,7,1462,45
2020-04-08,Ukraine,206,7,1668,52
2020-04-09,Ukraine,224,5,1892,57
2020-04-10,Ukraine,311,12,2203,69
2020-04-11,Ukraine,308,4,2511,73
2020-04-12,Ukraine,266,10,2777,83
2020-04-13,Ukraine,325,10,3102,93
2020-04-14,Ukraine,270,5,3372,98
2020-04-15,Ukraine,392,10,3764,108
2020-04-16,Ukraine,397,8,4161,116
2020-04-17,Ukraine,501,9,4662,125
2020-04-18,Ukraine,444,8,5106,133
2020-04-19,Ukraine,343,8,5449,141
2020-04-20,Ukraine,261,10,5710,151
2020-04-21,Ukraine,415,10,6125,161
2020-04-22,Ukraine,467,13,6592,174
2020-04-23,Ukraine,578,13,7170,187
2020-04-24,Ukraine,477,14,7647,201
2020-04-25,Ukraine,478,0,8125,201
2020-04-26,Ukraine,492,8,8617,209
2020-04-27,Ukraine,392,11,9009,220
2020-04-28,Ukraine,401,19,9410,239
2020-04-29,Ukraine,456,11,9866,250
2020-04-30,Ukraine,540,11,10406,261
2020-05-01,Ukraine,455,11,10861,272
2020-05-02,Ukraine,550,7,11411,279
2020-05-03,Ukraine,502,9,11913,288
2020-05-04,Ukraine,418,15,12331,303
2020-05-05,Ukraine,366,13,12697,316
2020-05-06,Ukraine,487,11,13184,327
2020-05-07,Ukraine,507,13,13691,340
2020-05-08,Ukraine,504,21,14195,361
2020-05-09,Ukraine,515,15,14710,376
2020-05-10,Ukraine,522,15,15232,391
2020-05-11,Ukraine,416,17,15648,408
2020-05-12,Ukraine,375,17,16023,425
2020-05-13,Ukraine,402,14,16425,439
2020-05-14,Ukraine,422,17,16847,456
2020-05-15,Ukraine,483,20,17330,476
2020-05-16,Ukraine,528,21,17858,497
2020-05-17,Ukraine,433,17,18291,514
2020-05-18,Ukraine,325,21,18616,535
2020-05-19,Ukraine,260,13,18876,548
2020-05-20,Ukraine,354,16,19230,564
2020-05-21,Ukraine,476,15,19706,579
2020-05-22,Ukraine,442,9,20148,588
2020-05-23,Ukraine,432,17,20580,605
2020-05-24,Ukraine,406,12,20986,617
2020-05-25,Ukraine,259,6,21245,623
2020-05-26,Ukraine,339,21,21584,644
2020-05-27,Ukraine,321,14,21905,658
2020-05-28,Ukraine,477,11,22382,669
2020-05-29,Ukraine,429,10,22811,679
2020-05-30,Ukraine,393,17,23204,696
2020-05-31,Ukraine,468,12,23672,708
2020-06-01,Ukraine,890,16,24562,724
2020-06-02,Ukraine,333,9,24895,733
2020-06-03,Ukraine,490,9,25385,742
2020-06-04,Ukraine,596,13,25981,755
2020-06-05,Ukraine,561,15,26542,770
2020-06-06,Ukraine,559,15,27101,785
2020-06-07,Ukraine,498,11,27599,796
2020-06-08,Ukraine,478,9,28077,805
2020-06-09,Ukraine,402,13,28479,818
2020-06-10,Ukraine,536,23,29015,841
2020-06-11,Ukraine,691,23,29706,864
2020-06-12,Ukraine,709,16,30415,880
2020-06-13,Ukraine,762,10,31177,890
2020-06-14,Ukraine,674,9,31851,899
2020-06-15,Ukraine,685,12,32536,911
2020-06-16,Ukraine,673,11,33209,922
2020-06-17,Ukraine,777,31,33986,953
2020-06-18,Ukraine,847,23,34833,976
2020-06-19,Ukraine,922,19,35755,995
2020-06-20,Ukraine,860,9,36615,1004
2020-06-21,Ukraine,746,8,37361,1012
2020-06-22,Ukraine,695,10,38056,1022
2020-06-23,Ukraine,845,23,38901,1045
2020-06-24,Ukraine,951,16,39852,1061
2020-06-25,Ukraine,1002,17,40854,1078
2020-06-26,Ukraine,1121,19,41975,1097
2020-06-27,Ukraine,957,24,42932,1121
2020-06-28,Ukraine,924,21,43856,1142
2020-06-29,Ukraine,682,19,44538,1161
2020-06-30,Ukraine,716,12,45254,1173
2020-07-01,Ukraine,670,15,45924,1188
2020-07-02,Ukraine,897,12,46821,1200
2020-07-03,Ukraine,884,27,47705,1227
2020-07-04,Ukraine,923,16,48628,1243
2020-07-05,Ukraine,840,22,49468,1265
2020-07-06,Ukraine,585,13,50053,1278
2020-07-07,Ukraine,569,21,50622,1299
2020-07-08,Ukraine,835,24,51457,1323
2020-07-09,Ukraine,828,21,52285,1344
2020-07-10,Ukraine,831,18,53116,1362
2020-07-11,Ukraine,825,27,53941,1389
2020-07-12,Ukraine,706,11,54647,1400
2020-07-13,Ukraine,638,15,55285,1415
2020-07-14,Ukraine,646,14,55931,1429
2020-07-15,Ukraine,848,15,56779,1444
2020-07-16,Ukraine,861,18,57640,1462
2020-07-17,Ukraine,826,11,58466,1473
2020-07-18,Ukraine,867,23,59333,1496
2020-07-19,Ukraine,744,8,60077,1504
2020-07-20,Ukraine,690,13,60767,1517
2020-07-21,Ukraine,687,20,61454,1537
2020-07-22,Ukraine,841,16,62295,1553
2020-07-23,Ukraine,874,17,63169,1570
2020-07-24,Ukraine,1004,21,64173,1591
2020-07-25,Ukraine,1144,19,65317,1610
2020-07-26,Ukraine,944,15,66261,1625
2020-07-27,Ukraine,835,11,67096,1636
2020-07-28,Ukraine,934,14,68030,1650
2020-07-29,Ukraine,1048,23,69078,1673
2020-07-30,Ukraine,1222,24,70300,1697
2020-07-31,Ukraine,1104,20,71404,1717
2020-08-01,Ukraine,1205,16,72609,1733
2020-08-02,Ukraine,1152,16,73761,1749
2020-08-03,Ukraine,1020,13,74781,1762
2020-08-04,Ukraine,1099,26,75880,1788
2020-08-05,Ukraine,1289,25,77169,1813
2020-08-06,Ukraine,1346,33,78515,1846
2020-08-07,Ukraine,1503,33,80018,1879
2020-08-08,Ukraine,1516,27,81534,1906
2020-08-09,Ukraine,1233,19,82767,1925
2020-08-10,Ukraine,1045,25,83812,1950
2020-08-11,Ukraine,1211,29,85023,1979
2020-08-12,Ukraine,1481,20,86504,1999
2020-08-13,Ukraine,1632,24,88136,2023
2020-08-14,Ukraine,1781,19,89917,2042
2020-08-15,Ukraine,1878,34,91795,2076
2020-08-16,Ukraine,1695,24,93490,2100
2020-08-17,Ukraine,1517,22,95007,2122
2020-08-18,Ukraine,1646,30,96653,2152
2020-08-19,Ukraine,2005,30,98658,2182
2020-08-20,Ukraine,2152,43,100810,2225
2020-08-21,Ukraine,2138,23,102948,2248
2020-08-22,Ukraine,2389,38,105337,2286
2020-08-23,Ukraine,2042,27,107379,2313
2020-08-24,Ukraine,1855,22,109234,2335
2020-08-25,Ukraine,1715,27,110949,2362
2020-08-26,Ukraine,1704,37,112653,2399
2020-08-27,Ukraine,2010,50,114663,2449
2020-08-28,Ukraine,2509,50,117172,2499
2020-08-29,Ukraine,2579,41,119751,2540
2020-08-30,Ukraine,2179,35,121930,2575
2020-08-31,Ukraine,2202,30,124132,2605
2020-09-01,Ukraine,2147,49,126279,2654
2020-09-02,Ukraine,2554,51,128833,2705
2020-09-03,Ukraine,2467,54,131300,2759
2020-09-04,Ukraine,2769,53,134069,2812
2020-09-05,Ukraine,2897,51,136966,2863
2020-09-06,Ukraine,2205,35,139171,2898
2020-09-07,Ukraine,2253,32,141424,2930
2020-09-08,Ukraine,2490,58,143914,2988
2020-09-09,Ukraine,2597,46,146511,3034
2020-09-10,Ukraine,2635,45,149146,3079
2020-09-11,Ukraine,3227,53,152373,3132
2020-09-12,Ukraine,3185,74,155558,3206
2020-09-13,Ukraine,2564,33,158122,3239
2020-09-14,Ukraine,2557,34,160679,3273
2020-09-15,Ukraine,2999,53,163678,3326
2020-09-16,Ukraine,3016,78,166694,3404
2020-09-17,Ukraine,3679,61,170373,3465
2020-09-18,Ukraine,3330,70,173703,3535
2020-09-19,Ukraine,3345,50,177048,3585
2020-09-20,Ukraine,3071,41,180119,3626
2020-09-21,Ukraine,2781,26,182900,3652
2020-09-22,Ukraine,2990,64,185890,3716
2020-09-23,Ukraine,3598,68,189488,3784
2020-09-24,Ukraine,3478,54,192966,3838
2020-09-25,Ukraine,3665,72,196631,3910
2020-09-26,Ukraine,3935,78,200566,3988
2020-09-27,Ukraine,3233,56,203799,4044
2020-09-28,Ukraine,2780,38,206579,4082
2020-09-29,Ukraine,3730,72,210309,4154
2020-09-30,Ukraine,4137,67,214446,4221
2020-10-01,Ukraine,4179,67,218625,4288
2020-10-02,Ukraine,4751,69,223376,4357
2020-10-03,Ukraine,4785,94,228161,4451
2020-10-04,Ukraine,4263,44,232424,4495
2020-10-05,Ukraine,3905,35,236329,4530
2020-10-06,Ukraine,4482,94,240811,4624
2020-10-07,Ukraine,4887,83,245698,4707
2020-10-08,Ukraine,5545,100,251243,4807
2020-10-09,Ukraine,5961,92,257204,4899
2020-10-10,Ukraine,5901,111,263105,5010
2020-10-11,Ukraine,4960,88,268065,5098
2020-10-12,Ukraine,4606,45,272671,5143
2020-10-13,Ukraine,5311,111,277982,5254
2020-10-14,Ukraine,5780,111,283762,5365
2020-10-15,Ukraine,5260,78,289022,5443
2020-10-16,Ukraine,6205,108,295227,5551
2020-10-17,Ukraine,6629,118,301856,5669
2020-10-18,Ukraine,5445,93,307301,5762
2020-10-19,Ukraine,4986,72,312287,5834
2020-10-20,Ukraine,5680,114,317967,5948
2020-10-21,Ukraine,6975,145,324942,6093
2020-10-22,Ukraine,7320,120,332262,6213
2020-10-23,Ukraine,7780,123,340042,6336
2020-10-24,Ukraine,7275,127,347317,6463
2020-10-25,Ukraine,6406,103,353723,6566
2020-10-26,Ukraine,5625,75,359348,6641
2020-10-27,Ukraine,6885,129,366233,6770
2020-10-28,Ukraine,7790,168,374023,6938
2020-10-29,Ukraine,7641,120,381664,7058
2020-10-30,Ukraine,8608,177,390272,7235
2020-10-31,Ukraine,9058,164,399330,7399
2020-11-01,Ukraine,8243,116,407573,7515
2020-11-02,Ukraine,6994,69,414567,7584
2020-11-03,Ukraine,9116,165,423683,7749
2020-11-04,Ukraine,9809,203,433492,7952
2020-11-05,Ukraine,10138,196,443630,8148
2020-11-06,Ukraine,9935,210,453565,8358
2020-11-07,Ukraine,11033,195,464598,8553
2020-11-08,Ukraine,9647,142,474245,8695
2020-11-09,Ukraine,8908,117,483153,8812
2020-11-10,Ukraine,10391,206,493544,9018
2020-11-11,Ukraine,10879,196,504423,9214
2020-11-12,Ukraine,11332,208,515755,9422
2020-11-13,Ukraine,12053,182,527808,9604
2020-11-14,Ukraine,12785,202,540593,9806
2020-11-15,Ukraine,10940,98,551533,9904
2020-11-16,Ukraine,10048,98,561581,10002
2020-11-17,Ukraine,12177,166,573758,10168
2020-11-18,Ukraine,12764,263,586522,10431
2020-11-19,Ukraine,13630,263,600152,10694
2020-11-20,Ukraine,14834,235,614986,10929
2020-11-21,Ukraine,14864,220,629850,11149
2020-11-22,Ukraine,12365,143,642215,11292
2020-11-23,Ukraine,11227,131,653442,11423
2020-11-24,Ukraine,12526,196,665968,11619
2020-11-25,Ukraine,14164,238,680132,11857
2020-11-26,Ukraine,15623,234,695755,12091
2020-11-27,Ukraine,16494,201,712249,12292
2020-11-28,Ukraine,16585,193,728834,12485
2020-11-29,Ukraine,13271,128,742105,12613
2020-11-30,Ukraine,10238,118,752343,12731
2020-12-01,Ukraine,12774,231,765117,12962
2020-12-02,Ukraine,13443,178,778560,13140
2020-12-03,Ukraine,14812,254,793372,13394
2020-12-04,Ukraine,15456,247,808828,13641
2020-12-05,Ukraine,14157,236,822985,13877
2020-12-06,Ukraine,11928,177,834913,14054
2020-12-07,Ukraine,8985,154,843898,14208
2020-12-08,Ukraine,11156,205,855054,14413
2020-12-09,Ukraine,12937,289,867991,14702
2020-12-10,Ukraine,13736,279,881727,14981
2020-12-11,Ukraine,13893,297,895620,15278
2020-12-12,Ukraine,13219,250,908839,15528
2020-12-13,Ukraine,9605,163,918444,15691
2020-12-14,Ukraine,6877,101,925321,15792
2020-12-15,Ukraine,8840,246,934161,16038
2020-12-16,Ukraine,11057,276,945218,16314
2020-12-17,Ukraine,12474,265,957692,16579
2020-12-18,Ukraine,13066,269,970758,16848
2020-12-19,Ukraine,12179,224,982937,17072
2020-12-20,Ukraine,8763,129,991700,17201
2020-12-21,Ukraine,6978,92,998678,17293
2020-12-22,Ukraine,8949,242,1007627,17535
2020-12-23,Ukraine,10572,288,1018199,17823
2020-12-24,Ukraine,11926,234,1030125,18057
2020-12-25,Ukraine,11458,198,1041583,18255
2020-12-26,Ukraine,8134,134,1049717,18389
2020-12-27,Ukraine,6548,83,1056265,18472
2020-12-28,Ukraine,4809,83,1061074,18555
2020-12-29,Ukraine,7402,246,1068476,18801
2020-12-30,Ukraine,8404,257,1076880,19058
2020-12-31,Ukraine,10117,223,1086997,19281
2021-01-01,Ukraine,9858,156,1096855,19437
2021-01-02,Ukraine,5401,61,1102256,19498
2021-01-03,Ukraine,4881,132,1107137,19630
2021-01-04,Ukraine,4494,82,1111631,19712
2021-01-05,Ukraine,5625,217,1117256,19929
2021-01-06,Ukraine,7226,242,1124482,20171
2021-01-07,Ukraine,9320,163,1133802,20334
2021-01-08,Ukraine,5998,98,1139800,20432
2021-01-09,Ukraine,5143,94,1144943,20526
2021-01-10,Ukraine,5322,115,1150265,20641
2021-01-11,Ukraine,4585,78,1154850,20719
2021-01-12,Ukraine,5393,196,1160243,20915
2021-01-13,Ukraine,6715,206,1166958,21121
2021-01-14,Ukraine,8385,179,1175343,21300
2021-01-15,Ukraine,8620,179,1183963,21479
2021-01-16,Ukraine,8151,158,1192114,21637
2021-01-17,Ukraine,6398,130,1198512,21767
2021-01-18,Ukraine,3382,80,1201894,21847
2021-01-19,Ukraine,4231,190,1206125,22037
2021-01-20,Ukraine,4729,227,1210854,22264
2021-01-21,Ukraine,5926,257,1216780,22521
2021-01-22,Ukraine,5679,177,1222459,22698
2021-01-23,Ukraine,5264,132,1227723,22830
2021-01-24,Ukraine,4242,96,1231965,22926
2021-01-25,Ukraine,2807,75,1234772,23001
2021-01-26,Ukraine,3038,147,1237810,23148
2021-01-27,Ukraine,4053,159,1241863,23307
2021-01-28,Ukraine,5811,162,1247674,23469
2021-01-29,Ukraine,5453,141,1253127,23610
2021-01-30,Ukraine,4966,159,1258093,23769
2021-01-31,Ukraine,3453,91,1261546,23860
2021-02-01,Ukraine,2287,71,1263833,23931
2021-02-02,Ukraine,2631,169,1266464,24100
2021-02-03,Ukraine,3537,176,1270001,24276
2021-02-04,Ukraine,5333,153,1275334,24429
2021-02-05,Ukraine,5167,170,1280501,24599
2021-02-06,Ukraine,4558,136,1285059,24735
2021-02-07,Ukraine,3610,93,1288669,24828
2021-02-08,Ukraine,2356,56,1291025,24884
2021-02-09,Ukraine,2867,138,1293892,25022
2021-02-10,Ukraine,3645,173,1297537,25195
2021-02-11,Ukraine,5274,135,1302811,25330
2021-02-12,Ukraine,4995,127,1307806,25457
2021-02-13,Ukraine,5403,121,1313209,25578
2021-02-14,Ukraine,3311,53,1316520,25631
2021-02-15,Ukraine,2540,71,1319060,25702
2021-02-16,Ukraine,3346,160,1322406,25862
2021-02-17,Ukraine,4485,155,1326891,26017
2021-02-18,Ukraine,6441,174,1333332,26191
2021-02-19,Ukraine,6722,129,1340054,26320
2021-02-20,Ukraine,6473,84,1346527,26404
2021-02-21,Ukraine,4663,66,1351190,26470
2021-02-22,Ukraine,3355,61,1354545,26531
2021-02-23,Ukraine,4326,159,1358871,26690
2021-02-24,Ukraine,5990,157,1364861,26847
2021-02-25,Ukraine,8278,144,1373139,26991
2021-02-26,Ukraine,8134,155,1381273,27146
2021-02-27,Ukraine,8297,160,1389570,27306
2021-02-28,Ukraine,5958,98,1395528,27404
2021-03-01,Ukraine,4406,76,1399934,27480
2021-03-02,Ukraine,5460,170,1405394,27650
2021-03-03,Ukraine,7354,194,1412748,27844
2021-03-04,Ukraine,10179,202,1422927,28046
2021-03-05,Ukraine,10273,181,1433200,28227
2021-03-06,Ukraine,9257,165,1442457,28392
2021-03-07,Ukraine,7284,110,1449741,28502
2021-03-08,Ukraine,5680,114,1455421,28616
2021-03-09,Ukraine,3364,82,1458785,28698
2021-03-10,Ukraine,6480,227,1465265,28925
2021-03-11,Ukraine,9187,270,1474452,29195
2021-03-12,Ukraine,13045,239,1487497,29434
2021-03-13,Ukraine,13376,250,1500873,29684
2021-03-14,Ukraine,9110,151,1509983,29835
2021-03-15,Ukraine,6882,134,1516865,29969
2021-03-16,Ukraine,9730,270,1526595,30239
2021-03-17,Ukraine,11921,296,1538516,30535
2021-03-18,Ukraine,15143,276,1553659,30811
2021-03-19,Ukraine,15937,267,1569596,31078
2021-03-20,Ukraine,15376,266,1584972,31344
2021-03-21,Ukraine,11229,170,1596201,31514
2021-03-22,Ukraine,7982,163,1604183,31677
2021-03-23,Ukraine,11564,341,1615747,32018
2021-03-24,Ukraine,14266,350,1630013,32368
2021-03-25,Ukraine,16762,369,1646775,32737
2021-03-26,Ukraine,18226,331,1665001,33068
2021-03-27,Ukraine,17526,295,1682527,33363
2021-03-28,Ukraine,12041,208,1694568,33571
2021-03-29,Ukraine,8468,181,1703036,33752
2021-03-30,Ukraine,10648,291,1713684,34043
2021-03-31,Ukraine,11345,413,1725029,34456
2021-04-01,Ukraine,17681,429,1742710,34885
2021-04-02,Ukraine,20003,441,1762713,35326
2021-04-03,Ukraine,20456,403,1783169,35729
2021-04-04,Ukraine,13858,265,1797027,35994
2021-04-05,Ukraine,10300,261,1807327,36255
2021-04-06,Ukraine,13398,437,1820725,36692
2021-04-07,Ukraine,15535,486,1836260,37178
2021-04-08,Ukraine,19546,471,1855806,37649
2020-01-29,United Arab Emirates,4,0,4,0
2020-01-30,United Arab Emirates,0,0,4,0
2020-01-31,United Arab Emirates,0,0,4,0
2020-02-01,United Arab Emirates,0,0,4,0
2020-02-02,United Arab Emirates,1,0,5,0
2020-02-03,United Arab Emirates,0,0,5,0
2020-02-04,United Arab Emirates,0,0,5,0
2020-02-05,United Arab Emirates,0,0,5,0
2020-02-06,United Arab Emirates,0,0,5,0
2020-02-07,United Arab Emirates,0,0,5,0
2020-02-08,United Arab Emirates,2,0,7,0
2020-02-09,United Arab Emirates,0,0,7,0
2020-02-10,United Arab Emirates,1,0,8,0
2020-02-11,United Arab Emirates,0,0,8,0
2020-02-12,United Arab Emirates,0,0,8,0
2020-02-13,United Arab Emirates,0,0,8,0
2020-02-14,United Arab Emirates,0,0,8,0
2020-02-15,United Arab Emirates,0,0,8,0
2020-02-16,United Arab Emirates,1,0,9,0
2020-02-17,United Arab Emirates,0,0,9,0
2020-02-18,United Arab Emirates,0,0,9,0
2020-02-19,United Arab Emirates,0,0,9,0
2020-02-20,United Arab Emirates,0,0,9,0
2020-02-21,United Arab Emirates,0,0,9,0
2020-02-22,United Arab Emirates,4,0,13,0
2020-02-23,United Arab Emirates,0,0,13,0
2020-02-24,United Arab Emirates,0,0,13,0
2020-02-25,United Arab Emirates,0,0,13,0
2020-02-26,United Arab Emirates,0,0,13,0
2020-02-27,United Arab Emirates,0,0,13,0
2020-02-28,United Arab Emirates,6,0,19,0
2020-02-29,United Arab Emirates,2,0,21,0
2020-03-01,United Arab Emirates,0,0,21,0
2020-03-02,United Arab Emirates,0,0,21,0
2020-03-03,United Arab Emirates,6,0,27,0
2020-03-04,United Arab Emirates,0,0,27,0
2020-03-05,United Arab Emirates,2,0,29,0
2020-03-06,United Arab Emirates,0,0,29,0
2020-03-07,United Arab Emirates,16,0,45,0
2020-03-08,United Arab Emirates,0,0,45,0
2020-03-09,United Arab Emirates,0,0,45,0
2020-03-10,United Arab Emirates,29,0,74,0
2020-03-11,United Arab Emirates,0,0,74,0
2020-03-12,United Arab Emirates,11,0,85,0
2020-03-13,United Arab Emirates,0,0,85,0
2020-03-14,United Arab Emirates,0,0,85,0
2020-03-15,United Arab Emirates,13,0,98,0
2020-03-16,United Arab Emirates,0,0,98,0
2020-03-17,United Arab Emirates,0,0,98,0
2020-03-18,United Arab Emirates,15,0,113,0
2020-03-19,United Arab Emirates,27,0,140,0
2020-03-20,United Arab Emirates,0,2,140,2
2020-03-21,United Arab Emirates,13,0,153,2
2020-03-22,United Arab Emirates,0,0,153,2
2020-03-23,United Arab Emirates,45,0,198,2
2020-03-24,United Arab Emirates,50,0,248,2
2020-03-25,United Arab Emirates,85,0,333,2
2020-03-26,United Arab Emirates,0,0,333,2
2020-03-27,United Arab Emirates,72,0,405,2
2020-03-28,United Arab Emirates,63,0,468,2
2020-03-29,United Arab Emirates,102,1,570,3
2020-03-30,United Arab Emirates,41,2,611,5
2020-03-31,United Arab Emirates,53,1,664,6
2020-04-01,United Arab Emirates,150,2,814,8
2020-04-02,United Arab Emirates,210,0,1024,8
2020-04-03,United Arab Emirates,240,1,1264,9
2020-04-04,United Arab Emirates,241,1,1505,10
2020-04-05,United Arab Emirates,294,0,1799,10
2020-04-06,United Arab Emirates,277,1,2076,11
2020-04-07,United Arab Emirates,283,1,2359,12
2020-04-08,United Arab Emirates,300,0,2659,12
2020-04-09,United Arab Emirates,331,2,2990,14
2020-04-10,United Arab Emirates,370,2,3360,16
2020-04-11,United Arab Emirates,376,4,3736,20
2020-04-12,United Arab Emirates,387,2,4123,22
2020-04-13,United Arab Emirates,398,3,4521,25
2020-04-14,United Arab Emirates,412,3,4933,28
2020-04-15,United Arab Emirates,432,5,5365,33
2020-04-16,United Arab Emirates,460,2,5825,35
2020-04-17,United Arab Emirates,477,2,6302,37
2020-04-18,United Arab Emirates,0,0,6302,37
2020-04-19,United Arab Emirates,479,4,6781,41
2020-04-20,United Arab Emirates,484,2,7265,43
2020-04-21,United Arab Emirates,490,3,7755,46
2020-04-22,United Arab Emirates,483,6,8238,52
2020-04-23,United Arab Emirates,518,4,8756,56
2020-04-24,United Arab Emirates,525,8,9281,64
2020-04-25,United Arab Emirates,532,7,9813,71
2020-04-26,United Arab Emirates,536,5,10349,76
2020-04-27,United Arab Emirates,490,6,10839,82
2020-04-28,United Arab Emirates,541,7,11380,89
2020-04-29,United Arab Emirates,549,9,11929,98
2020-04-30,United Arab Emirates,552,7,12481,105
2020-05-01,United Arab Emirates,557,6,13038,111
2020-05-02,United Arab Emirates,561,8,13599,119
2020-05-03,United Arab Emirates,564,7,14163,126
2020-05-04,United Arab Emirates,567,11,14730,137
2020-05-05,United Arab Emirates,462,9,15192,146
2020-05-06,United Arab Emirates,546,11,15738,157
2020-05-07,United Arab Emirates,502,8,16240,165
2020-05-08,United Arab Emirates,553,9,16793,174
2020-05-09,United Arab Emirates,624,11,17417,185
2020-05-10,United Arab Emirates,781,13,18198,198
2020-05-11,United Arab Emirates,680,3,18878,201
2020-05-12,United Arab Emirates,783,2,19661,203
2020-05-13,United Arab Emirates,725,3,20386,206
2020-05-14,United Arab Emirates,698,2,21084,208
2020-05-15,United Arab Emirates,747,2,21831,210
2020-05-16,United Arab Emirates,796,4,22627,214
2020-05-17,United Arab Emirates,731,6,23358,220
2020-05-18,United Arab Emirates,832,4,24190,224
2020-05-19,United Arab Emirates,873,3,25063,227
2020-05-20,United Arab Emirates,941,6,26004,233
2020-05-21,United Arab Emirates,894,4,26898,237
2020-05-22,United Arab Emirates,994,4,27892,241
2020-05-23,United Arab Emirates,812,3,28704,244
2020-05-24,United Arab Emirates,781,1,29485,245
2020-05-25,United Arab Emirates,822,3,30307,248
2020-05-26,United Arab Emirates,779,5,31086,253
2020-05-27,United Arab Emirates,883,2,31969,255
2020-05-28,United Arab Emirates,563,3,32532,258
2020-05-29,United Arab Emirates,638,2,33170,260
2020-05-30,United Arab Emirates,726,2,33896,262
2020-05-31,United Arab Emirates,661,2,34557,264
2020-06-01,United Arab Emirates,635,2,35192,266
2020-06-02,United Arab Emirates,596,3,35788,269
2020-06-03,United Arab Emirates,571,1,36359,270
2020-06-04,United Arab Emirates,659,3,37018,273
2020-06-05,United Arab Emirates,624,1,37642,274
2020-06-06,United Arab Emirates,626,1,38268,275
2020-06-07,United Arab Emirates,540,1,38808,276
2020-06-08,United Arab Emirates,568,5,39376,281
2020-06-09,United Arab Emirates,528,2,39904,283
2020-06-10,United Arab Emirates,603,1,40507,284
2020-06-11,United Arab Emirates,479,2,40986,286
2020-06-12,United Arab Emirates,513,1,41499,287
2020-06-13,United Arab Emirates,491,1,41990,288
2020-06-14,United Arab Emirates,304,1,42294,289
2020-06-15,United Arab Emirates,342,2,42636,291
2020-06-16,United Arab Emirates,346,2,42982,293
2020-06-17,United Arab Emirates,382,2,43364,295
2020-06-18,United Arab Emirates,388,3,43752,298
2020-06-19,United Arab Emirates,393,2,44145,300
2020-06-20,United Arab Emirates,388,1,44533,301
2020-06-21,United Arab Emirates,392,1,44925,302
2020-06-22,United Arab Emirates,378,1,45303,303
2020-06-23,United Arab Emirates,380,2,45683,305
2020-06-24,United Arab Emirates,450,2,46133,307
2020-06-25,United Arab Emirates,430,1,46563,308
2020-06-26,United Arab Emirates,410,2,46973,310
2020-06-27,United Arab Emirates,387,1,47360,311
2020-06-28,United Arab Emirates,437,2,47797,313
2020-06-29,United Arab Emirates,449,1,48246,314
2020-06-30,United Arab Emirates,421,1,48667,315
2020-07-01,United Arab Emirates,402,1,49069,316
2020-07-02,United Arab Emirates,400,1,49469,317
2020-07-03,United Arab Emirates,672,1,50141,318
2020-07-04,United Arab Emirates,716,3,50857,321
2020-07-05,United Arab Emirates,683,2,51540,323
2020-07-06,United Arab Emirates,528,1,52068,324
2020-07-07,United Arab Emirates,532,2,52600,326
2020-07-08,United Arab Emirates,445,1,53045,327
2020-07-09,United Arab Emirates,532,1,53577,328
2020-07-10,United Arab Emirates,473,2,54050,330
2020-07-11,United Arab Emirates,403,1,54453,331
2020-07-12,United Arab Emirates,401,2,54854,333
2020-07-13,United Arab Emirates,344,1,55198,334
2020-07-14,United Arab Emirates,375,1,55573,335
2020-07-15,United Arab Emirates,275,0,55848,335
2020-07-16,United Arab Emirates,281,0,56129,335
2020-07-17,United Arab Emirates,293,2,56422,337
2020-07-18,United Arab Emirates,289,1,56711,338
2020-07-19,United Arab Emirates,211,1,56922,339
2020-07-20,United Arab Emirates,271,1,57193,340
2020-07-21,United Arab Emirates,305,1,57498,341
2020-07-22,United Arab Emirates,236,1,57734,342
2020-07-23,United Arab Emirates,254,0,57988,342
2020-07-24,United Arab Emirates,261,1,58249,343
2020-07-25,United Arab Emirates,313,0,58562,343
2020-07-26,United Arab Emirates,351,1,58913,344
2020-07-27,United Arab Emirates,264,1,59177,345
2020-07-28,United Arab Emirates,369,2,59546,347
2020-07-29,United Arab Emirates,375,0,59921,347
2020-07-30,United Arab Emirates,302,2,60223,349
2020-07-31,United Arab Emirates,283,2,60506,351
2020-08-01,United Arab Emirates,254,0,60760,351
2020-08-02,United Arab Emirates,239,0,60999,351
2020-08-03,United Arab Emirates,164,0,61163,351
2020-08-04,United Arab Emirates,189,0,61352,351
2020-08-05,United Arab Emirates,254,2,61606,353
2020-08-06,United Arab Emirates,239,1,61845,354
2020-08-07,United Arab Emirates,216,2,62061,356
2020-08-08,United Arab Emirates,239,0,62300,356
2020-08-09,United Arab Emirates,225,1,62525,357
2020-08-10,United Arab Emirates,179,0,62704,357
2020-08-11,United Arab Emirates,262,1,62966,358
2020-08-12,United Arab Emirates,246,0,63212,358
2020-08-13,United Arab Emirates,277,0,63489,358
2020-08-14,United Arab Emirates,330,1,63819,359
2020-08-15,United Arab Emirates,283,2,64102,361
2020-08-16,United Arab Emirates,210,3,64312,364
2020-08-17,United Arab Emirates,229,0,64541,364
2020-08-18,United Arab Emirates,365,2,64906,366
2020-08-19,United Arab Emirates,435,1,65341,367
2020-08-20,United Arab Emirates,461,2,65802,369
2020-08-21,United Arab Emirates,391,1,66193,370
2020-08-22,United Arab Emirates,424,2,66617,372
2020-08-23,United Arab Emirates,390,3,67007,375
2020-08-24,United Arab Emirates,275,1,67282,376
2020-08-25,United Arab Emirates,339,1,67621,377
2020-08-26,United Arab Emirates,399,1,68020,378
2020-08-27,United Arab Emirates,491,0,68511,378
2020-08-28,United Arab Emirates,390,1,68901,379
2020-08-29,United Arab Emirates,427,0,69328,379
2020-08-30,United Arab Emirates,362,3,69690,382
2020-08-31,United Arab Emirates,541,2,70231,384
2020-09-01,United Arab Emirates,574,0,70805,384
2020-09-02,United Arab Emirates,735,3,71540,387
2020-09-03,United Arab Emirates,614,0,72154,387
2020-09-04,United Arab Emirates,612,0,72766,387
2020-09-05,United Arab Emirates,705,1,73471,388
2020-09-06,United Arab Emirates,513,0,73984,388
2020-09-07,United Arab Emirates,470,2,74454,390
2020-09-08,United Arab Emirates,644,1,75098,391
2020-09-09,United Arab Emirates,883,2,75981,393
2020-09-10,United Arab Emirates,930,5,76911,398
2020-09-11,United Arab Emirates,931,0,77842,398
2020-09-12,United Arab Emirates,1007,1,78849,399
2020-09-13,United Arab Emirates,640,0,79489,399
2020-09-14,United Arab Emirates,777,0,80266,399
2020-09-15,United Arab Emirates,674,2,80940,401
2020-09-16,United Arab Emirates,842,1,81782,402
2020-09-17,United Arab Emirates,786,0,82568,402
2020-09-18,United Arab Emirates,865,1,83433,403
2020-09-19,United Arab Emirates,809,1,84242,404
2020-09-20,United Arab Emirates,674,0,84916,404
2020-09-21,United Arab Emirates,679,1,85595,405
2020-09-22,United Arab Emirates,852,0,86447,405
2020-09-23,United Arab Emirates,1083,1,87530,406
2020-09-24,United Arab Emirates,1002,1,88532,407
2020-09-25,United Arab Emirates,1008,2,89540,409
2020-09-26,United Arab Emirates,1078,2,90618,411
2020-09-27,United Arab Emirates,851,1,91469,412
2020-09-28,United Arab Emirates,626,1,92095,413
2020-09-29,United Arab Emirates,995,3,93090,416
2020-09-30,United Arab Emirates,1100,3,94190,419
2020-10-01,United Arab Emirates,1158,2,95348,421
2020-10-02,United Arab Emirates,1181,3,96529,424
2020-10-03,United Arab Emirates,1231,2,97760,426
2020-10-04,United Arab Emirates,1041,0,98801,426
2020-10-05,United Arab Emirates,932,3,99733,429
2020-10-06,United Arab Emirates,1061,6,100794,435
2020-10-07,United Arab Emirates,1046,1,101840,436
2020-10-08,United Arab Emirates,1089,2,102929,438
2020-10-09,United Arab Emirates,1075,4,104004,442
2020-10-10,United Arab Emirates,1129,1,105133,443
2020-10-11,United Arab Emirates,1096,2,106229,445
2020-10-12,United Arab Emirates,1064,1,107293,446
2020-10-13,United Arab Emirates,1315,2,108608,448
2020-10-14,United Arab Emirates,1431,2,110039,450
2020-10-15,United Arab Emirates,1398,2,111437,452
2020-10-16,United Arab Emirates,1412,3,112849,455
2020-10-17,United Arab Emirates,1538,4,114387,459
2020-10-18,United Arab Emirates,1215,4,115602,463
2020-10-19,United Arab Emirates,915,3,116517,466
2020-10-20,United Arab Emirates,1077,4,117594,470
2020-10-21,United Arab Emirates,1538,2,119132,472
2020-10-22,United Arab Emirates,1578,2,120710,474
2020-10-23,United Arab Emirates,1563,1,122273,475
2020-10-24,United Arab Emirates,1491,0,123764,475
2020-10-25,United Arab Emirates,1359,2,125123,477
2020-10-26,United Arab Emirates,1111,3,126234,480
2020-10-27,United Arab Emirates,1390,2,127624,482
2020-10-28,United Arab Emirates,1400,3,129024,485
2020-10-29,United Arab Emirates,1312,3,130336,488
2020-10-30,United Arab Emirates,1172,2,131508,490
2020-10-31,United Arab Emirates,1121,5,132629,495
2020-11-01,United Arab Emirates,1278,1,133907,496
2020-11-02,United Arab Emirates,1234,1,135141,497
2020-11-03,United Arab Emirates,1008,6,136149,503
2020-11-04,United Arab Emirates,1161,2,137310,505
2020-11-05,United Arab Emirates,1289,3,138599,508
2020-11-06,United Arab Emirates,1292,2,139891,510
2020-11-07,United Arab Emirates,1141,4,141032,514
2020-11-08,United Arab Emirates,1111,0,142143,514
2020-11-09,United Arab Emirates,1146,1,143289,515
2020-11-10,United Arab Emirates,1096,3,144385,518
2020-11-11,United Arab Emirates,1214,2,145599,520
2020-11-12,United Arab Emirates,1136,3,146735,523
2020-11-13,United Arab Emirates,1226,5,147961,528
2020-11-14,United Arab Emirates,1174,0,149135,528
2020-11-15,United Arab Emirates,1210,2,150345,530
2020-11-16,United Arab Emirates,1209,4,151554,534
2020-11-17,United Arab Emirates,1255,4,152809,538
2020-11-18,United Arab Emirates,1292,4,154101,542
2020-11-19,United Arab Emirates,1153,2,155254,544
2020-11-20,United Arab Emirates,1269,3,156523,547
2020-11-21,United Arab Emirates,1262,1,157785,548
2020-11-22,United Arab Emirates,1205,4,158990,552
2020-11-23,United Arab Emirates,1065,2,160055,554
2020-11-24,United Arab Emirates,1310,5,161365,559
2020-11-25,United Arab Emirates,1297,4,162662,563
2020-11-26,United Arab Emirates,1305,1,163967,564
2020-11-27,United Arab Emirates,1283,3,165250,567
2020-11-28,United Arab Emirates,1252,2,166502,569
2020-11-29,United Arab Emirates,1251,1,167753,570
2020-11-30,United Arab Emirates,1107,2,168860,572
2020-12-01,United Arab Emirates,1289,4,170149,576
2020-12-02,United Arab Emirates,1285,4,171434,580
2020-12-03,United Arab Emirates,1317,5,172751,585
2020-12-04,United Arab Emirates,1311,1,174062,586
2020-12-05,United Arab Emirates,1214,3,175276,589
2020-12-06,United Arab Emirates,1153,3,176429,592
2020-12-07,United Arab Emirates,1148,2,177577,594
2020-12-08,United Arab Emirates,1260,2,178837,596
2020-12-09,United Arab Emirates,1313,2,180150,598
2020-12-10,United Arab Emirates,1255,4,181405,602
2020-12-11,United Arab Emirates,1196,5,182601,607
2020-12-12,United Arab Emirates,1154,2,183755,609
2020-12-13,United Arab Emirates,1194,8,184949,617
2020-12-14,United Arab Emirates,1092,1,186041,618
2020-12-15,United Arab Emirates,1226,4,187267,622
2020-12-16,United Arab Emirates,1278,4,188545,626
2020-12-17,United Arab Emirates,1321,3,189866,629
2020-12-18,United Arab Emirates,1284,1,191150,630
2020-12-19,United Arab Emirates,1254,4,192404,634
2020-12-20,United Arab Emirates,1171,3,193575,637
2020-12-21,United Arab Emirates,1077,2,194652,639
2020-12-22,United Arab Emirates,1226,3,195878,642
2020-12-23,United Arab Emirates,1246,3,197124,645
2020-12-24,United Arab Emirates,1311,2,198435,647
2020-12-25,United Arab Emirates,1230,6,199665,653
2020-12-26,United Arab Emirates,1227,2,200892,655
2020-12-27,United Arab Emirates,944,2,201836,657
2020-12-28,United Arab Emirates,1027,3,202863,660
2020-12-29,United Arab Emirates,1506,2,204369,662
2020-12-30,United Arab Emirates,1723,3,206092,665
2020-12-31,United Arab Emirates,1730,4,207822,669
2021-01-01,United Arab Emirates,1856,2,209678,671
2021-01-02,United Arab Emirates,1963,3,211641,674
2021-01-03,United Arab Emirates,1590,5,213231,679
2021-01-04,United Arab Emirates,1501,3,214732,682
2021-01-05,United Arab Emirates,1967,3,216699,685
2021-01-06,United Arab Emirates,2067,4,218766,689
2021-01-07,United Arab Emirates,2988,5,221754,694
2021-01-08,United Arab Emirates,2950,3,224704,697
2021-01-09,United Arab Emirates,2998,5,227702,702
2021-01-10,United Arab Emirates,2876,6,230578,708
2021-01-11,United Arab Emirates,2404,3,232982,711
2021-01-12,United Arab Emirates,3243,6,236225,717
2021-01-13,United Arab Emirates,3362,6,239587,723
2021-01-14,United Arab Emirates,3382,3,242969,726
2021-01-15,United Arab Emirates,3407,7,246376,733
2021-01-16,United Arab Emirates,3432,7,249808,740
2021-01-17,United Arab Emirates,3453,5,253261,745
2021-01-18,United Arab Emirates,3471,6,256732,751
2021-01-19,United Arab Emirates,3491,5,260223,756
2021-01-20,United Arab Emirates,3506,6,263729,762
2021-01-21,United Arab Emirates,3529,4,267258,766
2021-01-22,United Arab Emirates,3552,10,270810,776
2021-01-23,United Arab Emirates,3566,7,274376,783
2021-01-24,United Arab Emirates,3579,9,277955,792
2021-01-25,United Arab Emirates,3591,6,281546,798
2021-01-26,United Arab Emirates,3601,7,285147,805
2021-01-27,United Arab Emirates,3939,6,289086,811
2021-01-28,United Arab Emirates,3966,8,293052,819
2021-01-29,United Arab Emirates,3962,7,297014,826
2021-01-30,United Arab Emirates,3647,12,300661,838
2021-01-31,United Arab Emirates,2948,12,303609,850
2021-02-01,United Arab Emirates,2730,9,306339,859
2021-02-02,United Arab Emirates,3310,7,309649,866
2021-02-03,United Arab Emirates,3977,12,313626,878
2021-02-04,United Arab Emirates,3249,10,316875,888
2021-02-05,United Arab Emirates,3251,14,320126,902
2021-02-06,United Arab Emirates,3276,12,323402,914
2021-02-07,United Arab Emirates,3093,7,326495,921
2021-02-08,United Arab Emirates,2798,9,329293,930
2021-02-09,United Arab Emirates,3310,17,332603,947
2021-02-10,United Arab Emirates,3539,9,336142,956
2021-02-11,United Arab Emirates,3525,18,339667,974
2021-02-12,United Arab Emirates,3307,12,342974,986
2021-02-13,United Arab Emirates,2631,15,345605,1001
2021-02-14,United Arab Emirates,3167,13,348772,1014
2021-02-15,United Arab Emirates,3123,13,351895,1027
2021-02-16,United Arab Emirates,3236,14,355131,1041
2021-02-17,United Arab Emirates,3452,14,358583,1055
2021-02-18,United Arab Emirates,3294,18,361877,1073
2021-02-19,United Arab Emirates,3140,20,365017,1093
2021-02-20,United Arab Emirates,3158,15,368175,1108
2021-02-21,United Arab Emirates,2250,17,370425,1125
2021-02-22,United Arab Emirates,2105,15,372530,1140
2021-02-23,United Arab Emirates,3005,5,375535,1145
2021-02-24,United Arab Emirates,3102,19,378637,1164
2021-02-25,United Arab Emirates,3025,18,381662,1182
2021-02-26,United Arab Emirates,3498,16,385160,1198
2021-02-27,United Arab Emirates,3434,15,388594,1213
2021-02-28,United Arab Emirates,2930,8,391524,1221
2021-03-01,United Arab Emirates,2526,17,394050,1238
2021-03-02,United Arab Emirates,2721,15,396771,1253
2021-03-03,United Arab Emirates,2692,16,399463,1269
2021-03-04,United Arab Emirates,2742,17,402205,1286
2021-03-05,United Arab Emirates,3072,10,405277,1296
2021-03-06,United Arab Emirates,2959,14,408236,1310
2021-03-07,United Arab Emirates,2613,12,410849,1322
2021-03-08,United Arab Emirates,2483,13,413332,1335
2021-03-09,United Arab Emirates,2373,10,415705,1345
2021-03-10,United Arab Emirates,2204,8,417909,1353
2021-03-11,United Arab Emirates,2087,16,419996,1369
2021-03-12,United Arab Emirates,2250,9,422246,1378
2021-03-13,United Arab Emirates,2159,10,424405,1388
2021-03-14,United Arab Emirates,1992,7,426397,1395
2021-03-15,United Arab Emirates,1898,7,428295,1402
2021-03-16,United Arab Emirates,2018,4,430313,1406
2021-03-17,United Arab Emirates,2051,8,432364,1414
2021-03-18,United Arab Emirates,2101,10,434465,1424
2021-03-19,United Arab Emirates,2160,4,436625,1428
2021-03-20,United Arab Emirates,2013,5,438638,1433
2021-03-21,United Arab Emirates,1717,5,440355,1438
2021-03-22,United Arab Emirates,1871,7,442226,1445
2021-03-23,United Arab Emirates,2172,6,444398,1451
2021-03-24,United Arab Emirates,2196,5,446594,1456
2021-03-25,United Arab Emirates,2043,10,448637,1466
2021-03-26,United Arab Emirates,2128,6,450765,1472
2021-03-27,United Arab Emirates,2304,5,453069,1477
2021-03-28,United Arab Emirates,2128,4,455197,1481
2021-03-29,United Arab Emirates,1874,5,457071,1486
2021-03-30,United Arab Emirates,2289,6,459360,1492
2021-03-31,United Arab Emirates,2084,5,461444,1497
2021-04-01,United Arab Emirates,2315,2,463759,1499
2021-04-02,United Arab Emirates,2180,3,465939,1502
2021-04-03,United Arab Emirates,2084,2,468023,1504
2021-04-04,United Arab Emirates,2113,6,470136,1510
2021-04-05,United Arab Emirates,2012,2,472148,1512
2021-04-06,United Arab Emirates,1988,4,474136,1516
2021-04-07,United Arab Emirates,1883,4,476019,1520
2021-04-08,United Arab Emirates,2112,3,478131,1523
2020-01-31,United Kingdom,2,0,2,0
2020-02-01,United Kingdom,0,0,2,0
2020-02-02,United Kingdom,0,0,2,0
2020-02-03,United Kingdom,6,0,8,0
2020-02-04,United Kingdom,0,0,8,0
2020-02-05,United Kingdom,1,0,9,0
2020-02-06,United Kingdom,0,0,9,0
2020-02-07,United Kingdom,0,0,9,0
2020-02-08,United Kingdom,4,0,13,0
2020-02-09,United Kingdom,1,0,14,0
2020-02-10,United Kingdom,0,0,14,0
2020-02-11,United Kingdom,1,0,15,0
2020-02-12,United Kingdom,1,0,16,0
2020-02-13,United Kingdom,1,0,17,0
2020-02-14,United Kingdom,1,0,18,0
2020-02-15,United Kingdom,0,0,18,0
2020-02-16,United Kingdom,0,0,18,0
2020-02-17,United Kingdom,1,0,19,0
2020-02-18,United Kingdom,0,0,19,0
2020-02-19,United Kingdom,1,0,20,0
2020-02-20,United Kingdom,2,0,22,0
2020-02-21,United Kingdom,1,0,23,0
2020-02-22,United Kingdom,0,0,23,0
2020-02-23,United Kingdom,5,0,28,0
2020-02-24,United Kingdom,2,0,30,0
2020-02-25,United Kingdom,4,0,34,0
2020-02-26,United Kingdom,3,0,37,0
2020-02-27,United Kingdom,7,0,44,0
2020-02-28,United Kingdom,12,0,56,0
2020-02-29,United Kingdom,5,0,61,0
2020-03-01,United Kingdom,33,0,94,0
2020-03-02,United Kingdom,40,0,134,0
2020-03-03,United Kingdom,55,0,189,0
2020-03-04,United Kingdom,57,0,246,0
2020-03-05,United Kingdom,49,0,295,0
2020-03-06,United Kingdom,79,1,374,1
2020-03-07,United Kingdom,55,1,429,2
2020-03-08,United Kingdom,54,0,483,2
2020-03-09,United Kingdom,147,1,630,3
2020-03-10,United Kingdom,259,4,889,7
2020-03-11,United Kingdom,412,0,1301,7
2020-03-12,United Kingdom,489,2,1790,9
2020-03-13,United Kingdom,480,1,2270,10
2020-03-14,United Kingdom,364,19,2634,29
2020-03-15,United Kingdom,443,14,3077,43
2020-03-16,United Kingdom,615,23,3692,66
2020-03-17,United Kingdom,770,17,4462,83
2020-03-18,United Kingdom,1006,35,5468,118
2020-03-19,United Kingdom,1066,46,6534,164
2020-03-20,United Kingdom,1258,32,7792,196
2020-03-21,United Kingdom,1215,58,9007,254
2020-03-22,United Kingdom,1388,35,10395,289
2020-03-23,United Kingdom,2349,76,12744,365
2020-03-24,United Kingdom,2382,148,15126,513
2020-03-25,United Kingdom,2717,191,17843,704
2020-03-26,United Kingdom,3127,182,20970,886
2020-03-27,United Kingdom,3249,288,24219,1174
2020-03-28,United Kingdom,2843,292,27062,1466
2020-03-29,United Kingdom,2892,213,29954,1679
2020-03-30,United Kingdom,4327,374,34281,2053
2020-03-31,United Kingdom,4534,404,38815,2457
2020-04-01,United Kingdom,4974,673,43789,3130
2020-04-02,United Kingdom,4929,657,48718,3787
2020-04-03,United Kingdom,4981,737,53699,4524
2020-04-04,United Kingdom,4073,757,57772,5281
2020-04-05,United Kingdom,3650,601,61422,5882
2020-04-06,United Kingdom,5316,570,66738,6452
2020-04-07,United Kingdom,5486,1105,72224,7557
2020-04-08,United Kingdom,5163,1032,77387,8589
2020-04-09,United Kingdom,4906,1117,82293,9706
2020-04-10,United Kingdom,4367,1123,86660,10829
2020-04-11,United Kingdom,3613,844,90273,11673
2020-04-12,United Kingdom,3539,657,93812,12330
2020-04-13,United Kingdom,4205,725,98017,13055
2020-04-14,United Kingdom,4348,1080,102365,14135
2020-04-15,United Kingdom,5100,884,107465,15019
2020-04-16,United Kingdom,5343,1040,112808,16059
2020-04-17,United Kingdom,4990,914,117798,16973
2020-04-18,United Kingdom,4736,1108,122534,18081
2020-04-19,United Kingdom,3860,433,126394,18514
2020-04-20,United Kingdom,4866,576,131260,19090
2020-04-21,United Kingdom,4775,1224,136035,20314
2020-04-22,United Kingdom,5505,857,141540,21171
2020-04-23,United Kingdom,5168,684,146708,21855
2020-04-24,United Kingdom,4981,1018,151689,22873
2020-04-25,United Kingdom,3764,816,155453,23689
2020-04-26,United Kingdom,3473,364,158926,24053
2020-04-27,United Kingdom,4704,323,163630,24376
2020-04-28,United Kingdom,4727,971,168357,25347
2020-04-29,United Kingdom,5450,771,173807,26118
2020-04-30,United Kingdom,4964,636,178771,26754
2020-05-01,United Kingdom,4730,700,183501,27454
2020-05-02,United Kingdom,3230,585,186731,28039
2020-05-03,United Kingdom,2977,253,189708,28292
2020-05-04,United Kingdom,3383,273,193091,28565
2020-05-05,United Kingdom,3689,725,196780,29290
2020-05-06,United Kingdom,3836,647,200616,29937
2020-05-07,United Kingdom,3771,458,204387,30395
2020-05-08,United Kingdom,3052,580,207439,30975
2020-05-09,United Kingdom,2150,275,209589,31250
2020-05-10,United Kingdom,2322,217,211911,31467
2020-05-11,United Kingdom,3589,188,215500,31655
2020-05-12,United Kingdom,3395,615,218895,32270
2020-05-13,United Kingdom,3300,448,222195,32718
2020-05-14,United Kingdom,2618,353,224813,33071
2020-05-15,United Kingdom,2521,351,227334,33422
2020-05-16,United Kingdom,2072,411,229406,33833
2020-05-17,United Kingdom,1826,67,231232,33900
2020-05-18,United Kingdom,2577,146,233809,34046
2020-05-19,United Kingdom,3058,501,236867,34547
2020-05-20,United Kingdom,2712,329,239579,34876
2020-05-21,United Kingdom,2554,273,242133,35149
2020-05-22,United Kingdom,2041,291,244174,35440
2020-05-23,United Kingdom,1508,220,245682,35660
2020-05-24,United Kingdom,1355,379,247037,36039
2020-05-25,United Kingdom,1613,104,248650,36143
2020-05-26,United Kingdom,1659,131,250309,36274
2020-05-27,United Kingdom,1809,422,252118,36696
2020-05-28,United Kingdom,1736,343,253854,37039
2020-05-29,United Kingdom,1508,274,255362,37313
2020-05-30,United Kingdom,1107,154,256469,37467
2020-05-31,United Kingdom,1070,60,257539,37527
2020-06-01,United Kingdom,1444,86,258983,37613
2020-06-02,United Kingdom,1470,250,260453,37863
2020-06-03,United Kingdom,1349,254,261802,38117
2020-06-04,United Kingdom,1238,130,263040,38247
2020-06-05,United Kingdom,1110,258,264150,38505
2020-06-06,United Kingdom,794,143,264944,38648
2020-06-07,United Kingdom,718,54,265662,38702
2020-06-08,United Kingdom,1094,47,266756,38749
2020-06-09,United Kingdom,1159,197,267915,38946
2020-06-10,United Kingdom,1186,164,269101,39110
2020-06-11,United Kingdom,1007,76,270108,39186
2020-06-12,United Kingdom,1054,131,271162,39317
2020-06-13,United Kingdom,888,107,272050,39424
2020-06-14,United Kingdom,807,27,272857,39451
2020-06-15,United Kingdom,1031,29,273888,39480
2020-06-16,United Kingdom,1083,120,274971,39600
2020-06-17,United Kingdom,999,110,275970,39710
2020-06-18,United Kingdom,1020,67,276990,39777
2020-06-19,United Kingdom,984,84,277974,39861
2020-06-20,United Kingdom,666,71,278640,39932
2020-06-21,United Kingdom,624,31,279264,39963
2020-06-22,United Kingdom,892,13,280156,39976
2020-06-23,United Kingdom,882,94,281038,40070
2020-06-24,United Kingdom,777,87,281815,40157
2020-06-25,United Kingdom,697,99,282512,40256
2020-06-26,United Kingdom,639,77,283151,40333
2020-06-27,United Kingdom,634,40,283785,40373
2020-06-28,United Kingdom,407,31,284192,40404
2020-06-29,United Kingdom,620,21,284812,40425
2020-06-30,United Kingdom,404,54,285216,40479
2020-07-01,United Kingdom,63,97,285279,40576
2020-07-02,United Kingdom,6,41,285285,40617
2020-07-03,United Kingdom,502,49,285787,40666
2020-07-04,United Kingdom,625,32,286412,40698
2020-07-05,United Kingdom,519,19,286931,40717
2020-07-06,United Kingdom,359,11,287290,40728
2020-07-07,United Kingdom,584,54,287874,40782
2020-07-08,United Kingdom,637,57,288511,40839
2020-07-09,United Kingdom,643,31,289154,40870
2020-07-10,United Kingdom,524,34,289678,40904
2020-07-11,United Kingdom,826,17,290504,40921
2020-07-12,United Kingdom,650,9,291154,40930
2020-07-13,United Kingdom,537,10,291691,40940
2020-07-14,United Kingdom,1240,44,292931,40984
2020-07-15,United Kingdom,538,26,293469,41010
2020-07-16,United Kingdom,647,24,294116,41034
2020-07-17,United Kingdom,687,26,294803,41060
2020-07-18,United Kingdom,829,9,295632,41069
2020-07-19,United Kingdom,726,11,296358,41080
2020-07-20,United Kingdom,586,10,296944,41090
2020-07-21,United Kingdom,445,25,297389,41115
2020-07-22,United Kingdom,563,17,297952,41132
2020-07-23,United Kingdom,779,9,298731,41141
2020-07-24,United Kingdom,769,32,299500,41173
2020-07-25,United Kingdom,770,15,300270,41188
2020-07-26,United Kingdom,750,8,301020,41196
2020-07-27,United Kingdom,688,3,301708,41199
2020-07-28,United Kingdom,553,21,302261,41220
2020-07-29,United Kingdom,802,34,303063,41254
2020-07-30,United Kingdom,847,0,303910,41254
2020-07-31,United Kingdom,883,20,304793,41274
2020-08-01,United Kingdom,769,13,305562,41287
2020-08-02,United Kingdom,747,5,306309,41292
2020-08-03,United Kingdom,942,1,307251,41293
2020-08-04,United Kingdom,675,18,307926,41311
2020-08-05,United Kingdom,906,14,308832,41325
2020-08-06,United Kingdom,964,18,309796,41343
2020-08-07,United Kingdom,900,12,310696,41355
2020-08-08,United Kingdom,765,3,311461,41358
2020-08-09,United Kingdom,1113,5,312574,41363
2020-08-10,United Kingdom,818,18,313392,41381
2020-08-11,United Kingdom,1150,13,314542,41394
2020-08-12,United Kingdom,1039,20,315581,41414
2020-08-13,United Kingdom,1148,18,316729,41432
2020-08-14,United Kingdom,1461,11,318190,41443
2020-08-15,United Kingdom,1042,3,319232,41446
2020-08-16,United Kingdom,1111,5,320343,41451
2020-08-17,United Kingdom,721,3,321064,41454
2020-08-18,United Kingdom,1113,12,322177,41466
2020-08-19,United Kingdom,831,17,323008,41483
2020-08-20,United Kingdom,1195,6,324203,41489
2020-08-21,United Kingdom,1060,2,325263,41491
2020-08-22,United Kingdom,1332,18,326595,41509
2020-08-23,United Kingdom,1048,6,327643,41515
2020-08-24,United Kingdom,977,4,328620,41519
2020-08-25,United Kingdom,1201,16,329821,41535
2020-08-26,United Kingdom,1146,17,330967,41552
2020-08-27,United Kingdom,1542,12,332509,41564
2020-08-28,United Kingdom,1297,9,333806,41573
2020-08-29,United Kingdom,1110,12,334916,41585
2020-08-30,United Kingdom,1752,1,336668,41586
2020-08-31,United Kingdom,1415,3,338083,41589
2020-09-01,United Kingdom,1332,3,339415,41592
2020-09-02,United Kingdom,1514,10,340929,41602
2020-09-03,United Kingdom,1779,14,342708,41616
2020-09-04,United Kingdom,1978,10,344686,41626
2020-09-05,United Kingdom,1827,12,346513,41638
2020-09-06,United Kingdom,2987,2,349500,41640
2020-09-07,United Kingdom,2953,3,352453,41643
2020-09-08,United Kingdom,2481,32,354934,41675
2020-09-09,United Kingdom,2681,8,357615,41683
2020-09-10,United Kingdom,2931,14,360546,41697
2020-09-11,United Kingdom,3544,6,364090,41703
2020-09-12,United Kingdom,3504,9,367594,41712
2020-09-13,United Kingdom,3338,5,370932,41717
2020-09-14,United Kingdom,2625,9,373557,41726
2020-09-15,United Kingdom,3115,27,376672,41753
2020-09-16,United Kingdom,4007,20,380679,41773
2020-09-17,United Kingdom,3410,21,384089,41794
2020-09-18,United Kingdom,4329,27,388418,41821
2020-09-19,United Kingdom,4429,27,392847,41848
2020-09-20,United Kingdom,3899,18,396746,41866
2020-09-21,United Kingdom,4378,11,401124,41877
2020-09-22,United Kingdom,4936,37,406060,41914
2020-09-23,United Kingdom,6187,37,412247,41951
2020-09-24,United Kingdom,6644,40,418891,41991
2020-09-25,United Kingdom,6878,34,425769,42025
2020-09-26,United Kingdom,6050,35,431819,42060
2020-09-27,United Kingdom,5700,17,437519,42077
2020-09-28,United Kingdom,4056,13,441575,42090
2020-09-29,United Kingdom,7156,72,448731,42162
2020-09-30,United Kingdom,7117,71,455848,42233
2020-10-01,United Kingdom,6929,59,462777,42292
2020-10-02,United Kingdom,6994,66,469771,42358
2020-10-03,United Kingdom,12885,49,482656,42407
2020-10-04,United Kingdom,22965,33,505621,42440
2020-10-05,United Kingdom,12603,19,518224,42459
2020-10-06,United Kingdom,14557,76,532781,42535
2020-10-07,United Kingdom,14173,70,546954,42605
2020-10-08,United Kingdom,17550,77,564504,42682
2020-10-09,United Kingdom,13888,87,578392,42769
2020-10-10,United Kingdom,15175,81,593567,42850
2020-10-11,United Kingdom,12882,65,606449,42915
2020-10-12,United Kingdom,14011,50,620460,42965
2020-10-13,United Kingdom,17250,143,637710,43108
2020-10-14,United Kingdom,19751,137,657461,43245
2020-10-15,United Kingdom,18996,138,676457,43383
2020-10-16,United Kingdom,15657,136,692114,43519
2020-10-17,United Kingdom,16186,150,708300,43669
2020-10-18,United Kingdom,16994,67,725294,43736
2020-10-19,United Kingdom,18830,80,744124,43816
2020-10-20,United Kingdom,21365,241,765489,44057
2020-10-21,United Kingdom,26707,191,792196,44248
2020-10-22,United Kingdom,21257,189,813453,44437
2020-10-23,United Kingdom,20559,224,834012,44661
2020-10-24,United Kingdom,23033,174,857045,44835
2020-10-25,United Kingdom,19797,151,876842,44986
2020-10-26,United Kingdom,20900,102,897742,45088
2020-10-27,United Kingdom,22924,367,920666,45455
2020-10-28,United Kingdom,24714,310,945380,45765
2020-10-29,United Kingdom,23078,280,968458,46045
2020-10-30,United Kingdom,24418,274,992876,46319
2020-10-31,United Kingdom,21919,326,1014795,46645
2020-11-01,United Kingdom,23261,162,1038056,46807
2020-11-02,United Kingdom,18967,136,1057023,46943
2020-11-03,United Kingdom,20078,397,1077101,47340
2020-11-04,United Kingdom,25206,492,1102307,47832
2020-11-05,United Kingdom,24164,378,1126471,48210
2020-11-06,United Kingdom,23322,355,1149793,48565
2020-11-07,United Kingdom,24979,413,1174772,48978
2020-11-08,United Kingdom,20580,156,1195352,49134
2020-11-09,United Kingdom,21397,195,1216749,49329
2020-11-10,United Kingdom,20451,532,1237200,49861
2020-11-11,United Kingdom,23000,596,1260200,50457
2020-11-12,United Kingdom,33517,563,1293717,51020
2020-11-13,United Kingdom,27316,376,1321033,51396
2020-11-14,United Kingdom,26876,462,1347909,51858
2020-11-15,United Kingdom,24977,168,1372886,52026
2020-11-16,United Kingdom,21416,214,1394302,52240
2020-11-17,United Kingdom,20060,599,1414362,52839
2020-11-18,United Kingdom,19645,529,1434007,53368
2020-11-19,United Kingdom,22936,502,1456943,53870
2020-11-20,United Kingdom,20274,511,1477217,54381
2020-11-21,United Kingdom,19921,340,1497138,54721
2020-11-22,United Kingdom,18667,399,1515805,55120
2020-11-23,United Kingdom,15465,207,1531270,55327
2020-11-24,United Kingdom,11344,608,1542614,55935
2020-11-25,United Kingdom,18261,695,1560875,56630
2020-11-26,United Kingdom,17557,498,1578432,57128
2020-11-27,United Kingdom,14821,520,1593253,57648
2020-11-28,United Kingdom,15891,479,1609144,58127
2020-11-29,United Kingdom,12164,215,1621308,58342
2020-11-30,United Kingdom,12428,203,1633736,58545
2020-12-01,United Kingdom,13497,603,1647233,59148
2020-12-02,United Kingdom,16237,648,1663470,59796
2020-12-03,United Kingdom,14951,414,1678421,60210
2020-12-04,United Kingdom,16382,504,1694803,60714
2020-12-05,United Kingdom,15579,397,1710382,61111
2020-12-06,United Kingdom,17372,231,1727754,61342
2020-12-07,United Kingdom,14774,189,1742528,61531
2020-12-08,United Kingdom,12386,599,1754914,62130
2020-12-09,United Kingdom,16634,533,1771548,62663
2020-12-10,United Kingdom,21066,516,1792614,63179
2020-12-11,United Kingdom,21784,424,1814398,63603
2020-12-12,United Kingdom,21554,520,1835952,64123
2020-12-13,United Kingdom,18541,144,1854493,64267
2020-12-14,United Kingdom,20377,233,1874870,64500
2020-12-15,United Kingdom,18569,506,1893439,65006
2020-12-16,United Kingdom,25300,612,1918739,65618
2020-12-17,United Kingdom,35532,532,1954271,66150
2020-12-18,United Kingdom,28560,490,1982831,66640
2020-12-19,United Kingdom,27249,537,2010080,67177
2020-12-20,United Kingdom,36084,326,2046164,67503
2020-12-21,United Kingdom,33517,215,2079681,67718
2020-12-22,United Kingdom,36931,691,2116612,68409
2020-12-23,United Kingdom,39387,748,2155999,69157
2020-12-24,United Kingdom,39149,575,2195148,69732
2020-12-25,United Kingdom,32803,570,2227951,70302
2020-12-26,United Kingdom,34788,211,2262739,70513
2020-12-27,United Kingdom,32493,347,2295232,70860
2020-12-28,United Kingdom,41460,357,2336692,71217
2020-12-29,United Kingdom,53275,458,2389967,71675
2020-12-30,United Kingdom,50239,982,2440206,72657
2020-12-31,United Kingdom,56029,965,2496235,73622
2021-01-01,United Kingdom,53458,615,2549693,74237
2021-01-02,United Kingdom,57853,445,2607546,74682
2021-01-03,United Kingdom,55157,455,2662703,75137
2021-01-04,United Kingdom,58923,410,2721626,75547
2021-01-05,United Kingdom,61087,881,2782713,76428
2021-01-06,United Kingdom,62556,1042,2845269,77470
2021-01-07,United Kingdom,52787,1162,2898056,78632
2021-01-08,United Kingdom,68192,1333,2966248,79965
2021-01-09,United Kingdom,60098,1035,3026346,81000
2021-01-10,United Kingdom,55026,567,3081372,81567
2021-01-11,United Kingdom,46275,529,3127647,82096
2021-01-12,United Kingdom,45648,1246,3173295,83342
2021-01-13,United Kingdom,47662,1568,3220957,84910
2021-01-14,United Kingdom,48804,1253,3269761,86163
2021-01-15,United Kingdom,55885,1285,3325646,87448
2021-01-16,United Kingdom,41428,1299,3367074,88747
2021-01-17,United Kingdom,38670,682,3405744,89429
2021-01-18,United Kingdom,37610,602,3443354,90031
2021-01-19,United Kingdom,33454,1612,3476808,91643
2021-01-20,United Kingdom,38992,1826,3515800,93469
2021-01-21,United Kingdom,37977,1296,3553777,94765
2021-01-22,United Kingdom,40321,1401,3594098,96166
2021-01-23,United Kingdom,33652,1352,3627750,97518
2021-01-24,United Kingdom,30111,611,3657861,98129
2021-01-25,United Kingdom,22244,594,3680105,98723
2021-01-26,United Kingdom,20167,1636,3700272,100359
2021-01-27,United Kingdom,25369,1726,3725641,102085
2021-01-28,United Kingdom,28811,1239,3754452,103324
2021-01-29,United Kingdom,29145,1248,3783597,104572
2021-01-30,United Kingdom,23400,1205,3806997,105777
2021-01-31,United Kingdom,21190,590,3828187,106367
2021-02-01,United Kingdom,18668,407,3846855,106774
2021-02-02,United Kingdom,16906,1451,3863761,108225
2021-02-03,United Kingdom,19215,1322,3882976,109547
2021-02-04,United Kingdom,20734,915,3903710,110462
2021-02-05,United Kingdom,19204,1015,3922914,111477
2021-02-06,United Kingdom,18363,828,3941277,112305
2021-02-07,United Kingdom,15904,376,3957181,112681
2021-02-08,United Kingdom,14138,333,3971319,113014
2021-02-09,United Kingdom,12441,1052,3983760,114066
2021-02-10,United Kingdom,13077,1002,3996837,115068
2021-02-11,United Kingdom,13543,680,4010380,115748
2021-02-12,United Kingdom,15198,759,4025578,116507
2021-02-13,United Kingdom,13355,621,4038933,117128
2021-02-14,United Kingdom,10991,259,4049924,117387
2021-02-15,United Kingdom,9776,235,4059700,117622
2021-02-16,United Kingdom,10636,799,4070336,118421
2021-02-17,United Kingdom,12760,738,4083096,119159
2021-02-18,United Kingdom,12095,455,4095191,119614
2021-02-19,United Kingdom,12099,533,4107290,120147
2021-02-20,United Kingdom,10453,446,4117743,120593
2021-02-21,United Kingdom,9835,217,4127578,120810
2021-02-22,United Kingdom,10659,178,4138237,120988
2021-02-23,United Kingdom,8523,548,4146760,121536
2021-02-24,United Kingdom,9947,443,4156707,121979
2021-02-25,United Kingdom,10020,324,4166727,122303
2021-02-26,United Kingdom,8588,345,4175315,122648
2021-02-27,United Kingdom,7457,291,4182772,122939
2021-02-28,United Kingdom,6055,144,4188827,123083
2021-03-01,United Kingdom,5462,104,4194289,123187
2021-03-02,United Kingdom,6411,343,4200700,123530
2021-03-03,United Kingdom,6420,487,4207120,124017
2021-03-04,United Kingdom,6644,242,4213764,124259
2021-03-05,United Kingdom,6024,236,4219788,124495
2021-03-06,United Kingdom,6118,159,4225906,124654
2021-03-07,United Kingdom,5260,82,4231166,124736
2021-03-08,United Kingdom,4823,65,4235989,124801
2021-03-09,United Kingdom,5869,231,4241858,125032
2021-03-10,United Kingdom,6021,190,4247879,125222
2021-03-11,United Kingdom,6835,181,4254714,125403
2021-03-12,United Kingdom,6684,176,4261398,125579
2021-03-13,United Kingdom,5617,122,4267015,125701
2021-03-14,United Kingdom,4695,52,4271710,125753
2021-03-15,United Kingdom,5130,64,4276840,125817
2021-03-16,United Kingdom,5363,110,4282203,125927
2021-03-17,United Kingdom,5793,141,4287996,126068
2021-03-18,United Kingdom,6332,95,4294328,126163
2021-03-19,United Kingdom,4872,100,4299200,126263
2021-03-20,United Kingdom,5639,96,4304839,126359
2021-03-21,United Kingdom,5356,34,4310195,126393
2021-03-22,United Kingdom,5407,18,4315602,126411
2021-03-23,United Kingdom,5417,112,4321019,126523
2021-03-24,United Kingdom,5626,98,4326645,126621
2021-03-25,United Kingdom,6277,63,4332922,126684
2021-03-26,United Kingdom,6235,71,4339157,126755
2021-03-27,United Kingdom,3909,58,4343066,126813
2021-03-28,United Kingdom,3947,21,4347013,126834
2021-03-29,United Kingdom,4783,23,4351796,126857
2021-03-30,United Kingdom,4071,55,4355867,126912
2021-03-31,United Kingdom,4115,43,4359982,126955
2021-04-01,United Kingdom,4565,51,4364547,127006
2021-04-02,United Kingdom,3422,52,4367969,127058
2021-04-03,United Kingdom,3424,10,4371393,127068
2021-04-04,United Kingdom,2405,10,4373798,127078
2021-04-05,United Kingdom,2831,28,4376629,127106
2021-04-06,United Kingdom,2404,20,4379033,127126
2021-04-07,United Kingdom,2797,45,4381830,127171
2021-04-08,United Kingdom,3124,53,4384954,127224
2020-01-22,United States,0,0,1,0
2020-01-23,United States,0,0,1,0
2020-01-24,United States,1,0,2,0
2020-01-25,United States,0,0,2,0
2020-01-26,United States,3,0,5,0
2020-01-27,United States,0,0,5,0
2020-01-28,United States,0,0,5,0
2020-01-29,United States,1,0,6,0
2020-01-30,United States,0,0,6,0
2020-01-31,United States,2,0,8,0
2020-02-01,United States,0,0,8,0
2020-02-02,United States,0,0,8,0
2020-02-03,United States,3,0,11,0
2020-02-04,United States,0,0,11,0
2020-02-05,United States,0,0,11,0
2020-02-06,United States,1,0,12,0
2020-02-07,United States,0,0,12,0
2020-02-08,United States,0,0,12,0
2020-02-09,United States,0,0,12,0
2020-02-10,United States,0,0,12,0
2020-02-11,United States,1,0,13,0
2020-02-12,United States,0,0,13,0
2020-02-13,United States,1,0,14,0
2020-02-14,United States,0,0,14,0
2020-02-15,United States,0,0,14,0
2020-02-16,United States,0,0,14,0
2020-02-17,United States,0,0,14,0
2020-02-18,United States,0,0,14,0
2020-02-19,United States,0,0,14,0
2020-02-20,United States,0,0,14,0
2020-02-21,United States,2,0,16,0
2020-02-22,United States,0,0,16,0
2020-02-23,United States,0,0,16,0
2020-02-24,United States,0,0,16,0
2020-02-25,United States,0,0,16,0
2020-02-26,United States,0,0,16,0
2020-02-27,United States,1,0,17,0
2020-02-28,United States,0,0,17,0
2020-02-29,United States,8,1,25,1
2020-03-01,United States,7,0,32,1
2020-03-02,United States,23,5,55,6
2020-03-03,United States,19,1,74,7
2020-03-04,United States,33,4,107,11
2020-03-05,United States,77,1,184,12
2020-03-06,United States,53,2,237,14
2020-03-07,United States,166,3,403,17
2020-03-08,United States,116,4,519,21
2020-03-09,United States,75,1,594,22
2020-03-10,United States,188,6,782,28
2020-03-11,United States,365,5,1147,33
2020-03-12,United States,439,10,1586,43
2020-03-13,United States,633,8,2219,51
2020-03-14,United States,759,7,2978,58
2020-03-15,United States,234,12,3212,70
2020-03-16,United States,1467,27,4679,97
2020-03-17,United States,1833,37,6512,134
2020-03-18,United States,2657,60,9169,194
2020-03-19,United States,4494,72,13663,266
2020-03-20,United States,6367,106,20030,372
2020-03-21,United States,5995,103,26025,475
2020-03-22,United States,8873,121,34898,596
2020-03-23,United States,11238,192,46136,788
2020-03-24,United States,10619,243,56755,1031
2020-03-25,United States,12082,333,68837,1364
2020-03-26,United States,17856,420,86693,1784
2020-03-27,United States,18690,522,105383,2306
2020-03-28,United States,19630,642,125013,2948
2020-03-29,United States,18899,624,143912,3572
2020-03-30,United States,22075,713,165987,4285
2020-03-31,United States,26314,1085,192301,5370
2020-04-01,United States,32243,1284,224544,6654
2020-04-02,United States,32235,1512,256779,8166
2020-04-03,United States,32287,1430,289066,9596
2020-04-04,United States,32416,1565,321482,11161
2020-04-05,United States,29877,1613,351359,12774
2020-04-06,United States,31381,1771,382740,14545
2020-04-07,United States,30767,2578,413507,17123
2020-04-08,United States,31192,2155,444699,19278
2020-04-09,United States,35941,2202,480640,21480
2020-04-10,United States,34415,2194,515055,23674
2020-04-11,United States,29130,2128,544185,25802
2020-04-12,United States,27255,1873,571440,27675
2020-04-13,United States,26930,2013,598370,29688
2020-04-14,United States,28781,2434,627151,32122
2020-04-15,United States,25440,2605,652591,34727
2020-04-16,United States,30035,2143,682626,36870
2020-04-17,United States,33030,2109,715656,38979
2020-04-18,United States,27932,1980,743588,40959
2020-04-19,United States,26096,1970,769684,42929
2020-04-20,United States,29828,2232,799512,45161
2020-04-21,United States,25917,2516,825429,47677
2020-04-22,United States,28859,2452,854288,50129
2020-04-23,United States,33570,2463,887858,52592
2020-04-24,United States,32327,2186,920185,54778
2020-04-25,United States,30396,1710,950581,56488
2020-04-26,United States,26501,1399,977082,57887
2020-04-27,United States,23703,1508,1000785,59395
2020-04-28,United States,24577,2227,1025362,61622
2020-04-29,United States,26438,2415,1051800,64037
2020-04-30,United States,29220,2197,1081020,66234
2020-05-01,United States,34926,1905,1115946,68139
2020-05-02,United States,27350,1732,1143296,69871
2020-05-03,United States,24297,1189,1167593,71060
2020-05-04,United States,24085,1379,1191678,72439
2020-05-05,United States,24531,2246,1216209,74685
2020-05-06,United States,24560,2312,1240769,76997
2020-05-07,United States,27411,1927,1268180,78924
2020-05-08,United States,26839,1761,1295019,80685
2020-05-09,United States,25136,1467,1320155,82152
2020-05-10,United States,18867,976,1339022,83128
2020-05-11,United States,19271,1043,1358293,84171
2020-05-12,United States,22948,1600,1381241,85771
2020-05-13,United States,20408,1738,1401649,87509
2020-05-14,United States,26818,1787,1428467,89296
2020-05-15,United States,24747,1670,1453214,90966
2020-05-16,United States,24159,1199,1477373,92165
2020-05-17,United States,18363,818,1495736,92983
2020-05-18,United States,22390,1227,1518126,94210
2020-05-19,United States,21007,1457,1539133,95667
2020-05-20,United States,22697,1500,1561830,97167
2020-05-21,United States,25766,1188,1587596,98355
2020-05-22,United States,23657,1220,1611253,99575
2020-05-23,United States,21111,1086,1632364,100661
2020-05-24,United States,20067,637,1652431,101298
2020-05-25,United States,18673,592,1671104,101890
2020-05-26,United States,19650,677,1690754,102567
2020-05-27,United States,18549,1462,1709303,104029
2020-05-28,United States,22322,1107,1731625,105136
2020-05-29,United States,24473,1133,1756098,106269
2020-05-30,United States,23633,954,1779731,107223
2020-05-31,United States,18987,613,1798718,107836
2020-06-01,United States,17436,776,1816154,108612
2020-06-02,United States,21502,981,1837656,109593
2020-06-03,United States,19855,1011,1857511,110604
2020-06-04,United States,21639,1011,1879150,111615
2020-06-05,United States,25400,894,1904550,112509
2020-06-06,United States,21160,643,1925710,113152
2020-06-07,United States,17916,456,1943626,113608
2020-06-08,United States,17637,507,1961263,114115
2020-06-09,United States,18384,913,1979647,115028
2020-06-10,United States,21110,874,2000757,115902
2020-06-11,United States,23133,830,2023890,116732
2020-06-12,United States,24866,829,2048756,117561
2020-06-13,United States,25208,733,2073964,118294
2020-06-14,United States,18948,342,2092912,118636
2020-06-15,United States,19819,395,2112731,119031
2020-06-16,United States,23670,814,2136401,119845
2020-06-17,United States,27064,739,2163465,120584
2020-06-18,United States,28526,690,2191991,121274
2020-06-19,United States,31562,628,2223553,121902
2020-06-20,United States,32270,562,2255823,122464
2020-06-21,United States,25148,314,2280971,122778
2020-06-22,United States,32152,408,2313123,123186
2020-06-23,United States,37075,748,2350198,123934
2020-06-24,United States,35876,748,2386074,124682
2020-06-25,United States,40317,530,2426391,125212
2020-06-26,United States,45994,626,2472385,125838
2020-06-27,United States,41346,502,2513731,126340
2020-06-28,United States,40730,319,2554461,126659
2020-06-29,United States,41283,383,2595744,127042
2020-06-30,United States,46430,557,2642174,127599
2020-07-01,United States,51819,705,2693993,128304
2020-07-02,United States,56629,716,2750622,129020
2020-07-03,United States,51361,667,2801983,129687
2020-07-04,United States,45681,306,2847664,129993
2020-07-05,United States,50768,325,2898432,130318
2020-07-06,United States,43085,376,2941517,130694
2020-07-07,United States,60654,1163,3002171,131857
2020-07-08,United States,60119,841,3062290,132698
2020-07-09,United States,62496,1012,3124786,133710
2020-07-10,United States,68055,806,3192841,134516
2020-07-11,United States,60033,727,3252874,135243
2020-07-12,United States,58438,472,3311312,135715
2020-07-13,United States,58896,444,3370208,136159
2020-07-14,United States,68036,929,3438244,137088
2020-07-15,United States,68120,973,3506364,138061
2020-07-16,United States,75820,955,3582184,139016
2020-07-17,United States,72261,925,3654445,139941
2020-07-18,United States,62535,869,3716980,140810
2020-07-19,United States,60476,466,3777456,141276
2020-07-20,United States,62090,563,3839546,141839
2020-07-21,United States,64520,1094,3904066,142933
2020-07-22,United States,70564,1223,3974630,144156
2020-07-23,United States,68440,1086,4043070,145242
2020-07-24,United States,73323,1100,4116393,146342
2020-07-25,United States,64915,913,4181308,147255
2020-07-26,United States,54865,534,4236173,147789
2020-07-27,United States,56761,1120,4292934,148909
2020-07-28,United States,66457,1341,4359391,150250
2020-07-29,United States,71853,1427,4431244,151677
2020-07-30,United States,67457,1226,4498701,152903
2020-07-31,United States,68719,1217,4567420,154120
2020-08-01,United States,56184,1094,4623604,155214
2020-08-02,United States,45545,431,4669149,155645
2020-08-03,United States,45529,579,4714678,156224
2020-08-04,United States,58801,1340,4773479,157564
2020-08-05,United States,54457,1397,4827936,158961
2020-08-06,United States,59357,1238,4887293,160199
2020-08-07,United States,59297,1232,4946590,161431
2020-08-08,United States,54119,1075,5000709,162506
2020-08-09,United States,45754,560,5046463,163066
2020-08-10,United States,47624,588,5094087,163654
2020-08-11,United States,48001,1020,5142088,164674
2020-08-12,United States,56049,1503,5198137,166177
2020-08-13,United States,51314,1062,5249451,167239
2020-08-14,United States,65340,1340,5314791,168579
2020-08-15,United States,46921,1004,5361712,169583
2020-08-16,United States,39192,609,5400904,170192
2020-08-17,United States,36676,491,5437580,170683
2020-08-18,United States,45034,1273,5482614,171956
2020-08-19,United States,47359,1300,5529973,173256
2020-08-20,United States,43846,1093,5573819,174349
2020-08-21,United States,48743,1083,5622562,175432
2020-08-22,United States,43068,975,5665630,176407
2020-08-23,United States,34264,496,5699894,176903
2020-08-24,United States,36653,474,5736547,177377
2020-08-25,United States,40168,1227,5776715,178604
2020-08-26,United States,45360,1184,5822075,179788
2020-08-27,United States,45230,1099,5867305,180887
2020-08-28,United States,46983,958,5914288,181845
2020-08-29,United States,42694,902,5956982,182747
2020-08-30,United States,34400,465,5991382,183212
2020-08-31,United States,35513,542,6026895,183754
2020-09-01,United States,41729,1044,6068624,184798
2020-09-02,United States,41006,1061,6109630,185859
2020-09-03,United States,44192,1032,6153822,186891
2020-09-04,United States,50459,950,6204281,187841
2020-09-05,United States,43001,782,6247282,188623
2020-09-06,United States,31311,444,6278593,189067
2020-09-07,United States,23508,297,6302101,189364
2020-09-08,United States,27469,455,6329570,189819
2020-09-09,United States,33911,1150,6363481,190969
2020-09-10,United States,36173,902,6399654,191871
2020-09-11,United States,47724,1172,6447378,193043
2020-09-12,United States,41126,723,6488504,193766
2020-09-13,United States,34297,426,6522801,194192
2020-09-14,United States,34426,438,6557227,194630
2020-09-15,United States,39556,1202,6596783,195832
2020-09-16,United States,38924,944,6635707,196776
2020-09-17,United States,45225,866,6680932,197642
2020-09-18,United States,49243,908,6730175,198550
2020-09-19,United States,42154,722,6772329,199272
2020-09-20,United States,38403,268,6810732,199540
2020-09-21,United States,52039,428,6862771,199968
2020-09-22,United States,39850,1029,6902621,200997
2020-09-23,United States,39072,1055,6941693,202052
2020-09-24,United States,47103,907,6988796,202959
2020-09-25,United States,48275,928,7037071,203887
2020-09-26,United States,44650,776,7081721,204663
2020-09-27,United States,37543,316,7119264,204979
2020-09-28,United States,33257,358,7152521,205337
2020-09-29,United States,43419,860,7195940,206197
2020-09-30,United States,39433,936,7235373,207133
2020-10-01,United States,45652,867,7281025,208000
2020-10-02,United States,54859,855,7335884,208855
2020-10-03,United States,48594,681,7384478,209536
2020-10-04,United States,35767,383,7420245,209919
2020-10-05,United States,39466,481,7459711,210400
2020-10-06,United States,45200,689,7504911,211089
2020-10-07,United States,51084,920,7555995,212009
2020-10-08,United States,58591,993,7614586,213002
2020-10-09,United States,56358,968,7670944,213970
2020-10-10,United States,54961,654,7725905,214624
2020-10-11,United States,45900,468,7771805,215092
2020-10-12,United States,41876,395,7813681,215487
2020-10-13,United States,52233,794,7865914,216281
2020-10-14,United States,59778,983,7925692,217264
2020-10-15,United States,64864,858,7990556,218122
2020-10-16,United States,69165,932,8059721,219054
2020-10-17,United States,56710,769,8116431,219823
2020-10-18,United States,49352,490,8165783,220313
2020-10-19,United States,67778,478,8233561,220791
2020-10-20,United States,61966,925,8295527,221716
2020-10-21,United States,63258,1150,8358785,222866
2020-10-22,United States,76340,889,8435125,223755
2020-10-23,United States,81882,960,8517007,224715
2020-10-24,United States,82797,952,8599804,225667
2020-10-25,United States,62110,459,8661914,226126
2020-10-26,United States,67424,533,8729338,226659
2020-10-27,United States,76791,970,8806129,227629
2020-10-28,United States,79416,1038,8885545,228667
2020-10-29,United States,91099,1001,8976644,229668
2020-10-30,United States,99126,1068,9075770,230736
2020-10-31,United States,89779,908,9165549,231644
2020-11-01,United States,104918,496,9270467,232140
2020-11-02,United States,85308,573,9355775,232713
2020-11-03,United States,127116,1578,9482891,234291
2020-11-04,United States,104608,1122,9587499,235413
2020-11-05,United States,129354,1149,9716853,236562
2020-11-06,United States,128005,1234,9844858,237796
2020-11-07,United States,127308,1077,9972166,238873
2020-11-08,United States,115214,571,10087380,239444
2020-11-09,United States,120573,779,10207953,240223
2020-11-10,United States,140496,1418,10348449,241641
2020-11-11,United States,146626,1436,10495075,243077
2020-11-12,United States,164839,1204,10659914,244281
2020-11-13,United States,180389,1200,10840303,245481
2020-11-14,United States,167761,1346,11008064,246827
2020-11-15,United States,136224,775,11144288,247602
2020-11-16,United States,162945,829,11307233,248431
2020-11-17,United States,163922,1719,11471155,250150
2020-11-18,United States,173177,1936,11644332,252086
2020-11-19,United States,191548,2040,11835880,254126
2020-11-20,United States,198297,1949,12034177,256075
2020-11-21,United States,179274,1615,12213451,257690
2020-11-22,United States,146784,1032,12360235,258722
2020-11-23,United States,174449,1097,12534684,259819
2020-11-24,United States,175514,2129,12710198,261948
2020-11-25,United States,183287,2260,12893485,264208
2020-11-26,United States,112322,1385,13005807,265593
2020-11-27,United States,208188,1550,13213995,267143
2020-11-28,United States,155533,1359,13369528,268502
2020-11-29,United States,140234,1036,13509762,269538
2020-11-30,United States,160570,1346,13670332,270884
2020-12-01,United States,188219,2547,13858551,273431
2020-12-02,United States,202557,2819,14061108,276250
2020-12-03,United States,223613,2951,14284721,279201
2020-12-04,United States,232785,2677,14517506,281878
2020-12-05,United States,215542,2345,14733048,284223
2020-12-06,United States,181012,1352,14914060,285575
2020-12-07,United States,194858,1614,15108918,287189
2020-12-08,United States,224492,2627,15333410,289816
2020-12-09,United States,222539,3177,15555949,292993
2020-12-10,United States,231515,2992,15787464,295985
2020-12-11,United States,239973,3415,16027437,299400
2020-12-12,United States,217582,2456,16245019,301856
2020-12-13,United States,187696,1626,16432715,303482
2020-12-14,United States,193824,1656,16626539,305138
2020-12-15,United States,209980,3103,16836519,308241
2020-12-16,United States,246694,3722,17083213,311963
2020-12-17,United States,239717,3466,17322930,315429
2020-12-18,United States,251959,2942,17574889,318371
2020-12-19,United States,191894,2651,17766783,321022
2020-12-20,United States,187796,1710,17954579,322732
2020-12-21,United States,199033,1939,18153612,324671
2020-12-22,United States,197996,3392,18351608,328063
2020-12-23,United States,229604,3420,18581212,331483
2020-12-24,United States,194193,2910,18775405,334393
2020-12-25,United States,97646,1400,18873051,335793
2020-12-26,United States,226268,1879,19099319,337672
2020-12-27,United States,155621,1430,19254940,339102
2020-12-28,United States,174604,2003,19429544,341105
2020-12-29,United States,200231,3630,19629775,344735
2020-12-30,United States,233659,3729,19863434,348464
2020-12-31,United States,235656,3448,20099090,351912
2021-01-01,United States,153628,2154,20252718,354066
2021-01-02,United States,300295,2503,20553013,356569
2021-01-03,United States,208731,1441,20761744,358010
2021-01-04,United States,184265,2098,20946009,360108
2021-01-05,United States,235099,3691,21181108,363799
2021-01-06,United States,255425,3930,21436533,367729
2021-01-07,United States,278265,3966,21714798,371695
2021-01-08,United States,293262,4091,22008060,375786
2021-01-09,United States,262622,3334,22270682,379120
2021-01-10,United States,213237,1999,22483919,381119
2021-01-11,United States,214975,2096,22698894,383215
2021-01-12,United States,226909,4476,22925803,387691
2021-01-13,United States,230349,4029,23156152,391720
2021-01-14,United States,235700,3974,23391852,395694
2021-01-15,United States,242725,3900,23634577,399594
2021-01-16,United States,201669,3428,23836246,403022
2021-01-17,United States,177763,1868,24014009,404890
2021-01-18,United States,143398,1514,24157407,406404
2021-01-19,United States,176688,2731,24334095,409135
2021-01-20,United States,183218,4406,24517313,413541
2021-01-21,United States,193803,4181,24711116,417722
2021-01-22,United States,190737,3833,24901853,421555
2021-01-23,United States,170595,3343,25072448,424898
2021-01-24,United States,131051,1898,25203499,426796
2021-01-25,United States,151948,1971,25355447,428767
2021-01-26,United States,147519,4033,25502966,432800
2021-01-27,United States,153278,3953,25656244,436753
2021-01-28,United States,169242,4027,25825486,440780
2021-01-29,United States,166554,3615,25992040,444395
2021-01-30,United States,142299,2771,26134339,447166
2021-01-31,United States,111989,1841,26246328,449007
2021-02-01,United States,135184,2048,26381512,451055
2021-02-02,United States,115317,3474,26496829,454529
2021-02-03,United States,121621,3882,26618450,458411
2021-02-04,United States,123961,3744,26742411,462155
2021-02-05,United States,134390,3624,26876801,465779
2021-02-06,United States,103977,2600,26980778,468379
2021-02-07,United States,89630,1367,27070408,469746
2021-02-08,United States,90298,1608,27160706,471354
2021-02-09,United States,95621,3075,27256327,474429
2021-02-10,United States,95165,3325,27351492,477754
2021-02-11,United States,105741,3181,27457233,480935
2021-02-12,United States,99616,2916,27556849,483851
2021-02-13,United States,87106,2189,27643955,486040
2021-02-14,United States,65010,1128,27708965,487168
2021-02-15,United States,54184,953,27763149,488121
2021-02-16,United States,62711,1731,27825860,489852
2021-02-17,United States,70117,2411,27895977,492263
2021-02-18,United States,69597,2476,27965574,494739
2021-02-19,United States,79597,2652,28045171,497391
2021-02-20,United States,71519,1800,28116690,499191
2021-02-21,United States,57069,1214,28173759,500405
2021-02-22,United States,56208,1303,28229967,501708
2021-02-23,United States,72255,2273,28302222,503981
2021-02-24,United States,74717,3172,28376939,507153
2021-02-25,United States,77492,2367,28454431,509520
2021-02-26,United States,76971,2109,28531402,511629
2021-02-27,United States,64428,1509,28595830,513138
2021-02-28,United States,51197,1060,28647027,514198
2021-03-01,United States,58888,1538,28705915,515736
2021-03-02,United States,57052,1950,28762967,517686
2021-03-03,United States,67184,2494,28830151,520180
2021-03-04,United States,68045,1936,28898196,522116
2021-03-05,United States,66445,1784,28964641,523900
2021-03-06,United States,58191,1505,29022832,525405
2021-03-07,United States,40939,691,29063771,526096
2021-03-08,United States,45014,742,29108785,526838
2021-03-09,United States,57698,1805,29166483,528643
2021-03-10,United States,57906,1571,29224389,530214
2021-03-11,United States,62462,1567,29286851,531781
2021-03-12,United States,61317,1574,29348168,533355
2021-03-13,United States,53120,1744,29401288,535099
2021-03-14,United States,38212,582,29439500,535681
2021-03-15,United States,56649,750,29496149,536431
2021-03-16,United States,53946,1168,29550095,537599
2021-03-17,United States,59121,1182,29609216,538781
2021-03-18,United States,60525,1623,29669741,540404
2021-03-19,United States,61620,1104,29731361,541508
2021-03-20,United States,55369,785,29786730,542293
2021-03-21,United States,33760,450,29820490,542743
2021-03-22,United States,51577,562,29872067,543305
2021-03-23,United States,53588,848,29925655,544153
2021-03-24,United States,86951,1458,30012606,545611
2021-03-25,United States,67452,1562,30080058,547173
2021-03-26,United States,77314,1121,30157372,548294
2021-03-27,United States,62078,745,30219450,549039
2021-03-28,United States,43695,509,30263145,549548
2021-03-29,United States,69420,703,30332565,550251
2021-03-30,United States,61240,875,30393805,551126
2021-03-31,United States,67029,1076,30460834,552202
2021-04-01,United States,79034,1066,30539868,553268
2021-04-02,United States,69822,933,30609690,554201
2021-04-03,United States,62974,712,30672664,554913
2021-04-04,United States,34932,283,30707596,555196
2021-04-05,United States,77794,515,30785390,555711
2021-04-06,United States,61958,835,30847348,556546
2021-04-07,United States,75038,2570,30922386,559116
2021-04-08,United States,79878,1000,31002264,560116
2020-03-13,Uruguay,4,0,4,0
2020-03-14,Uruguay,2,0,6,0
2020-03-15,Uruguay,2,0,8,0
2020-03-16,Uruguay,21,0,29,0
2020-03-17,Uruguay,21,0,50,0
2020-03-18,Uruguay,29,0,79,0
2020-03-19,Uruguay,15,0,94,0
2020-03-20,Uruguay,16,0,110,0
2020-03-21,Uruguay,25,0,135,0
2020-03-22,Uruguay,23,0,158,0
2020-03-23,Uruguay,4,0,162,0
2020-03-24,Uruguay,27,0,189,0
2020-03-25,Uruguay,28,0,217,0
2020-03-26,Uruguay,21,0,238,0
2020-03-27,Uruguay,36,0,274,0
2020-03-28,Uruguay,29,1,303,1
2020-03-29,Uruguay,6,0,309,1
2020-03-30,Uruguay,11,0,320,1
2020-03-31,Uruguay,18,0,338,1
2020-04-01,Uruguay,12,1,350,2
2020-04-02,Uruguay,19,2,369,4
2020-04-03,Uruguay,17,0,386,4
2020-04-04,Uruguay,14,1,400,5
2020-04-05,Uruguay,6,1,406,6
2020-04-06,Uruguay,9,0,415,6
2020-04-07,Uruguay,9,1,424,7
2020-04-08,Uruguay,32,0,456,7
2020-04-09,Uruguay,17,0,473,7
2020-04-10,Uruguay,21,0,494,7
2020-04-11,Uruguay,7,0,501,7
2020-04-12,Uruguay,-21,0,480,7
2020-04-13,Uruguay,3,1,483,8
2020-04-14,Uruguay,9,0,492,8
2020-04-15,Uruguay,1,1,493,9
2020-04-16,Uruguay,9,0,502,9
2020-04-17,Uruguay,6,0,508,9
2020-04-18,Uruguay,9,0,517,9
2020-04-19,Uruguay,11,1,528,10
2020-04-20,Uruguay,7,0,535,10
2020-04-21,Uruguay,8,2,543,12
2020-04-22,Uruguay,6,0,549,12
2020-04-23,Uruguay,8,0,557,12
2020-04-24,Uruguay,6,0,563,12
2020-04-25,Uruguay,33,2,596,14
2020-04-26,Uruguay,10,1,606,15
2020-04-27,Uruguay,14,0,620,15
2020-04-28,Uruguay,5,0,625,15
2020-04-29,Uruguay,5,0,630,15
2020-04-30,Uruguay,13,2,643,17
2020-05-01,Uruguay,5,0,648,17
2020-05-02,Uruguay,4,0,652,17
2020-05-03,Uruguay,3,0,655,17
2020-05-04,Uruguay,2,0,657,17
2020-05-05,Uruguay,13,0,670,17
2020-05-06,Uruguay,3,0,673,17
2020-05-07,Uruguay,11,0,684,17
2020-05-08,Uruguay,10,1,694,18
2020-05-09,Uruguay,8,0,702,18
2020-05-10,Uruguay,5,1,707,19
2020-05-11,Uruguay,4,0,711,19
2020-05-12,Uruguay,6,0,717,19
2020-05-13,Uruguay,2,0,719,19
2020-05-14,Uruguay,5,0,724,19
2020-05-15,Uruguay,8,0,732,19
2020-05-16,Uruguay,1,0,733,19
2020-05-17,Uruguay,1,1,734,20
2020-05-18,Uruguay,3,0,737,20
2020-05-19,Uruguay,1,0,738,20
2020-05-20,Uruguay,8,0,746,20
2020-05-21,Uruguay,3,0,749,20
2020-05-22,Uruguay,4,0,753,20
2020-05-23,Uruguay,11,2,764,22
2020-05-24,Uruguay,5,0,769,22
2020-05-25,Uruguay,18,0,787,22
2020-05-26,Uruguay,2,0,789,22
2020-05-27,Uruguay,14,0,803,22
2020-05-28,Uruguay,8,0,811,22
2020-05-29,Uruguay,5,0,816,22
2020-05-30,Uruguay,5,0,821,22
2020-05-31,Uruguay,2,0,823,22
2020-06-01,Uruguay,2,1,825,23
2020-06-02,Uruguay,1,0,826,23
2020-06-03,Uruguay,2,0,828,23
2020-06-04,Uruguay,4,0,832,23
2020-06-05,Uruguay,2,0,834,23
2020-06-06,Uruguay,11,0,845,23
2020-06-07,Uruguay,0,0,845,23
2020-06-08,Uruguay,0,0,845,23
2020-06-09,Uruguay,1,0,846,23
2020-06-10,Uruguay,1,0,847,23
2020-06-11,Uruguay,0,0,847,23
2020-06-12,Uruguay,0,0,847,23
2020-06-13,Uruguay,0,0,847,23
2020-06-14,Uruguay,1,0,848,23
2020-06-15,Uruguay,0,0,848,23
2020-06-16,Uruguay,1,1,849,24
2020-06-17,Uruguay,0,0,849,24
2020-06-18,Uruguay,1,0,850,24
2020-06-19,Uruguay,3,0,853,24
2020-06-20,Uruguay,6,1,859,25
2020-06-21,Uruguay,17,0,876,25
2020-06-22,Uruguay,6,0,882,25
2020-06-23,Uruguay,3,0,885,25
2020-06-24,Uruguay,17,1,902,26
2020-06-25,Uruguay,5,0,907,26
2020-06-26,Uruguay,12,0,919,26
2020-06-27,Uruguay,5,0,924,26
2020-06-28,Uruguay,5,1,929,27
2020-06-29,Uruguay,3,0,932,27
2020-06-30,Uruguay,4,0,936,27
2020-07-01,Uruguay,7,1,943,28
2020-07-02,Uruguay,4,0,947,28
2020-07-03,Uruguay,5,0,952,28
2020-07-04,Uruguay,3,0,955,28
2020-07-05,Uruguay,1,0,956,28
2020-07-06,Uruguay,4,1,960,29
2020-07-07,Uruguay,5,0,965,29
2020-07-08,Uruguay,9,0,974,29
2020-07-09,Uruguay,3,0,977,29
2020-07-10,Uruguay,8,0,985,29
2020-07-11,Uruguay,1,1,986,30
2020-07-12,Uruguay,1,1,987,31
2020-07-13,Uruguay,2,0,989,31
2020-07-14,Uruguay,8,0,997,31
2020-07-15,Uruguay,12,0,1009,31
2020-07-16,Uruguay,17,1,1026,32
2020-07-17,Uruguay,11,0,1037,32
2020-07-18,Uruguay,7,1,1044,33
2020-07-19,Uruguay,10,0,1054,33
2020-07-20,Uruguay,10,0,1064,33
2020-07-21,Uruguay,32,0,1096,33
2020-07-22,Uruguay,21,1,1117,34
2020-07-23,Uruguay,24,0,1141,34
2020-07-24,Uruguay,25,0,1166,34
2020-07-25,Uruguay,8,0,1174,34
2020-07-26,Uruguay,18,0,1192,34
2020-07-27,Uruguay,10,1,1202,35
2020-07-28,Uruguay,16,0,1218,35
2020-07-29,Uruguay,19,0,1237,35
2020-07-30,Uruguay,6,0,1243,35
2020-07-31,Uruguay,21,0,1264,35
2020-08-01,Uruguay,14,0,1278,35
2020-08-02,Uruguay,8,1,1286,36
2020-08-03,Uruguay,5,0,1291,36
2020-08-04,Uruguay,9,1,1300,37
2020-08-05,Uruguay,9,0,1309,37
2020-08-06,Uruguay,9,0,1318,37
2020-08-07,Uruguay,7,0,1325,37
2020-08-08,Uruguay,10,0,1335,37
2020-08-09,Uruguay,18,0,1353,37
2020-08-10,Uruguay,11,0,1364,37
2020-08-11,Uruguay,21,0,1385,37
2020-08-12,Uruguay,8,0,1393,37
2020-08-13,Uruguay,16,0,1409,37
2020-08-14,Uruguay,12,1,1421,38
2020-08-15,Uruguay,13,0,1434,38
2020-08-16,Uruguay,6,0,1440,38
2020-08-17,Uruguay,17,2,1457,40
2020-08-18,Uruguay,28,0,1485,40
2020-08-19,Uruguay,8,0,1493,40
2020-08-20,Uruguay,13,1,1506,41
2020-08-21,Uruguay,10,1,1516,42
2020-08-22,Uruguay,5,0,1521,42
2020-08-23,Uruguay,6,0,1527,42
2020-08-24,Uruguay,6,0,1533,42
2020-08-25,Uruguay,3,1,1536,43
2020-08-26,Uruguay,7,0,1543,43
2020-08-27,Uruguay,8,0,1551,43
2020-08-28,Uruguay,5,0,1556,43
2020-08-29,Uruguay,14,1,1570,44
2020-08-30,Uruguay,15,0,1585,44
2020-08-31,Uruguay,10,0,1595,44
2020-09-01,Uruguay,16,0,1611,44
2020-09-02,Uruguay,15,0,1626,44
2020-09-03,Uruguay,10,0,1636,44
2020-09-04,Uruguay,17,1,1653,45
2020-09-05,Uruguay,16,0,1669,45
2020-09-06,Uruguay,10,0,1679,45
2020-09-07,Uruguay,14,0,1693,45
2020-09-08,Uruguay,19,0,1712,45
2020-09-09,Uruguay,29,0,1741,45
2020-09-10,Uruguay,18,0,1759,45
2020-09-11,Uruguay,14,0,1773,45
2020-09-12,Uruguay,7,0,1780,45
2020-09-13,Uruguay,28,0,1808,45
2020-09-14,Uruguay,4,0,1812,45
2020-09-15,Uruguay,15,0,1827,45
2020-09-16,Uruguay,29,0,1856,45
2020-09-17,Uruguay,20,1,1876,46
2020-09-18,Uruguay,14,0,1890,46
2020-09-19,Uruguay,14,0,1904,46
2020-09-20,Uruguay,13,0,1917,46
2020-09-21,Uruguay,10,0,1927,46
2020-09-22,Uruguay,7,0,1934,46
2020-09-23,Uruguay,12,1,1946,47
2020-09-24,Uruguay,13,0,1959,47
2020-09-25,Uruguay,8,0,1967,47
2020-09-26,Uruguay,31,0,1998,47
2020-09-27,Uruguay,10,0,2008,47
2020-09-28,Uruguay,2,0,2010,47
2020-09-29,Uruguay,23,1,2033,48
2020-09-30,Uruguay,13,0,2046,48
2020-10-01,Uruguay,15,0,2061,48
2020-10-02,Uruguay,36,0,2097,48
2020-10-03,Uruguay,25,0,2122,48
2020-10-04,Uruguay,23,0,2145,48
2020-10-05,Uruguay,10,0,2155,48
2020-10-06,Uruguay,22,1,2177,49
2020-10-07,Uruguay,29,0,2206,49
2020-10-08,Uruguay,20,0,2226,49
2020-10-09,Uruguay,25,0,2251,49
2020-10-10,Uruguay,17,1,2268,50
2020-10-11,Uruguay,26,0,2294,50
2020-10-12,Uruguay,19,1,2313,51
2020-10-13,Uruguay,24,0,2337,51
2020-10-14,Uruguay,51,0,2388,51
2020-10-15,Uruguay,29,0,2417,51
2020-10-16,Uruguay,33,0,2450,51
2020-10-17,Uruguay,51,0,2501,51
2020-10-18,Uruguay,30,0,2531,51
2020-10-19,Uruguay,29,0,2560,51
2020-10-20,Uruguay,63,1,2623,52
2020-10-21,Uruguay,40,1,2663,53
2020-10-22,Uruguay,38,0,2701,53
2020-10-23,Uruguay,58,0,2759,53
2020-10-24,Uruguay,48,0,2807,53
2020-10-25,Uruguay,44,0,2851,53
2020-10-26,Uruguay,21,1,2872,54
2020-10-27,Uruguay,44,0,2916,54
2020-10-28,Uruguay,65,1,2981,55
2020-10-29,Uruguay,63,2,3044,57
2020-10-30,Uruguay,38,1,3082,58
2020-10-31,Uruguay,42,0,3124,58
2020-11-01,Uruguay,25,1,3149,59
2020-11-02,Uruguay,16,1,3165,60
2020-11-03,Uruguay,31,1,3196,61
2020-11-04,Uruguay,49,0,3245,61
2020-11-05,Uruguay,64,0,3309,61
2020-11-06,Uruguay,61,0,3370,61
2020-11-07,Uruguay,71,0,3441,61
2020-11-08,Uruguay,73,1,3514,62
2020-11-09,Uruguay,46,0,3560,62
2020-11-10,Uruguay,60,0,3620,62
2020-11-11,Uruguay,80,1,3700,63
2020-11-12,Uruguay,95,0,3795,63
2020-11-13,Uruguay,88,1,3883,64
2020-11-14,Uruguay,74,0,3957,64
2020-11-15,Uruguay,73,1,4030,65
2020-11-16,Uruguay,74,2,4104,67
2020-11-17,Uruguay,104,1,4208,68
2020-11-18,Uruguay,88,0,4296,68
2020-11-19,Uruguay,81,1,4377,69
2020-11-20,Uruguay,100,0,4477,69
2020-11-21,Uruguay,87,0,4564,69
2020-11-22,Uruguay,135,2,4699,71
2020-11-23,Uruguay,64,0,4763,71
2020-11-24,Uruguay,107,1,4870,72
2020-11-25,Uruguay,118,1,4988,73
2020-11-26,Uruguay,129,1,5117,74
2020-11-27,Uruguay,186,0,5303,74
2020-11-28,Uruguay,208,1,5511,75
2020-11-29,Uruguay,205,1,5716,76
2020-11-30,Uruguay,141,1,5857,77
2020-12-01,Uruguay,167,1,6024,78
2020-12-02,Uruguay,201,2,6225,80
2020-12-03,Uruguay,230,0,6455,80
2020-12-04,Uruguay,276,0,6731,80
2020-12-05,Uruguay,234,1,6965,81
2020-12-06,Uruguay,338,1,7303,82
2020-12-07,Uruguay,202,1,7505,83
2020-12-08,Uruguay,301,3,7806,86
2020-12-09,Uruguay,298,1,8104,87
2020-12-10,Uruguay,383,3,8487,90
2020-12-11,Uruguay,362,0,8849,90
2020-12-12,Uruguay,331,1,9180,91
2020-12-13,Uruguay,528,1,9708,92
2020-12-14,Uruguay,321,3,10029,95
2020-12-15,Uruguay,389,3,10418,98
2020-12-16,Uruguay,475,4,10893,102
2020-12-17,Uruguay,543,3,11436,105
2020-12-18,Uruguay,514,4,11950,109
2020-12-19,Uruguay,607,5,12557,114
2020-12-20,Uruguay,491,5,13048,119
2020-12-21,Uruguay,429,0,13477,119
2020-12-22,Uruguay,524,1,14001,120
2020-12-23,Uruguay,709,8,14710,128
2020-12-24,Uruguay,747,7,15457,135
2020-12-25,Uruguay,391,8,15848,143
2020-12-26,Uruguay,370,4,16218,147
2020-12-27,Uruguay,510,11,16728,158
2020-12-28,Uruguay,578,2,17306,160
2020-12-29,Uruguay,656,8,17962,168
2020-12-30,Uruguay,518,6,18480,174
2020-12-31,Uruguay,639,7,19119,181
2021-01-01,Uruguay,634,12,19753,193
2021-01-02,Uruguay,522,8,20275,201
2021-01-03,Uruguay,548,3,20823,204
2021-01-04,Uruguay,603,7,21426,211
2021-01-05,Uruguay,678,6,22104,217
2021-01-06,Uruguay,944,4,23048,221
2021-01-07,Uruguay,759,10,23807,231
2021-01-08,Uruguay,532,9,24339,240
2021-01-09,Uruguay,635,8,24974,248
2021-01-10,Uruguay,1212,8,26186,256
2021-01-11,Uruguay,715,6,26901,262
2021-01-12,Uruguay,945,7,27846,269
2021-01-13,Uruguay,629,6,28475,275
2021-01-14,Uruguay,1514,5,29989,280
2021-01-15,Uruguay,957,11,30946,291
2021-01-16,Uruguay,723,7,31669,298
2021-01-17,Uruguay,709,13,32378,311
2021-01-18,Uruguay,485,8,32863,319
2021-01-19,Uruguay,583,11,33446,330
2021-01-20,Uruguay,848,6,34294,336
2021-01-21,Uruguay,698,11,34992,347
2021-01-22,Uruguay,1178,17,36170,364
2021-01-23,Uruguay,797,3,36967,367
2021-01-24,Uruguay,666,9,37633,376
2021-01-25,Uruguay,408,14,38041,390
2021-01-26,Uruguay,639,11,38680,401
2021-01-27,Uruguay,648,6,39328,407
2021-01-28,Uruguay,559,8,39887,415
2021-01-29,Uruguay,642,10,40529,425
2021-01-30,Uruguay,652,6,41181,431
2021-01-31,Uruguay,557,5,41738,436
2021-02-01,Uruguay,390,8,42128,444
2021-02-02,Uruguay,539,9,42667,453
2021-02-03,Uruguay,548,11,43215,464
2021-02-04,Uruguay,589,12,43804,476
2021-02-05,Uruguay,499,2,44303,478
2021-02-06,Uruguay,509,3,44812,481
2021-02-07,Uruguay,499,9,45311,490
2021-02-08,Uruguay,339,7,45650,497
2021-02-09,Uruguay,503,9,46153,506
2021-02-10,Uruguay,625,10,46778,516
2021-02-11,Uruguay,476,8,47254,524
2021-02-12,Uruguay,574,3,47828,527
2021-02-13,Uruguay,631,6,48459,533
2021-02-14,Uruguay,450,2,48909,535
2021-02-15,Uruguay,451,6,49360,541
2021-02-16,Uruguay,365,5,49725,546
2021-02-17,Uruguay,483,7,50208,553
2021-02-18,Uruguay,544,5,50752,558
2021-02-19,Uruguay,625,5,51377,563
2021-02-20,Uruguay,786,6,52163,569
2021-02-21,Uruguay,652,5,52815,574
2021-02-22,Uruguay,495,9,53310,583
2021-02-23,Uruguay,663,5,53973,588
2021-02-24,Uruguay,901,3,54874,591
2021-02-25,Uruguay,821,4,55695,595
2021-02-26,Uruguay,847,6,56542,601
2021-02-27,Uruguay,820,2,57362,603
2021-02-28,Uruguay,632,5,57994,608
2021-03-01,Uruguay,595,3,58589,611
2021-03-02,Uruguay,582,6,59171,617
2021-03-03,Uruguay,903,7,60074,624
2021-03-04,Uruguay,871,7,60945,631
2021-03-05,Uruguay,984,6,61929,637
2021-03-06,Uruguay,1081,8,63010,645
2021-03-07,Uruguay,827,6,63837,651
2021-03-08,Uruguay,863,7,64700,658
2021-03-09,Uruguay,827,8,65527,666
2021-03-10,Uruguay,957,12,66484,678
2021-03-11,Uruguay,1233,5,67717,683
2021-03-12,Uruguay,1357,6,69074,689
2021-03-13,Uruguay,1059,9,70133,698
2021-03-14,Uruguay,1558,14,71691,712
2021-03-15,Uruguay,1171,5,72862,717
2021-03-16,Uruguay,908,8,73770,725
2021-03-17,Uruguay,1368,15,75138,740
2021-03-18,Uruguay,1678,9,76816,749
2021-03-19,Uruguay,1585,11,78401,760
2021-03-20,Uruguay,1522,16,79923,776
2021-03-21,Uruguay,1614,16,81537,792
2021-03-22,Uruguay,2693,19,84230,811
2021-03-23,Uruguay,1777,16,86007,827
2021-03-24,Uruguay,1805,16,87812,843
2021-03-25,Uruguay,1646,13,89458,856
2021-03-26,Uruguay,2885,19,92343,875
2021-03-27,Uruguay,2935,26,95278,901
2021-03-28,Uruguay,2128,14,97406,915
2021-03-29,Uruguay,2178,13,99584,928
2021-03-30,Uruguay,2877,25,102461,953
2021-03-31,Uruguay,3088,21,105549,974
2021-04-01,Uruguay,2639,35,108188,1009
2021-04-02,Uruguay,3380,32,111568,1041
2021-04-03,Uruguay,2336,30,113904,1071
2021-04-04,Uruguay,3853,30,117757,1101
2021-04-05,Uruguay,2201,45,119958,1146
2021-04-06,Uruguay,3105,45,123063,1191
2021-04-07,Uruguay,3924,40,126987,1231
2021-04-08,Uruguay,3670,44,130657,1275
2020-03-15,Uzbekistan,1,0,1,0
2020-03-16,Uzbekistan,5,0,6,0
2020-03-17,Uzbekistan,4,0,10,0
2020-03-18,Uzbekistan,5,0,15,0
2020-03-19,Uzbekistan,8,0,23,0
2020-03-20,Uzbekistan,10,0,33,0
2020-03-21,Uzbekistan,10,0,43,0
2020-03-22,Uzbekistan,0,0,43,0
2020-03-23,Uzbekistan,3,0,46,0
2020-03-24,Uzbekistan,4,0,50,0
2020-03-25,Uzbekistan,10,0,60,0
2020-03-26,Uzbekistan,15,0,75,0
2020-03-27,Uzbekistan,13,1,88,1
2020-03-28,Uzbekistan,16,1,104,2
2020-03-29,Uzbekistan,40,0,144,2
2020-03-30,Uzbekistan,5,0,149,2
2020-03-31,Uzbekistan,23,0,172,2
2020-04-01,Uzbekistan,9,0,181,2
2020-04-02,Uzbekistan,24,0,205,2
2020-04-03,Uzbekistan,22,0,227,2
2020-04-04,Uzbekistan,39,0,266,2
2020-04-05,Uzbekistan,76,0,342,2
2020-04-06,Uzbekistan,115,0,457,2
2020-04-07,Uzbekistan,63,0,520,2
2020-04-08,Uzbekistan,25,1,545,3
2020-04-09,Uzbekistan,37,0,582,3
2020-04-10,Uzbekistan,42,0,624,3
2020-04-11,Uzbekistan,143,1,767,4
2020-04-12,Uzbekistan,98,0,865,4
2020-04-13,Uzbekistan,133,0,998,4
2020-04-14,Uzbekistan,167,0,1165,4
2020-04-15,Uzbekistan,137,0,1302,4
2020-04-16,Uzbekistan,47,0,1349,4
2020-04-17,Uzbekistan,56,0,1405,4
2020-04-18,Uzbekistan,85,1,1490,5
2020-04-19,Uzbekistan,75,0,1565,5
2020-04-20,Uzbekistan,62,0,1627,5
2020-04-21,Uzbekistan,51,1,1678,6
2020-04-22,Uzbekistan,38,1,1716,7
2020-04-23,Uzbekistan,42,0,1758,7
2020-04-24,Uzbekistan,46,1,1804,8
2020-04-25,Uzbekistan,58,0,1862,8
2020-04-26,Uzbekistan,7,0,1869,8
2020-04-27,Uzbekistan,35,0,1904,8
2020-04-28,Uzbekistan,35,0,1939,8
2020-04-29,Uzbekistan,63,1,2002,9
2020-04-30,Uzbekistan,37,0,2039,9
2020-05-01,Uzbekistan,47,0,2086,9
2020-05-02,Uzbekistan,32,0,2118,9
2020-05-03,Uzbekistan,31,1,2149,10
2020-05-04,Uzbekistan,40,0,2189,10
2020-05-05,Uzbekistan,18,0,2207,10
2020-05-06,Uzbekistan,26,0,2233,10
2020-05-07,Uzbekistan,65,0,2298,10
2020-05-08,Uzbekistan,27,0,2325,10
2020-05-09,Uzbekistan,24,0,2349,10
2020-05-10,Uzbekistan,69,0,2418,10
2020-05-11,Uzbekistan,68,0,2486,10
2020-05-12,Uzbekistan,33,0,2519,10
2020-05-13,Uzbekistan,93,1,2612,11
2020-05-14,Uzbekistan,33,0,2645,11
2020-05-15,Uzbekistan,41,0,2686,11
2020-05-16,Uzbekistan,52,0,2738,11
2020-05-17,Uzbekistan,15,1,2753,12
2020-05-18,Uzbekistan,38,1,2791,13
2020-05-19,Uzbekistan,64,0,2855,13
2020-05-20,Uzbekistan,84,0,2939,13
2020-05-21,Uzbekistan,25,0,2964,13
2020-05-22,Uzbekistan,64,0,3028,13
2020-05-23,Uzbekistan,87,0,3115,13
2020-05-24,Uzbekistan,49,0,3164,13
2020-05-25,Uzbekistan,25,0,3189,13
2020-05-26,Uzbekistan,101,1,3290,14
2020-05-27,Uzbekistan,79,0,3369,14
2020-05-28,Uzbekistan,75,0,3444,14
2020-05-29,Uzbekistan,24,0,3468,14
2020-05-30,Uzbekistan,78,0,3546,14
2020-05-31,Uzbekistan,77,1,3623,15
2020-06-01,Uzbekistan,79,0,3702,15
2020-06-02,Uzbekistan,58,0,3760,15
2020-06-03,Uzbekistan,83,1,3843,16
2020-06-04,Uzbekistan,96,0,3939,16
2020-06-05,Uzbekistan,68,0,4007,16
2020-06-06,Uzbekistan,87,1,4094,17
2020-06-07,Uzbekistan,237,0,4331,17
2020-06-08,Uzbekistan,109,1,4440,18
2020-06-09,Uzbekistan,80,0,4520,18
2020-06-10,Uzbekistan,103,1,4623,19
2020-06-11,Uzbekistan,118,0,4741,19
2020-06-12,Uzbekistan,128,0,4869,19
2020-06-13,Uzbekistan,97,0,4966,19
2020-06-14,Uzbekistan,114,0,5080,19
2020-06-15,Uzbekistan,183,0,5263,19
2020-06-16,Uzbekistan,230,0,5493,19
2020-06-17,Uzbekistan,189,0,5682,19
2020-06-18,Uzbekistan,85,0,5767,19
2020-06-19,Uzbekistan,179,0,5946,19
2020-06-20,Uzbekistan,207,0,6153,19
2020-06-21,Uzbekistan,162,0,6315,19
2020-06-22,Uzbekistan,146,0,6461,19
2020-06-23,Uzbekistan,201,0,6662,19
2020-06-24,Uzbekistan,328,0,6990,19
2020-06-25,Uzbekistan,187,1,7177,20
2020-06-26,Uzbekistan,250,0,7427,20
2020-06-27,Uzbekistan,255,0,7682,20
2020-06-28,Uzbekistan,266,2,7948,22
2020-06-29,Uzbekistan,274,1,8222,23
2020-06-30,Uzbekistan,281,3,8503,26
2020-07-01,Uzbekistan,278,0,8781,26
2020-07-02,Uzbekistan,297,1,9078,27
2020-07-03,Uzbekistan,318,2,9396,29
2020-07-04,Uzbekistan,312,2,9708,31
2020-07-05,Uzbekistan,312,3,10020,34
2020-07-06,Uzbekistan,342,3,10362,37
2020-07-07,Uzbekistan,476,4,10838,41
2020-07-08,Uzbekistan,254,4,11092,45
2020-07-09,Uzbekistan,472,6,11564,51
2020-07-10,Uzbekistan,463,3,12027,54
2020-07-11,Uzbekistan,486,3,12513,57
2020-07-12,Uzbekistan,484,3,12997,60
2020-07-13,Uzbekistan,594,4,13591,64
2020-07-14,Uzbekistan,494,3,14085,67
2020-07-15,Uzbekistan,496,4,14581,71
2020-07-16,Uzbekistan,485,4,15066,75
2020-07-17,Uzbekistan,541,4,15607,79
2020-07-18,Uzbekistan,579,4,16186,83
2020-07-19,Uzbekistan,566,4,16752,87
2020-07-20,Uzbekistan,397,3,17149,90
2020-07-21,Uzbekistan,732,5,17881,95
2020-07-22,Uzbekistan,498,3,18379,98
2020-07-23,Uzbekistan,607,5,18986,103
2020-07-24,Uzbekistan,374,3,19360,106
2020-07-25,Uzbekistan,592,5,19952,111
2020-07-26,Uzbekistan,579,5,20531,116
2020-07-27,Uzbekistan,678,5,21209,121
2020-07-28,Uzbekistan,490,3,21699,124
2020-07-29,Uzbekistan,886,7,22585,131
2020-07-30,Uzbekistan,686,5,23271,136
2020-07-31,Uzbekistan,738,5,24009,141
2020-08-01,Uzbekistan,774,6,24783,147
2020-08-02,Uzbekistan,553,4,25336,151
2020-08-03,Uzbekistan,730,6,26066,157
2020-08-04,Uzbekistan,981,8,27047,165
2020-08-05,Uzbekistan,746,6,27793,171
2020-08-06,Uzbekistan,522,4,28315,175
2020-08-07,Uzbekistan,742,6,29057,181
2020-08-08,Uzbekistan,595,6,29652,187
2020-08-09,Uzbekistan,957,7,30609,194
2020-08-10,Uzbekistan,695,6,31304,200
2020-08-11,Uzbekistan,443,4,31747,204
2020-08-12,Uzbekistan,907,7,32654,211
2020-08-13,Uzbekistan,669,5,33323,216
2020-08-14,Uzbekistan,498,4,33821,220
2020-08-15,Uzbekistan,707,5,34528,225
2020-08-16,Uzbekistan,801,7,35329,232
2020-08-17,Uzbekistan,373,4,35702,236
2020-08-18,Uzbekistan,650,6,36352,242
2020-08-19,Uzbekistan,760,6,37112,248
2020-08-20,Uzbekistan,435,4,37547,252
2020-08-21,Uzbekistan,527,8,38074,260
2020-08-22,Uzbekistan,458,7,38532,267
2020-08-23,Uzbekistan,414,6,38946,273
2020-08-24,Uzbekistan,402,7,39348,280
2020-08-25,Uzbekistan,293,4,39641,284
2020-08-26,Uzbekistan,323,7,39964,291
2020-08-27,Uzbekistan,483,7,40447,298
2020-08-28,Uzbekistan,273,4,40720,302
2020-08-29,Uzbekistan,347,5,41067,307
2020-08-30,Uzbekistan,357,6,41424,313
2020-08-31,Uzbekistan,469,7,41893,320
2020-09-01,Uzbekistan,234,3,42127,323
2020-09-02,Uzbekistan,310,4,42437,327
2020-09-03,Uzbekistan,251,4,42688,331
2020-09-04,Uzbekistan,310,7,42998,338
2020-09-05,Uzbekistan,295,5,43293,343
2020-09-06,Uzbekistan,294,4,43587,347
2020-09-07,Uzbekistan,306,5,43893,352
2020-09-08,Uzbekistan,388,6,44281,358
2020-09-09,Uzbekistan,649,8,44930,366
2020-09-10,Uzbekistan,543,4,45473,370
2020-09-11,Uzbekistan,687,7,46160,377
2020-09-12,Uzbekistan,561,7,46721,384
2020-09-13,Uzbekistan,566,6,47287,390
2020-09-14,Uzbekistan,549,6,47836,396
2020-09-15,Uzbekistan,593,6,48429,402
2020-09-16,Uzbekistan,586,5,49015,407
2020-09-17,Uzbekistan,612,6,49627,413
2020-09-18,Uzbekistan,626,6,50253,419
2020-09-19,Uzbekistan,739,8,50992,427
2020-09-20,Uzbekistan,648,6,51640,433
2020-09-21,Uzbekistan,430,4,52070,437
2020-09-22,Uzbekistan,615,5,52685,442
2020-09-23,Uzbekistan,590,2,53275,444
2020-09-24,Uzbekistan,559,2,53834,446
2020-09-25,Uzbekistan,558,3,54392,449
2020-09-26,Uzbekistan,427,3,54819,452
2020-09-27,Uzbekistan,501,6,55320,458
2020-09-28,Uzbekistan,456,2,55776,460
2020-09-29,Uzbekistan,578,6,56354,466
2020-09-30,Uzbekistan,363,4,56717,470
2020-10-01,Uzbekistan,473,1,57190,471
2020-10-02,Uzbekistan,264,1,57454,472
2020-10-03,Uzbekistan,784,5,58238,477
2020-10-04,Uzbekistan,374,3,58612,480
2020-10-05,Uzbekistan,334,5,58946,485
2020-10-06,Uzbekistan,397,4,59343,489
2020-10-07,Uzbekistan,236,2,59579,491
2020-10-08,Uzbekistan,447,5,60026,496
2020-10-09,Uzbekistan,316,2,60342,498
2020-10-10,Uzbekistan,434,4,60776,502
2020-10-11,Uzbekistan,322,3,61098,505
2020-10-12,Uzbekistan,221,4,61319,509
2020-10-13,Uzbekistan,323,2,61642,511
2020-10-14,Uzbekistan,308,3,61950,514
2020-10-15,Uzbekistan,328,4,62278,518
2020-10-16,Uzbekistan,310,2,62588,520
2020-10-17,Uzbekistan,221,2,62809,522
2020-10-18,Uzbekistan,315,3,63124,525
2020-10-19,Uzbekistan,399,6,63523,531
2020-10-20,Uzbekistan,308,3,63831,534
2020-10-21,Uzbekistan,179,0,64010,534
2020-10-22,Uzbekistan,429,6,64439,540
2020-10-23,Uzbekistan,285,2,64724,542
2020-10-24,Uzbekistan,199,2,64923,544
2020-10-25,Uzbekistan,384,5,65307,549
2020-10-26,Uzbekistan,360,3,65667,552
2020-10-27,Uzbekistan,214,4,65881,556
2020-10-28,Uzbekistan,260,2,66141,558
2020-10-29,Uzbekistan,251,3,66392,561
2020-10-30,Uzbekistan,236,2,66628,563
2020-10-31,Uzbekistan,304,3,66932,566
2020-11-01,Uzbekistan,224,4,67156,570
2020-11-02,Uzbekistan,98,1,67254,571
2020-11-03,Uzbekistan,299,3,67553,574
2020-11-04,Uzbekistan,226,3,67779,577
2020-11-05,Uzbekistan,230,2,68009,579
2020-11-06,Uzbekistan,130,0,68139,579
2020-11-07,Uzbekistan,228,2,68367,581
2020-11-08,Uzbekistan,363,4,68730,585
2020-11-09,Uzbekistan,297,3,69027,588
2020-11-10,Uzbekistan,0,0,69027,588
2020-11-11,Uzbekistan,370,3,69397,591
2020-11-12,Uzbekistan,163,2,69560,593
2020-11-13,Uzbekistan,194,1,69754,594
2020-11-14,Uzbekistan,233,0,69987,594
2020-11-15,Uzbekistan,256,4,70243,598
2020-11-16,Uzbekistan,138,0,70381,598
2020-11-17,Uzbekistan,267,1,70648,599
2020-11-18,Uzbekistan,210,2,70858,601
2020-11-19,Uzbekistan,63,0,70921,601
2020-11-20,Uzbekistan,287,2,71208,603
2020-11-21,Uzbekistan,223,0,71431,603
2020-11-22,Uzbekistan,186,0,71617,603
2020-11-23,Uzbekistan,157,1,71774,604
2020-11-24,Uzbekistan,211,0,71985,604
2020-11-25,Uzbekistan,242,2,72227,606
2020-11-26,Uzbekistan,182,1,72409,607
2020-11-27,Uzbekistan,104,0,72513,607
2020-11-28,Uzbekistan,205,1,72718,608
2020-11-29,Uzbekistan,152,0,72870,608
2020-11-30,Uzbekistan,224,2,73094,610
2020-12-01,Uzbekistan,182,1,73276,611
2020-12-02,Uzbekistan,59,0,73335,611
2020-12-03,Uzbekistan,96,0,73431,611
2020-12-04,Uzbekistan,320,0,73751,611
2020-12-05,Uzbekistan,0,0,73751,611
2020-12-06,Uzbekistan,302,0,74053,611
2020-12-07,Uzbekistan,0,0,74053,611
2020-12-08,Uzbekistan,153,0,74206,611
2020-12-09,Uzbekistan,146,0,74352,611
2020-12-10,Uzbekistan,146,0,74498,611
2020-12-11,Uzbekistan,313,1,74811,612
2020-12-12,Uzbekistan,0,0,74811,612
2020-12-13,Uzbekistan,145,0,74956,612
2020-12-14,Uzbekistan,138,0,75094,612
2020-12-15,Uzbekistan,147,0,75241,612
2020-12-16,Uzbekistan,297,0,75538,612
2020-12-17,Uzbekistan,0,0,75538,612
2020-12-18,Uzbekistan,137,0,75675,612
2020-12-19,Uzbekistan,131,0,75806,612
2020-12-20,Uzbekistan,127,0,75933,612
2020-12-21,Uzbekistan,115,0,76048,612
2020-12-22,Uzbekistan,132,0,76180,612
2020-12-23,Uzbekistan,135,0,76315,612
2020-12-24,Uzbekistan,141,0,76456,612
2020-12-25,Uzbekistan,112,0,76568,612
2020-12-26,Uzbekistan,98,0,76666,612
2020-12-27,Uzbekistan,85,1,76751,613
2020-12-28,Uzbekistan,81,0,76832,613
2020-12-29,Uzbekistan,75,0,76907,613
2020-12-30,Uzbekistan,78,1,76985,614
2020-12-31,Uzbekistan,75,0,77060,614
2021-01-01,Uzbekistan,122,0,77182,614
2021-01-02,Uzbekistan,0,0,77182,614
2021-01-03,Uzbekistan,76,0,77258,614
2021-01-04,Uzbekistan,0,0,77258,614
2021-01-05,Uzbekistan,37,0,77295,614
2021-01-06,Uzbekistan,55,1,77350,615
2021-01-07,Uzbekistan,62,0,77412,615
2021-01-08,Uzbekistan,73,1,77485,616
2021-01-09,Uzbekistan,45,0,77530,616
2021-01-10,Uzbekistan,42,1,77572,617
2021-01-11,Uzbekistan,39,0,77611,617
2021-01-12,Uzbekistan,52,0,77663,617
2021-01-13,Uzbekistan,53,1,77716,618
2021-01-14,Uzbekistan,61,0,77777,618
2021-01-15,Uzbekistan,127,1,77904,619
2021-01-16,Uzbekistan,64,0,77968,619
2021-01-17,Uzbekistan,0,0,77968,619
2021-01-18,Uzbekistan,68,0,78036,619
2021-01-19,Uzbekistan,55,1,78091,620
2021-01-20,Uzbekistan,72,0,78163,620
2021-01-21,Uzbekistan,56,0,78219,620
2021-01-22,Uzbekistan,53,0,78272,620
2021-01-23,Uzbekistan,45,1,78317,621
2021-01-24,Uzbekistan,58,0,78375,621
2021-01-25,Uzbekistan,54,0,78429,621
2021-01-26,Uzbekistan,42,0,78471,621
2021-01-27,Uzbekistan,39,0,78510,621
2021-01-28,Uzbekistan,46,0,78556,621
2021-01-29,Uzbekistan,46,0,78602,621
2021-01-30,Uzbekistan,109,0,78711,621
2021-01-31,Uzbekistan,0,0,78711,621
2021-02-01,Uzbekistan,44,0,78755,621
2021-02-02,Uzbekistan,46,0,78801,621
2021-02-03,Uzbekistan,58,0,78859,621
2021-02-04,Uzbekistan,57,0,78916,621
2021-02-05,Uzbekistan,73,0,78989,621
2021-02-06,Uzbekistan,56,0,79045,621
2021-02-07,Uzbekistan,53,0,79098,621
2021-02-08,Uzbekistan,64,0,79162,621
2021-02-09,Uzbekistan,42,0,79204,621
2021-02-10,Uzbekistan,33,0,79237,621
2021-02-11,Uzbekistan,66,1,79303,622
2021-02-12,Uzbekistan,37,0,79340,622
2021-02-13,Uzbekistan,41,0,79381,622
2021-02-14,Uzbekistan,35,0,79416,622
2021-02-15,Uzbekistan,26,0,79442,622
2021-02-16,Uzbekistan,19,0,79461,622
2021-02-17,Uzbekistan,36,0,79497,622
2021-02-18,Uzbekistan,51,0,79548,622
2021-02-19,Uzbekistan,50,0,79598,622
2021-02-20,Uzbekistan,34,0,79632,622
2021-02-21,Uzbekistan,22,0,79654,622
2021-02-22,Uzbekistan,27,0,79681,622
2021-02-23,Uzbekistan,36,0,79717,622
2021-02-24,Uzbekistan,32,0,79749,622
2021-02-25,Uzbekistan,24,0,79773,622
2021-02-26,Uzbekistan,31,0,79804,622
2021-02-27,Uzbekistan,32,0,79836,622
2021-02-28,Uzbekistan,90,0,79926,622
2021-03-01,Uzbekistan,0,0,79926,622
2021-03-02,Uzbekistan,35,0,79961,622
2021-03-03,Uzbekistan,74,0,80035,622
2021-03-04,Uzbekistan,0,0,80035,622
2021-03-05,Uzbekistan,46,0,80081,622
2021-03-06,Uzbekistan,44,0,80125,622
2021-03-07,Uzbekistan,51,0,80176,622
2021-03-08,Uzbekistan,43,0,80219,622
2021-03-09,Uzbekistan,28,0,80247,622
2021-03-10,Uzbekistan,21,0,80268,622
2021-03-11,Uzbekistan,124,0,80392,622
2021-03-12,Uzbekistan,0,0,80392,622
2021-03-13,Uzbekistan,89,0,80481,622
2021-03-14,Uzbekistan,86,0,80567,622
2021-03-15,Uzbekistan,111,0,80678,622
2021-03-16,Uzbekistan,65,0,80743,622
2021-03-17,Uzbekistan,115,0,80858,622
2021-03-18,Uzbekistan,113,0,80971,622
2021-03-19,Uzbekistan,124,0,81095,622
2021-03-20,Uzbekistan,244,0,81339,622
2021-03-21,Uzbekistan,0,0,81339,622
2021-03-22,Uzbekistan,107,0,81446,622
2021-03-23,Uzbekistan,232,1,81678,623
2021-03-24,Uzbekistan,0,0,81678,623
2021-03-25,Uzbekistan,138,1,81816,624
2021-03-26,Uzbekistan,144,0,81960,624
2021-03-27,Uzbekistan,186,1,82146,625
2021-03-28,Uzbekistan,194,1,82340,626
2021-03-29,Uzbekistan,196,0,82536,626
2021-03-30,Uzbekistan,146,2,82682,628
2021-03-31,Uzbekistan,187,1,82869,629
2021-04-01,Uzbekistan,181,1,83050,630
2021-04-02,Uzbekistan,189,0,83239,630
2021-04-03,Uzbekistan,196,0,83435,630
2021-04-04,Uzbekistan,188,1,83623,631
2021-04-05,Uzbekistan,179,0,83802,631
2021-04-06,Uzbekistan,133,1,83935,632
2021-04-07,Uzbekistan,192,1,84127,633
2021-04-08,Uzbekistan,195,1,84322,634
2020-11-10,Vanuatu,1,0,1,0
2020-11-11,Vanuatu,0,0,1,0
2020-11-12,Vanuatu,0,0,1,0
2020-11-13,Vanuatu,0,0,1,0
2020-11-14,Vanuatu,0,0,1,0
2020-11-15,Vanuatu,0,0,1,0
2020-11-16,Vanuatu,0,0,1,0
2020-11-17,Vanuatu,0,0,1,0
2020-11-18,Vanuatu,0,0,1,0
2020-11-19,Vanuatu,0,0,1,0
2020-11-20,Vanuatu,0,0,1,0
2020-11-21,Vanuatu,0,0,1,0
2020-11-22,Vanuatu,0,0,1,0
2020-11-23,Vanuatu,0,0,1,0
2020-11-24,Vanuatu,0,0,1,0
2020-11-25,Vanuatu,0,0,1,0
2020-11-26,Vanuatu,0,0,1,0
2020-11-27,Vanuatu,0,0,1,0
2020-11-28,Vanuatu,0,0,1,0
2020-11-29,Vanuatu,0,0,1,0
2020-11-30,Vanuatu,0,0,1,0
2020-12-01,Vanuatu,0,0,1,0
2020-12-02,Vanuatu,0,0,1,0
2020-12-03,Vanuatu,0,0,1,0
2020-12-04,Vanuatu,0,0,1,0
2020-12-05,Vanuatu,0,0,1,0
2020-12-06,Vanuatu,0,0,1,0
2020-12-07,Vanuatu,0,0,1,0
2020-12-08,Vanuatu,0,0,1,0
2020-12-09,Vanuatu,0,0,1,0
2020-12-10,Vanuatu,0,0,1,0
2020-12-11,Vanuatu,0,0,1,0
2020-12-12,Vanuatu,0,0,1,0
2020-12-13,Vanuatu,0,0,1,0
2020-12-14,Vanuatu,0,0,1,0
2020-12-15,Vanuatu,0,0,1,0
2020-12-16,Vanuatu,0,0,1,0
2020-12-17,Vanuatu,0,0,1,0
2020-12-18,Vanuatu,0,0,1,0
2020-12-19,Vanuatu,0,0,1,0
2020-12-20,Vanuatu,0,0,1,0
2020-12-21,Vanuatu,0,0,1,0
2020-12-22,Vanuatu,0,0,1,0
2020-12-23,Vanuatu,0,0,1,0
2020-12-24,Vanuatu,0,0,1,0
2020-12-25,Vanuatu,0,0,1,0
2020-12-26,Vanuatu,0,0,1,0
2020-12-27,Vanuatu,0,0,1,0
2020-12-28,Vanuatu,0,0,1,0
2020-12-29,Vanuatu,0,0,1,0
2020-12-30,Vanuatu,0,0,1,0
2020-12-31,Vanuatu,0,0,1,0
2021-01-01,Vanuatu,0,0,1,0
2021-01-02,Vanuatu,0,0,1,0
2021-01-03,Vanuatu,0,0,1,0
2021-01-04,Vanuatu,0,0,1,0
2021-01-05,Vanuatu,0,0,1,0
2021-01-06,Vanuatu,0,0,1,0
2021-01-07,Vanuatu,0,0,1,0
2021-01-08,Vanuatu,0,0,1,0
2021-01-09,Vanuatu,0,0,1,0
2021-01-10,Vanuatu,0,0,1,0
2021-01-11,Vanuatu,0,0,1,0
2021-01-12,Vanuatu,0,0,1,0
2021-01-13,Vanuatu,0,0,1,0
2021-01-14,Vanuatu,0,0,1,0
2021-01-15,Vanuatu,0,0,1,0
2021-01-16,Vanuatu,0,0,1,0
2021-01-17,Vanuatu,0,0,1,0
2021-01-18,Vanuatu,0,0,1,0
2021-01-19,Vanuatu,0,0,1,0
2021-01-20,Vanuatu,0,0,1,0
2021-01-21,Vanuatu,0,0,1,0
2021-01-22,Vanuatu,0,0,1,0
2021-01-23,Vanuatu,0,0,1,0
2021-01-24,Vanuatu,0,0,1,0
2021-01-25,Vanuatu,0,0,1,0
2021-01-26,Vanuatu,0,0,1,0
2021-01-27,Vanuatu,0,0,1,0
2021-01-28,Vanuatu,0,0,1,0
2021-01-29,Vanuatu,0,0,1,0
2021-01-30,Vanuatu,0,0,1,0
2021-01-31,Vanuatu,0,0,1,0
2021-02-01,Vanuatu,0,0,1,0
2021-02-02,Vanuatu,0,0,1,0
2021-02-03,Vanuatu,0,0,1,0
2021-02-04,Vanuatu,0,0,1,0
2021-02-05,Vanuatu,0,0,1,0
2021-02-06,Vanuatu,0,0,1,0
2021-02-07,Vanuatu,0,0,1,0
2021-02-08,Vanuatu,0,0,1,0
2021-02-09,Vanuatu,0,0,1,0
2021-02-10,Vanuatu,0,0,1,0
2021-02-11,Vanuatu,0,0,1,0
2021-02-12,Vanuatu,0,0,1,0
2021-02-13,Vanuatu,0,0,1,0
2021-02-14,Vanuatu,0,0,1,0
2021-02-15,Vanuatu,0,0,1,0
2021-02-16,Vanuatu,0,0,1,0
2021-02-17,Vanuatu,0,0,1,0
2021-02-18,Vanuatu,0,0,1,0
2021-02-19,Vanuatu,0,0,1,0
2021-02-20,Vanuatu,0,0,1,0
2021-02-21,Vanuatu,0,0,1,0
2021-02-22,Vanuatu,0,0,1,0
2021-02-23,Vanuatu,0,0,1,0
2021-02-24,Vanuatu,0,0,1,0
2021-02-25,Vanuatu,0,0,1,0
2021-02-26,Vanuatu,0,0,1,0
2021-02-27,Vanuatu,0,0,1,0
2021-02-28,Vanuatu,0,0,1,0
2021-03-01,Vanuatu,0,0,1,0
2021-03-02,Vanuatu,0,0,1,0
2021-03-03,Vanuatu,0,0,1,0
2021-03-04,Vanuatu,0,0,1,0
2021-03-05,Vanuatu,0,0,1,0
2021-03-06,Vanuatu,0,0,1,0
2021-03-07,Vanuatu,0,0,1,0
2021-03-08,Vanuatu,2,0,3,0
2021-03-09,Vanuatu,0,0,3,0
2021-03-10,Vanuatu,0,0,3,0
2021-03-11,Vanuatu,0,0,3,0
2021-03-12,Vanuatu,0,0,3,0
2021-03-13,Vanuatu,0,0,3,0
2021-03-14,Vanuatu,0,0,3,0
2021-03-15,Vanuatu,0,0,3,0
2021-03-16,Vanuatu,0,0,3,0
2021-03-17,Vanuatu,0,0,3,0
2021-03-18,Vanuatu,0,0,3,0
2021-03-19,Vanuatu,0,0,3,0
2021-03-20,Vanuatu,0,0,3,0
2021-03-21,Vanuatu,0,0,3,0
2021-03-22,Vanuatu,0,0,3,0
2021-03-23,Vanuatu,0,0,3,0
2021-03-24,Vanuatu,0,0,3,0
2021-03-25,Vanuatu,0,0,3,0
2021-03-26,Vanuatu,0,0,3,0
2021-03-27,Vanuatu,0,0,3,0
2021-03-28,Vanuatu,0,0,3,0
2021-03-29,Vanuatu,0,0,3,0
2021-03-30,Vanuatu,0,0,3,0
2021-03-31,Vanuatu,0,0,3,0
2021-04-01,Vanuatu,0,0,3,0
2021-04-02,Vanuatu,0,0,3,0
2021-04-03,Vanuatu,0,0,3,0
2021-04-04,Vanuatu,0,0,3,0
2021-04-05,Vanuatu,0,0,3,0
2021-04-06,Vanuatu,0,0,3,0
2021-04-07,Vanuatu,0,0,3,0
2021-04-08,Vanuatu,0,0,3,0
2020-03-06,Vatican,1,0,1,0
2020-03-07,Vatican,0,0,1,0
2020-03-08,Vatican,0,0,1,0
2020-03-09,Vatican,0,0,1,0
2020-03-10,Vatican,0,0,1,0
2020-03-11,Vatican,0,0,1,0
2020-03-12,Vatican,0,0,1,0
2020-03-13,Vatican,0,0,1,0
2020-03-14,Vatican,0,0,1,0
2020-03-15,Vatican,0,0,1,0
2020-03-16,Vatican,0,0,1,0
2020-03-17,Vatican,0,0,1,0
2020-03-18,Vatican,0,0,1,0
2020-03-19,Vatican,0,0,1,0
2020-03-20,Vatican,0,0,1,0
2020-03-21,Vatican,0,0,1,0
2020-03-22,Vatican,0,0,1,0
2020-03-23,Vatican,0,0,1,0
2020-03-24,Vatican,3,0,4,0
2020-03-25,Vatican,0,0,4,0
2020-03-26,Vatican,0,0,4,0
2020-03-27,Vatican,0,0,4,0
2020-03-28,Vatican,2,0,6,0
2020-03-29,Vatican,0,0,6,0
2020-03-30,Vatican,0,0,6,0
2020-03-31,Vatican,0,0,6,0
2020-04-01,Vatican,0,0,6,0
2020-04-02,Vatican,1,0,7,0
2020-04-03,Vatican,0,0,7,0
2020-04-04,Vatican,0,0,7,0
2020-04-05,Vatican,0,0,7,0
2020-04-06,Vatican,0,0,7,0
2020-04-07,Vatican,0,0,7,0
2020-04-08,Vatican,1,0,8,0
2020-04-09,Vatican,0,0,8,0
2020-04-10,Vatican,0,0,8,0
2020-04-11,Vatican,0,0,8,0
2020-04-12,Vatican,0,0,8,0
2020-04-13,Vatican,0,0,8,0
2020-04-14,Vatican,0,0,8,0
2020-04-15,Vatican,0,0,8,0
2020-04-16,Vatican,0,0,8,0
2020-04-17,Vatican,0,0,8,0
2020-04-18,Vatican,0,0,8,0
2020-04-19,Vatican,0,0,8,0
2020-04-20,Vatican,1,0,9,0
2020-04-21,Vatican,0,0,9,0
2020-04-22,Vatican,0,0,9,0
2020-04-23,Vatican,0,0,9,0
2020-04-24,Vatican,0,0,9,0
2020-04-25,Vatican,0,0,9,0
2020-04-26,Vatican,0,0,9,0
2020-04-27,Vatican,0,0,9,0
2020-04-28,Vatican,1,0,10,0
2020-04-29,Vatican,0,0,10,0
2020-04-30,Vatican,1,0,11,0
2020-05-01,Vatican,0,0,11,0
2020-05-02,Vatican,0,0,11,0
2020-05-03,Vatican,0,0,11,0
2020-05-04,Vatican,0,0,11,0
2020-05-05,Vatican,0,0,11,0
2020-05-06,Vatican,1,0,12,0
2020-05-07,Vatican,0,0,12,0
2020-05-08,Vatican,0,0,12,0
2020-05-09,Vatican,0,0,12,0
2020-05-10,Vatican,0,0,12,0
2020-05-11,Vatican,0,0,12,0
2020-05-12,Vatican,0,0,12,0
2020-05-13,Vatican,0,0,12,0
2020-05-14,Vatican,0,0,12,0
2020-05-15,Vatican,0,0,12,0
2020-05-16,Vatican,0,0,12,0
2020-05-17,Vatican,0,0,12,0
2020-05-18,Vatican,0,0,12,0
2020-05-19,Vatican,0,0,12,0
2020-05-20,Vatican,0,0,12,0
2020-05-21,Vatican,0,0,12,0
2020-05-22,Vatican,0,0,12,0
2020-05-23,Vatican,0,0,12,0
2020-05-24,Vatican,0,0,12,0
2020-05-25,Vatican,0,0,12,0
2020-05-26,Vatican,0,0,12,0
2020-05-27,Vatican,0,0,12,0
2020-05-28,Vatican,0,0,12,0
2020-05-29,Vatican,0,0,12,0
2020-05-30,Vatican,0,0,12,0
2020-05-31,Vatican,0,0,12,0
2020-06-01,Vatican,0,0,12,0
2020-06-02,Vatican,0,0,12,0
2020-06-03,Vatican,0,0,12,0
2020-06-04,Vatican,0,0,12,0
2020-06-05,Vatican,0,0,12,0
2020-06-06,Vatican,0,0,12,0
2020-06-07,Vatican,0,0,12,0
2020-06-08,Vatican,0,0,12,0
2020-06-09,Vatican,0,0,12,0
2020-06-10,Vatican,0,0,12,0
2020-06-11,Vatican,0,0,12,0
2020-06-12,Vatican,0,0,12,0
2020-06-13,Vatican,0,0,12,0
2020-06-14,Vatican,0,0,12,0
2020-06-15,Vatican,0,0,12,0
2020-06-16,Vatican,0,0,12,0
2020-06-17,Vatican,0,0,12,0
2020-06-18,Vatican,0,0,12,0
2020-06-19,Vatican,0,0,12,0
2020-06-20,Vatican,0,0,12,0
2020-06-21,Vatican,0,0,12,0
2020-06-22,Vatican,0,0,12,0
2020-06-23,Vatican,0,0,12,0
2020-06-24,Vatican,0,0,12,0
2020-06-25,Vatican,0,0,12,0
2020-06-26,Vatican,0,0,12,0
2020-06-27,Vatican,0,0,12,0
2020-06-28,Vatican,0,0,12,0
2020-06-29,Vatican,0,0,12,0
2020-06-30,Vatican,0,0,12,0
2020-07-01,Vatican,0,0,12,0
2020-07-02,Vatican,0,0,12,0
2020-07-03,Vatican,0,0,12,0
2020-07-04,Vatican,0,0,12,0
2020-07-05,Vatican,0,0,12,0
2020-07-06,Vatican,0,0,12,0
2020-07-07,Vatican,0,0,12,0
2020-07-08,Vatican,0,0,12,0
2020-07-09,Vatican,0,0,12,0
2020-07-10,Vatican,0,0,12,0
2020-07-11,Vatican,0,0,12,0
2020-07-12,Vatican,0,0,12,0
2020-07-13,Vatican,0,0,12,0
2020-07-14,Vatican,0,0,12,0
2020-07-15,Vatican,0,0,12,0
2020-07-16,Vatican,0,0,12,0
2020-07-17,Vatican,0,0,12,0
2020-07-18,Vatican,0,0,12,0
2020-07-19,Vatican,0,0,12,0
2020-07-20,Vatican,0,0,12,0
2020-07-21,Vatican,0,0,12,0
2020-07-22,Vatican,0,0,12,0
2020-07-23,Vatican,0,0,12,0
2020-07-24,Vatican,0,0,12,0
2020-07-25,Vatican,0,0,12,0
2020-07-26,Vatican,0,0,12,0
2020-07-27,Vatican,0,0,12,0
2020-07-28,Vatican,0,0,12,0
2020-07-29,Vatican,0,0,12,0
2020-07-30,Vatican,0,0,12,0
2020-07-31,Vatican,0,0,12,0
2020-08-01,Vatican,0,0,12,0
2020-08-02,Vatican,0,0,12,0
2020-08-03,Vatican,0,0,12,0
2020-08-04,Vatican,0,0,12,0
2020-08-05,Vatican,0,0,12,0
2020-08-06,Vatican,0,0,12,0
2020-08-07,Vatican,0,0,12,0
2020-08-08,Vatican,0,0,12,0
2020-08-09,Vatican,0,0,12,0
2020-08-10,Vatican,0,0,12,0
2020-08-11,Vatican,0,0,12,0
2020-08-12,Vatican,0,0,12,0
2020-08-13,Vatican,0,0,12,0
2020-08-14,Vatican,0,0,12,0
2020-08-15,Vatican,0,0,12,0
2020-08-16,Vatican,0,0,12,0
2020-08-17,Vatican,0,0,12,0
2020-08-18,Vatican,0,0,12,0
2020-08-19,Vatican,0,0,12,0
2020-08-20,Vatican,0,0,12,0
2020-08-21,Vatican,0,0,12,0
2020-08-22,Vatican,0,0,12,0
2020-08-23,Vatican,0,0,12,0
2020-08-24,Vatican,0,0,12,0
2020-08-25,Vatican,0,0,12,0
2020-08-26,Vatican,0,0,12,0
2020-08-27,Vatican,0,0,12,0
2020-08-28,Vatican,0,0,12,0
2020-08-29,Vatican,0,0,12,0
2020-08-30,Vatican,0,0,12,0
2020-08-31,Vatican,0,0,12,0
2020-09-01,Vatican,0,0,12,0
2020-09-02,Vatican,0,0,12,0
2020-09-03,Vatican,0,0,12,0
2020-09-04,Vatican,0,0,12,0
2020-09-05,Vatican,0,0,12,0
2020-09-06,Vatican,0,0,12,0
2020-09-07,Vatican,0,0,12,0
2020-09-08,Vatican,0,0,12,0
2020-09-09,Vatican,0,0,12,0
2020-09-10,Vatican,0,0,12,0
2020-09-11,Vatican,0,0,12,0
2020-09-12,Vatican,0,0,12,0
2020-09-13,Vatican,0,0,12,0
2020-09-14,Vatican,0,0,12,0
2020-09-15,Vatican,0,0,12,0
2020-09-16,Vatican,0,0,12,0
2020-09-17,Vatican,0,0,12,0
2020-09-18,Vatican,0,0,12,0
2020-09-19,Vatican,0,0,12,0
2020-09-20,Vatican,0,0,12,0
2020-09-21,Vatican,0,0,12,0
2020-09-22,Vatican,0,0,12,0
2020-09-23,Vatican,0,0,12,0
2020-09-24,Vatican,0,0,12,0
2020-09-25,Vatican,0,0,12,0
2020-09-26,Vatican,0,0,12,0
2020-09-27,Vatican,0,0,12,0
2020-09-28,Vatican,0,0,12,0
2020-09-29,Vatican,0,0,12,0
2020-09-30,Vatican,0,0,12,0
2020-10-01,Vatican,0,0,12,0
2020-10-02,Vatican,0,0,12,0
2020-10-03,Vatican,0,0,12,0
2020-10-04,Vatican,0,0,12,0
2020-10-05,Vatican,0,0,12,0
2020-10-06,Vatican,0,0,12,0
2020-10-07,Vatican,0,0,12,0
2020-10-08,Vatican,0,0,12,0
2020-10-09,Vatican,0,0,12,0
2020-10-10,Vatican,0,0,12,0
2020-10-11,Vatican,0,0,12,0
2020-10-12,Vatican,7,0,19,0
2020-10-13,Vatican,0,0,19,0
2020-10-14,Vatican,0,0,19,0
2020-10-15,Vatican,7,0,26,0
2020-10-16,Vatican,0,0,26,0
2020-10-17,Vatican,1,0,27,0
2020-10-18,Vatican,0,0,27,0
2020-10-19,Vatican,0,0,27,0
2020-10-20,Vatican,0,0,27,0
2020-10-21,Vatican,0,0,27,0
2020-10-22,Vatican,0,0,27,0
2020-10-23,Vatican,0,0,27,0
2020-10-24,Vatican,0,0,27,0
2020-10-25,Vatican,0,0,27,0
2020-10-26,Vatican,0,0,27,0
2020-10-27,Vatican,0,0,27,0
2020-10-28,Vatican,0,0,27,0
2020-10-29,Vatican,0,0,27,0
2020-10-30,Vatican,0,0,27,0
2020-10-31,Vatican,0,0,27,0
2020-11-01,Vatican,0,0,27,0
2020-11-02,Vatican,0,0,27,0
2020-11-03,Vatican,0,0,27,0
2020-11-04,Vatican,0,0,27,0
2020-11-05,Vatican,0,0,27,0
2020-11-06,Vatican,0,0,27,0
2020-11-07,Vatican,0,0,27,0
2020-11-08,Vatican,0,0,27,0
2020-11-09,Vatican,0,0,27,0
2020-11-10,Vatican,0,0,27,0
2020-11-11,Vatican,0,0,27,0
2020-11-12,Vatican,0,0,27,0
2020-11-13,Vatican,0,0,27,0
2020-11-14,Vatican,0,0,27,0
2020-11-15,Vatican,0,0,27,0
2020-11-16,Vatican,0,0,27,0
2020-11-17,Vatican,0,0,27,0
2020-11-18,Vatican,0,0,27,0
2020-11-19,Vatican,0,0,27,0
2020-11-20,Vatican,0,0,27,0
2020-11-21,Vatican,0,0,27,0
2020-11-22,Vatican,0,0,27,0
2020-11-23,Vatican,0,0,27,0
2020-11-24,Vatican,0,0,27,0
2020-11-25,Vatican,0,0,27,0
2020-11-26,Vatican,0,0,27,0
2020-11-27,Vatican,0,0,27,0
2020-11-28,Vatican,0,0,27,0
2020-11-29,Vatican,0,0,27,0
2020-11-30,Vatican,0,0,27,0
2020-12-01,Vatican,0,0,27,0
2020-12-02,Vatican,0,0,27,0
2020-12-03,Vatican,0,0,27,0
2020-12-04,Vatican,0,0,27,0
2020-12-05,Vatican,0,0,27,0
2020-12-06,Vatican,0,0,27,0
2020-12-07,Vatican,0,0,27,0
2020-12-08,Vatican,0,0,27,0
2020-12-09,Vatican,0,0,27,0
2020-12-10,Vatican,0,0,27,0
2020-12-11,Vatican,0,0,27,0
2020-12-12,Vatican,0,0,27,0
2020-12-13,Vatican,0,0,27,0
2020-12-14,Vatican,0,0,27,0
2020-12-15,Vatican,0,0,27,0
2020-12-16,Vatican,0,0,27,0
2020-12-17,Vatican,0,0,27,0
2020-12-18,Vatican,0,0,27,0
2020-12-19,Vatican,0,0,27,0
2020-12-20,Vatican,0,0,27,0
2020-12-21,Vatican,0,0,27,0
2020-12-22,Vatican,0,0,27,0
2020-12-23,Vatican,0,0,27,0
2020-12-24,Vatican,0,0,27,0
2020-12-25,Vatican,0,0,27,0
2020-12-26,Vatican,0,0,27,0
2020-12-27,Vatican,0,0,27,0
2020-12-28,Vatican,0,0,27,0
2020-12-29,Vatican,0,0,27,0
2020-12-30,Vatican,0,0,27,0
2020-12-31,Vatican,0,0,27,0
2021-01-01,Vatican,0,0,27,0
2021-01-02,Vatican,0,0,27,0
2021-01-03,Vatican,0,0,27,0
2021-01-04,Vatican,0,0,27,0
2021-01-05,Vatican,0,0,27,0
2021-01-06,Vatican,0,0,27,0
2021-01-07,Vatican,0,0,27,0
2021-01-08,Vatican,0,0,27,0
2021-01-09,Vatican,0,0,27,0
2021-01-10,Vatican,0,0,27,0
2021-01-11,Vatican,0,0,27,0
2021-01-12,Vatican,0,0,27,0
2021-01-13,Vatican,0,0,27,0
2021-01-14,Vatican,0,0,27,0
2021-01-15,Vatican,0,0,27,0
2021-01-16,Vatican,0,0,27,0
2021-01-17,Vatican,0,0,27,0
2021-01-18,Vatican,0,0,27,0
2021-01-19,Vatican,0,0,27,0
2021-01-20,Vatican,0,0,27,0
2021-01-21,Vatican,0,0,27,0
2021-01-22,Vatican,0,0,27,0
2021-01-23,Vatican,0,0,27,0
2021-01-24,Vatican,0,0,27,0
2021-01-25,Vatican,0,0,27,0
2021-01-26,Vatican,0,0,27,0
2021-01-27,Vatican,0,0,27,0
2021-01-28,Vatican,0,0,27,0
2021-01-29,Vatican,0,0,27,0
2021-01-30,Vatican,0,0,27,0
2021-01-31,Vatican,0,0,27,0
2021-02-01,Vatican,0,0,27,0
2021-02-02,Vatican,0,0,27,0
2021-02-03,Vatican,0,0,27,0
2021-02-04,Vatican,0,0,27,0
2021-02-05,Vatican,0,0,27,0
2021-02-06,Vatican,0,0,27,0
2021-02-07,Vatican,0,0,27,0
2021-02-08,Vatican,0,0,27,0
2021-02-09,Vatican,0,0,27,0
2021-02-10,Vatican,0,0,27,0
2021-02-11,Vatican,0,0,27,0
2021-02-12,Vatican,0,0,27,0
2021-02-13,Vatican,0,0,27,0
2021-02-14,Vatican,0,0,27,0
2021-02-15,Vatican,0,0,27,0
2021-02-16,Vatican,0,0,27,0
2021-02-17,Vatican,0,0,27,0
2021-02-18,Vatican,0,0,27,0
2021-02-19,Vatican,0,0,27,0
2021-02-20,Vatican,0,0,27,0
2021-02-21,Vatican,0,0,27,0
2021-02-22,Vatican,0,0,27,0
2021-02-23,Vatican,0,0,27,0
2021-02-24,Vatican,0,0,27,0
2021-02-25,Vatican,0,0,27,0
2021-02-26,Vatican,0,0,27,0
2021-02-27,Vatican,0,0,27,0
2021-02-28,Vatican,0,0,27,0
2021-03-01,Vatican,0,0,27,0
2021-03-02,Vatican,0,0,27,0
2021-03-03,Vatican,0,0,27,0
2021-03-04,Vatican,0,0,27,0
2021-03-05,Vatican,0,0,27,0
2021-03-06,Vatican,0,0,27,0
2021-03-07,Vatican,0,0,27,0
2021-03-08,Vatican,0,0,27,0
2021-03-09,Vatican,0,0,27,0
2021-03-10,Vatican,0,0,27,0
2021-03-11,Vatican,0,0,27,0
2021-03-12,Vatican,0,0,27,0
2021-03-13,Vatican,0,0,27,0
2021-03-14,Vatican,0,0,27,0
2021-03-15,Vatican,0,0,27,0
2021-03-16,Vatican,0,0,27,0
2021-03-17,Vatican,0,0,27,0
2021-03-18,Vatican,0,0,27,0
2021-03-19,Vatican,0,0,27,0
2021-03-20,Vatican,0,0,27,0
2021-03-21,Vatican,0,0,27,0
2021-03-22,Vatican,0,0,27,0
2021-03-23,Vatican,0,0,27,0
2021-03-24,Vatican,0,0,27,0
2021-03-25,Vatican,0,0,27,0
2021-03-26,Vatican,0,0,27,0
2021-03-27,Vatican,0,0,27,0
2021-03-28,Vatican,0,0,27,0
2021-03-29,Vatican,0,0,27,0
2021-03-30,Vatican,0,0,27,0
2021-03-31,Vatican,0,0,27,0
2021-04-01,Vatican,0,0,27,0
2021-04-02,Vatican,0,0,27,0
2021-04-03,Vatican,0,0,27,0
2021-04-04,Vatican,0,0,27,0
2021-04-05,Vatican,0,0,27,0
2021-04-06,Vatican,0,0,27,0
2021-04-07,Vatican,0,0,27,0
2021-04-08,Vatican,0,0,27,0
2020-03-14,Venezuela,2,0,2,0
2020-03-15,Venezuela,8,0,10,0
2020-03-16,Venezuela,7,0,17,0
2020-03-17,Venezuela,16,0,33,0
2020-03-18,Venezuela,3,0,36,0
2020-03-19,Venezuela,6,0,42,0
2020-03-20,Venezuela,0,0,42,0
2020-03-21,Venezuela,28,0,70,0
2020-03-22,Venezuela,0,0,70,0
2020-03-23,Venezuela,7,0,77,0
2020-03-24,Venezuela,7,0,84,0
2020-03-25,Venezuela,7,0,91,0
2020-03-26,Venezuela,16,0,107,0
2020-03-27,Venezuela,0,1,107,1
2020-03-28,Venezuela,12,1,119,2
2020-03-29,Venezuela,0,0,119,2
2020-03-30,Venezuela,16,1,135,3
2020-03-31,Venezuela,0,0,135,3
2020-04-01,Venezuela,8,0,143,3
2020-04-02,Venezuela,3,2,146,5
2020-04-03,Venezuela,7,2,153,7
2020-04-04,Venezuela,2,0,155,7
2020-04-05,Venezuela,4,0,159,7
2020-04-06,Venezuela,6,0,165,7
2020-04-07,Venezuela,0,0,165,7
2020-04-08,Venezuela,2,2,167,9
2020-04-09,Venezuela,4,0,171,9
2020-04-10,Venezuela,0,0,171,9
2020-04-11,Venezuela,4,0,175,9
2020-04-12,Venezuela,6,0,181,9
2020-04-13,Venezuela,8,0,189,9
2020-04-14,Venezuela,0,0,189,9
2020-04-15,Venezuela,8,0,197,9
2020-04-16,Venezuela,7,0,204,9
2020-04-17,Venezuela,0,0,204,9
2020-04-18,Venezuela,23,0,227,9
2020-04-19,Venezuela,29,0,256,9
2020-04-20,Venezuela,0,0,256,9
2020-04-21,Venezuela,29,1,285,10
2020-04-22,Venezuela,3,0,288,10
2020-04-23,Venezuela,23,0,311,10
2020-04-24,Venezuela,7,0,318,10
2020-04-25,Venezuela,5,0,323,10
2020-04-26,Venezuela,2,0,325,10
2020-04-27,Venezuela,4,0,329,10
2020-04-28,Venezuela,0,0,329,10
2020-04-29,Venezuela,2,0,331,10
2020-04-30,Venezuela,2,6,333,16
2020-05-01,Venezuela,2,-6,335,10
2020-05-02,Venezuela,10,0,345,10
2020-05-03,Venezuela,12,0,357,10
2020-05-04,Venezuela,0,0,357,10
2020-05-05,Venezuela,4,0,361,10
2020-05-06,Venezuela,18,0,379,10
2020-05-07,Venezuela,2,0,381,10
2020-05-08,Venezuela,7,0,388,10
2020-05-09,Venezuela,14,0,402,10
2020-05-10,Venezuela,12,0,414,10
2020-05-11,Venezuela,8,0,422,10
2020-05-12,Venezuela,1,0,423,10
2020-05-13,Venezuela,0,0,423,10
2020-05-14,Venezuela,32,0,455,10
2020-05-15,Venezuela,4,0,459,10
2020-05-16,Venezuela,45,0,504,10
2020-05-17,Venezuela,37,0,541,10
2020-05-18,Venezuela,77,0,618,10
2020-05-19,Venezuela,131,0,749,10
2020-05-20,Venezuela,75,0,824,10
2020-05-21,Venezuela,58,0,882,10
2020-05-22,Venezuela,62,0,944,10
2020-05-23,Venezuela,66,0,1010,10
2020-05-24,Venezuela,111,0,1121,10
2020-05-25,Venezuela,56,0,1177,10
2020-05-26,Venezuela,34,1,1211,11
2020-05-27,Venezuela,34,0,1245,11
2020-05-28,Venezuela,80,0,1325,11
2020-05-29,Venezuela,45,3,1370,14
2020-05-30,Venezuela,89,0,1459,14
2020-05-31,Venezuela,51,0,1510,14
2020-06-01,Venezuela,152,3,1662,17
2020-06-02,Venezuela,157,1,1819,18
2020-06-03,Venezuela,133,2,1952,20
2020-06-04,Venezuela,135,0,2087,20
2020-06-05,Venezuela,58,0,2145,20
2020-06-06,Venezuela,171,2,2316,22
2020-06-07,Venezuela,61,0,2377,22
2020-06-08,Venezuela,96,0,2473,22
2020-06-09,Venezuela,159,1,2632,23
2020-06-10,Venezuela,106,0,2738,23
2020-06-11,Venezuela,76,0,2814,23
2020-06-12,Venezuela,65,0,2879,23
2020-06-13,Venezuela,25,1,2904,24
2020-06-14,Venezuela,74,1,2978,25
2020-06-15,Venezuela,84,1,3062,26
2020-06-16,Venezuela,88,1,3150,27
2020-06-17,Venezuela,236,1,3386,28
2020-06-18,Venezuela,97,0,3483,28
2020-06-19,Venezuela,108,2,3591,30
2020-06-20,Venezuela,198,3,3789,33
2020-06-21,Venezuela,128,0,3917,33
2020-06-22,Venezuela,131,2,4048,35
2020-06-23,Venezuela,139,0,4187,35
2020-06-24,Venezuela,179,3,4366,38
2020-06-25,Venezuela,197,1,4563,39
2020-06-26,Venezuela,216,2,4779,41
2020-06-27,Venezuela,351,1,5130,42
2020-06-28,Venezuela,167,2,5297,44
2020-06-29,Venezuela,233,4,5530,48
2020-06-30,Venezuela,302,3,5832,51
2020-07-01,Venezuela,230,3,6062,54
2020-07-02,Venezuela,211,3,6273,57
2020-07-03,Venezuela,264,2,6537,59
2020-07-04,Venezuela,213,3,6750,62
2020-07-05,Venezuela,419,3,7169,65
2020-07-06,Venezuela,242,3,7411,68
2020-07-07,Venezuela,282,3,7693,71
2020-07-08,Venezuela,315,4,8008,75
2020-07-09,Venezuela,364,5,8372,80
2020-07-10,Venezuela,431,3,8803,83
2020-07-11,Venezuela,375,2,9178,85
2020-07-12,Venezuela,287,4,9465,89
2020-07-13,Venezuela,242,4,9707,93
2020-07-14,Venezuela,303,3,10010,96
2020-07-15,Venezuela,418,4,10428,100
2020-07-16,Venezuela,426,4,10854,104
2020-07-17,Venezuela,337,3,11191,107
2020-07-18,Venezuela,292,3,11483,110
2020-07-19,Venezuela,408,2,11891,112
2020-07-20,Venezuela,443,4,12334,116
2020-07-21,Venezuela,440,4,12774,120
2020-07-22,Venezuela,390,4,13164,124
2020-07-23,Venezuela,449,5,13613,129
2020-07-24,Venezuela,650,5,14263,134
2020-07-25,Venezuela,666,4,14929,138
2020-07-26,Venezuela,534,4,15463,142
2020-07-27,Venezuela,525,4,15988,146
2020-07-28,Venezuela,583,5,16571,151
2020-07-29,Venezuela,587,5,17158,156
2020-07-30,Venezuela,701,2,17859,158
2020-07-31,Venezuela,715,6,18574,164
2020-08-01,Venezuela,869,5,19443,169
2020-08-02,Venezuela,763,5,20206,174
2020-08-03,Venezuela,548,6,20754,180
2020-08-04,Venezuela,684,7,21438,187
2020-08-05,Venezuela,861,8,22299,195
2020-08-06,Venezuela,981,7,23280,202
2020-08-07,Venezuela,886,6,24166,208
2020-08-08,Venezuela,795,7,24961,215
2020-08-09,Venezuela,844,8,25805,223
2020-08-10,Venezuela,995,6,26800,229
2020-08-11,Venezuela,1138,9,27938,238
2020-08-12,Venezuela,1150,9,29088,247
2020-08-13,Venezuela,1281,12,30369,259
2020-08-14,Venezuela,1012,7,31381,266
2020-08-15,Venezuela,1226,10,32607,276
2020-08-16,Venezuela,1148,5,33755,281
2020-08-17,Venezuela,1047,7,34802,288
2020-08-18,Venezuela,895,9,35697,297
2020-08-19,Venezuela,1171,6,36868,303
2020-08-20,Venezuela,699,8,37567,311
2020-08-21,Venezuela,652,6,38219,317
2020-08-22,Venezuela,738,6,38957,323
2020-08-23,Venezuela,607,6,39564,329
2020-08-24,Venezuela,774,8,40338,337
2020-08-25,Venezuela,820,6,41158,343
2020-08-26,Venezuela,807,8,41965,351
2020-08-27,Venezuela,933,7,42898,358
2020-08-28,Venezuela,981,8,43879,366
2020-08-29,Venezuela,1067,9,44946,375
2020-08-30,Venezuela,922,6,45868,381
2020-08-31,Venezuela,860,5,46728,386
2020-09-01,Venezuela,1028,5,47756,391
2020-09-02,Venezuela,1127,7,48883,398
2020-09-03,Venezuela,994,4,49877,402
2020-09-04,Venezuela,1096,10,50973,412
2020-09-05,Venezuela,1192,8,52165,420
2020-09-06,Venezuela,1124,8,53289,428
2020-09-07,Venezuela,1061,8,54350,436
2020-09-08,Venezuela,1213,8,55563,444
2020-09-09,Venezuela,1188,8,56751,452
2020-09-10,Venezuela,1072,8,57823,460
2020-09-11,Venezuela,840,8,58663,468
2020-09-12,Venezuela,967,9,59630,477
2020-09-13,Venezuela,910,8,60540,485
2020-09-14,Venezuela,1029,9,61569,494
2020-09-15,Venezuela,1086,8,62655,502
2020-09-16,Venezuela,761,9,63416,511
2020-09-17,Venezuela,868,9,64284,520
2020-09-18,Venezuela,890,10,65174,530
2020-09-19,Venezuela,775,9,65949,539
2020-09-20,Venezuela,707,8,66656,547
2020-09-21,Venezuela,787,8,67443,555
2020-09-22,Venezuela,1010,9,68453,564
2020-09-23,Venezuela,986,10,69439,574
2020-09-24,Venezuela,967,7,70406,581
2020-09-25,Venezuela,867,10,71273,591
2020-09-26,Venezuela,667,9,71940,600
2020-09-27,Venezuela,751,6,72691,606
2020-09-28,Venezuela,837,8,73528,614
2020-09-29,Venezuela,835,7,74363,621
2020-09-30,Venezuela,759,7,75122,628
2020-10-01,Venezuela,907,7,76029,635
2020-10-02,Venezuela,791,8,76820,643
2020-10-03,Venezuela,826,6,77646,649
2020-10-04,Venezuela,788,4,78434,653
2020-10-05,Venezuela,683,5,79117,658
2020-10-06,Venezuela,679,7,79796,665
2020-10-07,Venezuela,608,6,80404,671
2020-10-08,Venezuela,615,7,81019,678
2020-10-09,Venezuela,677,6,81696,684
2020-10-10,Venezuela,757,7,82453,691
2020-10-11,Venezuela,684,6,83137,697
2020-10-12,Venezuela,619,7,83756,704
2020-10-13,Venezuela,635,6,84391,710
2020-10-14,Venezuela,614,4,85005,714
2020-10-15,Venezuela,464,6,85469,720
2020-10-16,Venezuela,289,5,85758,725
2020-10-17,Venezuela,531,6,86289,731
2020-10-18,Venezuela,347,5,86636,736
2020-10-19,Venezuela,0,0,86636,736
2020-10-20,Venezuela,1008,11,87644,747
2020-10-21,Venezuela,391,6,88035,753
2020-10-22,Venezuela,381,6,88416,759
2020-10-23,Venezuela,302,5,88718,764
2020-10-24,Venezuela,424,6,89142,770
2020-10-25,Venezuela,423,3,89565,773
2020-10-26,Venezuela,482,4,90047,777
2020-10-27,Venezuela,353,3,90400,780
2020-10-28,Venezuela,476,4,90876,784
2020-10-29,Venezuela,404,5,91280,789
2020-10-30,Venezuela,309,4,91589,793
2020-10-31,Venezuela,424,5,92013,798
2020-11-01,Venezuela,312,3,92325,801
2020-11-02,Venezuela,380,5,92705,806
2020-11-03,Venezuela,395,4,93100,810
2020-11-04,Venezuela,380,4,93480,814
2020-11-05,Venezuela,441,5,93921,819
2020-11-06,Venezuela,384,2,94305,821
2020-11-07,Venezuela,393,3,94698,824
2020-11-08,Venezuela,185,2,94883,826
2020-11-09,Venezuela,266,4,95149,830
2020-11-10,Venezuela,296,4,95445,834
2020-11-11,Venezuela,305,4,95750,838
2020-11-12,Venezuela,390,3,96140,841
2020-11-13,Venezuela,301,3,96441,844
2020-11-14,Venezuela,492,4,96933,848
2020-11-15,Venezuela,419,3,97352,851
2020-11-16,Venezuela,387,4,97739,855
2020-11-17,Venezuela,311,3,98050,858
2020-11-18,Venezuela,300,2,98350,860
2020-11-19,Venezuela,315,3,98665,863
2020-11-20,Venezuela,352,3,99017,866
2020-11-21,Venezuela,418,3,99435,869
2020-11-22,Venezuela,400,2,99835,871
2020-11-23,Venezuela,308,2,100143,873
2020-11-24,Venezuela,355,3,100498,876
2020-11-25,Venezuela,319,4,100817,880
2020-11-26,Venezuela,398,4,101215,884
2020-11-27,Venezuela,309,4,101524,888
2020-11-28,Venezuela,236,4,101760,892
2020-11-29,Venezuela,280,2,102040,894
2020-11-30,Venezuela,354,3,102394,897
2020-12-01,Venezuela,227,4,102621,901
2020-12-02,Venezuela,446,4,103067,905
2020-12-03,Venezuela,481,4,103548,909
2020-12-04,Venezuela,329,4,103877,913
2020-12-05,Venezuela,300,3,104177,916
2020-12-06,Venezuela,265,3,104442,919
2020-12-07,Venezuela,462,5,104904,924
2020-12-08,Venezuela,480,4,105384,928
2020-12-09,Venezuela,468,5,105852,933
2020-12-10,Venezuela,428,5,106280,938
2020-12-11,Venezuela,435,6,106715,944
2020-12-12,Venezuela,462,5,107177,949
2020-12-13,Venezuela,609,5,107786,954
2020-12-14,Venezuela,339,6,108125,960
2020-12-15,Venezuela,355,5,108480,965
2020-12-16,Venezuela,237,5,108717,970
2020-12-17,Venezuela,364,5,109081,975
2020-12-18,Venezuela,314,4,109395,979
2020-12-19,Venezuela,386,5,109781,984
2020-12-20,Venezuela,294,4,110075,988
2020-12-21,Venezuela,438,5,110513,993
2020-12-22,Venezuela,315,4,110828,997
2020-12-23,Venezuela,196,5,111024,1002
2020-12-24,Venezuela,221,4,111245,1006
2020-12-25,Venezuela,358,4,111603,1010
2020-12-26,Venezuela,348,3,111951,1013
2020-12-27,Venezuela,365,1,112316,1014
2020-12-28,Venezuela,320,4,112636,1018
2020-12-29,Venezuela,225,3,112861,1021
2020-12-30,Venezuela,260,4,113121,1025
2020-12-31,Venezuela,437,3,113558,1028
2021-01-01,Venezuela,326,2,113884,1030
2021-01-02,Venezuela,199,2,114083,1032
2021-01-03,Venezuela,147,2,114230,1034
2021-01-04,Venezuela,177,4,114407,1038
2021-01-05,Venezuela,255,4,114662,1042
2021-01-06,Venezuela,246,5,114908,1047
2021-01-07,Venezuela,414,5,115322,1052
2021-01-08,Venezuela,345,4,115667,1056
2021-01-09,Venezuela,505,5,116172,1061
2021-01-10,Venezuela,438,0,116610,1061
2021-01-11,Venezuela,373,12,116983,1073
2021-01-12,Venezuela,316,5,117299,1078
2021-01-13,Venezuela,512,6,117811,1084
2021-01-14,Venezuela,604,6,118415,1090
2021-01-15,Venezuela,441,5,118856,1095
2021-01-16,Venezuela,450,6,119306,1101
2021-01-17,Venezuela,497,5,119803,1106
2021-01-18,Venezuela,641,6,120444,1112
2021-01-19,Venezuela,673,4,121117,1116
2021-01-20,Venezuela,574,6,121691,1122
2021-01-21,Venezuela,569,7,122260,1129
2021-01-22,Venezuela,535,7,122795,1136
2021-01-23,Venezuela,450,6,123245,1142
2021-01-24,Venezuela,464,6,123709,1148
2021-01-25,Venezuela,403,6,124112,1154
2021-01-26,Venezuela,413,5,124525,1159
2021-01-27,Venezuela,433,6,124958,1165
2021-01-28,Venezuela,406,6,125364,1171
2021-01-29,Venezuela,412,6,125776,1177
2021-01-30,Venezuela,547,6,126323,1183
2021-01-31,Venezuela,604,6,126927,1189
2021-02-01,Venezuela,419,7,127346,1196
2021-02-02,Venezuela,406,6,127752,1202
2021-02-03,Venezuela,563,7,128315,1209
2021-02-04,Venezuela,460,7,128775,1216
2021-02-05,Venezuela,456,7,129231,1223
2021-02-06,Venezuela,412,5,129643,1228
2021-02-07,Venezuela,473,5,130116,1233
2021-02-08,Venezuela,480,7,130596,1240
2021-02-09,Venezuela,500,7,131096,1247
2021-02-10,Venezuela,380,6,131476,1253
2021-02-11,Venezuela,352,7,131828,1260
2021-02-12,Venezuela,431,7,132259,1267
2021-02-13,Venezuela,484,6,132743,1273
2021-02-14,Venezuela,475,6,133218,1279
2021-02-15,Venezuela,359,6,133577,1285
2021-02-16,Venezuela,350,7,133927,1292
2021-02-17,Venezuela,392,5,134319,1297
2021-02-18,Venezuela,462,6,134781,1303
2021-02-19,Venezuela,333,5,135114,1308
2021-02-20,Venezuela,489,4,135603,1312
2021-02-21,Venezuela,465,4,136068,1316
2021-02-22,Venezuela,477,4,136545,1320
2021-02-23,Venezuela,441,5,136986,1325
2021-02-24,Venezuela,459,6,137445,1331
2021-02-25,Venezuela,426,3,137871,1334
2021-02-26,Venezuela,424,4,138295,1338
2021-02-27,Venezuela,444,3,138739,1341
2021-02-28,Venezuela,377,3,139116,1344
2021-03-01,Venezuela,429,4,139545,1348
2021-03-02,Venezuela,389,5,139934,1353
2021-03-03,Venezuela,449,5,140383,1358
2021-03-04,Venezuela,577,6,140960,1364
2021-03-05,Venezuela,396,7,141356,1371
2021-03-06,Venezuela,529,7,141885,1378
2021-03-07,Venezuela,453,6,142338,1384
2021-03-08,Venezuela,436,7,142774,1391
2021-03-09,Venezuela,547,8,143321,1399
2021-03-10,Venezuela,0,0,143321,1399
2021-03-11,Venezuela,956,16,144277,1415
2021-03-12,Venezuela,509,7,144786,1422
2021-03-13,Venezuela,593,8,145379,1430
2021-03-14,Venezuela,0,0,145379,1430
2021-03-15,Venezuela,1109,14,146488,1444
2021-03-16,Venezuela,540,7,147028,1451
2021-03-17,Venezuela,549,8,147577,1459
2021-03-18,Venezuela,631,8,148208,1467
2021-03-19,Venezuela,937,8,149145,1475
2021-03-20,Venezuela,1161,8,150306,1483
2021-03-21,Venezuela,817,10,151123,1493
2021-03-22,Venezuela,771,9,151894,1502
2021-03-23,Venezuela,614,9,152508,1511
2021-03-24,Venezuela,807,10,153315,1521
2021-03-25,Venezuela,850,11,154165,1532
2021-03-26,Venezuela,740,11,154905,1543
2021-03-27,Venezuela,758,12,155663,1555
2021-03-28,Venezuela,992,10,156655,1565
2021-03-29,Venezuela,1288,12,157943,1577
2021-03-30,Venezuela,1206,12,159149,1589
2021-03-31,Venezuela,1348,13,160497,1602
2021-04-01,Venezuela,1254,13,161751,1615
2021-04-02,Venezuela,979,14,162730,1629
2021-04-03,Venezuela,1607,18,164337,1647
2021-04-04,Venezuela,1786,15,166123,1662
2021-04-05,Venezuela,1425,16,167548,1678
2021-04-06,Venezuela,1526,15,169074,1693
2021-04-07,Venezuela,1115,12,170189,1705
2021-04-08,Venezuela,1184,15,171373,1720
2020-01-23,Vietnam,2,0,2,0
2020-01-24,Vietnam,0,0,2,0
2020-01-25,Vietnam,0,0,2,0
2020-01-26,Vietnam,0,0,2,0
2020-01-27,Vietnam,0,0,2,0
2020-01-28,Vietnam,0,0,2,0
2020-01-29,Vietnam,0,0,2,0
2020-01-30,Vietnam,0,0,2,0
2020-01-31,Vietnam,0,0,2,0
2020-02-01,Vietnam,4,0,6,0
2020-02-02,Vietnam,0,0,6,0
2020-02-03,Vietnam,2,0,8,0
2020-02-04,Vietnam,0,0,8,0
2020-02-05,Vietnam,0,0,8,0
2020-02-06,Vietnam,2,0,10,0
2020-02-07,Vietnam,0,0,10,0
2020-02-08,Vietnam,3,0,13,0
2020-02-09,Vietnam,0,0,13,0
2020-02-10,Vietnam,1,0,14,0
2020-02-11,Vietnam,1,0,15,0
2020-02-12,Vietnam,0,0,15,0
2020-02-13,Vietnam,1,0,16,0
2020-02-14,Vietnam,0,0,16,0
2020-02-15,Vietnam,0,0,16,0
2020-02-16,Vietnam,0,0,16,0
2020-02-17,Vietnam,0,0,16,0
2020-02-18,Vietnam,0,0,16,0
2020-02-19,Vietnam,0,0,16,0
2020-02-20,Vietnam,0,0,16,0
2020-02-21,Vietnam,0,0,16,0
2020-02-22,Vietnam,0,0,16,0
2020-02-23,Vietnam,0,0,16,0
2020-02-24,Vietnam,0,0,16,0
2020-02-25,Vietnam,0,0,16,0
2020-02-26,Vietnam,0,0,16,0
2020-02-27,Vietnam,0,0,16,0
2020-02-28,Vietnam,0,0,16,0
2020-02-29,Vietnam,0,0,16,0
2020-03-01,Vietnam,0,0,16,0
2020-03-02,Vietnam,0,0,16,0
2020-03-03,Vietnam,0,0,16,0
2020-03-04,Vietnam,0,0,16,0
2020-03-05,Vietnam,0,0,16,0
2020-03-06,Vietnam,0,0,16,0
2020-03-07,Vietnam,2,0,18,0
2020-03-08,Vietnam,12,0,30,0
2020-03-09,Vietnam,0,0,30,0
2020-03-10,Vietnam,1,0,31,0
2020-03-11,Vietnam,7,0,38,0
2020-03-12,Vietnam,1,0,39,0
2020-03-13,Vietnam,8,0,47,0
2020-03-14,Vietnam,6,0,53,0
2020-03-15,Vietnam,3,0,56,0
2020-03-16,Vietnam,5,0,61,0
2020-03-17,Vietnam,5,0,66,0
2020-03-18,Vietnam,9,0,75,0
2020-03-19,Vietnam,10,0,85,0
2020-03-20,Vietnam,6,0,91,0
2020-03-21,Vietnam,3,0,94,0
2020-03-22,Vietnam,19,0,113,0
2020-03-23,Vietnam,10,0,123,0
2020-03-24,Vietnam,11,0,134,0
2020-03-25,Vietnam,7,0,141,0
2020-03-26,Vietnam,12,0,153,0
2020-03-27,Vietnam,10,0,163,0
2020-03-28,Vietnam,11,0,174,0
2020-03-29,Vietnam,14,0,188,0
2020-03-30,Vietnam,15,0,203,0
2020-03-31,Vietnam,9,0,212,0
2020-04-01,Vietnam,6,0,218,0
2020-04-02,Vietnam,15,0,233,0
2020-04-03,Vietnam,4,0,237,0
2020-04-04,Vietnam,3,0,240,0
2020-04-05,Vietnam,1,0,241,0
2020-04-06,Vietnam,4,0,245,0
2020-04-07,Vietnam,4,0,249,0
2020-04-08,Vietnam,2,0,251,0
2020-04-09,Vietnam,4,0,255,0
2020-04-10,Vietnam,2,0,257,0
2020-04-11,Vietnam,1,0,258,0
2020-04-12,Vietnam,4,0,262,0
2020-04-13,Vietnam,3,0,265,0
2020-04-14,Vietnam,1,0,266,0
2020-04-15,Vietnam,1,0,267,0
2020-04-16,Vietnam,1,0,268,0
2020-04-17,Vietnam,0,0,268,0
2020-04-18,Vietnam,0,0,268,0
2020-04-19,Vietnam,0,0,268,0
2020-04-20,Vietnam,0,0,268,0
2020-04-21,Vietnam,0,0,268,0
2020-04-22,Vietnam,0,0,268,0
2020-04-23,Vietnam,0,0,268,0
2020-04-24,Vietnam,2,0,270,0
2020-04-25,Vietnam,0,0,270,0
2020-04-26,Vietnam,0,0,270,0
2020-04-27,Vietnam,0,0,270,0
2020-04-28,Vietnam,0,0,270,0
2020-04-29,Vietnam,0,0,270,0
2020-04-30,Vietnam,0,0,270,0
2020-05-01,Vietnam,0,0,270,0
2020-05-02,Vietnam,0,0,270,0
2020-05-03,Vietnam,1,0,271,0
2020-05-04,Vietnam,0,0,271,0
2020-05-05,Vietnam,0,0,271,0
2020-05-06,Vietnam,0,0,271,0
2020-05-07,Vietnam,17,0,288,0
2020-05-08,Vietnam,0,0,288,0
2020-05-09,Vietnam,0,0,288,0
2020-05-10,Vietnam,0,0,288,0
2020-05-11,Vietnam,0,0,288,0
2020-05-12,Vietnam,0,0,288,0
2020-05-13,Vietnam,0,0,288,0
2020-05-14,Vietnam,24,0,312,0
2020-05-15,Vietnam,2,0,314,0
2020-05-16,Vietnam,4,0,318,0
2020-05-17,Vietnam,2,0,320,0
2020-05-18,Vietnam,4,0,324,0
2020-05-19,Vietnam,0,0,324,0
2020-05-20,Vietnam,0,0,324,0
2020-05-21,Vietnam,0,0,324,0
2020-05-22,Vietnam,0,0,324,0
2020-05-23,Vietnam,1,0,325,0
2020-05-24,Vietnam,0,0,325,0
2020-05-25,Vietnam,1,0,326,0
2020-05-26,Vietnam,1,0,327,0
2020-05-27,Vietnam,0,0,327,0
2020-05-28,Vietnam,0,0,327,0
2020-05-29,Vietnam,1,0,328,0
2020-05-30,Vietnam,0,0,328,0
2020-05-31,Vietnam,0,0,328,0
2020-06-01,Vietnam,0,0,328,0
2020-06-02,Vietnam,0,0,328,0
2020-06-03,Vietnam,0,0,328,0
2020-06-04,Vietnam,0,0,328,0
2020-06-05,Vietnam,0,0,328,0
2020-06-06,Vietnam,1,0,329,0
2020-06-07,Vietnam,2,0,331,0
2020-06-08,Vietnam,1,0,332,0
2020-06-09,Vietnam,0,0,332,0
2020-06-10,Vietnam,0,0,332,0
2020-06-11,Vietnam,0,0,332,0
2020-06-12,Vietnam,1,0,333,0
2020-06-13,Vietnam,1,0,334,0
2020-06-14,Vietnam,0,0,334,0
2020-06-15,Vietnam,0,0,334,0
2020-06-16,Vietnam,0,0,334,0
2020-06-17,Vietnam,1,0,335,0
2020-06-18,Vietnam,7,0,342,0
2020-06-19,Vietnam,7,0,349,0
2020-06-20,Vietnam,0,0,349,0
2020-06-21,Vietnam,0,0,349,0
2020-06-22,Vietnam,0,0,349,0
2020-06-23,Vietnam,0,0,349,0
2020-06-24,Vietnam,3,0,352,0
2020-06-25,Vietnam,0,0,352,0
2020-06-26,Vietnam,1,0,353,0
2020-06-27,Vietnam,2,0,355,0
2020-06-28,Vietnam,0,0,355,0
2020-06-29,Vietnam,0,0,355,0
2020-06-30,Vietnam,0,0,355,0
2020-07-01,Vietnam,0,0,355,0
2020-07-02,Vietnam,0,0,355,0
2020-07-03,Vietnam,0,0,355,0
2020-07-04,Vietnam,0,0,355,0
2020-07-05,Vietnam,0,0,355,0
2020-07-06,Vietnam,14,0,369,0
2020-07-07,Vietnam,0,0,369,0
2020-07-08,Vietnam,0,0,369,0
2020-07-09,Vietnam,0,0,369,0
2020-07-10,Vietnam,1,0,370,0
2020-07-11,Vietnam,0,0,370,0
2020-07-12,Vietnam,2,0,372,0
2020-07-13,Vietnam,1,0,373,0
2020-07-14,Vietnam,0,0,373,0
2020-07-15,Vietnam,8,0,381,0
2020-07-16,Vietnam,0,0,381,0
2020-07-17,Vietnam,1,0,382,0
2020-07-18,Vietnam,0,0,382,0
2020-07-19,Vietnam,1,0,383,0
2020-07-20,Vietnam,1,0,384,0
2020-07-21,Vietnam,17,0,401,0
2020-07-22,Vietnam,7,0,408,0
2020-07-23,Vietnam,4,0,412,0
2020-07-24,Vietnam,3,0,415,0
2020-07-25,Vietnam,2,0,417,0
2020-07-26,Vietnam,3,0,420,0
2020-07-27,Vietnam,11,0,431,0
2020-07-28,Vietnam,15,0,446,0
2020-07-29,Vietnam,13,0,459,0
2020-07-30,Vietnam,50,0,509,0
2020-07-31,Vietnam,49,3,558,3
2020-08-01,Vietnam,32,0,590,3
2020-08-02,Vietnam,31,3,621,6
2020-08-03,Vietnam,31,1,652,7
2020-08-04,Vietnam,20,1,672,8
2020-08-05,Vietnam,45,1,717,9
2020-08-06,Vietnam,33,1,750,10
2020-08-07,Vietnam,39,0,789,10
2020-08-08,Vietnam,23,0,812,10
2020-08-09,Vietnam,29,3,841,13
2020-08-10,Vietnam,6,2,847,15
2020-08-11,Vietnam,19,1,866,16
2020-08-12,Vietnam,17,2,883,18
2020-08-13,Vietnam,28,3,911,21
2020-08-14,Vietnam,19,1,930,22
2020-08-15,Vietnam,21,2,951,24
2020-08-16,Vietnam,13,0,964,24
2020-08-17,Vietnam,19,1,983,25
2020-08-18,Vietnam,6,1,989,26
2020-08-19,Vietnam,5,-1,994,25
2020-08-20,Vietnam,13,0,1007,25
2020-08-21,Vietnam,2,0,1009,25
2020-08-22,Vietnam,5,1,1014,26
2020-08-23,Vietnam,2,1,1016,27
2020-08-24,Vietnam,6,0,1022,27
2020-08-25,Vietnam,7,0,1029,27
2020-08-26,Vietnam,5,3,1034,30
2020-08-27,Vietnam,2,0,1036,30
2020-08-28,Vietnam,2,0,1038,30
2020-08-29,Vietnam,2,2,1040,32
2020-08-30,Vietnam,0,0,1040,32
2020-08-31,Vietnam,4,2,1044,34
2020-09-01,Vietnam,0,0,1044,34
2020-09-02,Vietnam,2,0,1046,34
2020-09-03,Vietnam,0,1,1046,35
2020-09-04,Vietnam,3,0,1049,35
2020-09-05,Vietnam,0,0,1049,35
2020-09-06,Vietnam,0,0,1049,35
2020-09-07,Vietnam,0,0,1049,35
2020-09-08,Vietnam,5,0,1054,35
2020-09-09,Vietnam,5,0,1059,35
2020-09-10,Vietnam,0,0,1059,35
2020-09-11,Vietnam,1,0,1060,35
2020-09-12,Vietnam,0,0,1060,35
2020-09-13,Vietnam,3,0,1063,35
2020-09-14,Vietnam,0,0,1063,35
2020-09-15,Vietnam,0,0,1063,35
2020-09-16,Vietnam,0,0,1063,35
2020-09-17,Vietnam,3,0,1066,35
2020-09-18,Vietnam,2,0,1068,35
2020-09-19,Vietnam,0,0,1068,35
2020-09-20,Vietnam,0,0,1068,35
2020-09-21,Vietnam,0,0,1068,35
2020-09-22,Vietnam,0,0,1068,35
2020-09-23,Vietnam,1,0,1069,35
2020-09-24,Vietnam,0,0,1069,35
2020-09-25,Vietnam,0,0,1069,35
2020-09-26,Vietnam,0,0,1069,35
2020-09-27,Vietnam,5,0,1074,35
2020-09-28,Vietnam,3,0,1077,35
2020-09-29,Vietnam,17,0,1094,35
2020-09-30,Vietnam,0,0,1094,35
2020-10-01,Vietnam,1,0,1095,35
2020-10-02,Vietnam,1,0,1096,35
2020-10-03,Vietnam,0,0,1096,35
2020-10-04,Vietnam,0,0,1096,35
2020-10-05,Vietnam,1,0,1097,35
2020-10-06,Vietnam,1,0,1098,35
2020-10-07,Vietnam,1,0,1099,35
2020-10-08,Vietnam,1,0,1100,35
2020-10-09,Vietnam,5,0,1105,35
2020-10-10,Vietnam,2,0,1107,35
2020-10-11,Vietnam,2,0,1109,35
2020-10-12,Vietnam,1,0,1110,35
2020-10-13,Vietnam,3,0,1113,35
2020-10-14,Vietnam,9,0,1122,35
2020-10-15,Vietnam,2,0,1124,35
2020-10-16,Vietnam,0,0,1124,35
2020-10-17,Vietnam,2,0,1126,35
2020-10-18,Vietnam,8,0,1134,35
2020-10-19,Vietnam,6,0,1140,35
2020-10-20,Vietnam,1,0,1141,35
2020-10-21,Vietnam,3,0,1144,35
2020-10-22,Vietnam,4,0,1148,35
2020-10-23,Vietnam,0,0,1148,35
2020-10-24,Vietnam,12,0,1160,35
2020-10-25,Vietnam,8,0,1168,35
2020-10-26,Vietnam,1,0,1169,35
2020-10-27,Vietnam,3,0,1172,35
2020-10-28,Vietnam,1,0,1173,35
2020-10-29,Vietnam,4,0,1177,35
2020-10-30,Vietnam,0,0,1177,35
2020-10-31,Vietnam,3,0,1180,35
2020-11-01,Vietnam,0,0,1180,35
2020-11-02,Vietnam,12,0,1192,35
2020-11-03,Vietnam,10,0,1202,35
2020-11-04,Vietnam,1,0,1203,35
2020-11-05,Vietnam,4,0,1207,35
2020-11-06,Vietnam,5,0,1212,35
2020-11-07,Vietnam,1,0,1213,35
2020-11-08,Vietnam,0,0,1213,35
2020-11-09,Vietnam,2,0,1215,35
2020-11-10,Vietnam,11,0,1226,35
2020-11-11,Vietnam,26,0,1252,35
2020-11-12,Vietnam,1,0,1253,35
2020-11-13,Vietnam,3,0,1256,35
2020-11-14,Vietnam,9,0,1265,35
2020-11-15,Vietnam,16,0,1281,35
2020-11-16,Vietnam,2,0,1283,35
2020-11-17,Vietnam,5,0,1288,35
2020-11-18,Vietnam,12,0,1300,35
2020-11-19,Vietnam,4,0,1304,35
2020-11-20,Vietnam,1,0,1305,35
2020-11-21,Vietnam,1,0,1306,35
2020-11-22,Vietnam,1,0,1307,35
2020-11-23,Vietnam,5,0,1312,35
2020-11-24,Vietnam,4,0,1316,35
2020-11-25,Vietnam,5,0,1321,35
2020-11-26,Vietnam,10,0,1331,35
2020-11-27,Vietnam,8,0,1339,35
2020-11-28,Vietnam,2,0,1341,35
2020-11-29,Vietnam,2,0,1343,35
2020-11-30,Vietnam,4,0,1347,35
2020-12-01,Vietnam,4,0,1351,35
2020-12-02,Vietnam,7,0,1358,35
2020-12-03,Vietnam,3,0,1361,35
2020-12-04,Vietnam,0,0,1361,35
2020-12-05,Vietnam,4,0,1365,35
2020-12-06,Vietnam,1,0,1366,35
2020-12-07,Vietnam,1,0,1367,35
2020-12-08,Vietnam,10,0,1377,35
2020-12-09,Vietnam,4,0,1381,35
2020-12-10,Vietnam,4,0,1385,35
2020-12-11,Vietnam,6,0,1391,35
2020-12-12,Vietnam,4,0,1395,35
2020-12-13,Vietnam,2,0,1397,35
2020-12-14,Vietnam,5,0,1402,35
2020-12-15,Vietnam,3,0,1405,35
2020-12-16,Vietnam,0,0,1405,35
2020-12-17,Vietnam,2,0,1407,35
2020-12-18,Vietnam,3,0,1410,35
2020-12-19,Vietnam,1,0,1411,35
2020-12-20,Vietnam,2,0,1413,35
2020-12-21,Vietnam,1,0,1414,35
2020-12-22,Vietnam,6,0,1420,35
2020-12-23,Vietnam,1,0,1421,35
2020-12-24,Vietnam,11,0,1432,35
2020-12-25,Vietnam,7,0,1439,35
2020-12-26,Vietnam,1,0,1440,35
2020-12-27,Vietnam,1,0,1441,35
2020-12-28,Vietnam,10,0,1451,35
2020-12-29,Vietnam,3,0,1454,35
2020-12-30,Vietnam,2,0,1456,35
2020-12-31,Vietnam,9,0,1465,35
2021-01-01,Vietnam,9,0,1474,35
2021-01-02,Vietnam,8,0,1482,35
2021-01-03,Vietnam,12,0,1494,35
2021-01-04,Vietnam,3,0,1497,35
2021-01-05,Vietnam,7,0,1504,35
2021-01-06,Vietnam,1,0,1505,35
2021-01-07,Vietnam,4,0,1509,35
2021-01-08,Vietnam,3,0,1512,35
2021-01-09,Vietnam,1,0,1513,35
2021-01-10,Vietnam,1,0,1514,35
2021-01-11,Vietnam,1,0,1515,35
2021-01-12,Vietnam,5,0,1520,35
2021-01-13,Vietnam,1,0,1521,35
2021-01-14,Vietnam,10,0,1531,35
2021-01-15,Vietnam,5,0,1536,35
2021-01-16,Vietnam,1,0,1537,35
2021-01-17,Vietnam,0,0,1537,35
2021-01-18,Vietnam,2,0,1539,35
2021-01-19,Vietnam,1,0,1540,35
2021-01-20,Vietnam,4,0,1544,35
2021-01-21,Vietnam,2,0,1546,35
2021-01-22,Vietnam,2,0,1548,35
2021-01-23,Vietnam,0,0,1548,35
2021-01-24,Vietnam,0,0,1548,35
2021-01-25,Vietnam,1,0,1549,35
2021-01-26,Vietnam,2,0,1551,35
2021-01-27,Vietnam,2,0,1553,35
2021-01-28,Vietnam,98,0,1651,35
2021-01-29,Vietnam,6,0,1657,35
2021-01-30,Vietnam,110,0,1767,35
2021-01-31,Vietnam,50,0,1817,35
2021-02-01,Vietnam,33,0,1850,35
2021-02-02,Vietnam,32,0,1882,35
2021-02-03,Vietnam,66,0,1948,35
2021-02-04,Vietnam,9,0,1957,35
2021-02-05,Vietnam,19,0,1976,35
2021-02-06,Vietnam,9,0,1985,35
2021-02-07,Vietnam,16,0,2001,35
2021-02-08,Vietnam,49,0,2050,35
2021-02-09,Vietnam,14,0,2064,35
2021-02-10,Vietnam,27,0,2091,35
2021-02-11,Vietnam,49,0,2140,35
2021-02-12,Vietnam,2,0,2142,35
2021-02-13,Vietnam,53,0,2195,35
2021-02-14,Vietnam,33,0,2228,35
2021-02-15,Vietnam,41,0,2269,35
2021-02-16,Vietnam,42,0,2311,35
2021-02-17,Vietnam,18,0,2329,35
2021-02-18,Vietnam,18,0,2347,35
2021-02-19,Vietnam,15,0,2362,35
2021-02-20,Vietnam,6,0,2368,35
2021-02-21,Vietnam,15,0,2383,35
2021-02-22,Vietnam,9,0,2392,35
2021-02-23,Vietnam,11,0,2403,35
2021-02-24,Vietnam,9,0,2412,35
2021-02-25,Vietnam,9,0,2421,35
2021-02-26,Vietnam,5,0,2426,35
2021-02-27,Vietnam,6,0,2432,35
2021-02-28,Vietnam,16,0,2448,35
2021-03-01,Vietnam,0,0,2448,35
2021-03-02,Vietnam,27,0,2475,35
2021-03-03,Vietnam,7,0,2482,35
2021-03-04,Vietnam,6,0,2488,35
2021-03-05,Vietnam,6,0,2494,35
2021-03-06,Vietnam,7,0,2501,35
2021-03-07,Vietnam,11,0,2512,35
2021-03-08,Vietnam,12,0,2524,35
2021-03-09,Vietnam,2,0,2526,35
2021-03-10,Vietnam,3,0,2529,35
2021-03-11,Vietnam,4,0,2533,35
2021-03-12,Vietnam,17,0,2550,35
2021-03-13,Vietnam,3,0,2553,35
2021-03-14,Vietnam,1,0,2554,35
2021-03-15,Vietnam,3,0,2557,35
2021-03-16,Vietnam,3,0,2560,35
2021-03-17,Vietnam,7,0,2567,35
2021-03-18,Vietnam,3,0,2570,35
2021-03-19,Vietnam,1,0,2571,35
2021-03-20,Vietnam,1,0,2572,35
2021-03-21,Vietnam,0,0,2572,35
2021-03-22,Vietnam,3,0,2575,35
2021-03-23,Vietnam,0,0,2575,35
2021-03-24,Vietnam,1,0,2576,35
2021-03-25,Vietnam,3,0,2579,35
2021-03-26,Vietnam,7,0,2586,35
2021-03-27,Vietnam,0,0,2586,35
2021-03-28,Vietnam,5,0,2591,35
2021-03-29,Vietnam,3,0,2594,35
2021-03-30,Vietnam,0,0,2594,35
2021-03-31,Vietnam,9,0,2603,35
2021-04-01,Vietnam,14,0,2617,35
2021-04-02,Vietnam,3,0,2620,35
2021-04-03,Vietnam,6,0,2626,35
2021-04-04,Vietnam,5,0,2631,35
2021-04-05,Vietnam,6,0,2637,35
2021-04-06,Vietnam,11,0,2648,35
2021-04-07,Vietnam,11,0,2659,35
2021-04-08,Vietnam,9,0,2668,35
2020-01-22,World,0,0,557,17
2020-01-23,World,98,1,655,18
2020-01-24,World,286,8,941,26
2020-01-25,World,492,16,1433,42
2020-01-26,World,685,14,2118,56
2020-01-27,World,809,26,2927,82
2020-01-28,World,2651,49,5578,131
2020-01-29,World,589,2,6167,133
2020-01-30,World,2068,38,8235,171
2020-01-31,World,1692,42,9927,213
2020-02-01,World,2111,46,12038,259
2020-02-02,World,4749,103,16787,362
2020-02-03,World,3100,64,19887,426
2020-02-04,World,4011,66,23898,492
2020-02-05,World,3745,72,27643,564
2020-02-06,World,3160,70,30803,634
2020-02-07,World,3593,85,34396,719
2020-02-08,World,2734,87,37130,806
2020-02-09,World,3030,100,40160,906
2020-02-10,World,2609,107,42769,1013
2020-02-11,World,2042,100,44811,1113
2020-02-12,World,418,5,45229,1118
2020-02-13,World,15153,253,60382,1371
2020-02-14,World,6527,152,66909,1523
2020-02-15,World,2143,143,69052,1666
2020-02-16,World,2183,104,71235,1770
2020-02-17,World,2035,98,73270,1868
2020-02-18,World,1882,140,75152,2008
2020-02-19,World,500,115,75652,2123
2020-02-20,World,560,125,76212,2248
2020-02-21,World,629,4,76841,2252
2020-02-22,World,1761,207,78602,2459
2020-02-23,World,380,11,78982,2470
2020-02-24,World,564,160,79546,2630
2020-02-25,World,853,80,80399,2710
2020-02-26,World,977,61,81376,2771
2020-02-27,World,1360,43,82736,2814
2020-02-28,World,1386,59,84122,2873
2020-02-29,World,1891,69,86013,2942
2020-03-01,World,2381,54,88394,2996
2020-03-02,World,1983,89,90377,3085
2020-03-03,World,2594,75,92971,3160
2020-03-04,World,2308,95,95279,3255
2020-03-05,World,2811,94,98090,3349
2020-03-06,World,3913,111,102003,3460
2020-03-07,World,4095,104,106098,3564
2020-03-08,World,3949,239,110047,3803
2020-03-09,World,4172,190,114219,3993
2020-03-10,World,4822,274,119041,4267
2020-03-11,World,7661,344,126702,4611
2020-03-12,World,5790,306,132492,4917
2020-03-13,World,14384,497,146876,5414
2020-03-14,World,11074,420,157950,5834
2020-03-15,World,11269,636,169219,6470
2020-03-16,World,14808,683,184027,7153
2020-03-17,World,15943,813,199970,7966
2020-03-18,World,19565,906,219535,8872
2020-03-19,World,27049,1111,246584,9983
2020-03-20,World,30775,1486,277359,11469
2020-03-21,World,31991,1722,309350,13191
2020-03-22,World,34855,1686,344205,14877
2020-03-23,World,42835,1949,387040,16826
2020-03-24,World,41179,2290,428219,19116
2020-03-25,World,51001,2810,479220,21926
2020-03-26,World,62877,3036,542097,24962
2020-03-27,World,65041,3488,607138,28450
2020-03-28,World,67280,3730,674418,32180
2020-03-29,World,59237,3519,733655,35699
2020-03-30,World,65294,4081,798949,39780
2020-03-31,World,76845,4748,875794,44528
2020-04-01,World,82792,5999,958586,50527
2020-04-02,World,83063,5887,1041649,56414
2020-04-03,World,83551,6160,1125200,62574
2020-04-04,World,58389,5916,1183589,68490
2020-04-05,World,72592,5186,1256181,73676
2020-04-06,World,73143,5938,1329324,79614
2020-04-07,World,69829,8261,1399153,87875
2020-04-08,World,83355,6806,1482508,94681
2020-04-09,World,87019,7783,1569527,102464
2020-04-10,World,85535,7378,1655062,109842
2020-04-11,World,74311,6173,1729373,116015
2020-04-12,World,119694,5858,1849067,121873
2020-04-13,World,70732,5970,1919799,127843
2020-04-14,World,83967,6969,2003766,134812
2020-04-15,World,77148,8466,2080914,143278
2020-04-16,World,95551,7259,2176465,150537
2020-04-17,World,87997,8393,2264462,158930
2020-04-18,World,77240,6152,2341702,165082
2020-04-19,World,76605,5232,2418307,170314
2020-04-20,World,76018,5874,2494325,176188
2020-04-21,World,75749,7275,2570074,183463
2020-04-22,World,81247,6856,2651321,190319
2020-04-23,World,84249,6835,2735570,197154
2020-04-24,World,84096,6768,2819666,203922
2020-04-25,World,82259,5627,2901925,209549
2020-04-26,World,71588,3979,2973513,213528
2020-04-27,World,70192,4746,3043705,218274
2020-04-28,World,75540,6581,3119245,224855
2020-04-29,World,77110,6722,3196355,231577
2020-04-30,World,83495,5843,3279850,237420
2020-05-01,World,88376,5147,3368226,242567
2020-05-02,World,79200,5496,3447426,248063
2020-05-03,World,76373,3510,3523799,251573
2020-05-04,World,77689,4212,3601488,255785
2020-05-05,World,80502,5827,3681990,261612
2020-05-06,World,90028,6503,3772018,268115
2020-05-07,World,88706,5308,3860724,273423
2020-05-08,World,90279,5550,3951003,278973
2020-05-09,World,85223,4224,4036226,283197
2020-05-10,World,74976,3557,4111202,286754
2020-05-11,World,76631,3487,4187833,290241
2020-05-12,World,84491,5486,4272324,295727
2020-05-13,World,84980,5143,4357304,300870
2020-05-14,World,96231,5160,4453535,306030
2020-05-15,World,95732,5223,4549267,311253
2020-05-16,World,94439,4177,4643706,315430
2020-05-17,World,78022,3184,4721728,318614
2020-05-18,World,89167,3763,4810895,322377
2020-05-19,World,96775,4648,4907670,327025
2020-05-20,World,101878,4778,5009548,331803
2020-05-21,World,106644,4662,5116192,336465
2020-05-22,World,106422,5247,5222614,341712
2020-05-23,World,104804,3923,5327418,345635
2020-05-24,World,94211,3014,5421629,348649
2020-05-25,World,86717,1212,5508346,349861
2020-05-26,World,93967,4242,5602313,354103
2020-05-27,World,102762,5055,5705075,359158
2020-05-28,World,119283,4558,5824358,363716
2020-05-29,World,120903,4608,5945261,368324
2020-05-30,World,136515,4024,6081776,372348
2020-05-31,World,106408,2690,6188184,375038
2020-06-01,World,95995,3073,6284179,378111
2020-06-02,World,121964,4677,6406143,382788
2020-06-03,World,114249,5433,6520392,388221
2020-06-04,World,130944,5032,6651336,393253
2020-06-05,World,131223,4581,6782559,397834
2020-06-06,World,133737,3770,6916296,401604
2020-06-07,World,112363,2737,7028659,404341
2020-06-08,World,102497,3702,7131156,408043
2020-06-09,World,125060,4774,7256216,412817
2020-06-10,World,135105,5041,7391321,417858
2020-06-11,World,138020,4640,7529341,422498
2020-06-12,World,128765,4209,7658106,426707
2020-06-13,World,135289,4114,7793395,430821
2020-06-14,World,132284,3397,7925679,434218
2020-06-15,World,119658,3415,8045337,437633
2020-06-16,World,142084,6710,8187421,444343
2020-06-17,World,143746,5147,8331167,449490
2020-06-18,World,141063,4911,8472230,454401
2020-06-19,World,179915,6065,8652145,460466
2020-06-20,World,157448,4112,8809593,464578
2020-06-21,World,127702,4011,8937295,468589
2020-06-22,World,139361,3563,9076656,472152
2020-06-23,World,166809,5217,9243465,477369
2020-06-24,World,172594,5186,9416059,482555
2020-06-25,World,178381,4685,9594440,487240
2020-06-26,World,191597,4745,9786037,491985
2020-06-27,World,178132,4462,9964169,496447
2020-06-28,World,163871,3167,10128040,499614
2020-06-29,World,155347,3676,10283387,503290
2020-06-30,World,174542,4889,10457929,508179
2020-07-01,World,217607,4946,10675536,513125
2020-07-02,World,209945,5078,10885481,518203
2020-07-03,World,201385,4924,11086866,523127
2020-07-04,World,193809,4395,11280675,527522
2020-07-05,World,184003,3488,11464678,531010
2020-07-06,World,163975,3845,11628653,534855
2020-07-07,World,211362,5968,11840015,540823
2020-07-08,World,214159,5291,12054174,546114
2020-07-09,World,226827,5399,12281001,551513
2020-07-10,World,232674,5288,12513675,556801
2020-07-11,World,216482,4817,12730157,561618
2020-07-12,World,192274,3987,12922431,565605
2020-07-13,World,191444,3910,13113875,569515
2020-07-14,World,222188,5598,13336063,575113
2020-07-15,World,231468,5444,13567531,580557
2020-07-16,World,251312,5771,13818843,586328
2020-07-17,World,242742,6669,14061585,592997
2020-07-18,World,236178,5609,14297763,598606
2020-07-19,World,213434,4067,14511197,602673
2020-07-20,World,207116,4210,14718313,606883
2020-07-21,World,233681,6172,14951994,613055
2020-07-22,World,279868,6946,15231862,620001
2020-07-23,World,282854,9904,15514716,629905
2020-07-24,World,281074,6023,15795790,635928
2020-07-25,World,254054,5552,16049844,641480
2020-07-26,World,213126,3716,16262970,645196
2020-07-27,World,226440,5177,16489410,650373
2020-07-28,World,252785,6276,16742195,656649
2020-07-29,World,291728,6620,17033923,663269
2020-07-30,World,280100,6045,17314023,669314
2020-07-31,World,290744,6166,17604767,675480
2020-08-01,World,248338,5456,17853105,680936
2020-08-02,World,230992,4320,18084097,685256
2020-08-03,World,206475,4684,18290572,689940
2020-08-04,World,257942,6588,18548514,696528
2020-08-05,World,276575,7010,18825089,703538
2020-08-06,World,285202,6485,19110291,710023
2020-08-07,World,282239,6283,19392530,716306
2020-08-08,World,258518,5411,19651048,721717
2020-08-09,World,224683,4609,19875731,726326
2020-08-10,World,226029,5305,20101760,731631
2020-08-11,World,257570,6199,20359330,737830
2020-08-12,World,276647,6572,20635977,744402
2020-08-13,World,289216,6209,20925193,750611
2020-08-14,World,303748,10142,21228941,760753
2020-08-15,World,247708,5360,21476649,766113
2020-08-16,World,214470,4256,21691119,770369
2020-08-17,World,207732,4179,21898851,774548
2020-08-18,World,258256,6854,22157107,781402
2020-08-19,World,279590,6688,22436697,788090
2020-08-20,World,272360,6062,22709057,794152
2020-08-21,World,261119,5430,22970176,799582
2020-08-22,World,264274,5564,23234450,805146
2020-08-23,World,206181,3905,23440631,809051
2020-08-24,World,225399,4507,23666030,813558
2020-08-25,World,243809,6277,23909839,819835
2020-08-26,World,283987,6244,24193826,826079
2020-08-27,World,283745,5879,24477571,831958
2020-08-28,World,283762,5510,24761333,837468
2020-08-29,World,263756,5322,25025089,842790
2020-08-30,World,220984,4056,25246073,846846
2020-08-31,World,263016,4177,25509089,851023
2020-09-01,World,264790,6415,25773879,857438
2020-09-02,World,283496,6091,26057375,863529
2020-09-03,World,281401,5679,26338776,869208
2020-09-04,World,314082,5861,26652858,875069
2020-09-05,World,269904,4960,26922762,880029
2020-09-06,World,230607,3820,27153369,883849
2020-09-07,World,217823,9375,27371192,893224
2020-09-08,World,242275,4916,27613467,898140
2020-09-09,World,284676,6095,27898143,904235
2020-09-10,World,299976,5790,28198119,910025
2020-09-11,World,321316,5849,28519435,915874
2020-09-12,World,286642,4902,28806077,920776
2020-09-13,World,242665,3706,29048742,924482
2020-09-14,World,263750,4447,29312492,928929
2020-09-15,World,285511,6428,29598003,935357
2020-09-16,World,304441,5768,29902444,941125
2020-09-17,World,314974,5473,30217418,946598
2020-09-18,World,325880,5680,30543298,952278
2020-09-19,World,292114,5269,30835412,957547
2020-09-20,World,252102,3742,31087514,961289
2020-09-21,World,276153,4103,31363667,965392
2020-09-22,World,284502,5969,31648169,971361
2020-09-23,World,276102,5609,31924271,976970
2020-09-24,World,353029,6664,32277300,983634
2020-09-25,World,330863,5887,32608163,989521
2020-09-26,World,288440,5353,32896603,994874
2020-09-27,World,251426,3688,33148029,998562
2020-09-28,World,254802,3975,33402831,1002537
2020-09-29,World,282639,5929,33685470,1008466
2020-09-30,World,326209,6442,34011679,1014908
2020-10-01,World,318302,8709,34329981,1023617
2020-10-02,World,297763,4931,34627744,1028548
2020-10-03,World,332103,5361,34959847,1033909
2020-10-04,World,261449,3841,35221296,1037750
2020-10-05,World,301040,6947,35522336,1044697
2020-10-06,World,326463,5779,35848799,1050476
2020-10-07,World,351019,5829,36199818,1056305
2020-10-08,World,361325,6282,36561143,1062587
2020-10-09,World,360874,6150,36922017,1068737
2020-10-10,World,357144,4878,37279161,1073615
2020-10-11,World,286871,4030,37566032,1077645
2020-10-12,World,291800,3984,37857832,1081629
2020-10-13,World,319244,5284,38177076,1086913
2020-10-14,World,382347,6066,38559423,1092979
2020-10-15,World,406960,6124,38966383,1099103
2020-10-16,World,411790,6180,39378173,1105283
2020-10-17,World,372631,5604,39750804,1110887
2020-10-18,World,316575,3539,40067379,1114426
2020-10-19,World,387236,4835,40454615,1119261
2020-10-20,World,388997,6555,40843612,1125816
2020-10-21,World,444865,6659,41288477,1132475
2020-10-22,World,472759,5910,41761236,1138385
2020-10-23,World,496731,6964,42257967,1145349
2020-10-24,World,456852,5818,42714819,1151167
2020-10-25,World,360623,4208,43075442,1155375
2020-10-26,World,486432,5517,43561874,1160892
2020-10-27,World,470181,7369,44032055,1168261
2020-10-28,World,511884,7163,44543939,1175424
2020-10-29,World,550462,7083,45094401,1182507
2020-10-30,World,570941,7606,45665342,1190113
2020-10-31,World,476849,6576,46142191,1196689
2020-11-01,World,462454,5010,46604645,1201699
2020-11-02,World,563127,6104,47167772,1207803
2020-11-03,World,553745,9345,47721517,1217148
2020-11-04,World,511552,10258,48233069,1227406
2020-11-05,World,596558,8007,48829627,1235413
2020-11-06,World,644854,9656,49474481,1245069
2020-11-07,World,596750,7596,50071231,1252665
2020-11-08,World,484116,5874,50555347,1258539
2020-11-09,World,501532,7223,51056879,1265762
2020-11-10,World,559377,9993,51616256,1275755
2020-11-11,World,648606,10451,52264862,1286206
2020-11-12,World,649543,9766,52914405,1295972
2020-11-13,World,652073,9588,53566478,1305560
2020-11-14,World,594970,9081,54161448,1314641
2020-11-15,World,473941,6423,54635389,1321064
2020-11-16,World,534457,7954,55169846,1329018
2020-11-17,World,611220,11069,55781066,1340087
2020-11-18,World,627103,11431,56408169,1351518
2020-11-19,World,653585,11020,57061754,1362538
2020-11-20,World,668744,11879,57730498,1374417
2020-11-21,World,587564,8968,58318062,1383385
2020-11-22,World,487981,7194,58806043,1390579
2020-11-23,World,525319,8523,59331362,1399102
2020-11-24,World,590261,12660,59921623,1411762
2020-11-25,World,636224,12128,60557847,1423890
2020-11-26,World,582475,10888,61140322,1434778
2020-11-27,World,687148,11388,61827470,1446166
2020-11-28,World,586031,9281,62413501,1455447
2020-11-29,World,488583,7160,62902084,1462607
2020-11-30,World,508641,8880,63410725,1471487
2020-12-01,World,612097,12687,64022822,1484174
2020-12-02,World,651398,12593,64674220,1496767
2020-12-03,World,694328,12570,65368548,1509337
2020-12-04,World,683276,12498,66051824,1521835
2020-12-05,World,642163,10280,66693987,1532115
2020-12-06,World,538754,7434,67232741,1539549
2020-12-07,World,520019,8723,67752760,1548272
2020-12-08,World,643528,12286,68396288,1560558
2020-12-09,World,669911,12714,69066199,1573272
2020-12-10,World,674988,12693,70564412,1585965
2020-12-11,World,704493,13025,71268905,1598990
2020-12-12,World,634847,10539,71903752,1609529
2020-12-13,World,530831,7457,72434583,1616986
2020-12-14,World,524390,9176,72958973,1626162
2020-12-15,World,637180,13937,73596153,1640099
2020-12-16,World,733720,13717,74329873,1653816
2020-12-17,World,739574,13415,75069447,1667231
2020-12-18,World,720452,12764,75789899,1679995
2020-12-19,World,611241,10767,76401140,1690762
2020-12-20,World,533450,7910,76934590,1698672
2020-12-21,World,549281,9666,77483871,1708338
2020-12-22,World,650246,14306,78134117,1722644
2020-12-23,World,695108,13802,78829225,1736446
2020-12-24,World,666629,11633,79495854,1748079
2020-12-25,World,465550,8574,79961404,1756653
2020-12-26,World,512582,7393,80473986,1764046
2020-12-27,World,438439,7402,80912425,1771448
2020-12-28,World,496293,9755,81408718,1781203
2020-12-29,World,664407,15163,82073125,1796366
2020-12-30,World,761205,15258,82834330,1811624
2020-12-31,World,724998,13137,83559328,1824761
2021-01-01,World,533018,9667,84092346,1834428
2021-01-02,World,626344,8428,84718690,1842856
2021-01-03,World,532781,7335,85251471,1850191
2021-01-04,World,554101,10153,85805572,1860344
2021-01-05,World,740110,15311,86545682,1875655
2021-01-06,World,783353,15056,87329035,1890711
2021-01-07,World,880812,14918,88209847,1905629
2021-01-08,World,801269,15149,89011116,1920778
2021-01-09,World,762921,12797,89774037,1933575
2021-01-10,World,589123,8347,90363160,1941922
2021-01-11,World,619911,10316,90983071,1952238
2021-01-12,World,705497,17105,91688568,1969343
2021-01-13,World,748375,16704,92436943,1986047
2021-01-14,World,755221,15357,93192164,2001404
2021-01-15,World,767181,15118,93959345,2016522
2021-01-16,World,639133,13272,94598478,2029794
2021-01-17,World,529193,8633,95127671,2038427
2021-01-18,World,515048,9405,95642719,2047832
2021-01-19,World,608408,16581,96251127,2064413
2021-01-20,World,692919,17904,96944046,2082317
2021-01-21,World,656308,16765,97600354,2099082
2021-01-22,World,659045,16007,98259399,2115089
2021-01-23,World,568106,13292,98827505,2128381
2021-01-24,World,445643,8967,99273148,2137348
2021-01-25,World,497319,10762,99770467,2148110
2021-01-26,World,556217,17333,100326684,2165443
2021-01-27,World,597694,16672,100924378,2182115
2021-01-28,World,614883,17039,101539261,2199154
2021-01-29,World,590429,14927,102129690,2214081
2021-01-30,World,515317,13571,102645007,2227652
2021-01-31,World,381631,7977,103026638,2235629
2021-02-01,World,446756,10199,103473394,2245828
2021-02-02,World,457941,14880,103931335,2260708
2021-02-03,World,521961,15703,104453296,2276411
2021-02-04,World,466893,12541,104920189,2288952
2021-02-05,World,535421,16507,105455610,2305459
2021-02-06,World,372115,10096,105827725,2315555
2021-02-07,World,398060,7916,106225785,2323471
2021-02-08,World,315876,8323,106541661,2331794
2021-02-09,World,428022,15537,106969683,2347331
2021-02-10,World,435729,13418,107405412,2360749
2021-02-11,World,441446,13447,107846858,2374196
2021-02-12,World,428667,12460,108275525,2386656
2021-02-13,World,373285,9796,108648810,2396452
2021-02-14,World,293839,6329,108942649,2402781
2021-02-15,World,283164,6888,109225813,2409669
2021-02-16,World,351012,10899,109576825,2420568
2021-02-17,World,395554,11344,109972379,2431912
2021-02-18,World,403189,11327,110375568,2443239
2021-02-19,World,412819,11069,110788387,2454308
2021-02-20,World,370449,8494,111158836,2462802
2021-02-21,World,314435,5845,111473271,2468647
2021-02-22,World,288426,6929,111761697,2475576
2021-02-23,World,388844,11179,112150541,2486755
2021-02-24,World,444922,11996,112595463,2498751
2021-02-25,World,447469,10086,113042932,2508837
2021-02-26,World,442664,10291,113485596,2519128
2021-02-27,World,389083,8134,113874679,2527262
2021-02-28,World,303349,5400,114178028,2532662
2021-03-01,World,306523,7225,114484551,2539887
2021-03-02,World,310280,10434,114794831,2550321
2021-03-03,World,441133,11076,115235964,2561397
2021-03-04,World,453043,9776,115689007,2571173
2021-03-05,World,447046,10016,116136053,2581189
2021-03-06,World,410523,7831,116546576,2589020
2021-03-07,World,368244,5267,116914820,2594287
2021-03-08,World,298701,6862,117213521,2601149
2021-03-09,World,414721,9979,117628242,2611128
2021-03-10,World,467065,9689,118095307,2620817
2021-03-11,World,476884,9765,118572191,2630582
2021-03-12,World,489122,9631,119061313,2640213
2021-03-13,World,454304,8732,119515617,2648945
2021-03-14,World,360376,5500,119875993,2654445
2021-03-15,World,348884,6814,120224877,2661259
2021-03-16,World,473002,9879,120697879,2671138
2021-03-17,World,539270,10072,121237149,2681210
2021-03-18,World,553710,10531,121790859,2691741
2021-03-19,World,561670,10354,122352529,2702095
2021-03-20,World,498815,8087,122851344,2710182
2021-03-21,World,423307,5811,123274651,2715993
2021-03-22,World,416805,7338,123691456,2723331
2021-03-23,World,514230,11077,124205686,2734408
2021-03-24,World,633572,9667,124839258,2744075
2021-03-25,World,651337,11490,125490595,2755565
2021-03-26,World,641344,12188,126131939,2767753
2021-03-27,World,583970,9794,126715909,2777547
2021-03-28,World,470555,6466,127186464,2784013
2021-03-29,World,458397,7953,127644861,2791966
2021-03-30,World,568264,11561,128213125,2803527
2021-03-31,World,683195,12262,128896320,2815789
2021-04-01,World,711775,11863,129608095,2827652
2021-04-02,World,629008,10155,130237103,2837807
2021-04-03,World,534073,8456,130771176,2846263
2021-04-04,World,552763,6919,131323939,2853182
2021-04-05,World,489699,7470,131813638,2860652
2021-04-06,World,605501,11801,132419139,2872453
2021-04-07,World,684346,14825,133103485,2887278
2021-04-08,World,839850,14631,133943335,2901909
2020-04-10,Yemen,1,0,1,0
2020-04-11,Yemen,0,0,1,0
2020-04-12,Yemen,0,0,1,0
2020-04-13,Yemen,0,0,1,0
2020-04-14,Yemen,0,0,1,0
2020-04-15,Yemen,0,0,1,0
2020-04-16,Yemen,0,0,1,0
2020-04-17,Yemen,0,0,1,0
2020-04-18,Yemen,0,0,1,0
2020-04-19,Yemen,0,0,1,0
2020-04-20,Yemen,0,0,1,0
2020-04-21,Yemen,0,0,1,0
2020-04-22,Yemen,0,0,1,0
2020-04-23,Yemen,0,0,1,0
2020-04-24,Yemen,0,0,1,0
2020-04-25,Yemen,0,0,1,0
2020-04-26,Yemen,0,0,1,0
2020-04-27,Yemen,0,0,1,0
2020-04-28,Yemen,0,0,1,0
2020-04-29,Yemen,5,0,6,0
2020-04-30,Yemen,0,2,6,2
2020-05-01,Yemen,1,0,7,2
2020-05-02,Yemen,3,0,10,2
2020-05-03,Yemen,0,0,10,2
2020-05-04,Yemen,2,0,12,2
2020-05-05,Yemen,9,1,21,3
2020-05-06,Yemen,4,2,25,5
2020-05-07,Yemen,0,0,25,5
2020-05-08,Yemen,9,0,34,5
2020-05-09,Yemen,0,2,34,7
2020-05-10,Yemen,17,1,51,8
2020-05-11,Yemen,5,1,56,9
2020-05-12,Yemen,9,1,65,10
2020-05-13,Yemen,5,2,70,12
2020-05-14,Yemen,15,0,85,12
2020-05-15,Yemen,21,3,106,15
2020-05-16,Yemen,16,3,122,18
2020-05-17,Yemen,6,2,128,20
2020-05-18,Yemen,2,0,130,20
2020-05-19,Yemen,37,8,167,28
2020-05-20,Yemen,13,1,180,29
2020-05-21,Yemen,13,4,193,33
2020-05-22,Yemen,12,0,205,33
2020-05-23,Yemen,7,6,212,39
2020-05-24,Yemen,10,3,222,42
2020-05-25,Yemen,11,2,233,44
2020-05-26,Yemen,16,5,249,49
2020-05-27,Yemen,6,4,255,53
2020-05-28,Yemen,23,4,278,57
2020-05-29,Yemen,5,8,283,65
2020-05-30,Yemen,27,12,310,77
2020-05-31,Yemen,13,3,323,80
2020-06-01,Yemen,31,4,354,84
2020-06-02,Yemen,45,3,399,87
2020-06-03,Yemen,20,8,419,95
2020-06-04,Yemen,34,8,453,103
2020-06-05,Yemen,16,8,469,111
2020-06-06,Yemen,13,0,482,111
2020-06-07,Yemen,2,1,484,112
2020-06-08,Yemen,12,0,496,112
2020-06-09,Yemen,28,15,524,127
2020-06-10,Yemen,36,2,560,129
2020-06-11,Yemen,31,7,591,136
2020-06-12,Yemen,41,3,632,139
2020-06-13,Yemen,73,21,705,160
2020-06-14,Yemen,23,4,728,164
2020-06-15,Yemen,116,44,844,208
2020-06-16,Yemen,41,6,885,214
2020-06-17,Yemen,17,30,902,244
2020-06-18,Yemen,7,4,909,248
2020-06-19,Yemen,10,3,919,251
2020-06-20,Yemen,3,3,922,254
2020-06-21,Yemen,19,2,941,256
2020-06-22,Yemen,26,1,967,257
2020-06-23,Yemen,25,4,992,261
2020-06-24,Yemen,23,13,1015,274
2020-06-25,Yemen,61,14,1076,288
2020-06-26,Yemen,13,5,1089,293
2020-06-27,Yemen,14,3,1103,296
2020-06-28,Yemen,15,6,1118,302
2020-06-29,Yemen,10,2,1128,304
2020-06-30,Yemen,30,8,1158,312
2020-07-01,Yemen,32,6,1190,318
2020-07-02,Yemen,31,7,1221,325
2020-07-03,Yemen,19,10,1240,335
2020-07-04,Yemen,8,2,1248,337
2020-07-05,Yemen,17,1,1265,338
2020-07-06,Yemen,25,7,1290,345
2020-07-07,Yemen,7,3,1297,348
2020-07-08,Yemen,21,3,1318,351
2020-07-09,Yemen,38,10,1356,361
2020-07-10,Yemen,24,3,1380,364
2020-07-11,Yemen,9,1,1389,365
2020-07-12,Yemen,76,52,1465,417
2020-07-13,Yemen,33,7,1498,424
2020-07-14,Yemen,18,5,1516,429
2020-07-15,Yemen,10,4,1526,433
2020-07-16,Yemen,26,5,1552,438
2020-07-17,Yemen,24,2,1576,440
2020-07-18,Yemen,5,3,1581,443
2020-07-19,Yemen,25,2,1606,445
2020-07-20,Yemen,13,2,1619,447
2020-07-21,Yemen,10,9,1629,456
2020-07-22,Yemen,11,2,1640,458
2020-07-23,Yemen,14,3,1654,461
2020-07-24,Yemen,20,8,1674,469
2020-07-25,Yemen,0,5,1674,474
2020-07-26,Yemen,7,5,1681,479
2020-07-27,Yemen,10,4,1691,483
2020-07-28,Yemen,12,1,1703,484
2020-07-29,Yemen,8,1,1711,485
2020-07-30,Yemen,15,2,1726,487
2020-07-31,Yemen,2,6,1728,493
2020-08-01,Yemen,2,1,1730,494
2020-08-02,Yemen,4,3,1734,497
2020-08-03,Yemen,0,2,1734,499
2020-08-04,Yemen,26,7,1760,506
2020-08-05,Yemen,3,2,1763,508
2020-08-06,Yemen,5,0,1768,508
2020-08-07,Yemen,28,4,1796,512
2020-08-08,Yemen,1,0,1797,512
2020-08-09,Yemen,7,3,1804,515
2020-08-10,Yemen,28,3,1832,518
2020-08-11,Yemen,-1,5,1831,523
2020-08-12,Yemen,10,5,1841,528
2020-08-13,Yemen,6,0,1847,528
2020-08-14,Yemen,11,0,1858,528
2020-08-15,Yemen,0,0,1858,528
2020-08-16,Yemen,11,2,1869,530
2020-08-17,Yemen,0,5,1869,535
2020-08-18,Yemen,20,2,1889,537
2020-08-19,Yemen,3,2,1892,539
2020-08-20,Yemen,7,2,1899,541
2020-08-21,Yemen,7,1,1906,542
2020-08-22,Yemen,1,4,1907,546
2020-08-23,Yemen,4,7,1911,553
2020-08-24,Yemen,5,2,1916,555
2020-08-25,Yemen,8,2,1924,557
2020-08-26,Yemen,6,3,1930,560
2020-08-27,Yemen,3,2,1933,562
2020-08-28,Yemen,10,1,1943,563
2020-08-29,Yemen,3,0,1946,563
2020-08-30,Yemen,7,1,1953,564
2020-08-31,Yemen,5,2,1958,566
2020-09-01,Yemen,4,4,1962,570
2020-09-02,Yemen,14,1,1976,571
2020-09-03,Yemen,3,0,1979,571
2020-09-04,Yemen,4,1,1983,572
2020-09-05,Yemen,0,0,1983,572
2020-09-06,Yemen,4,0,1987,572
2020-09-07,Yemen,2,1,1989,573
2020-09-08,Yemen,5,3,1994,576
2020-09-09,Yemen,5,0,1999,576
2020-09-10,Yemen,4,4,2003,580
2020-09-11,Yemen,4,2,2007,582
2020-09-12,Yemen,2,0,2009,582
2020-09-13,Yemen,2,1,2011,583
2020-09-14,Yemen,2,0,2013,583
2020-09-15,Yemen,3,0,2016,583
2020-09-16,Yemen,3,0,2019,583
2020-09-17,Yemen,3,2,2022,585
2020-09-18,Yemen,2,0,2024,585
2020-09-19,Yemen,2,0,2026,585
2020-09-20,Yemen,0,1,2026,586
2020-09-21,Yemen,2,0,2028,586
2020-09-22,Yemen,0,0,2028,586
2020-09-23,Yemen,1,0,2029,586
2020-09-24,Yemen,0,0,2029,586
2020-09-25,Yemen,0,1,2029,587
2020-09-26,Yemen,1,0,2030,587
2020-09-27,Yemen,0,0,2030,587
2020-09-28,Yemen,1,0,2031,587
2020-09-29,Yemen,0,0,2031,587
2020-09-30,Yemen,3,0,2034,587
2020-10-01,Yemen,5,0,2039,587
2020-10-02,Yemen,1,2,2040,589
2020-10-03,Yemen,1,0,2041,589
2020-10-04,Yemen,0,2,2041,591
2020-10-05,Yemen,0,1,2041,592
2020-10-06,Yemen,6,1,2047,593
2020-10-07,Yemen,2,0,2049,593
2020-10-08,Yemen,1,0,2050,593
2020-10-09,Yemen,1,0,2051,593
2020-10-10,Yemen,0,2,2051,595
2020-10-11,Yemen,1,0,2052,595
2020-10-12,Yemen,0,1,2052,596
2020-10-13,Yemen,1,0,2053,596
2020-10-14,Yemen,0,0,2053,596
2020-10-15,Yemen,0,0,2053,596
2020-10-16,Yemen,2,0,2055,596
2020-10-17,Yemen,0,0,2055,596
2020-10-18,Yemen,1,1,2056,597
2020-10-19,Yemen,0,0,2056,597
2020-10-20,Yemen,1,0,2057,597
2020-10-21,Yemen,0,0,2057,597
2020-10-22,Yemen,0,0,2057,597
2020-10-23,Yemen,3,2,2060,599
2020-10-24,Yemen,0,0,2060,599
2020-10-25,Yemen,0,0,2060,599
2020-10-26,Yemen,0,0,2060,599
2020-10-27,Yemen,0,0,2060,599
2020-10-28,Yemen,1,0,2061,599
2020-10-29,Yemen,1,0,2062,599
2020-10-30,Yemen,0,0,2062,599
2020-10-31,Yemen,1,0,2063,599
2020-11-01,Yemen,0,1,2063,600
2020-11-02,Yemen,0,1,2063,601
2020-11-03,Yemen,0,0,2063,601
2020-11-04,Yemen,0,0,2063,601
2020-11-05,Yemen,0,0,2063,601
2020-11-06,Yemen,0,0,2063,601
2020-11-07,Yemen,0,0,2063,601
2020-11-08,Yemen,0,0,2063,601
2020-11-09,Yemen,0,0,2063,601
2020-11-10,Yemen,0,0,2063,601
2020-11-11,Yemen,0,0,2063,601
2020-11-12,Yemen,5,1,2068,602
2020-11-13,Yemen,0,0,2068,602
2020-11-14,Yemen,0,0,2068,602
2020-11-15,Yemen,0,1,2068,603
2020-11-16,Yemen,0,0,2068,603
2020-11-17,Yemen,0,0,2068,603
2020-11-18,Yemen,0,0,2068,603
2020-11-19,Yemen,0,1,2068,604
2020-11-20,Yemen,1,0,2069,604
2020-11-21,Yemen,0,0,2069,604
2020-11-22,Yemen,0,0,2069,604
2020-11-23,Yemen,3,0,2072,604
2020-11-24,Yemen,1,0,2073,604
2020-11-25,Yemen,0,0,2073,604
2020-11-26,Yemen,1,0,2074,604
2020-11-27,Yemen,0,0,2074,604
2020-11-28,Yemen,0,0,2074,604
2020-11-29,Yemen,3,1,2077,605
2020-11-30,Yemen,0,0,2077,605
2020-12-01,Yemen,0,0,2077,605
2020-12-02,Yemen,0,0,2077,605
2020-12-03,Yemen,0,1,2077,606
2020-12-04,Yemen,0,0,2077,606
2020-12-05,Yemen,0,0,2077,606
2020-12-06,Yemen,1,0,2078,606
2020-12-07,Yemen,0,0,2078,606
2020-12-08,Yemen,1,0,2079,606
2020-12-09,Yemen,0,0,2079,606
2020-12-10,Yemen,2,0,2081,606
2020-12-11,Yemen,1,0,2082,606
2020-12-12,Yemen,1,0,2083,606
2020-12-13,Yemen,0,0,2083,606
2020-12-14,Yemen,1,0,2084,606
2020-12-15,Yemen,1,0,2085,606
2020-12-16,Yemen,0,0,2085,606
2020-12-17,Yemen,2,0,2087,606
2020-12-18,Yemen,0,0,2087,606
2020-12-19,Yemen,0,0,2087,606
2020-12-20,Yemen,0,0,2087,606
2020-12-21,Yemen,0,0,2087,606
2020-12-22,Yemen,0,0,2087,606
2020-12-23,Yemen,0,0,2087,606
2020-12-24,Yemen,5,0,2092,606
2020-12-25,Yemen,0,0,2092,606
2020-12-26,Yemen,0,0,2092,606
2020-12-27,Yemen,2,1,2094,607
2020-12-28,Yemen,2,1,2096,608
2020-12-29,Yemen,0,2,2096,610
2020-12-30,Yemen,1,0,2097,610
2020-12-31,Yemen,2,0,2099,610
2021-01-01,Yemen,2,0,2101,610
2021-01-02,Yemen,0,0,2101,610
2021-01-03,Yemen,0,0,2101,610
2021-01-04,Yemen,0,0,2101,610
2021-01-05,Yemen,0,0,2101,610
2021-01-06,Yemen,1,0,2102,610
2021-01-07,Yemen,2,0,2104,610
2021-01-08,Yemen,0,0,2104,610
2021-01-09,Yemen,0,0,2104,610
2021-01-10,Yemen,0,1,2104,611
2021-01-11,Yemen,1,1,2105,612
2021-01-12,Yemen,2,0,2107,612
2021-01-13,Yemen,2,0,2109,612
2021-01-14,Yemen,1,0,2110,612
2021-01-15,Yemen,1,0,2111,612
2021-01-16,Yemen,1,0,2112,612
2021-01-17,Yemen,0,0,2112,612
2021-01-18,Yemen,1,0,2113,612
2021-01-19,Yemen,2,0,2115,612
2021-01-20,Yemen,0,0,2115,612
2021-01-21,Yemen,0,2,2115,614
2021-01-22,Yemen,3,0,2118,614
2021-01-23,Yemen,0,1,2118,615
2021-01-24,Yemen,0,0,2118,615
2021-01-25,Yemen,0,0,2118,615
2021-01-26,Yemen,1,0,2119,615
2021-01-27,Yemen,1,0,2120,615
2021-01-28,Yemen,0,0,2120,615
2021-01-29,Yemen,0,0,2120,615
2021-01-30,Yemen,0,0,2120,615
2021-01-31,Yemen,1,0,2121,615
2021-02-01,Yemen,1,0,2122,615
2021-02-02,Yemen,0,0,2122,615
2021-02-03,Yemen,0,0,2122,615
2021-02-04,Yemen,0,0,2122,615
2021-02-05,Yemen,2,0,2124,615
2021-02-06,Yemen,3,0,2127,615
2021-02-07,Yemen,0,0,2127,615
2021-02-08,Yemen,4,0,2131,615
2021-02-09,Yemen,0,0,2131,615
2021-02-10,Yemen,2,1,2133,616
2021-02-11,Yemen,1,0,2134,616
2021-02-12,Yemen,2,0,2136,616
2021-02-13,Yemen,0,0,2136,616
2021-02-14,Yemen,9,1,2145,617
2021-02-15,Yemen,0,0,2145,617
2021-02-16,Yemen,3,1,2148,618
2021-02-17,Yemen,3,0,2151,618
2021-02-18,Yemen,3,0,2154,618
2021-02-19,Yemen,3,0,2157,618
2021-02-20,Yemen,0,0,2157,618
2021-02-21,Yemen,8,1,2165,619
2021-02-22,Yemen,11,0,2176,619
2021-02-23,Yemen,11,1,2187,620
2021-02-24,Yemen,34,4,2221,624
2021-02-25,Yemen,34,1,2255,625
2021-02-26,Yemen,12,2,2267,627
2021-02-27,Yemen,2,4,2269,631
2021-02-28,Yemen,16,3,2285,634
2021-03-01,Yemen,25,0,2310,634
2021-03-02,Yemen,32,6,2342,640
2021-03-03,Yemen,21,3,2363,643
2021-03-04,Yemen,12,2,2375,645
2021-03-05,Yemen,36,3,2411,648
2021-03-06,Yemen,33,2,2444,650
2021-03-07,Yemen,29,1,2473,651
2021-03-08,Yemen,72,2,2545,653
2021-03-09,Yemen,41,1,2586,654
2021-03-10,Yemen,41,7,2627,661
2021-03-11,Yemen,40,6,2667,667
2021-03-12,Yemen,62,12,2729,679
2021-03-13,Yemen,42,4,2771,683
2021-03-14,Yemen,65,6,2836,689
2021-03-15,Yemen,72,9,2908,698
2021-03-16,Yemen,61,9,2969,707
2021-03-17,Yemen,68,6,3037,713
2021-03-18,Yemen,89,10,3126,723
2021-03-19,Yemen,91,10,3217,733
2021-03-20,Yemen,61,4,3278,737
2021-03-21,Yemen,140,14,3418,751
2021-03-22,Yemen,98,20,3516,771
2021-03-23,Yemen,96,14,3612,785
2021-03-24,Yemen,91,15,3703,800
2021-03-25,Yemen,113,10,3816,810
2021-03-26,Yemen,84,10,3900,820
2021-03-27,Yemen,69,12,3969,832
2021-03-28,Yemen,64,19,4033,851
2021-03-29,Yemen,82,12,4115,863
2021-03-30,Yemen,132,19,4247,882
2021-03-31,Yemen,110,6,4357,888
2021-04-01,Yemen,174,18,4531,906
2021-04-02,Yemen,89,10,4620,916
2021-04-03,Yemen,77,16,4697,932
2021-04-04,Yemen,101,14,4798,946
2021-04-05,Yemen,83,9,4881,955
2021-04-06,Yemen,94,21,4975,976
2021-04-07,Yemen,72,10,5047,986
2021-04-08,Yemen,86,18,5133,1004
2020-03-18,Zambia,2,0,2,0
2020-03-19,Zambia,0,0,2,0
2020-03-20,Zambia,0,0,2,0
2020-03-21,Zambia,0,0,2,0
2020-03-22,Zambia,1,0,3,0
2020-03-23,Zambia,0,0,3,0
2020-03-24,Zambia,0,0,3,0
2020-03-25,Zambia,9,0,12,0
2020-03-26,Zambia,4,0,16,0
2020-03-27,Zambia,6,0,22,0
2020-03-28,Zambia,6,0,28,0
2020-03-29,Zambia,1,0,29,0
2020-03-30,Zambia,6,0,35,0
2020-03-31,Zambia,0,0,35,0
2020-04-01,Zambia,1,0,36,0
2020-04-02,Zambia,3,1,39,1
2020-04-03,Zambia,0,0,39,1
2020-04-04,Zambia,0,0,39,1
2020-04-05,Zambia,0,0,39,1
2020-04-06,Zambia,0,0,39,1
2020-04-07,Zambia,0,0,39,1
2020-04-08,Zambia,0,0,39,1
2020-04-09,Zambia,0,0,39,1
2020-04-10,Zambia,1,1,40,2
2020-04-11,Zambia,0,0,40,2
2020-04-12,Zambia,3,0,43,2
2020-04-13,Zambia,2,0,45,2
2020-04-14,Zambia,0,0,45,2
2020-04-15,Zambia,3,0,48,2
2020-04-16,Zambia,0,0,48,2
2020-04-17,Zambia,4,0,52,2
2020-04-18,Zambia,5,0,57,2
2020-04-19,Zambia,4,1,61,3
2020-04-20,Zambia,4,0,65,3
2020-04-21,Zambia,5,0,70,3
2020-04-22,Zambia,4,0,74,3
2020-04-23,Zambia,2,0,76,3
2020-04-24,Zambia,8,0,84,3
2020-04-25,Zambia,0,0,84,3
2020-04-26,Zambia,4,0,88,3
2020-04-27,Zambia,0,0,88,3
2020-04-28,Zambia,7,0,95,3
2020-04-29,Zambia,2,0,97,3
2020-04-30,Zambia,9,0,106,3
2020-05-01,Zambia,3,0,109,3
2020-05-02,Zambia,10,0,119,3
2020-05-03,Zambia,5,0,124,3
2020-05-04,Zambia,13,0,137,3
2020-05-05,Zambia,1,0,138,3
2020-05-06,Zambia,8,1,146,4
2020-05-07,Zambia,7,0,153,4
2020-05-08,Zambia,14,0,167,4
2020-05-09,Zambia,85,3,252,7
2020-05-10,Zambia,15,0,267,7
2020-05-11,Zambia,0,0,267,7
2020-05-12,Zambia,174,0,441,7
2020-05-13,Zambia,5,0,446,7
2020-05-14,Zambia,208,0,654,7
2020-05-15,Zambia,0,0,654,7
2020-05-16,Zambia,25,0,679,7
2020-05-17,Zambia,74,0,753,7
2020-05-18,Zambia,8,0,761,7
2020-05-19,Zambia,11,0,772,7
2020-05-20,Zambia,60,0,832,7
2020-05-21,Zambia,34,0,866,7
2020-05-22,Zambia,54,0,920,7
2020-05-23,Zambia,0,0,920,7
2020-05-24,Zambia,0,0,920,7
2020-05-25,Zambia,0,0,920,7
2020-05-26,Zambia,0,0,920,7
2020-05-27,Zambia,137,0,1057,7
2020-05-28,Zambia,0,0,1057,7
2020-05-29,Zambia,0,0,1057,7
2020-05-30,Zambia,0,0,1057,7
2020-05-31,Zambia,0,0,1057,7
2020-06-01,Zambia,32,0,1089,7
2020-06-02,Zambia,0,0,1089,7
2020-06-03,Zambia,0,0,1089,7
2020-06-04,Zambia,0,0,1089,7
2020-06-05,Zambia,0,0,1089,7
2020-06-06,Zambia,0,0,1089,7
2020-06-07,Zambia,0,0,1089,7
2020-06-08,Zambia,111,3,1200,10
2020-06-09,Zambia,0,0,1200,10
2020-06-10,Zambia,0,0,1200,10
2020-06-11,Zambia,0,0,1200,10
2020-06-12,Zambia,121,0,1321,10
2020-06-13,Zambia,36,0,1357,10
2020-06-14,Zambia,1,1,1358,11
2020-06-15,Zambia,24,0,1382,11
2020-06-16,Zambia,23,0,1405,11
2020-06-17,Zambia,7,0,1412,11
2020-06-18,Zambia,4,0,1416,11
2020-06-19,Zambia,14,0,1430,11
2020-06-20,Zambia,0,0,1430,11
2020-06-21,Zambia,0,0,1430,11
2020-06-22,Zambia,0,0,1430,11
2020-06-23,Zambia,47,7,1477,18
2020-06-24,Zambia,12,0,1489,18
2020-06-25,Zambia,8,0,1497,18
2020-06-26,Zambia,34,3,1531,21
2020-06-27,Zambia,0,0,1531,21
2020-06-28,Zambia,26,1,1557,22
2020-06-29,Zambia,11,0,1568,22
2020-06-30,Zambia,26,2,1594,24
2020-07-01,Zambia,38,6,1632,30
2020-07-02,Zambia,0,0,1632,30
2020-07-03,Zambia,0,0,1632,30
2020-07-04,Zambia,0,0,1632,30
2020-07-05,Zambia,0,0,1632,30
2020-07-06,Zambia,0,0,1632,30
2020-07-07,Zambia,263,12,1895,42
2020-07-08,Zambia,0,0,1895,42
2020-07-09,Zambia,0,0,1895,42
2020-07-10,Zambia,0,0,1895,42
2020-07-11,Zambia,0,0,1895,42
2020-07-12,Zambia,0,0,1895,42
2020-07-13,Zambia,0,0,1895,42
2020-07-14,Zambia,0,0,1895,42
2020-07-15,Zambia,0,0,1895,42
2020-07-16,Zambia,0,0,1895,42
2020-07-17,Zambia,915,67,2810,109
2020-07-18,Zambia,170,11,2980,120
2020-07-19,Zambia,0,0,2980,120
2020-07-20,Zambia,346,8,3326,128
2020-07-21,Zambia,60,0,3386,128
2020-07-22,Zambia,197,0,3583,128
2020-07-23,Zambia,206,6,3789,134
2020-07-24,Zambia,67,2,3856,136
2020-07-25,Zambia,472,3,4328,139
2020-07-26,Zambia,153,0,4481,139
2020-07-27,Zambia,71,1,4552,140
2020-07-28,Zambia,450,2,5002,142
2020-07-29,Zambia,247,4,5249,146
2020-07-30,Zambia,306,3,5555,149
2020-07-31,Zambia,408,2,5963,151
2020-08-01,Zambia,265,14,6228,165
2020-08-02,Zambia,119,5,6347,170
2020-08-03,Zambia,233,1,6580,171
2020-08-04,Zambia,213,2,6793,173
2020-08-05,Zambia,229,3,7022,176
2020-08-06,Zambia,142,23,7164,199
2020-08-07,Zambia,322,1,7486,200
2020-08-08,Zambia,417,3,7903,203
2020-08-09,Zambia,182,32,8085,235
2020-08-10,Zambia,125,6,8210,241
2020-08-11,Zambia,65,0,8275,241
2020-08-12,Zambia,226,5,8501,246
2020-08-13,Zambia,162,0,8663,246
2020-08-14,Zambia,358,10,9021,256
2020-08-15,Zambia,165,4,9186,260
2020-08-16,Zambia,157,0,9343,260
2020-08-17,Zambia,496,4,9839,264
2020-08-18,Zambia,142,0,9981,264
2020-08-19,Zambia,237,5,10218,269
2020-08-20,Zambia,154,5,10372,274
2020-08-21,Zambia,255,3,10627,277
2020-08-22,Zambia,204,2,10831,279
2020-08-23,Zambia,251,1,11082,280
2020-08-24,Zambia,66,0,11148,280
2020-08-25,Zambia,137,2,11285,282
2020-08-26,Zambia,91,0,11376,282
2020-08-27,Zambia,225,0,11601,282
2020-08-28,Zambia,178,1,11779,283
2020-08-29,Zambia,123,1,11902,284
2020-08-30,Zambia,123,3,12025,287
2020-08-31,Zambia,72,1,12097,288
2020-09-01,Zambia,284,2,12381,290
2020-09-02,Zambia,34,2,12415,292
2020-09-03,Zambia,108,0,12523,292
2020-09-04,Zambia,116,0,12639,292
2020-09-05,Zambia,70,0,12709,292
2020-09-06,Zambia,67,3,12776,295
2020-09-07,Zambia,60,0,12836,295
2020-09-08,Zambia,116,2,12952,297
2020-09-09,Zambia,160,3,13112,300
2020-09-10,Zambia,102,0,13214,300
2020-09-11,Zambia,109,6,13323,306
2020-09-12,Zambia,143,6,13466,312
2020-09-13,Zambia,73,0,13539,312
2020-09-14,Zambia,181,8,13720,320
2020-09-15,Zambia,99,4,13819,324
2020-09-16,Zambia,68,2,13887,326
2020-09-17,Zambia,41,0,13928,326
2020-09-18,Zambia,94,3,14022,329
2020-09-19,Zambia,48,1,14070,330
2020-09-20,Zambia,61,0,14131,330
2020-09-21,Zambia,44,1,14175,331
2020-09-22,Zambia,214,0,14389,331
2020-09-23,Zambia,54,1,14443,332
2020-09-24,Zambia,48,0,14491,332
2020-09-25,Zambia,24,0,14515,332
2020-09-26,Zambia,97,0,14612,332
2020-09-27,Zambia,29,0,14641,332
2020-09-28,Zambia,19,0,14660,332
2020-09-29,Zambia,55,0,14715,332
2020-09-30,Zambia,44,0,14759,332
2020-10-01,Zambia,43,1,14802,333
2020-10-02,Zambia,28,0,14830,333
2020-10-03,Zambia,144,0,14974,333
2020-10-04,Zambia,78,0,15052,333
2020-10-05,Zambia,37,1,15089,334
2020-10-06,Zambia,81,1,15170,335
2020-10-07,Zambia,54,0,15224,335
2020-10-08,Zambia,77,0,15301,335
2020-10-09,Zambia,38,1,15339,336
2020-10-10,Zambia,76,1,15415,337
2020-10-11,Zambia,43,0,15458,337
2020-10-12,Zambia,91,8,15549,345
2020-10-13,Zambia,38,0,15587,345
2020-10-14,Zambia,29,0,15616,345
2020-10-15,Zambia,43,1,15659,346
2020-10-16,Zambia,0,0,15659,346
2020-10-17,Zambia,130,0,15789,346
2020-10-18,Zambia,64,0,15853,346
2020-10-19,Zambia,44,0,15897,346
2020-10-20,Zambia,85,0,15982,346
2020-10-21,Zambia,18,0,16000,346
2020-10-22,Zambia,35,0,16035,346
2020-10-23,Zambia,60,0,16095,346
2020-10-24,Zambia,22,2,16117,348
2020-10-25,Zambia,0,0,16117,348
2020-10-26,Zambia,83,0,16200,348
2020-10-27,Zambia,43,0,16243,348
2020-10-28,Zambia,42,0,16285,348
2020-10-29,Zambia,40,0,16325,348
2020-10-30,Zambia,90,1,16415,349
2020-10-31,Zambia,17,0,16432,349
2020-11-01,Zambia,48,0,16480,349
2020-11-02,Zambia,63,0,16543,349
2020-11-03,Zambia,118,0,16661,349
2020-11-04,Zambia,37,0,16698,349
2020-11-05,Zambia,72,0,16770,349
2020-11-06,Zambia,49,0,16819,349
2020-11-07,Zambia,89,0,16908,349
2020-11-08,Zambia,46,0,16954,349
2020-11-09,Zambia,17,0,16971,349
2020-11-10,Zambia,26,1,16997,350
2020-11-11,Zambia,39,0,17036,350
2020-11-12,Zambia,20,0,17056,350
2020-11-13,Zambia,37,0,17093,350
2020-11-14,Zambia,4,0,17097,350
2020-11-15,Zambia,26,3,17123,353
2020-11-16,Zambia,64,0,17187,353
2020-11-17,Zambia,56,0,17243,353
2020-11-18,Zambia,37,3,17280,356
2020-11-19,Zambia,70,0,17350,356
2020-11-20,Zambia,23,0,17373,356
2020-11-21,Zambia,21,0,17394,356
2020-11-22,Zambia,30,1,17424,357
2020-11-23,Zambia,30,0,17454,357
2020-11-24,Zambia,12,0,17466,357
2020-11-25,Zambia,69,0,17535,357
2020-11-26,Zambia,18,0,17553,357
2020-11-27,Zambia,16,0,17569,357
2020-11-28,Zambia,20,0,17589,357
2020-11-29,Zambia,19,0,17608,357
2020-11-30,Zambia,39,0,17647,357
2020-12-01,Zambia,18,0,17665,357
2020-12-02,Zambia,35,0,17700,357
2020-12-03,Zambia,30,0,17730,357
2020-12-04,Zambia,127,7,17857,364
2020-12-05,Zambia,41,0,17898,364
2020-12-06,Zambia,18,0,17916,364
2020-12-07,Zambia,15,0,17931,364
2020-12-08,Zambia,32,0,17963,364
2020-12-09,Zambia,99,0,18062,364
2020-12-10,Zambia,29,0,18091,364
2020-12-11,Zambia,70,1,18161,365
2020-12-12,Zambia,56,1,18217,366
2020-12-13,Zambia,57,1,18274,367
2020-12-14,Zambia,48,0,18322,367
2020-12-15,Zambia,106,1,18428,368
2020-12-16,Zambia,28,1,18456,369
2020-12-17,Zambia,48,0,18504,369
2020-12-18,Zambia,71,4,18575,373
2020-12-19,Zambia,45,0,18620,373
2020-12-20,Zambia,96,0,18716,373
2020-12-21,Zambia,52,2,18768,375
2020-12-22,Zambia,113,4,18881,379
2020-12-23,Zambia,241,1,19122,380
2020-12-24,Zambia,112,1,19234,381
2020-12-25,Zambia,337,0,19571,381
2020-12-26,Zambia,100,1,19671,382
2020-12-27,Zambia,163,1,19834,383
2020-12-28,Zambia,109,1,19943,384
2020-12-29,Zambia,234,1,20177,385
2020-12-30,Zambia,285,1,20462,386
2020-12-31,Zambia,263,2,20725,388
2021-01-01,Zambia,272,2,20997,390
2021-01-02,Zambia,233,2,21230,392
2021-01-03,Zambia,352,2,21582,394
2021-01-04,Zambia,411,4,21993,398
2021-01-05,Zambia,652,14,22645,412
2021-01-06,Zambia,850,5,23495,417
2021-01-07,Zambia,802,6,24297,423
2021-01-08,Zambia,1029,18,25326,441
2021-01-09,Zambia,1241,23,26567,464
2021-01-10,Zambia,1161,5,27728,469
2021-01-11,Zambia,868,2,28596,471
2021-01-12,Zambia,1161,24,29757,495
2021-01-13,Zambia,1343,14,31100,509
2021-01-14,Zambia,1700,5,32800,514
2021-01-15,Zambia,1478,13,34278,527
2021-01-16,Zambia,1796,10,36074,537
2021-01-17,Zambia,1531,9,37605,546
2021-01-18,Zambia,602,13,38207,559
2021-01-19,Zambia,1308,19,39515,578
2021-01-20,Zambia,1434,7,40949,585
2021-01-21,Zambia,1264,12,42213,597
2021-01-22,Zambia,1120,13,43333,610
2021-01-23,Zambia,1259,17,44592,627
2021-01-24,Zambia,745,12,45337,639
2021-01-25,Zambia,809,21,46146,660
2021-01-26,Zambia,1476,12,47622,672
2021-01-27,Zambia,1289,16,48911,688
2021-01-28,Zambia,1408,17,50319,705
2021-01-29,Zambia,1305,23,51624,728
2021-01-30,Zambia,1728,17,53352,745
2021-01-31,Zambia,865,18,54217,763
2021-02-01,Zambia,825,17,55042,780
2021-02-02,Zambia,1191,14,56233,794
2021-02-03,Zambia,1256,10,57489,804
2021-02-04,Zambia,1514,8,59003,812
2021-02-05,Zambia,1424,16,60427,828
2021-02-06,Zambia,1000,11,61427,839
2021-02-07,Zambia,1206,14,62633,853
2021-02-08,Zambia,940,16,63573,869
2021-02-09,Zambia,1037,12,64610,881
2021-02-10,Zambia,963,20,65573,901
2021-02-11,Zambia,1025,13,66598,914
2021-02-12,Zambia,1083,17,67681,931
2021-02-13,Zambia,773,9,68454,940
2021-02-14,Zambia,983,11,69437,951
2021-02-15,Zambia,811,8,70248,959
2021-02-16,Zambia,575,15,70823,974
2021-02-17,Zambia,854,9,71677,983
2021-02-18,Zambia,790,8,72467,991
2021-02-19,Zambia,736,11,73203,1002
2021-02-20,Zambia,691,14,73894,1016
2021-02-21,Zambia,609,4,74503,1020
2021-02-22,Zambia,524,11,75027,1031
2021-02-23,Zambia,555,9,75582,1040
2021-02-24,Zambia,902,11,76484,1051
2021-02-25,Zambia,687,8,77171,1059
2021-02-26,Zambia,468,7,77639,1066
2021-02-27,Zambia,563,15,78202,1081
2021-02-28,Zambia,332,10,78534,1091
2021-03-01,Zambia,468,7,79002,1098
2021-03-02,Zambia,555,6,79557,1104
2021-03-03,Zambia,533,4,80090,1108
2021-03-04,Zambia,597,1,80687,1109
2021-03-05,Zambia,654,4,81341,1113
2021-03-06,Zambia,670,3,82011,1116
2021-03-07,Zambia,410,8,82421,1124
2021-03-08,Zambia,234,8,82655,1132
2021-03-09,Zambia,242,5,82897,1137
2021-03-10,Zambia,436,3,83333,1140
2021-03-11,Zambia,580,8,83913,1148
2021-03-12,Zambia,327,1,84240,1149
2021-03-13,Zambia,234,4,84474,1153
2021-03-14,Zambia,323,5,84797,1158
2021-03-15,Zambia,153,6,84950,1164
2021-03-16,Zambia,290,3,85240,1167
2021-03-17,Zambia,262,3,85502,1170
2021-03-18,Zambia,387,5,85889,1175
2021-03-19,Zambia,170,3,86059,1178
2021-03-20,Zambia,214,0,86273,1178
2021-03-21,Zambia,176,1,86449,1179
2021-03-22,Zambia,86,3,86535,1182
2021-03-23,Zambia,244,3,86779,1185
2021-03-24,Zambia,214,2,86993,1187
2021-03-25,Zambia,325,4,87318,1191
2021-03-26,Zambia,265,3,87583,1194
2021-03-27,Zambia,0,4,87583,1198
2021-03-28,Zambia,289,2,87872,1200
2021-03-29,Zambia,140,0,88012,1200
2021-03-30,Zambia,187,2,88199,1202
2021-03-31,Zambia,219,6,88418,1208
2021-04-01,Zambia,131,4,88549,1212
2021-04-02,Zambia,181,3,88730,1215
2021-04-03,Zambia,70,0,88800,1215
2021-04-04,Zambia,130,5,88930,1220
2021-04-05,Zambia,79,2,89009,1222
2021-04-06,Zambia,62,2,89071,1224
2021-04-07,Zambia,315,0,89386,1224
2021-04-08,Zambia,206,1,89592,1225
2020-03-20,Zimbabwe,1,0,1,0
2020-03-21,Zimbabwe,2,0,3,0
2020-03-22,Zimbabwe,0,0,3,0
2020-03-23,Zimbabwe,0,1,3,1
2020-03-24,Zimbabwe,0,0,3,1
2020-03-25,Zimbabwe,0,0,3,1
2020-03-26,Zimbabwe,0,0,3,1
2020-03-27,Zimbabwe,2,0,5,1
2020-03-28,Zimbabwe,2,0,7,1
2020-03-29,Zimbabwe,0,0,7,1
2020-03-30,Zimbabwe,0,0,7,1
2020-03-31,Zimbabwe,1,0,8,1
2020-04-01,Zimbabwe,0,0,8,1
2020-04-02,Zimbabwe,1,0,9,1
2020-04-03,Zimbabwe,0,0,9,1
2020-04-04,Zimbabwe,0,0,9,1
2020-04-05,Zimbabwe,0,0,9,1
2020-04-06,Zimbabwe,1,0,10,1
2020-04-07,Zimbabwe,1,1,11,2
2020-04-08,Zimbabwe,0,1,11,3
2020-04-09,Zimbabwe,0,0,11,3
2020-04-10,Zimbabwe,2,0,13,3
2020-04-11,Zimbabwe,1,0,14,3
2020-04-12,Zimbabwe,0,0,14,3
2020-04-13,Zimbabwe,3,0,17,3
2020-04-14,Zimbabwe,0,0,17,3
2020-04-15,Zimbabwe,6,0,23,3
2020-04-16,Zimbabwe,0,0,23,3
2020-04-17,Zimbabwe,1,0,24,3
2020-04-18,Zimbabwe,1,0,25,3
2020-04-19,Zimbabwe,0,0,25,3
2020-04-20,Zimbabwe,0,0,25,3
2020-04-21,Zimbabwe,3,0,28,3
2020-04-22,Zimbabwe,0,1,28,4
2020-04-23,Zimbabwe,0,0,28,4
2020-04-24,Zimbabwe,1,0,29,4
2020-04-25,Zimbabwe,2,0,31,4
2020-04-26,Zimbabwe,0,0,31,4
2020-04-27,Zimbabwe,1,0,32,4
2020-04-28,Zimbabwe,0,0,32,4
2020-04-29,Zimbabwe,0,0,32,4
2020-04-30,Zimbabwe,8,0,40,4
2020-05-01,Zimbabwe,0,0,40,4
2020-05-02,Zimbabwe,-6,0,34,4
2020-05-03,Zimbabwe,0,0,34,4
2020-05-04,Zimbabwe,0,0,34,4
2020-05-05,Zimbabwe,0,0,34,4
2020-05-06,Zimbabwe,0,0,34,4
2020-05-07,Zimbabwe,0,0,34,4
2020-05-08,Zimbabwe,0,0,34,4
2020-05-09,Zimbabwe,1,0,35,4
2020-05-10,Zimbabwe,1,0,36,4
2020-05-11,Zimbabwe,0,0,36,4
2020-05-12,Zimbabwe,0,0,36,4
2020-05-13,Zimbabwe,1,0,37,4
2020-05-14,Zimbabwe,0,0,37,4
2020-05-15,Zimbabwe,5,0,42,4
2020-05-16,Zimbabwe,0,0,42,4
2020-05-17,Zimbabwe,2,0,44,4
2020-05-18,Zimbabwe,2,0,46,4
2020-05-19,Zimbabwe,0,0,46,4
2020-05-20,Zimbabwe,2,0,48,4
2020-05-21,Zimbabwe,3,0,51,4
2020-05-22,Zimbabwe,0,0,51,4
2020-05-23,Zimbabwe,5,0,56,4
2020-05-24,Zimbabwe,0,0,56,4
2020-05-25,Zimbabwe,0,0,56,4
2020-05-26,Zimbabwe,0,0,56,4
2020-05-27,Zimbabwe,76,0,132,4
2020-05-28,Zimbabwe,17,0,149,4
2020-05-29,Zimbabwe,0,0,149,4
2020-05-30,Zimbabwe,25,0,174,4
2020-05-31,Zimbabwe,4,0,178,4
2020-06-01,Zimbabwe,25,0,203,4
2020-06-02,Zimbabwe,3,0,206,4
2020-06-03,Zimbabwe,16,0,222,4
2020-06-04,Zimbabwe,15,0,237,4
2020-06-05,Zimbabwe,28,0,265,4
2020-06-06,Zimbabwe,14,0,279,4
2020-06-07,Zimbabwe,3,0,282,4
2020-06-08,Zimbabwe,5,0,287,4
2020-06-09,Zimbabwe,27,0,314,4
2020-06-10,Zimbabwe,6,0,320,4
2020-06-11,Zimbabwe,12,0,332,4
2020-06-12,Zimbabwe,11,0,343,4
2020-06-13,Zimbabwe,13,0,356,4
2020-06-14,Zimbabwe,27,0,383,4
2020-06-15,Zimbabwe,4,0,387,4
2020-06-16,Zimbabwe,4,0,391,4
2020-06-17,Zimbabwe,10,0,401,4
2020-06-18,Zimbabwe,62,0,463,4
2020-06-19,Zimbabwe,16,0,479,4
2020-06-20,Zimbabwe,0,0,479,4
2020-06-21,Zimbabwe,10,2,489,6
2020-06-22,Zimbabwe,23,0,512,6
2020-06-23,Zimbabwe,13,0,525,6
2020-06-24,Zimbabwe,5,0,530,6
2020-06-25,Zimbabwe,21,0,551,6
2020-06-26,Zimbabwe,10,0,561,6
2020-06-27,Zimbabwe,6,0,567,6
2020-06-28,Zimbabwe,0,0,567,6
2020-06-29,Zimbabwe,7,1,574,7
2020-06-30,Zimbabwe,17,0,591,7
2020-07-01,Zimbabwe,14,0,605,7
2020-07-02,Zimbabwe,12,0,617,7
2020-07-03,Zimbabwe,8,0,625,7
2020-07-04,Zimbabwe,73,1,698,8
2020-07-05,Zimbabwe,18,0,716,8
2020-07-06,Zimbabwe,18,1,734,9
2020-07-07,Zimbabwe,53,0,787,9
2020-07-08,Zimbabwe,98,0,885,9
2020-07-09,Zimbabwe,0,0,885,9
2020-07-10,Zimbabwe,57,4,942,13
2020-07-11,Zimbabwe,40,5,982,18
2020-07-12,Zimbabwe,3,0,985,18
2020-07-13,Zimbabwe,49,1,1034,19
2020-07-14,Zimbabwe,30,1,1064,20
2020-07-15,Zimbabwe,25,0,1089,20
2020-07-16,Zimbabwe,273,3,1362,23
2020-07-17,Zimbabwe,58,1,1420,24
2020-07-18,Zimbabwe,58,1,1478,25
2020-07-19,Zimbabwe,133,0,1611,25
2020-07-20,Zimbabwe,102,1,1713,26
2020-07-21,Zimbabwe,107,0,1820,26
2020-07-22,Zimbabwe,214,0,2034,26
2020-07-23,Zimbabwe,90,2,2124,28
2020-07-24,Zimbabwe,172,4,2296,32
2020-07-25,Zimbabwe,138,2,2434,34
2020-07-26,Zimbabwe,78,0,2512,34
2020-07-27,Zimbabwe,192,2,2704,36
2020-07-28,Zimbabwe,113,4,2817,40
2020-07-29,Zimbabwe,62,1,2879,41
2020-07-30,Zimbabwe,213,12,3092,53
2020-07-31,Zimbabwe,77,14,3169,67
2020-08-01,Zimbabwe,490,2,3659,69
2020-08-02,Zimbabwe,262,1,3921,70
2020-08-03,Zimbabwe,154,10,4075,80
2020-08-04,Zimbabwe,146,1,4221,81
2020-08-05,Zimbabwe,0,0,4221,81
2020-08-06,Zimbabwe,118,3,4339,84
2020-08-07,Zimbabwe,112,18,4451,102
2020-08-08,Zimbabwe,124,0,4575,102
2020-08-09,Zimbabwe,74,2,4649,104
2020-08-10,Zimbabwe,99,0,4748,104
2020-08-11,Zimbabwe,70,0,4818,104
2020-08-12,Zimbabwe,75,18,4893,122
2020-08-13,Zimbabwe,97,6,4990,128
2020-08-14,Zimbabwe,82,0,5072,128
2020-08-15,Zimbabwe,104,2,5176,130
2020-08-16,Zimbabwe,85,2,5261,132
2020-08-17,Zimbabwe,47,3,5308,135
2020-08-18,Zimbabwe,70,6,5378,141
2020-08-19,Zimbabwe,265,9,5643,150
2020-08-20,Zimbabwe,102,1,5745,151
2020-08-21,Zimbabwe,70,1,5815,152
2020-08-22,Zimbabwe,78,1,5893,153
2020-08-23,Zimbabwe,37,2,5930,155
2020-08-24,Zimbabwe,140,0,6070,155
2020-08-25,Zimbabwe,126,11,6196,166
2020-08-26,Zimbabwe,55,13,6251,179
2020-08-27,Zimbabwe,41,10,6292,189
2020-08-28,Zimbabwe,96,6,6388,195
2020-08-29,Zimbabwe,18,1,6406,196
2020-08-30,Zimbabwe,6,0,6412,196
2020-08-31,Zimbabwe,85,6,6497,202
2020-09-01,Zimbabwe,62,1,6559,203
2020-09-02,Zimbabwe,79,3,6638,206
2020-09-03,Zimbabwe,40,0,6678,206
2020-09-04,Zimbabwe,159,0,6837,206
2020-09-05,Zimbabwe,0,0,6837,206
2020-09-06,Zimbabwe,0,0,6837,206
2020-09-07,Zimbabwe,461,4,7298,210
2020-09-08,Zimbabwe,90,8,7388,218
2020-09-09,Zimbabwe,41,4,7429,222
2020-09-10,Zimbabwe,24,0,7453,222
2020-09-11,Zimbabwe,26,2,7479,224
2020-09-12,Zimbabwe,29,0,7508,224
2020-09-13,Zimbabwe,18,0,7526,224
2020-09-14,Zimbabwe,5,0,7531,224
2020-09-15,Zimbabwe,45,0,7576,224
2020-09-16,Zimbabwe,22,0,7598,224
2020-09-17,Zimbabwe,35,0,7633,224
2020-09-18,Zimbabwe,14,0,7647,224
2020-09-19,Zimbabwe,25,1,7672,225
2020-09-20,Zimbabwe,11,0,7683,225
2020-09-21,Zimbabwe,0,0,7683,225
2020-09-22,Zimbabwe,28,1,7711,226
2020-09-23,Zimbabwe,14,1,7725,227
2020-09-24,Zimbabwe,27,0,7752,227
2020-09-25,Zimbabwe,35,0,7787,227
2020-09-26,Zimbabwe,16,0,7803,227
2020-09-27,Zimbabwe,9,0,7812,227
2020-09-28,Zimbabwe,4,1,7816,228
2020-09-29,Zimbabwe,21,0,7837,228
2020-09-30,Zimbabwe,1,0,7838,228
2020-10-01,Zimbabwe,12,0,7850,228
2020-10-02,Zimbabwe,8,0,7858,228
2020-10-03,Zimbabwe,27,0,7885,228
2020-10-04,Zimbabwe,3,0,7888,228
2020-10-05,Zimbabwe,10,0,7898,228
2020-10-06,Zimbabwe,17,1,7915,229
2020-10-07,Zimbabwe,4,0,7919,229
2020-10-08,Zimbabwe,32,0,7951,229
2020-10-09,Zimbabwe,43,0,7994,229
2020-10-10,Zimbabwe,16,1,8010,230
2020-10-11,Zimbabwe,1,0,8011,230
2020-10-12,Zimbabwe,10,0,8021,230
2020-10-13,Zimbabwe,15,0,8036,230
2020-10-14,Zimbabwe,19,1,8055,231
2020-10-15,Zimbabwe,20,0,8075,231
2020-10-16,Zimbabwe,24,0,8099,231
2020-10-17,Zimbabwe,11,0,8110,231
2020-10-18,Zimbabwe,37,0,8147,231
2020-10-19,Zimbabwe,12,1,8159,232
2020-10-20,Zimbabwe,28,1,8187,233
2020-10-21,Zimbabwe,28,3,8215,236
2020-10-22,Zimbabwe,27,0,8242,236
2020-10-23,Zimbabwe,15,0,8257,236
2020-10-24,Zimbabwe,12,0,8269,236
2020-10-25,Zimbabwe,7,1,8276,237
2020-10-26,Zimbabwe,27,5,8303,242
2020-10-27,Zimbabwe,12,0,8315,242
2020-10-28,Zimbabwe,5,0,8320,242
2020-10-29,Zimbabwe,29,0,8349,242
2020-10-30,Zimbabwe,13,0,8362,242
2020-10-31,Zimbabwe,5,1,8367,243
2020-11-01,Zimbabwe,7,0,8374,243
2020-11-02,Zimbabwe,15,2,8389,245
2020-11-03,Zimbabwe,21,1,8410,246
2020-11-04,Zimbabwe,17,2,8427,248
2020-11-05,Zimbabwe,17,0,8444,248
2020-11-06,Zimbabwe,27,2,8471,250
2020-11-07,Zimbabwe,27,1,8498,251
2020-11-08,Zimbabwe,33,2,8531,253
2020-11-09,Zimbabwe,30,1,8561,254
2020-11-10,Zimbabwe,49,1,8610,255
2020-11-11,Zimbabwe,57,0,8667,255
2020-11-12,Zimbabwe,29,0,8696,255
2020-11-13,Zimbabwe,69,2,8765,257
2020-11-14,Zimbabwe,21,0,8786,257
2020-11-15,Zimbabwe,43,0,8829,257
2020-11-16,Zimbabwe,68,0,8897,257
2020-11-17,Zimbabwe,48,3,8945,260
2020-11-18,Zimbabwe,36,1,8981,261
2020-11-19,Zimbabwe,65,4,9046,265
2020-11-20,Zimbabwe,74,0,9120,265
2020-11-21,Zimbabwe,52,0,9172,265
2020-11-22,Zimbabwe,48,3,9220,268
2020-11-23,Zimbabwe,88,5,9308,273
2020-11-24,Zimbabwe,90,1,9398,274
2020-11-25,Zimbabwe,110,0,9508,274
2020-11-26,Zimbabwe,115,0,9623,274
2020-11-27,Zimbabwe,91,1,9714,275
2020-11-28,Zimbabwe,108,0,9822,275
2020-11-29,Zimbabwe,0,0,9822,275
2020-11-30,Zimbabwe,128,1,9950,276
2020-12-01,Zimbabwe,179,1,10129,277
2020-12-02,Zimbabwe,0,0,10129,277
2020-12-03,Zimbabwe,295,3,10424,280
2020-12-04,Zimbabwe,123,1,10547,281
2020-12-05,Zimbabwe,70,10,10617,291
2020-12-06,Zimbabwe,101,0,10718,291
2020-12-07,Zimbabwe,121,3,10839,294
2020-12-08,Zimbabwe,73,9,10912,303
2020-12-09,Zimbabwe,95,1,11007,304
2020-12-10,Zimbabwe,74,1,11081,305
2020-12-11,Zimbabwe,81,1,11162,306
2020-12-12,Zimbabwe,57,1,11219,307
2020-12-13,Zimbabwe,27,0,11246,307
2020-12-14,Zimbabwe,112,2,11358,309
2020-12-15,Zimbabwe,164,1,11522,310
2020-12-16,Zimbabwe,227,3,11749,313
2020-12-17,Zimbabwe,117,1,11866,314
2020-12-18,Zimbabwe,181,2,12047,316
2020-12-19,Zimbabwe,104,2,12151,318
2020-12-20,Zimbabwe,174,2,12325,320
2020-12-21,Zimbabwe,97,2,12422,322
2020-12-22,Zimbabwe,122,4,12544,326
2020-12-23,Zimbabwe,112,4,12656,330
2020-12-24,Zimbabwe,130,9,12786,339
2020-12-25,Zimbabwe,94,2,12880,341
2020-12-26,Zimbabwe,83,0,12963,341
2020-12-27,Zimbabwe,114,8,13077,349
2020-12-28,Zimbabwe,71,5,13148,354
2020-12-29,Zimbabwe,177,5,13325,359
2020-12-30,Zimbabwe,300,1,13625,360
2020-12-31,Zimbabwe,242,3,13867,363
2021-01-01,Zimbabwe,217,6,14084,369
2021-01-02,Zimbabwe,407,8,14491,377
2021-01-03,Zimbabwe,774,3,15265,380
2021-01-04,Zimbabwe,564,4,15829,384
2021-01-05,Zimbabwe,1365,34,17194,418
2021-01-06,Zimbabwe,610,13,17804,431
2021-01-07,Zimbabwe,871,15,18675,446
2021-01-08,Zimbabwe,985,22,19660,468
2021-01-09,Zimbabwe,839,15,20499,483
2021-01-10,Zimbabwe,978,24,21477,507
2021-01-11,Zimbabwe,820,21,22297,528
2021-01-12,Zimbabwe,942,23,23239,551
2021-01-13,Zimbabwe,1017,38,24256,589
2021-01-14,Zimbabwe,1112,47,25368,636
2021-01-15,Zimbabwe,741,30,26109,666
2021-01-16,Zimbabwe,772,17,26881,683
2021-01-17,Zimbabwe,322,30,27203,713
2021-01-18,Zimbabwe,689,60,27892,773
2021-01-19,Zimbabwe,783,52,28675,825
2021-01-20,Zimbabwe,733,54,29408,879
2021-01-21,Zimbabwe,639,38,30047,917
2021-01-22,Zimbabwe,476,45,30523,962
2021-01-23,Zimbabwe,484,12,31007,974
2021-01-24,Zimbabwe,313,31,31320,1005
2021-01-25,Zimbabwe,326,70,31646,1075
2021-01-26,Zimbabwe,358,28,32004,1103
2021-01-27,Zimbabwe,300,19,32304,1122
2021-01-28,Zimbabwe,342,38,32646,1160
2021-01-29,Zimbabwe,306,18,32952,1178
2021-01-30,Zimbabwe,321,15,33273,1193
2021-01-31,Zimbabwe,115,24,33388,1217
2021-02-01,Zimbabwe,160,17,33548,1234
2021-02-02,Zimbabwe,266,20,33814,1254
2021-02-03,Zimbabwe,150,15,33964,1269
2021-02-04,Zimbabwe,207,19,34171,1288
2021-02-05,Zimbabwe,160,15,34331,1303
2021-02-06,Zimbabwe,156,13,34487,1316
2021-02-07,Zimbabwe,65,10,34552,1326
2021-02-08,Zimbabwe,106,13,34658,1339
2021-02-09,Zimbabwe,123,14,34781,1353
2021-02-10,Zimbabwe,83,11,34864,1364
2021-02-11,Zimbabwe,0,0,34864,1364
2021-02-12,Zimbabwe,181,29,35045,1393
2021-02-13,Zimbabwe,59,5,35104,1398
2021-02-14,Zimbabwe,68,2,35172,1400
2021-02-15,Zimbabwe,50,10,35222,1410
2021-02-16,Zimbabwe,93,4,35315,1414
2021-02-17,Zimbabwe,108,4,35423,1418
2021-02-18,Zimbabwe,120,2,35543,1420
2021-02-19,Zimbabwe,167,10,35710,1430
2021-02-20,Zimbabwe,58,2,35768,1432
2021-02-21,Zimbabwe,28,4,35796,1436
2021-02-22,Zimbabwe,66,5,35862,1441
2021-02-23,Zimbabwe,48,7,35910,1448
2021-02-24,Zimbabwe,50,8,35960,1456
2021-02-25,Zimbabwe,34,2,35994,1458
2021-02-26,Zimbabwe,50,5,36044,1463
2021-02-27,Zimbabwe,14,0,36058,1463
2021-02-28,Zimbabwe,31,0,36089,1463
2021-03-01,Zimbabwe,26,5,36115,1468
2021-03-02,Zimbabwe,33,4,36148,1472
2021-03-03,Zimbabwe,31,6,36179,1478
2021-03-04,Zimbabwe,44,5,36223,1483
2021-03-05,Zimbabwe,25,1,36248,1484
2021-03-06,Zimbabwe,12,1,36260,1485
2021-03-07,Zimbabwe,11,0,36271,1485
2021-03-08,Zimbabwe,18,2,36289,1487
2021-03-09,Zimbabwe,32,2,36321,1489
2021-03-10,Zimbabwe,20,0,36341,1489
2021-03-11,Zimbabwe,36,3,36377,1492
2021-03-12,Zimbabwe,46,4,36423,1496
2021-03-13,Zimbabwe,48,5,36471,1501
2021-03-14,Zimbabwe,13,2,36484,1503
2021-03-15,Zimbabwe,20,1,36504,1504
2021-03-16,Zimbabwe,31,3,36535,1507
2021-03-17,Zimbabwe,17,1,36552,1508
2021-03-18,Zimbabwe,59,1,36611,1509
2021-03-19,Zimbabwe,41,1,36652,1510
2021-03-20,Zimbabwe,10,0,36662,1510
2021-03-21,Zimbabwe,3,2,36665,1512
2021-03-22,Zimbabwe,19,2,36684,1514
2021-03-23,Zimbabwe,33,2,36717,1516
2021-03-24,Zimbabwe,32,0,36749,1516
2021-03-25,Zimbabwe,29,2,36778,1518
2021-03-26,Zimbabwe,27,0,36805,1518
2021-03-27,Zimbabwe,13,1,36818,1519
2021-03-28,Zimbabwe,4,1,36822,1520
2021-03-29,Zimbabwe,17,0,36839,1520
2021-03-30,Zimbabwe,0,0,36839,1520
2021-03-31,Zimbabwe,43,3,36882,1523
2021-04-01,Zimbabwe,14,0,36896,1523
2021-04-02,Zimbabwe,7,1,36903,1524
2021-04-03,Zimbabwe,8,0,36911,1524
2021-04-04,Zimbabwe,12,1,36923,1525
2021-04-05,Zimbabwe,11,0,36934,1525
2021-04-06,Zimbabwe,32,6,36966,1531
2021-04-07,Zimbabwe,18,0,36984,1531
2021-04-08,Zimbabwe,68,1,37052,1532
